p_306,3,4,e_0,2,17,23,3.0,0,0,0.0,3,0,0,15,6,21
p_550,6,9,e_1,28,32,46,2.0,2,0,5.0,5,1,1,4,14,18
p_70,0,11,e_1,4,4,56,0.0,0,0,0.0,3,0,0,0,52,52
p_551,6,11,e_1,10,32,56,6.0,0,0,1.0,5,1,0,22,24,46
p_622,7,14,e_2,5,36,68,7.0,0,0,0.0,3,0,0,31,32,63
p_69,0,6,e_0,13,41,71,17.5,1,1,2.5,5,0,1,28,30,58
p_763,9,15,e_3,10,51,77,9.0,0,0,0.0,3,0,0,41,26,67
p_1239,15,12,e_1,67,74,88,2.5,2,0,13.5,5,0,1,7,14,21
p_549,6,10,e_0,51,71,89,15.0,1,1,2.0,5,2,1,20,18,38
p_1240,15,10,e_1,31,74,98,10.0,2,0,6.0,5,1,1,43,24,67
p_391,4,12,e_0,46,61,99,14.0,2,2,1.0,5,1,1,15,38,53
p_1015,12,7,e_2,53,58,100,9.0,2,1,11.0,5,1,0,5,42,47
p_1014,12,13,e_0,71,99,105,28.0,2,2,6.0,2,3,2,28,6,34
p_1013,12,13,e_0,89,99,105,20.0,1,1,10.0,5,3,1,10,6,16
p_762,9,7,e_3,91,103,113,2.0,1,0,11.5,4,1,0,12,10,22
p_463,5,4,e_2,99,110,116,4.0,2,0,7.0,1,4,0,11,6,17
p_916,11,3,e_2,60,82,122,8.0,2,1,12.5,5,2,0,22,40,62
p_1161,14,2,e_2,25,68,128,11.0,1,0,4.5,5,0,1,43,60,103
p_1160,14,1,e_2,56,68,134,6.0,2,1,12.0,5,1,1,12,66,78
p_621,7,2,e_3,27,41,135,7.0,1,1,4.0,5,0,1,14,94,108
p_687,8,6,e_0,125,129,139,24.0,2,2,8.5,4,3,2,4,10,14
p_141,1,0,e_2,104,134,140,8.0,2,2,6.5,4,3,1,30,6,36
p_223,2,4,e_3,92,135,145,9.5,2,0,11.5,4,1,1,43,10,53
p_689,8,5,e_0,108,129,145,28.0,2,2,12.5,4,2,1,21,16,37
p_915,11,4,e_0,109,115,151,25.0,2,2,12.0,4,2,2,6,36,42
p_688,8,4,e_0,124,129,151,24.5,2,2,9.0,4,3,2,5,22,27
p_465,5,10,e_1,79,124,156,15.5,1,1,14.0,4,2,0,45,32,77
p_547,6,3,e_0,59,71,157,13.5,2,1,3.5,5,2,3,12,86,98
p_460,5,7,e_3,141,151,161,2.0,5,1,3.0,5,2,3,10,10,20
p_464,5,11,e_1,97,124,162,11.5,2,1,10.0,4,1,3,27,38,65
p_390,4,11,e_1,113,130,162,7.0,1,1,7.0,4,1,2,17,32,49
p_389,4,2,e_0,131,151,163,26.5,3,3,8.0,4,5,1,20,12,32
p_222,2,8,e_3,112,135,167,5.0,2,0,7.0,4,2,0,23,32,55
p_144,1,0,e_0,40,47,175,10.0,2,1,0.0,3,0,0,7,128,135
p_548,6,0,e_0,55,71,175,14.5,2,1,3.0,5,2,2,16,104,120
p_142,1,9,e_2,73,134,178,16.5,2,2,13.0,4,3,1,61,44,105
p_690,8,14,e_1,83,108,180,17.5,1,1,13.0,4,2,1,25,72,97
p_462,5,14,e_1,120,124,180,6.5,1,1,5.5,4,2,2,4,56,60
p_761,9,10,e_2,159,178,184,3.0,6,2,4.5,5,3,0,19,6,25
p_546,6,15,e_1,88,118,186,14.5,1,1,12.0,4,1,2,30,68,98
p_1012,12,15,e_1,149,168,186,7.0,5,3,8.5,5,4,1,19,18,37
p_139,1,3,e_0,166,169,189,23.0,6,6,1.5,4,2,1,3,20,23
p_461,5,12,e_3,129,151,189,4.0,2,1,3.0,4,1,1,22,38,60
p_140,1,12,e_2,124,134,194,3.5,2,0,2.5,4,2,0,10,60,70
p_68,0,14,e_2,135,140,204,18.0,4,4,1.0,4,3,0,5,64,69
p_620,7,15,e_3,149,161,205,2.0,5,0,5.0,5,1,4,12,44,56
p_1159,14,15,e_2,199,204,210,30.0,5,5,13.0,5,1,1,5,6,11
p_1095,13,10,e_1,144,174,212,9.0,4,4,7.0,5,4,0,30,38,68
p_305,3,8,e_0,58,157,215,22.5,2,2,3.5,5,2,2,99,58,157
p_1091,13,9,e_1,191,196,218,5.0,4,1,14.0,4,4,2,5,22,27
p_143,1,9,e_0,53,169,221,22.0,2,2,2.5,5,2,1,116,52,168
p_618,7,9,e_0,189,209,221,25.0,4,4,3.0,5,2,1,20,12,32
p_1094,13,12,e_3,146,195,221,9.0,4,0,4.0,5,1,3,49,26,75
p_1237,15,8,e_1,160,186,224,8.0,5,0,11.0,5,3,2,26,38,64
p_619,7,13,e_0,169,209,239,29.0,5,5,1.0,1,2,0,40,30,70
p_686,8,13,e_0,194,215,239,25.0,3,3,4.0,5,2,1,21,24,45
p_829,10,7,e_3,120,177,243,23.5,1,1,5.5,4,1,0,57,66,123
p_1235,15,7,e_2,191,210,244,3.0,4,0,11.5,5,2,0,19,34,53
p_1236,15,3,e_1,170,186,248,6.5,5,0,12.0,5,2,1,16,62,78
p_1093,13,3,e_1,177,196,248,7.0,5,1,13.5,5,3,0,19,52,71
p_1011,12,3,e_1,187,202,248,6.0,5,2,15.0,4,4,1,15,46,61
p_1090,13,6,e_3,196,215,249,4.0,4,1,13.0,5,4,0,19,34,53
p_459,5,15,e_0,194,199,251,22.0,3,3,4.0,5,2,1,5,52,57
p_760,9,15,e_0,182,221,251,28.0,5,5,1.5,5,3,1,39,30,69
p_1092,13,2,e_1,179,196,254,7.0,5,1,14.0,5,3,1,17,58,75
p_1010,12,5,e_3,215,221,255,1.0,3,0,13.0,1,3,0,6,34,40
p_1234,15,5,e_2,197,210,256,1.5,5,0,12.5,5,1,1,13,46,59
p_1238,15,1,e_1,142,186,260,11.5,5,0,7.0,5,4,0,44,74,118
p_386,4,1,e_1,221,242,260,8.0,4,2,8.5,4,4,1,21,18,39
p_218,2,1,e_1,250,254,260,4.0,3,3,2.5,4,3,1,4,6,10
p_617,7,4,e_3,239,243,261,0.0,5,0,7.5,4,4,1,4,18,22
p_1232,15,13,e_0,237,251,261,20.5,5,5,12.5,5,2,1,14,10,24
p_219,2,0,e_1,243,254,266,5.0,4,4,4.0,4,4,0,11,12,23
p_914,11,3,e_3,141,183,267,8.0,4,0,3.0,5,2,2,42,84,126
p_138,1,4,e_1,231,260,284,8.5,5,0,6.5,4,3,1,29,24,53
p_220,2,6,e_2,219,270,290,10.5,4,0,13.0,4,2,0,51,20,71
p_1158,14,7,e_0,215,245,295,26.0,3,3,8.0,5,3,0,30,50,80
p_387,4,10,e_3,219,261,299,10.5,4,1,12.5,4,4,0,42,38,80
p_828,10,6,e_0,252,277,301,22.5,3,3,15.0,4,4,1,25,24,49
p_221,2,7,e_1,199,254,302,18.0,5,5,12.5,4,6,2,55,48,103
p_458,5,11,e_3,238,255,305,7.0,5,2,8.0,4,4,1,17,50,67
p_1233,15,5,e_0,228,251,307,22.5,5,5,10.5,5,2,1,23,56,79
p_615,7,8,e_1,299,302,308,25.0,4,4,6.5,5,5,0,3,6,9
p_545,6,10,e_2,237,250,310,8.5,5,3,8.5,4,2,1,13,60,73
p_616,7,12,e_3,264,285,311,4.5,4,0,3.5,4,4,0,21,26,47
p_913,11,4,e_0,250,271,313,22.0,3,3,15.0,5,3,0,21,42,63
p_685,8,4,e_0,265,289,313,22.0,5,5,12.5,4,3,3,24,24,48
p_543,6,9,e_1,288,296,314,26.5,5,5,5.0,5,3,2,8,18,26
p_385,4,13,e_3,222,261,317,10.0,5,1,12.0,4,4,1,39,56,95
p_1089,13,3,e_0,235,239,319,23.0,5,5,12.0,5,2,1,4,80,84
p_758,9,12,e_2,295,304,322,28.0,5,5,7.0,5,2,1,9,18,27
p_67,0,11,e_1,261,266,324,4.0,2,0,1.0,4,4,1,5,58,63
p_544,6,11,e_1,245,296,324,7.0,4,3,3.5,4,4,0,51,28,79
p_757,9,11,e_1,309,314,324,25.0,4,4,8.0,5,4,0,5,10,15
p_759,9,1,e_0,263,283,329,21.5,4,4,12.5,4,3,2,20,46,66
p_384,4,0,e_0,307,313,335,13.0,4,3,5.0,1,4,1,6,22,28
p_456,5,15,e_2,267,284,336,6.0,4,0,2.5,4,1,1,17,52,69
p_1088,13,11,e_3,277,317,337,7.5,4,0,5.5,5,3,1,40,20,60
p_388,4,14,e_1,194,242,338,21.0,3,3,13.0,4,4,2,48,96,144
p_304,3,4,e_0,321,349,355,17.5,3,3,3.0,4,2,1,28,6,34
p_912,11,9,e_2,273,316,362,10.5,4,1,2.5,5,2,1,43,46,89
p_383,4,7,e_0,324,355,371,18.0,3,2,2.0,4,2,2,31,16,47
p_455,5,7,e_0,334,361,371,16.5,3,2,0.0,3,1,3,27,10,37
p_1157,14,2,e_3,282,323,375,7.5,4,0,6.5,5,3,1,41,52,93
p_66,0,9,e_0,271,335,381,22.5,4,4,11.0,1,3,3,64,46,110
p_217,2,1,e_3,325,375,381,12.0,3,1,14.0,4,3,0,50,6,56
p_457,5,3,e_1,265,290,386,25.0,5,5,0.0,3,4,1,25,96,121
p_911,11,0,e_3,297,305,387,7.0,5,3,10.0,5,4,1,8,82,90
p_1087,13,11,e_2,366,384,394,21.0,2,2,9.0,3,0,0,18,10,28
p_827,10,1,e_1,348,356,396,28.5,2,2,12.0,4,1,0,8,40,48
p_614,7,13,e_0,310,371,401,23.0,3,3,4.5,4,3,1,61,30,91
p_64,0,3,e_3,384,387,401,0.5,3,0,0.5,4,1,2,3,14,17
p_613,7,14,e_0,321,371,407,21.5,3,3,2.5,4,2,2,50,36,86
p_910,11,14,e_0,387,391,407,11.0,4,4,10.5,5,2,1,4,16,20
p_63,0,1,e_1,388,402,408,18.0,4,4,3.0,4,1,0,14,6,20
p_65,0,9,e_3,375,387,433,2.0,1,0,2.0,1,2,0,12,46,58
p_454,5,9,e_3,377,413,433,7.0,2,2,2.0,4,2,0,36,20,56
p_1231,15,10,e_0,342,413,435,25.0,2,2,1.5,5,1,5,71,22,93
p_62,0,9,e_1,397,402,446,16.0,4,4,1.0,4,0,2,5,44,49
p_216,2,9,e_1,411,414,446,27.5,3,3,1.5,5,2,2,3,32,35
p_684,8,12,e_3,420,427,447,2.0,3,0,6.5,5,2,1,7,20,27
p_1086,13,0,e_2,369,384,448,20.5,2,2,9.5,5,0,1,15,64,79
p_826,10,0,e_2,386,400,448,20.0,3,3,13.0,4,2,1,14,48,62
p_825,10,0,e_2,392,400,448,9.0,4,0,11.5,4,2,2,8,48,56
p_542,6,0,e_2,376,418,448,26.0,2,2,11.0,5,0,1,42,30,72
p_215,2,0,e_2,419,436,448,21.5,3,3,6.0,4,1,1,17,12,29
p_136,1,0,e_2,399,442,448,14.0,4,3,10.0,4,1,2,43,6,49
p_137,1,11,e_1,398,408,456,16.5,4,4,1.0,4,0,2,10,48,58
p_1008,12,14,e_3,416,447,457,7.0,2,1,5.5,5,2,0,31,10,41
p_303,3,12,e_1,410,420,462,28.5,3,3,1.5,5,2,1,10,42,52
p_1156,14,4,e_0,341,407,463,26.0,2,2,1.0,5,1,4,66,56,122
p_453,5,4,e_0,423,457,463,17.5,4,4,13.0,4,3,0,34,6,40
p_382,4,15,e_3,381,407,463,5.0,2,1,1.0,1,2,1,26,56,82
p_1152,14,15,e_3,450,457,463,2.0,4,0,12.5,5,3,1,7,6,13
p_1009,12,13,e_1,395,462,468,10.0,4,4,1.0,1,1,1,67,6,73
p_1155,14,2,e_0,343,407,473,25.5,2,2,2.0,5,1,6,64,66,130
p_135,1,6,e_2,441,442,478,20.5,4,4,1.0,4,1,1,1,36,37
p_133,1,6,e_2,449,454,478,19.0,4,4,0.0,5,1,2,5,24,29
p_452,5,1,e_0,425,457,479,17.0,5,4,12.5,4,3,1,32,22,54
p_1151,14,13,e_1,468,474,480,29.0,4,4,13.0,5,1,1,6,6,12
p_1230,15,9,e_3,438,463,489,5.0,4,0,10.0,5,3,1,25,26,51
p_754,9,8,e_3,463,489,495,6.0,4,0,15.0,2,3,2,26,6,32
p_134,1,10,e_2,446,454,496,19.0,5,5,0.5,4,2,1,8,42,50
p_1007,12,9,e_1,441,462,498,7.5,4,2,8.0,5,3,1,21,36,57
p_1154,14,7,e_3,425,457,501,8.0,4,1,8.0,5,2,2,32,44,76
p_451,5,6,e_0,492,499,505,11.5,4,2,3.5,5,1,1,7,6,13
p_381,4,13,e_2,444,468,510,22.5,4,4,1.0,4,2,0,24,42,66
p_380,4,13,e_2,445,468,510,22.5,5,5,0.5,4,2,1,23,42,65
p_824,10,13,e_2,463,496,510,25.0,4,4,3.0,5,2,1,33,14,47
p_302,3,7,e_0,471,489,511,14.0,4,1,2.5,4,2,0,18,22,40
p_683,8,4,e_3,444,495,515,10.5,4,3,11.5,5,3,1,51,20,71
p_1153,14,3,e_1,427,474,524,8.0,4,1,4.5,5,3,0,47,50,97
p_755,9,2,e_3,455,489,525,7.0,4,1,14.0,5,3,1,34,36,70
p_682,8,2,e_3,482,495,525,2.0,4,1,10.5,4,3,1,13,30,43
p_756,9,1,e_3,405,433,531,5.0,3,0,4.0,5,1,2,28,98,126
p_541,6,11,e_0,477,505,531,15.5,4,1,1.0,4,1,1,28,26,54
p_540,6,11,e_0,491,505,531,13.0,4,2,3.0,5,1,1,14,26,40
p_612,7,12,e_0,495,511,537,13.0,3,2,4.0,5,1,2,16,26,42
p_753,9,12,e_0,500,521,537,14.0,3,3,5.0,5,2,0,21,16,37
p_908,11,13,e_0,517,531,543,15.0,3,3,8.0,5,2,1,14,12,26
p_1228,15,8,e_2,502,520,550,21.0,3,3,11.5,5,1,1,18,30,48
p_752,9,15,e_0,508,521,553,12.5,3,3,6.5,5,2,1,13,32,45
p_61,0,4,e_1,509,538,556,5.5,3,0,6.5,4,1,0,29,18,47
p_301,3,5,e_3,530,551,561,4.0,2,1,1.0,1,1,2,21,10,31
p_60,0,8,e_3,512,537,577,4.5,3,0,4.5,4,3,0,25,40,65
p_379,4,9,e_1,533,556,580,4.5,3,0,1.0,4,0,1,23,24,47
p_1229,15,2,e_2,476,520,584,26.0,4,4,6.0,5,3,0,44,64,108
p_539,6,2,e_2,527,560,584,26.0,2,2,13.5,4,2,0,33,24,57
p_378,4,2,e_2,562,570,584,13.0,4,4,6.0,4,1,0,8,14,22
p_750,9,8,e_0,557,579,585,6.5,4,1,14.0,4,2,0,22,6,28
p_59,0,10,e_1,517,538,586,4.0,3,0,4.5,4,1,1,21,48,69
p_449,5,10,e_3,546,561,587,3.0,4,1,2.0,5,1,3,15,26,41
p_450,5,11,e_1,544,562,592,4.0,4,1,1.5,5,2,1,18,30,48
p_823,10,11,e_3,542,587,593,9.0,3,3,1.0,5,1,2,45,6,51
p_907,11,12,e_3,560,593,599,6.0,4,3,5.0,5,2,2,33,6,39
p_751,9,13,e_1,535,580,602,9.0,3,0,0.5,4,0,2,45,22,67
p_906,11,14,e_1,561,592,608,6.0,4,3,5.0,5,2,2,31,16,47
p_611,7,14,e_3,530,571,613,8.0,2,1,1.0,4,1,1,41,42,83
p_1227,15,1,e_0,536,553,615,15.0,2,2,12.0,2,4,0,17,62,79
p_1150,14,13,e_3,580,613,619,5.5,3,0,8.5,5,2,1,33,6,39
p_909,11,0,e_0,506,531,621,24.0,3,3,6.0,5,2,1,25,90,115
p_1085,13,12,e_3,601,607,625,3.0,4,1,12.0,2,4,0,6,18,24
p_132,1,9,e_2,572,590,626,22.0,4,4,4.0,4,1,1,18,36,54
p_377,4,9,e_2,590,604,626,21.5,2,2,1.0,5,2,0,14,22,36
p_131,1,3,e_0,619,627,639,12.0,5,0,0.0,4,1,0,8,12,20
p_1084,13,9,e_3,604,607,639,2.5,5,1,12.5,5,4,1,3,32,35
p_300,3,13,e_2,566,576,648,19.0,4,4,4.5,4,1,1,10,72,82
p_299,3,13,e_2,575,576,648,23.5,4,4,3.0,1,1,1,1,72,73
p_1006,12,7,e_3,599,599,649,4.0,4,1,12.0,2,4,1,0,50,50
p_749,9,14,e_2,607,626,654,24.0,6,6,4.5,5,2,0,19,28,47
p_822,10,14,e_2,629,632,654,15.5,4,4,9.5,5,2,0,3,22,25
p_904,11,6,e_3,589,593,655,6.5,2,1,10.5,5,2,0,4,62,66
p_538,6,5,e_3,640,655,661,3.0,3,1,9.0,4,3,0,15,6,21
p_1226,15,4,e_1,559,614,664,10.0,4,0,4.5,5,2,1,55,50,105
p_609,7,3,e_1,615,650,670,6.0,6,2,15.0,4,1,0,35,20,55
p_905,11,3,e_3,575,593,671,9.5,4,1,7.5,5,3,1,18,78,96
p_903,11,2,e_1,620,632,676,2.0,5,1,14.0,4,1,1,12,44,56
p_610,7,2,e_3,593,649,677,10.0,4,2,11.0,5,4,0,56,28,84
p_1004,12,6,e_2,630,642,688,26.0,4,4,9.5,5,2,2,12,46,58
p_130,1,15,e_0,627,627,693,10.5,4,0,1.0,2,0,2,0,66,66
p_537,6,15,e_0,648,653,693,11.0,3,2,5.0,5,2,0,5,40,45
p_1149,14,15,e_0,676,687,693,14.0,2,1,11.5,5,2,0,11,6,17
p_536,6,5,e_2,670,688,694,26.0,3,3,10.5,4,2,0,18,6,24
p_128,1,4,e_3,677,683,697,1.0,2,0,2.0,4,0,2,6,14,20
p_1005,12,4,e_2,629,642,700,26.5,4,4,9.5,5,2,1,13,58,71
p_56,0,6,e_1,675,686,712,2.5,2,0,2.0,4,1,1,11,26,37
p_608,7,10,e_3,677,711,725,7.0,1,1,2.0,4,0,1,34,14,48
p_1225,15,7,e_0,684,693,729,14.0,3,0,13.5,5,2,2,9,36,45
p_1003,12,7,e_0,684,707,729,15.0,3,1,13.5,5,2,1,23,22,45
p_1001,12,13,e_3,712,735,741,5.0,2,1,7.0,5,2,0,23,6,29
p_57,0,13,e_1,631,686,746,10.5,4,0,11.0,1,1,1,55,60,115
p_129,1,14,e_3,641,683,747,8.0,3,0,9.0,4,3,0,42,64,106
p_607,7,3,e_0,692,729,749,18.0,3,1,15.0,5,2,1,37,20,57
p_376,4,3,e_0,700,743,749,19.5,2,2,13.5,4,2,1,43,6,49
p_448,5,7,e_2,719,746,758,26.0,4,4,0.5,4,2,2,27,12,39
p_375,4,1,e_0,730,743,761,15.0,3,3,7.0,4,2,3,13,18,31
p_213,2,1,e_0,728,755,761,17.5,3,3,7.0,1,2,2,27,6,33
p_212,2,1,e_0,750,755,761,13.5,1,1,3.0,4,2,1,5,6,11
p_54,0,8,e_2,709,722,764,21.5,2,2,2.5,4,1,3,13,42,55
p_606,7,8,e_2,748,758,764,23.0,1,1,5.0,5,6,1,10,6,16
p_298,3,0,e_0,623,639,767,9.0,5,3,0.5,5,0,1,16,128,144
p_126,1,0,e_0,719,761,767,20.0,4,4,9.0,4,2,1,42,6,48
p_297,3,9,e_2,699,706,770,27.0,2,2,4.0,1,1,2,7,64,71
p_535,6,10,e_2,729,752,776,25.5,3,3,1.0,5,5,1,23,24,47
p_214,2,11,e_2,705,712,782,24.5,2,2,3.0,4,0,3,7,70,77
p_681,8,11,e_2,732,764,782,26.5,3,3,1.5,5,5,2,32,18,50
p_211,2,3,e_0,751,755,783,17.5,1,1,3.0,4,2,1,4,28,32
p_820,10,8,e_1,765,780,790,2.0,5,1,13.0,1,4,0,15,10,25
p_55,0,12,e_2,695,722,790,24.0,3,3,5.0,4,1,1,27,68,95
p_901,11,12,e_2,694,782,790,8.0,3,2,5.0,4,1,1,88,8,96
p_998,12,8,e_3,759,767,791,1.0,4,0,13.5,4,2,2,8,24,32
p_748,9,8,e_3,767,785,791,3.0,5,2,12.0,4,3,2,18,6,24
p_900,11,7,e_3,751,773,797,4.5,1,1,14.5,5,0,1,22,24,46
p_127,1,14,e_2,718,728,800,22.5,4,4,1.0,4,2,1,10,72,82
p_902,11,14,e_2,686,782,800,10.0,3,2,6.0,4,2,0,96,18,114
p_899,11,5,e_3,771,773,807,0.0,6,0,11.5,4,3,3,2,34,36
p_821,10,5,e_3,754,779,807,5.0,3,1,15.0,4,2,1,25,28,53
p_819,10,5,e_3,770,779,807,1.0,6,0,11.5,4,3,3,9,28,37
p_210,2,8,e_0,769,777,809,11.5,6,1,0.5,5,2,0,8,32,40
p_604,7,8,e_0,783,803,809,14.5,6,3,3.0,2,4,1,20,6,26
p_1219,15,14,e_2,786,806,812,23.0,5,5,11.5,5,3,1,20,6,26
p_1002,12,3,e_1,708,738,814,9.5,2,1,5.5,5,2,0,30,76,106
p_1000,12,3,e_1,716,738,814,8.0,3,1,7.0,5,1,1,22,76,98
p_1081,13,3,e_1,753,766,814,6.0,1,0,14.5,5,3,1,13,48,61
p_446,5,3,e_1,789,804,814,3.0,5,1,8.0,1,5,0,15,10,25
p_209,2,10,e_0,770,777,819,11.5,6,1,0.5,5,2,1,7,42,49
p_1083,13,2,e_1,721,746,820,8.0,4,2,8.0,5,1,2,25,74,99
p_1222,15,2,e_3,749,753,821,0.5,1,0,14.5,5,0,1,4,68,72
p_999,12,1,e_1,739,740,826,5.5,3,3,12.0,5,2,1,1,86,87
p_1082,13,1,e_1,735,746,826,5.0,3,2,11.5,5,1,2,11,80,91
p_1224,15,1,e_3,717,753,827,6.5,3,0,8.5,5,2,1,36,74,110
p_58,0,12,e_0,625,767,829,12.0,4,0,1.0,5,0,2,142,62,204
p_53,0,12,e_0,741,767,829,17.0,2,2,4.0,4,2,3,26,62,88
p_445,5,12,e_0,790,793,829,11.0,5,2,4.5,5,3,2,3,36,39
p_605,7,12,e_0,773,803,829,16.0,7,3,1.5,5,2,1,30,26,56
p_1223,15,0,e_1,718,756,832,6.5,4,0,7.5,5,1,1,38,76,114
p_447,5,13,e_0,785,793,835,12.0,5,2,3.5,5,3,1,8,42,50
p_817,10,14,e_0,810,819,841,12.5,2,2,8.0,5,3,0,9,22,31
p_1221,15,9,e_2,773,806,842,25.0,5,5,9.5,5,4,0,33,36,69
p_52,0,3,e_3,812,833,847,4.0,2,0,4.0,4,2,0,21,14,35
p_997,12,7,e_2,809,824,852,22.0,2,2,14.5,4,4,3,15,28,43
p_897,11,7,e_2,791,830,852,26.0,4,4,12.0,5,2,1,39,22,61
p_747,9,7,e_2,800,842,852,26.5,3,3,14.0,5,1,2,42,10,52
p_374,4,5,e_1,815,850,856,7.0,3,3,3.0,4,3,0,35,6,41
p_1080,13,6,e_2,808,818,858,21.0,2,2,14.5,4,4,1,10,40,50
p_1218,15,13,e_0,832,847,859,15.0,5,5,12.5,5,2,0,15,12,27
p_1220,15,5,e_2,781,806,864,23.5,6,6,11.0,5,3,1,25,58,83
p_818,10,4,e_2,809,836,870,24.0,2,2,14.5,4,4,2,27,34,61
p_898,11,3,e_2,783,784,876,27.5,6,6,11.0,5,2,1,1,92,93
p_125,1,10,e_3,794,827,877,6.5,4,0,7.5,4,4,0,33,50,83
p_816,10,2,e_2,828,836,882,21.0,5,5,11.0,4,5,2,8,46,54
p_123,1,11,e_3,802,827,883,5.0,3,0,6.0,4,3,0,25,56,81
p_1148,14,7,e_0,842,853,885,14.0,5,1,14.0,5,0,1,11,32,43
p_208,2,14,e_3,801,821,897,6.5,3,1,6.5,4,3,0,20,76,96
p_122,1,3,e_2,855,888,900,26.5,4,4,6.5,4,5,0,33,12,45
p_206,2,3,e_2,891,894,900,19.0,4,4,1.5,5,3,0,3,6,9
p_124,1,15,e_3,800,827,903,5.5,3,0,6.5,4,3,0,27,76,103
p_533,6,3,e_0,859,891,905,18.5,4,4,13.0,4,1,0,32,14,46
p_121,1,5,e_2,873,888,910,21.5,4,4,3.5,4,2,1,15,22,37
p_603,7,2,e_0,862,885,911,16.5,4,4,12.5,4,1,1,23,26,49
p_120,1,3,e_0,906,917,927,13.5,5,0,3.0,4,3,0,11,10,21
p_896,11,9,e_3,881,883,933,8.5,3,2,10.5,5,3,0,2,50,52
p_1079,13,8,e_3,905,913,939,1.0,4,0,14.5,4,2,2,8,26,34
p_996,12,7,e_1,865,888,940,10.5,4,2,6.5,5,1,2,23,52,75
p_746,9,11,e_2,916,930,940,13.5,4,2,6.5,5,1,2,14,10,24
p_678,8,6,e_1,912,934,946,5.0,4,2,13.5,4,3,1,22,12,34
p_600,7,6,e_1,916,940,946,5.0,4,3,12.0,4,3,2,24,6,30
p_532,6,8,e_0,864,891,949,29.0,4,4,12.0,4,1,1,27,58,85
p_679,8,13,e_2,910,924,952,13.5,5,1,5.0,5,1,0,14,28,42
p_602,7,5,e_1,890,940,952,10.5,4,2,12.0,2,2,2,50,12,62
p_530,6,5,e_3,929,949,955,3.0,5,1,9.5,4,3,2,20,6,26
p_1147,14,4,e_3,871,897,961,7.0,4,1,9.0,5,4,0,26,64,90
p_895,11,4,e_3,896,923,961,5.0,3,1,14.0,2,3,1,27,38,65
p_995,12,3,e_1,888,890,962,6.0,4,2,12.0,5,2,2,2,72,74
p_1217,15,3,e_1,847,904,962,12.0,4,0,3.5,5,0,3,57,58,115
p_601,7,3,e_1,908,940,962,7.0,5,4,14.5,4,3,1,32,22,54
p_207,2,15,e_2,861,882,962,25.5,4,4,5.5,4,4,1,21,80,101
p_994,12,15,e_2,913,946,962,17.0,4,4,5.5,5,1,1,33,16,49
p_531,6,11,e_0,873,891,965,26.5,4,4,9.5,4,1,1,18,74,92
p_534,6,1,e_1,837,862,972,23.5,5,4,1.0,5,0,1,25,110,135
p_373,4,2,e_3,903,961,973,11.0,4,0,15.0,2,3,2,58,12,70
p_372,4,2,e_3,924,961,973,7.0,3,2,11.0,4,3,0,37,12,49
p_680,8,1,e_3,885,939,979,10.5,3,2,11.5,5,3,0,54,40,94
p_444,5,1,e_3,941,955,979,2.0,4,1,7.5,4,2,2,14,24,38
p_205,2,4,e_3,929,973,993,9.5,4,1,9.5,4,3,1,44,20,64
p_202,2,3,e_1,983,988,994,1.0,5,0,1.0,5,2,1,5,6,11
p_1216,15,7,e_2,908,962,996,25.0,5,5,4.5,5,2,0,54,34,88
p_745,9,6,e_0,939,955,1001,28.0,4,4,5.5,5,2,1,16,46,62
p_993,12,6,e_0,929,971,1001,26.5,5,5,3.0,5,2,0,42,30,72
p_992,12,6,e_0,951,971,1001,22.5,4,4,8.5,5,1,2,20,30,50
p_119,1,7,e_3,925,979,1007,10.0,3,0,11.0,4,3,0,54,28,82
p_744,9,3,e_0,974,985,1015,22.0,5,5,11.5,4,1,0,11,30,41
p_677,8,3,e_0,979,991,1015,19.0,5,3,10.5,4,1,1,12,24,36
p_204,2,9,e_3,937,973,1017,8.5,5,1,8.5,4,2,3,36,44,80
p_529,6,2,e_2,951,1002,1020,28.5,4,4,13.0,5,2,0,51,18,69
p_528,6,2,e_0,967,1001,1021,26.0,2,2,11.0,5,1,1,34,20,54
p_51,0,9,e_1,843,978,1022,27.5,5,5,2.5,5,0,2,135,44,179
p_443,5,10,e_1,982,1004,1028,4.0,5,1,0.5,5,2,0,22,24,46
p_203,2,12,e_3,941,973,1031,7.5,4,1,7.5,4,2,2,32,58,90
p_201,2,4,e_2,993,1020,1032,26.0,4,4,7.5,4,1,2,27,12,39
p_295,3,4,e_2,1019,1026,1032,22.0,3,3,2.0,4,2,1,7,6,13
p_894,11,12,e_1,1027,1034,1040,28.0,3,3,10.0,5,2,1,7,6,13
p_296,3,14,e_3,963,967,1041,4.5,2,2,3.5,4,2,0,4,74,78
p_48,0,3,e_0,998,1031,1045,23.0,4,4,6.5,4,2,1,33,14,47
p_50,0,13,e_1,951,978,1046,5.5,4,0,5.0,1,3,1,27,68,95
p_990,12,14,e_1,1031,1040,1052,28.0,2,2,10.5,5,3,2,9,12,21
p_1076,13,14,e_1,1040,1046,1052,27.0,2,2,12.0,5,4,1,6,6,12
p_599,7,8,e_2,990,996,1052,4.0,5,1,8.0,4,1,1,6,56,62
p_442,5,10,e_2,1021,1038,1062,23.5,3,3,2.0,5,2,2,17,24,41
p_1146,14,11,e_1,1042,1052,1066,30.0,3,3,12.0,5,4,1,10,14,24
p_597,7,8,e_0,1050,1063,1069,19.0,3,2,4.0,5,2,0,13,6,19
p_991,12,7,e_3,992,1031,1073,8.0,4,4,4.0,3,5,0,39,42,81
p_815,10,9,e_1,985,1028,1078,16.0,5,2,1.5,5,2,2,43,50,93
p_49,0,10,e_0,980,1031,1079,27.0,5,5,10.0,4,1,2,51,48,99
p_676,8,13,e_2,1021,1052,1080,26.5,3,3,2.0,5,2,2,31,28,59
p_675,8,11,e_0,1052,1069,1085,19.5,4,4,4.5,5,2,1,17,16,33
p_814,10,14,e_2,993,1062,1086,6.0,4,2,7.5,4,1,1,69,24,93
p_813,10,7,e_1,997,1028,1088,13.0,4,2,3.5,5,2,2,31,60,91
p_812,10,7,e_1,1015,1028,1088,9.5,3,2,7.5,5,3,0,13,60,73
p_598,7,4,e_3,1017,1073,1089,12.0,2,2,9.0,2,3,0,56,16,72
p_294,3,12,e_0,1027,1045,1091,20.0,3,3,0.5,4,0,1,18,46,64
p_743,9,3,e_3,1060,1063,1095,0.0,4,0,9.5,4,1,3,3,32,35
p_441,5,3,e_3,1071,1083,1095,2.0,5,0,7.5,4,2,3,12,12,24
p_370,4,3,e_3,1085,1089,1095,1.0,4,0,5.0,4,2,2,4,6,10
p_1215,15,14,e_2,1062,1092,1098,24.0,5,5,10.0,5,2,2,30,6,36
p_1078,13,5,e_1,1013,1046,1100,6.5,3,1,7.0,5,3,0,33,54,87
p_293,3,2,e_3,1051,1095,1101,9.0,3,2,12.0,4,1,2,44,6,50
p_371,4,1,e_3,1039,1089,1107,10.5,2,1,13.5,5,2,0,50,18,68
p_811,10,3,e_1,1068,1072,1110,28.0,5,5,11.0,4,4,1,4,38,42
p_527,6,3,e_1,1025,1094,1110,11.5,3,2,9.5,5,2,0,69,16,85
p_1077,13,1,e_1,1027,1046,1120,4.0,3,1,10.0,2,2,2,19,74,93
p_45,0,2,e_3,1111,1113,1123,0.5,5,0,0.5,4,2,3,2,10,12
p_893,11,9,e_2,1040,1068,1124,11.0,3,0,5.5,5,2,0,28,56,84
p_1214,15,9,e_2,1069,1092,1124,22.5,5,5,11.0,5,4,2,23,32,55
p_1145,14,9,e_0,1081,1101,1125,21.5,5,5,10.0,5,2,0,20,24,44
p_890,11,9,e_0,1090,1115,1125,23.0,4,4,12.0,2,2,1,25,10,35
p_889,11,7,e_2,1100,1114,1134,21.0,3,3,14.0,4,3,0,14,20,34
p_292,3,5,e_3,1059,1095,1139,12.5,4,1,9.5,4,1,3,36,44,80
p_291,3,5,e_3,1084,1095,1139,8.0,4,2,5.0,4,2,2,11,44,55
p_674,8,6,e_0,1090,1131,1143,26.0,4,4,12.0,2,2,2,41,12,53
p_892,11,5,e_2,1041,1068,1144,11.0,3,0,5.5,5,2,1,27,76,103
p_988,12,4,e_2,1101,1108,1150,20.0,3,3,13.5,4,3,1,7,42,49
p_595,7,4,e_2,1118,1134,1150,20.0,7,3,10.0,4,5,0,16,16,32
p_46,0,7,e_3,1074,1113,1151,7.0,5,0,7.0,4,2,3,39,38,77
p_199,2,7,e_3,1115,1123,1151,2.0,7,0,0.0,5,5,2,8,28,36
p_368,4,7,e_3,1113,1133,1151,4.0,7,1,0.0,5,5,2,20,18,38
p_891,11,4,e_0,1077,1085,1153,25.0,5,5,10.0,5,3,0,8,68,76
p_1144,14,4,e_0,1082,1101,1153,21.0,5,5,10.5,5,2,1,19,52,71
p_594,7,8,e_1,1123,1158,1164,5.0,6,2,0.5,4,1,3,35,6,41
p_989,12,0,e_2,1049,1074,1168,30.0,3,3,7.5,5,2,1,25,94,119
p_200,2,11,e_3,1061,1101,1171,11.5,5,1,9.5,4,1,4,40,70,110
p_526,6,11,e_3,1127,1145,1171,3.0,6,2,3.0,5,4,2,18,26,44
p_741,9,10,e_1,1119,1170,1176,8.0,7,4,1.0,1,2,2,51,6,57
p_289,3,0,e_0,1114,1159,1177,25.0,7,6,11.0,4,2,3,45,18,63
p_44,0,11,e_1,1113,1126,1182,28.0,7,7,2.5,4,2,1,13,56,69
p_739,9,11,e_1,1131,1170,1182,6.0,7,4,1.0,5,2,4,39,12,51
p_42,0,3,e_2,1146,1168,1182,24.0,5,5,5.0,4,2,0,22,14,36
p_47,0,14,e_3,1040,1113,1185,14.0,2,2,14.0,2,2,1,73,72,145
p_742,9,14,e_3,1110,1161,1185,9.5,4,0,0.5,4,2,2,51,24,75
p_738,9,14,e_3,1137,1161,1185,4.0,7,2,5.0,5,5,2,24,24,48
p_43,0,4,e_2,1127,1168,1188,25.5,6,6,8.5,4,4,0,41,20,61
p_198,2,3,e_0,1139,1165,1191,27.0,6,6,6.5,4,3,1,26,26,52
p_369,4,15,e_3,1107,1133,1191,5.0,3,1,1.0,4,2,1,26,58,84
p_290,3,13,e_1,1108,1110,1192,4.0,4,1,3.0,4,2,1,2,82,84
p_673,8,13,e_1,1105,1164,1192,9.5,4,1,4.0,4,2,0,59,28,87
p_288,3,5,e_2,1157,1182,1194,24.5,4,4,2.5,4,1,0,25,12,37
p_810,10,14,e_1,1123,1176,1198,8.0,6,4,0.5,4,1,4,53,22,75
p_737,9,15,e_1,1168,1170,1204,28.5,4,4,8.5,5,3,2,2,34,36
p_524,6,7,e_0,1201,1205,1211,10.5,4,1,5.5,5,3,0,4,6,10
p_671,8,10,e_2,1182,1208,1218,24.5,3,3,3.0,2,2,1,26,10,36
p_596,7,10,e_0,1113,1137,1225,7.0,7,3,11.0,4,2,2,24,88,112
p_1213,15,7,e_3,1176,1191,1227,3.0,3,0,12.0,5,3,0,15,36,51
p_367,4,12,e_2,1159,1188,1228,25.0,4,4,2.0,4,1,1,29,40,69
p_1141,14,10,e_1,1204,1210,1230,24.0,4,4,15.0,2,2,1,6,20,26
p_740,9,6,e_3,1126,1161,1233,16.5,6,2,2.5,5,4,2,35,72,107
p_197,2,14,e_0,1151,1165,1243,25.0,4,4,4.0,4,2,2,14,78,92
p_593,7,4,e_3,1212,1227,1243,3.0,5,0,10.0,4,2,3,15,16,31
p_118,1,15,e_0,1153,1171,1249,24.0,4,4,4.0,1,2,2,18,78,96
p_1143,14,6,e_1,1200,1210,1252,25.0,4,4,14.5,5,2,0,10,42,52
p_670,8,6,e_1,1207,1240,1252,3.0,5,1,14.5,4,1,1,33,12,45
p_591,7,6,e_1,1225,1246,1252,29.0,6,6,11.0,4,5,2,21,6,27
p_287,3,2,e_3,1238,1249,1255,2.0,6,1,5.0,4,3,3,11,6,17
p_525,6,5,e_1,1143,1152,1258,18.0,6,5,4.0,5,2,4,9,106,115
p_809,10,1,e_3,1193,1213,1263,5.0,2,0,15.0,4,2,0,20,50,70
p_987,12,9,e_2,1240,1250,1266,21.5,7,7,14.0,2,1,1,10,16,26
p_886,11,9,e_2,1230,1256,1266,24.5,5,5,12.5,5,1,3,26,10,36
p_1142,14,3,e_1,1201,1210,1270,24.5,4,4,14.5,5,2,1,9,60,69
p_887,11,8,e_2,1229,1256,1272,25.0,5,5,12.0,5,1,2,27,16,43
p_196,2,3,e_3,1219,1255,1273,8.5,4,1,8.5,4,3,1,36,18,54
p_888,11,2,e_1,1219,1224,1276,26.5,5,5,12.0,4,4,2,5,52,57
p_440,5,2,e_1,1208,1258,1276,6.0,5,3,14.5,4,1,2,50,18,68
p_364,4,6,e_3,1256,1279,1289,4.0,6,1,2.0,1,4,2,23,10,33
p_672,8,4,e_2,1170,1208,1290,11.0,3,2,0.5,5,2,0,38,82,120
p_1075,13,4,e_2,1226,1234,1290,23.0,5,5,11.5,5,2,1,8,56,64
p_117,1,7,e_3,1204,1263,1295,11.0,4,0,12.0,4,2,2,59,32,91
p_1140,14,3,e_2,1215,1240,1296,24.5,4,4,9.5,5,3,0,25,56,81
p_885,11,5,e_0,1264,1270,1300,18.0,8,2,12.0,4,1,1,6,30,36
p_523,6,8,e_3,1212,1233,1301,14.0,4,2,10.0,1,2,2,21,68,89
p_807,10,4,e_0,1265,1276,1306,19.0,8,2,12.0,4,1,2,11,30,41
p_366,4,9,e_3,1197,1243,1307,10.0,3,0,14.0,4,2,1,46,64,110
p_520,6,9,e_3,1280,1289,1307,2.0,8,0,4.0,5,6,2,9,18,27
p_195,2,10,e_3,1256,1257,1313,2.0,6,1,2.0,4,4,2,1,56,57
p_590,7,10,e_3,1274,1295,1313,4.0,7,1,3.0,5,5,2,21,18,39
p_1139,14,2,e_0,1253,1256,1316,17.5,5,5,14.5,4,0,1,3,60,63
p_735,9,2,e_0,1249,1282,1316,23.0,5,5,15.0,3,0,0,33,34,67
p_521,6,12,e_3,1274,1289,1325,3.0,8,1,3.0,5,5,3,15,36,51
p_115,1,10,e_1,1282,1292,1330,26.5,8,8,0.5,4,3,1,10,38,48
p_736,9,13,e_3,1220,1307,1331,15.5,5,5,8.5,4,3,2,87,24,111
p_668,8,10,e_2,1315,1320,1332,28.0,5,5,7.0,5,1,4,5,12,17
p_522,6,11,e_1,1221,1252,1336,12.0,6,3,11.5,4,4,3,31,84,115
p_365,4,11,e_1,1241,1264,1336,6.0,7,3,8.0,4,4,1,23,72,95
p_116,1,14,e_3,1237,1263,1337,4.5,6,0,5.5,4,3,3,26,74,100
p_808,10,14,e_3,1232,1313,1337,14.0,4,3,6.0,1,3,2,81,24,105
p_41,0,12,e_1,1269,1286,1342,27.5,8,8,3.0,4,5,0,17,56,73
p_1072,13,15,e_3,1317,1331,1343,3.0,5,2,10.5,5,3,2,14,12,26
p_363,4,12,e_2,1296,1302,1344,27.0,7,7,3.0,5,0,2,6,42,48
p_285,3,8,e_0,1314,1322,1348,23.0,5,5,2.5,4,1,1,8,26,34
p_592,7,13,e_1,1216,1246,1348,14.5,4,3,12.5,4,4,1,30,102,132
p_362,4,9,e_0,1322,1328,1354,22.5,5,5,3.0,2,0,2,6,26,32
p_439,5,15,e_1,1213,1258,1358,13.0,4,2,13.5,4,4,1,45,100,145
p_883,11,15,e_2,1284,1338,1360,6.0,9,5,5.5,4,2,1,54,22,76
p_589,7,11,e_0,1317,1342,1364,26.5,5,5,2.0,5,0,1,25,22,47
p_1212,15,10,e_3,1254,1343,1365,16.0,4,4,2.0,1,4,1,89,22,111
p_286,3,12,e_0,1312,1322,1370,23.0,5,5,3.0,4,1,0,10,48,58
p_361,4,14,e_0,1325,1328,1380,22.0,4,4,3.5,5,2,3,3,52,55
p_1210,15,11,e_1,1344,1358,1380,29.0,6,6,12.0,5,3,1,14,22,36
p_1138,14,10,e_1,1354,1364,1386,27.5,6,6,14.0,5,2,1,10,22,32
p_1073,13,9,e_2,1313,1350,1386,7.0,5,2,6.5,5,1,4,37,36,73
p_984,12,15,e_0,1353,1370,1386,23.0,6,6,9.0,5,4,1,17,16,33
p_1211,15,6,e_3,1294,1343,1387,8.0,7,0,7.0,2,6,2,49,44,93
p_667,8,5,e_3,1330,1375,1393,9.0,5,2,13.0,5,4,1,45,18,63
p_519,6,4,e_3,1367,1387,1399,4.0,6,2,10.0,4,3,3,20,12,32
p_518,6,4,e_3,1380,1387,1399,1.0,6,0,7.0,1,4,2,7,12,19
p_734,9,6,e_2,1283,1326,1400,16.0,9,5,5.5,4,2,0,43,74,117
p_985,12,6,e_2,1315,1344,1400,8.0,5,3,7.0,5,1,4,29,56,85
p_1071,13,7,e_1,1358,1370,1402,27.5,6,6,15.0,4,2,2,12,32,44
p_884,11,2,e_3,1283,1319,1411,14.5,8,3,4.5,5,6,2,36,92,128
p_666,8,2,e_3,1362,1375,1411,2.0,6,0,10.5,4,4,2,13,36,49
p_588,7,2,e_3,1366,1381,1411,3.0,5,1,10.0,4,3,2,15,30,45
p_665,8,4,e_1,1377,1396,1416,28.5,6,6,11.5,4,4,1,19,20,39
p_1209,15,9,e_0,1363,1386,1416,24.0,6,6,11.0,2,3,1,23,30,53
p_986,12,1,e_3,1274,1325,1417,15.0,7,2,3.0,5,5,2,51,92,143
p_281,3,2,e_2,1394,1414,1420,2.0,7,1,7.5,4,3,1,20,6,26
p_669,8,1,e_2,1309,1320,1426,13.0,6,6,5.5,5,1,2,11,106,117
p_882,11,2,e_1,1285,1336,1426,13.5,9,3,0.0,3,3,1,51,90,141
p_283,3,4,e_3,1372,1405,1431,9.5,6,2,8.5,4,3,3,33,26,59
p_282,3,4,e_3,1380,1405,1431,8.0,6,2,7.0,1,4,2,25,26,51
p_1074,13,0,e_2,1312,1350,1432,7.0,6,2,6.0,5,1,3,38,82,120
p_880,11,6,e_0,1386,1406,1432,24.0,6,6,15.0,2,1,2,20,26,46
p_193,2,0,e_1,1344,1426,1436,13.0,6,4,12.0,5,3,1,82,10,92
p_437,5,7,e_3,1367,1393,1447,12.5,6,2,9.5,4,3,3,26,54,80
p_190,2,3,e_2,1438,1442,1448,27.0,6,6,1.5,5,1,2,4,6,10
p_436,5,8,e_3,1429,1437,1453,1.0,7,0,4.0,5,6,1,8,16,24
p_1208,15,1,e_0,1370,1386,1456,23.0,6,6,12.0,5,2,1,16,70,86
p_881,11,1,e_0,1383,1406,1456,25.0,6,6,14.5,5,1,1,23,50,73
p_663,8,1,e_0,1406,1422,1456,24.0,6,6,11.0,1,3,0,16,34,50
p_360,4,5,e_1,1342,1416,1458,19.0,5,5,12.0,2,4,0,74,42,116
p_284,3,5,e_2,1333,1414,1460,19.5,5,5,10.0,5,3,2,81,46,127
p_983,12,0,e_0,1397,1400,1462,21.5,7,7,12.5,4,2,2,3,62,65
p_113,1,10,e_3,1401,1417,1463,3.0,6,0,4.0,4,4,2,16,46,62
p_664,8,10,e_3,1378,1453,1463,13.5,6,5,7.5,4,4,2,75,10,85
p_359,4,6,e_2,1448,1454,1466,27.0,5,5,3.0,2,2,2,6,12,18
p_435,5,7,e_2,1446,1460,1472,28.0,5,5,3.0,5,2,2,14,12,26
p_191,2,8,e_1,1419,1426,1474,1.0,7,0,3.5,4,2,2,7,48,55
p_516,6,8,e_1,1456,1464,1474,27.5,4,4,5.0,5,2,3,8,10,18
p_114,1,13,e_3,1352,1417,1477,12.0,6,0,13.0,4,4,2,65,60,125
p_806,10,13,e_3,1447,1463,1477,3.0,5,1,7.0,2,6,0,16,14,30
p_192,2,14,e_3,1354,1411,1483,12.5,6,1,12.5,4,4,2,57,72,129
p_40,0,4,e_0,1317,1462,1484,19.0,5,5,2.0,5,0,2,145,22,167
p_187,2,4,e_0,1460,1474,1484,22.5,4,4,0.5,4,3,0,14,10,24
p_438,5,15,e_3,1334,1393,1489,21.5,5,5,13.5,5,4,1,59,96,155
p_194,2,15,e_3,1333,1411,1489,18.5,5,5,13.5,5,4,1,78,78,156
p_189,2,6,e_0,1444,1450,1494,25.5,6,6,3.0,4,2,0,6,44,50
p_982,12,13,e_1,1412,1492,1498,12.0,6,1,5.0,4,2,1,80,6,86
p_188,2,7,e_0,1446,1450,1500,25.0,5,5,3.0,4,2,1,4,50,54
p_112,1,8,e_0,1461,1468,1506,21.5,4,4,0.0,4,3,1,7,38,45
p_517,6,15,e_1,1419,1464,1508,5.0,7,1,3.5,4,2,2,45,44,89
p_1205,15,11,e_3,1457,1489,1511,6.0,4,0,9.0,5,4,0,32,22,54
p_733,9,8,e_3,1477,1521,1527,8.0,5,2,13.0,5,3,2,44,6,50
p_1203,15,10,e_2,1504,1508,1530,25.0,6,6,14.5,5,2,2,4,22,26
p_1070,13,10,e_1,1403,1498,1530,19.0,6,6,7.0,4,2,0,95,32,127
p_876,11,13,e_0,1498,1520,1532,20.5,7,5,7.0,5,3,0,22,12,34
p_877,11,7,e_3,1495,1511,1533,3.0,7,1,14.0,1,4,3,16,22,38
p_1207,15,9,e_2,1414,1508,1536,15.5,6,6,3.0,1,2,0,94,28,122
p_1068,13,9,e_1,1440,1498,1536,11.5,6,2,0.5,5,2,3,58,38,96
p_1066,13,14,e_0,1516,1532,1538,19.0,7,7,10.0,5,1,2,16,6,22
p_111,1,15,e_0,1466,1468,1544,20.5,3,3,0.5,5,3,2,2,76,78
p_587,7,15,e_0,1479,1500,1544,24.0,6,6,3.0,5,5,0,21,44,65
p_1067,13,15,e_0,1501,1532,1544,21.5,7,6,7.0,5,2,1,31,12,43
p_586,7,5,e_3,1509,1533,1545,4.0,7,1,11.5,4,4,3,24,12,36
p_879,11,6,e_2,1414,1490,1550,19.5,6,6,3.0,1,2,1,76,60,136
p_1206,15,4,e_3,1434,1489,1551,10.5,7,0,4.5,5,5,2,55,62,117
p_1136,14,4,e_3,1485,1495,1551,1.5,5,1,14.5,5,2,3,10,56,66
p_979,12,4,e_3,1488,1505,1551,3.0,5,0,15.0,2,2,4,17,46,63
p_1204,15,3,e_3,1469,1489,1557,3.5,3,0,11.5,5,3,0,20,68,88
p_978,12,3,e_3,1497,1505,1557,1.0,7,0,13.5,4,4,3,8,52,60
p_981,12,5,e_1,1459,1492,1558,8.5,4,3,5.0,5,1,3,33,66,99
p_1133,14,12,e_0,1548,1550,1560,20.5,4,4,14.5,4,3,1,2,10,12
p_1069,13,2,e_3,1422,1477,1563,15.0,7,2,2.0,5,6,1,55,86,141
p_1137,14,2,e_3,1455,1483,1563,7.5,4,1,8.5,5,4,0,28,80,108
p_977,12,2,e_3,1502,1505,1563,0.0,7,0,12.5,4,4,3,3,58,61
p_515,6,2,e_3,1508,1539,1563,5.0,6,1,11.5,4,4,2,31,24,55
p_434,5,2,e_3,1477,1545,1563,12.0,3,2,13.0,2,3,1,68,18,86
p_280,3,0,e_3,1470,1557,1573,15.5,3,3,11.5,5,3,0,87,16,103
p_980,12,2,e_1,1460,1492,1574,8.5,4,3,5.5,5,1,3,32,82,114
p_878,11,0,e_2,1434,1490,1578,14.5,7,3,0.5,5,1,2,56,88,144
p_278,3,4,e_1,1559,1568,1584,6.0,2,2,5.0,4,3,1,9,16,25
p_662,8,7,e_0,1558,1582,1588,25.0,2,2,12.0,4,4,1,24,6,30
p_1134,14,5,e_0,1519,1538,1598,23.0,7,7,11.0,5,1,3,19,60,79
p_875,11,5,e_0,1540,1566,1598,25.0,5,5,14.5,5,4,0,26,32,58
p_184,2,5,e_2,1576,1588,1602,2.0,4,1,0.5,4,2,0,12,14,26
p_975,12,4,e_0,1525,1526,1604,24.5,7,7,12.0,5,2,2,1,78,79
p_1135,14,4,e_0,1517,1538,1604,24.0,7,7,10.5,5,1,2,21,66,87
p_976,12,3,e_0,1524,1526,1610,24.5,7,7,12.0,5,2,1,2,84,86
p_732,9,3,e_0,1559,1576,1610,24.0,2,2,12.0,1,4,2,17,34,51
p_185,2,11,e_1,1529,1574,1616,10.0,7,1,10.0,4,4,1,45,42,87
p_186,2,10,e_3,1527,1563,1617,6.0,6,0,8.0,1,5,2,36,54,90
p_513,6,12,e_1,1553,1594,1622,10.0,3,3,6.0,4,4,0,41,28,69
p_38,0,11,e_3,1532,1573,1623,7.0,6,0,7.0,1,4,3,41,50,91
p_585,7,13,e_1,1522,1546,1628,12.0,7,5,12.0,4,4,0,24,82,106
p_36,0,1,e_0,1604,1626,1632,21.0,5,5,4.0,1,2,2,22,6,28
p_279,3,11,e_2,1482,1564,1636,19.0,6,6,9.0,5,0,2,82,72,154
p_514,6,15,e_1,1551,1552,1638,10.0,3,3,6.0,4,3,0,1,86,87
p_39,0,14,e_3,1527,1573,1639,8.0,6,0,8.0,4,4,2,46,66,112
p_974,12,14,e_3,1578,1629,1639,11.0,3,2,1.0,2,3,0,51,10,61
p_183,2,3,e_0,1595,1616,1642,25.5,5,5,5.5,4,3,1,21,26,47
p_874,11,10,e_2,1590,1636,1652,13.5,5,2,2.5,5,2,2,46,16,62
p_804,10,8,e_2,1618,1630,1662,8.0,4,3,8.0,5,2,3,12,32,44
p_1202,15,11,e_3,1637,1645,1663,1.0,3,0,14.0,5,2,1,8,18,26
p_37,0,7,e_0,1587,1626,1664,25.0,5,5,7.0,4,4,0,39,38,77
p_731,9,6,e_2,1599,1624,1672,13.0,5,4,4.5,5,2,2,25,48,73
p_873,11,6,e_2,1608,1636,1672,9.0,5,2,6.0,2,1,4,28,36,64
p_35,0,9,e_0,1611,1626,1676,19.5,5,5,3.0,4,0,3,15,50,65
p_1132,14,7,e_3,1618,1639,1681,4.0,4,0,10.0,5,3,1,21,42,63
p_805,10,4,e_2,1582,1630,1682,16.5,5,3,0.5,5,1,1,48,52,100
p_973,12,3,e_2,1588,1642,1688,13.0,5,1,2.0,2,1,1,54,46,100
p_872,11,4,e_1,1637,1656,1688,3.5,3,1,15.0,5,1,0,19,32,51
p_870,11,12,e_0,1658,1686,1692,23.0,4,3,6.0,5,5,0,28,6,34
p_34,0,13,e_0,1622,1626,1698,17.0,3,3,1.0,4,1,3,4,72,76
p_510,6,13,e_0,1649,1658,1698,20.5,4,2,4.5,5,3,2,9,40,49
p_512,6,0,e_2,1600,1608,1704,16.0,5,4,5.0,5,2,3,8,96,104
p_661,8,0,e_2,1607,1618,1704,12.0,5,4,6.0,2,1,3,11,86,97
p_511,6,14,e_0,1607,1658,1704,26.0,5,5,3.5,4,1,2,51,46,97
p_358,4,2,e_3,1623,1695,1705,13.0,3,2,11.0,2,3,1,72,10,82
p_584,7,1,e_1,1668,1674,1706,3.0,3,0,8.0,4,2,2,6,32,38
p_433,5,15,e_0,1616,1652,1710,23.0,5,5,2.0,4,1,2,36,58,94
p_660,8,15,e_0,1666,1670,1710,18.5,3,3,7.5,5,4,2,4,40,44
p_277,3,0,e_1,1652,1694,1712,10.0,4,3,11.5,4,0,1,42,18,60
p_110,1,0,e_3,1573,1579,1715,1.0,1,1,0.0,3,2,0,6,136,142
p_357,4,0,e_3,1692,1695,1715,0.0,2,0,4.5,4,1,1,3,20,23
p_108,1,2,e_2,1700,1710,1716,4.0,3,1,0.5,4,2,2,10,6,16
p_972,12,11,e_0,1661,1692,1730,29.5,4,4,6.5,5,5,1,31,38,69
p_971,12,10,e_0,1669,1692,1736,28.0,3,3,8.0,5,4,3,23,44,67
p_1201,15,10,e_0,1688,1710,1736,20.5,2,2,11.5,5,5,1,22,26,48
p_868,11,10,e_0,1715,1730,1736,11.0,3,3,14.0,4,5,1,15,6,21
p_109,1,7,e_2,1672,1698,1742,10.0,3,1,6.0,4,3,0,26,44,70
p_506,6,7,e_2,1719,1736,1742,6.0,4,1,2.5,5,1,3,17,6,23
p_866,11,9,e_0,1724,1730,1742,15.0,4,1,12.0,4,6,0,6,12,18
p_182,2,6,e_1,1667,1700,1742,12.0,3,1,8.5,4,2,1,33,42,75
p_432,5,6,e_1,1693,1736,1742,9.5,2,1,3.0,4,2,2,43,6,49
p_970,12,8,e_0,1699,1724,1748,21.5,3,3,13.0,5,6,0,25,24,49
p_352,4,8,e_1,1725,1730,1752,2.0,4,0,3.0,5,2,2,5,22,27
p_869,11,5,e_0,1680,1686,1762,26.0,3,3,10.0,5,3,2,6,76,82
p_969,12,5,e_0,1702,1724,1762,20.5,3,3,13.5,5,6,1,22,38,60
p_803,10,5,e_0,1683,1736,1762,27.0,2,2,10.5,5,3,2,53,26,79
p_355,4,11,e_2,1710,1726,1764,5.0,2,1,1.0,2,1,3,16,38,54
p_353,4,12,e_2,1722,1726,1770,3.0,4,0,3.5,5,1,3,4,44,48
p_659,8,12,e_2,1730,1748,1770,5.0,4,3,4.5,5,4,2,18,22,40
p_431,5,12,e_1,1732,1736,1770,1.0,3,3,4.0,5,3,2,4,34,38
p_1065,13,3,e_0,1686,1698,1772,23.0,2,2,11.0,2,3,2,12,74,86
p_354,4,12,e_3,1711,1733,1773,4.5,2,0,0.5,4,1,1,22,40,62
p_430,5,12,e_3,1734,1739,1773,1.0,4,0,4.0,5,2,2,5,34,39
p_507,6,12,e_3,1694,1745,1773,10.0,2,1,4.0,4,1,1,51,28,79
p_730,9,13,e_2,1689,1754,1776,14.0,2,2,3.0,4,1,2,65,22,87
p_968,12,13,e_1,1721,1770,1776,11.0,4,3,2.0,5,2,1,49,6,55
p_867,11,2,e_0,1716,1730,1778,17.0,4,1,13.5,4,5,1,14,48,62
p_509,6,14,e_2,1676,1736,1782,14.0,3,2,5.0,4,3,1,60,46,106
p_967,12,14,e_1,1756,1770,1782,4.0,4,0,8.5,5,2,0,14,12,26
p_33,0,14,e_3,1713,1715,1785,0.5,3,0,0.5,4,1,2,2,70,72
p_1131,14,1,e_0,1695,1704,1786,20.0,3,3,12.5,5,6,0,9,82,91
p_871,11,15,e_1,1651,1656,1788,24.5,4,3,12.0,4,0,1,5,132,137
p_508,6,15,e_1,1693,1742,1788,10.0,2,1,3.0,1,2,2,49,46,95
p_802,10,0,e_0,1707,1736,1792,21.5,2,2,14.5,5,6,1,29,56,85
p_800,10,7,e_3,1779,1803,1817,5.0,5,1,13.0,5,3,2,24,14,38
p_181,2,6,e_0,1778,1780,1820,17.0,4,4,2.0,4,4,0,2,40,42
p_350,4,6,e_0,1788,1810,1820,13.5,4,1,1.0,4,5,0,22,10,32
p_1064,13,6,e_3,1738,1779,1823,10.0,5,1,5.0,5,2,3,41,44,85
p_801,10,5,e_3,1773,1803,1829,6.0,4,2,12.0,2,3,2,30,26,56
p_1063,13,4,e_2,1750,1776,1830,8.0,3,1,8.5,5,4,1,26,54,80
p_107,1,8,e_0,1768,1786,1830,18.0,4,4,4.0,4,4,0,18,44,62
p_865,11,3,e_2,1775,1796,1836,5.0,5,2,13.0,2,4,1,21,40,61
p_275,3,9,e_0,1763,1772,1836,21.5,4,4,5.0,4,4,0,9,64,73
p_349,4,9,e_0,1801,1810,1836,10.5,4,1,2.0,5,4,1,9,26,35
p_356,4,2,e_2,1703,1726,1842,28.0,3,3,0.0,3,2,3,23,116,139
p_582,7,2,e_2,1764,1816,1842,11.0,4,3,11.0,2,6,0,52,26,78
p_583,7,2,e_3,1715,1751,1845,7.0,2,2,0.0,3,1,2,36,94,130
p_1200,15,2,e_1,1740,1788,1846,10.0,5,0,5.5,5,4,0,48,58,106
p_505,6,2,e_1,1768,1826,1846,11.0,4,3,12.0,5,2,1,58,20,78
p_429,5,2,e_1,1762,1832,1846,13.5,4,3,10.0,5,2,0,70,14,84
p_729,9,1,e_2,1712,1754,1848,21.5,3,3,1.0,5,2,3,42,94,136
p_658,8,0,e_2,1795,1810,1854,4.0,4,1,11.0,4,3,2,15,44,59
p_351,4,0,e_3,1771,1835,1855,12.0,4,2,12.0,5,3,1,64,20,84
p_276,3,13,e_0,1737,1772,1856,26.5,5,5,10.0,4,7,0,35,84,119
p_965,12,13,e_0,1840,1850,1856,15.0,2,2,9.5,5,2,4,10,6,16
p_964,12,13,e_0,1842,1850,1856,14.5,2,1,10.0,5,2,4,8,6,14
p_966,12,15,e_0,1811,1850,1870,16.0,5,5,4.0,5,4,1,39,20,59
p_1199,15,13,e_0,1807,1870,1880,22.0,5,5,3.5,5,4,1,63,10,73
p_1061,13,11,e_0,1828,1856,1890,20.0,2,2,7.5,5,3,4,28,34,62
p_32,0,9,e_1,1841,1856,1894,3.0,2,0,3.0,4,1,0,15,38,53
p_1129,14,10,e_0,1848,1864,1896,17.5,1,1,12.0,5,2,4,16,32,48
p_963,12,9,e_0,1845,1850,1902,20.0,1,1,11.0,5,2,4,5,52,57
p_1060,13,7,e_0,1855,1856,1912,13.0,0,0,13.0,2,4,2,1,56,57
p_1130,14,7,e_0,1816,1864,1912,21.0,5,5,5.5,5,4,2,48,48,96
p_579,7,3,e_2,1869,1891,1913,6.5,1,1,2.5,5,0,2,22,22,44
p_864,11,10,e_3,1875,1908,1914,7.0,1,0,4.0,5,0,1,33,6,39
p_657,8,6,e_0,1817,1830,1918,27.0,4,4,5.5,5,4,3,13,88,101
p_1059,13,6,e_0,1864,1880,1918,12.0,1,0,14.0,2,6,0,16,38,54
p_581,7,6,e_0,1825,1912,1918,26.5,3,3,7.0,5,3,3,87,6,93
p_428,5,2,e_2,1857,1881,1919,5.0,0,0,0.0,3,0,0,24,38,62
p_1198,15,5,e_0,1827,1870,1924,18.0,3,3,7.5,5,3,4,43,54,97
p_580,7,5,e_0,1832,1912,1924,25.5,2,2,8.5,5,3,4,80,12,92
p_427,5,1,e_2,1888,1901,1925,9.5,2,2,6.5,5,2,2,13,24,37
p_347,4,1,e_2,1894,1907,1925,10.0,2,1,6.5,4,3,2,13,18,31
p_962,12,7,e_1,1873,1908,1930,8.5,1,0,4.0,5,1,0,35,22,57
p_1197,15,4,e_0,1837,1870,1930,19.0,2,2,9.0,5,2,4,33,60,93
p_348,4,0,e_2,1864,1875,1931,11.0,1,1,1.5,5,0,1,11,56,67
p_656,8,6,e_3,1857,1892,1932,8.0,0,0,0.0,3,0,0,35,40,75
p_1062,13,2,e_0,1809,1856,1942,23.5,5,5,4.0,3,4,1,47,86,133
p_799,10,3,e_3,1898,1902,1946,3.0,2,1,9.0,5,1,1,4,44,48
p_274,3,5,e_0,1884,1936,1958,18.5,2,2,12.0,4,8,0,52,22,74
p_655,8,9,e_1,1950,1954,1960,5.0,2,1,7.0,5,1,1,4,6,10
p_426,5,6,e_0,1896,1924,1964,18.0,2,2,10.0,4,6,1,28,40,68
p_106,1,10,e_2,1883,1925,1973,17.0,2,2,5.5,5,2,1,42,48,90
p_272,3,10,e_3,1930,1946,1980,3.0,2,0,6.0,4,2,0,16,34,50
p_425,5,14,e_1,1914,1940,1982,9.0,2,1,10.5,4,1,0,26,42,68
p_273,3,12,e_0,1904,1936,1990,14.5,3,3,8.5,4,5,1,32,54,86
p_798,10,9,e_3,1966,1980,1996,2.5,7,0,7.5,5,2,5,14,16,30
p_31,0,15,e_2,1906,1931,1997,11.0,3,3,4.0,4,4,1,25,66,91
p_300,0,4,e_0,8,8,28,0.0,0,0,0.0,3,0,0,0,20,20
p_299,0,5,e_1,9,9,33,0.0,0,0,0.0,3,0,0,0,24,24
p_297,0,6,e_3,15,16,44,0.0,0,0,0.0,3,0,0,1,28,29
p_298,0,9,e_2,11,12,52,0.0,0,0,0.0,3,0,0,1,40,41
p_286,0,3,e_0,46,46,62,6.0,0,0,0.0,3,0,1,0,16,16
p_296,0,4,e_0,28,46,68,10.0,1,1,4.0,3,1,0,18,22,40
p_289,0,4,e_0,43,46,68,6.0,0,0,0.5,4,0,1,3,22,25
p_295,0,5,e_0,29,46,74,9.5,1,1,4.0,4,0,1,17,28,45
p_287,0,5,e_0,45,46,74,6.0,0,0,0.0,3,0,0,1,28,29
p_292,0,6,e_0,38,46,80,7.5,1,1,2.0,4,0,1,8,34,42
p_290,0,6,e_0,40,46,80,6.5,1,1,1.0,4,0,1,6,34,40
p_281,0,1,e_1,73,75,83,6.0,0,0,0.5,4,0,1,2,8,10
p_288,0,8,e_0,44,46,90,6.0,0,0,0.5,4,0,1,2,44,46
p_285,0,4,e_1,53,75,97,6.0,0,0,5.0,3,0,0,22,22,44
p_284,0,4,e_1,54,75,97,6.0,0,0,5.0,4,0,1,21,22,43
p_291,0,11,e_0,39,46,104,7.0,1,1,1.5,4,0,1,7,58,65
p_294,0,12,e_0,31,46,110,9.0,1,1,3.5,4,0,1,15,64,79
p_293,0,12,e_0,33,46,110,8.5,1,1,3.0,4,0,1,13,64,77
p_282,0,7,e_1,66,75,111,6.0,0,0,2.0,4,0,1,9,36,45
p_278,0,2,e_3,77,102,112,6.0,1,0,6.0,4,0,1,25,10,35
p_283,0,9,e_1,57,75,121,6.0,0,0,4.5,4,0,1,18,46,64
p_279,0,5,e_3,76,102,126,6.0,0,0,6.0,3,0,0,26,24,50
p_277,0,6,e_3,82,102,132,4.5,1,0,4.5,4,0,1,20,30,50
p_274,0,8,e_3,88,102,142,3.0,1,0,3.0,4,0,1,14,40,54
p_280,0,14,e_1,75,75,143,6.0,0,0,0.0,3,0,0,0,68,68
p_276,0,11,e_3,84,102,156,4.0,1,0,4.0,4,0,1,18,54,72
p_271,0,1,e_2,121,149,157,24.0,5,5,7.0,4,0,1,28,8,36
p_267,0,1,e_2,148,149,157,18.5,2,2,0.0,3,0,0,1,8,9
p_268,0,2,e_2,144,149,163,19.5,2,2,1.0,4,0,1,5,14,19
p_275,0,14,e_3,86,102,170,3.5,1,0,3.5,4,0,1,16,68,84
p_273,0,4,e_2,110,149,173,26.0,6,6,9.0,3,0,0,39,24,63
p_270,0,9,e_2,122,149,195,24.0,5,5,6.5,4,0,1,27,46,73
p_269,0,9,e_2,127,149,195,23.0,4,4,5.5,4,0,1,22,46,68
p_272,0,10,e_2,113,149,201,26.0,5,5,8.5,4,0,1,36,52,88
p_255,0,3,e_0,184,202,216,14.0,0,0,4.0,4,0,1,18,14,32
p_265,0,4,e_0,152,202,222,17.5,2,2,12.0,3,0,1,50,20,70
p_254,0,4,e_0,187,202,222,14.0,0,0,3.5,4,0,1,15,20,35
p_262,0,5,e_0,157,202,228,17.0,1,1,11.0,4,0,1,45,26,71
p_261,0,5,e_0,164,202,228,15.5,1,1,9.5,4,0,1,38,26,64
p_253,0,5,e_0,190,202,228,14.0,0,0,2.5,4,0,1,12,26,38
p_266,0,6,e_0,151,202,234,18.0,2,2,12.0,3,0,0,51,32,83
p_263,0,7,e_0,154,202,240,17.0,2,2,11.5,4,0,1,48,38,86
p_260,0,7,e_0,165,202,240,15.0,1,1,9.0,4,0,1,37,38,75
p_258,0,7,e_0,168,202,240,14.5,1,1,8.0,4,0,1,34,38,72
p_256,0,10,e_0,182,202,254,14.0,0,0,5.0,4,0,1,20,52,72
p_250,0,2,e_2,217,248,258,14.0,0,0,7.5,4,0,1,31,10,41
p_264,0,11,e_0,153,202,260,17.5,2,2,12.0,4,0,1,49,58,107
p_252,0,5,e_2,205,248,272,14.0,0,0,10.0,3,0,0,43,24,67
p_248,0,5,e_2,246,248,272,14.0,0,0,0.5,4,0,1,2,24,26
p_257,0,14,e_0,169,202,274,14.0,1,1,8.0,4,0,1,33,72,105
p_249,0,6,e_2,239,248,278,14.0,0,0,2.0,4,0,1,9,30,39
p_259,0,15,e_0,167,202,280,14.5,1,1,8.5,4,0,1,35,78,113
p_251,0,15,e_2,209,248,316,14.0,0,0,9.5,4,0,1,39,68,107
p_241,0,1,e_1,283,308,316,14.0,0,0,6.0,4,0,1,25,8,33
p_236,0,1,e_1,305,308,316,14.0,0,0,0.5,4,0,1,3,8,11
p_247,0,5,e_1,250,308,334,14.0,0,0,14.0,3,0,0,58,26,84
p_245,0,7,e_1,269,308,344,14.0,0,0,9.5,4,0,1,39,36,75
p_237,0,7,e_1,304,308,344,14.0,0,0,1.0,4,0,1,4,36,40
p_242,0,8,e_1,277,308,350,14.0,0,0,7.5,4,0,1,31,42,73
p_235,0,8,e_1,308,308,350,14.0,0,0,0.0,3,0,0,0,42,42
p_240,0,9,e_1,301,308,356,14.0,0,0,1.5,4,0,1,7,48,55
p_246,0,10,e_1,262,308,362,14.0,0,0,11.0,4,0,1,46,54,100
p_239,0,11,e_1,302,308,368,14.0,0,0,1.5,4,0,1,6,60,66
p_244,0,12,e_1,271,308,374,14.0,0,0,9.0,4,0,1,37,66,103
p_238,0,13,e_1,303,308,380,14.0,0,0,1.0,4,0,1,5,72,77
p_233,0,1,e_0,311,373,381,14.0,1,1,15.0,3,0,0,62,8,70
p_226,0,2,e_3,329,369,381,9.5,1,0,9.5,4,0,1,40,12,52
p_223,0,2,e_3,336,369,381,8.0,1,0,8.0,4,0,1,33,12,45
p_230,0,3,e_3,319,369,387,12.5,1,0,12.5,4,0,1,50,18,68
p_243,0,15,e_1,272,308,390,14.0,0,0,8.5,4,0,1,36,82,118
p_228,0,4,e_3,325,369,393,11.0,1,0,11.0,4,0,1,44,24,68
p_196,0,4,e_0,371,373,395,26.0,9,9,0.0,4,0,1,2,22,24
p_232,0,5,e_3,314,369,399,13.5,1,0,13.5,4,0,1,55,30,85
p_225,0,5,e_3,330,369,399,9.5,1,0,9.5,4,0,1,39,30,69
p_224,0,5,e_3,331,369,399,9.0,1,0,9.0,4,0,1,38,30,68
p_222,0,5,e_3,337,369,399,8.0,1,0,8.0,4,0,1,32,30,62
p_219,0,5,e_3,342,369,399,6.5,1,0,6.5,4,0,1,27,30,57
p_221,0,6,e_3,339,369,405,7.5,1,0,7.5,4,0,1,30,36,66
p_220,0,6,e_3,341,369,405,7.0,1,0,7.0,4,0,1,28,36,64
p_231,0,7,e_3,317,369,411,13.0,1,0,13.0,4,0,1,52,42,94
p_234,0,8,e_3,310,369,417,14.0,0,0,14.0,3,0,0,59,48,107
p_197,0,10,e_0,370,373,421,26.0,10,10,0.5,4,0,1,3,48,51
p_227,0,12,e_3,327,369,435,10.5,1,0,10.5,4,0,1,42,66,108
p_229,0,13,e_3,320,369,441,12.0,1,0,12.0,4,0,1,49,72,121
p_195,0,15,e_0,372,373,443,26.0,9,9,0.0,3,0,0,1,70,71
p_190,0,1,e_2,379,436,444,24.5,9,9,14.0,4,0,1,57,8,65
p_183,0,1,e_2,396,436,444,21.5,6,6,10.0,4,0,1,40,8,48
p_182,0,2,e_2,397,436,450,21.0,6,6,9.5,4,0,1,39,14,53
p_180,0,2,e_2,399,436,450,21.0,5,5,9.0,4,0,1,37,14,51
p_186,0,4,e_2,390,436,460,22.5,7,7,11.0,4,0,1,46,24,70
p_194,0,6,e_2,373,436,470,26.0,9,9,15.0,3,0,0,63,34,97
p_192,0,8,e_2,375,436,480,25.0,9,9,15.0,4,0,1,61,44,105
p_189,0,8,e_2,382,436,480,24.0,8,8,13.5,4,0,1,54,44,98
p_191,0,10,e_2,376,436,490,25.0,9,9,14.5,4,0,1,60,54,114
p_185,0,10,e_2,391,436,490,22.0,7,7,11.0,4,0,1,45,54,99
p_193,0,11,e_2,374,436,496,25.5,9,9,15.0,3,0,1,62,60,122
p_216,0,1,e_3,347,495,501,5.0,1,0,5.0,4,0,1,148,6,154
p_187,0,12,e_2,389,436,502,22.5,7,7,11.5,4,0,1,47,66,113
p_184,0,12,e_2,392,436,502,4.0,6,6,10.5,4,0,1,44,66,110
p_209,0,2,e_3,357,495,507,2.5,1,0,2.5,4,0,1,138,12,150
p_205,0,2,e_3,362,495,507,1.5,1,0,1.5,4,0,1,133,12,145
p_188,0,13,e_2,384,436,508,23.5,8,8,12.5,4,0,1,52,72,124
p_214,0,3,e_3,349,495,513,4.5,1,0,4.5,4,0,1,146,18,164
p_181,0,15,e_2,398,436,518,21.0,5,5,9.0,4,0,1,38,82,120
p_108,0,6,e_1,496,499,527,30.0,9,9,0.5,4,0,1,3,28,31
p_210,0,6,e_3,354,495,527,3.5,1,0,3.5,4,0,1,141,32,173
p_208,0,6,e_3,358,495,527,2.5,1,0,2.5,4,0,1,137,32,169
p_217,0,7,e_3,346,495,533,5.5,1,0,5.5,4,0,1,149,38,187
p_212,0,7,e_3,351,495,533,4.5,1,0,4.5,4,0,1,144,38,182
p_153,0,9,e_1,437,499,541,13.5,1,1,15.0,3,0,0,62,42,104
p_107,0,11,e_1,499,499,551,29.5,9,9,0.0,3,0,0,0,52,52
p_218,0,11,e_3,343,495,551,6.0,1,0,6.0,4,0,1,152,56,208
p_207,0,11,e_3,359,495,551,2.0,1,0,2.0,4,0,1,136,56,192
p_206,0,12,e_3,361,495,557,1.5,1,0,1.5,4,0,1,134,62,196
p_204,0,14,e_3,363,495,567,1.0,1,0,1.0,4,0,1,132,72,204
p_96,0,1,e_0,517,562,570,26.0,6,6,11.0,4,0,1,45,8,53
p_215,0,15,e_3,348,495,573,5.0,1,0,5.0,4,0,1,147,78,225
p_213,0,15,e_3,350,495,573,4.5,1,0,4.5,4,0,1,145,78,223
p_211,0,15,e_3,353,495,573,4.0,1,0,4.0,4,0,1,142,78,220
p_106,0,3,e_0,500,562,580,29.0,8,8,15.0,3,0,0,62,18,80
p_92,0,4,e_0,525,562,586,24.5,6,6,9.0,4,0,1,37,24,61
p_99,0,6,e_0,514,562,596,27.0,6,6,11.5,4,0,1,48,34,82
p_94,0,6,e_0,519,562,596,26.0,6,6,10.5,4,0,1,43,34,77
p_102,0,7,e_0,509,562,602,27.5,7,7,13.0,4,0,1,53,40,93
p_98,0,7,e_0,515,562,602,26.5,6,6,11.5,4,0,1,47,40,87
p_97,0,7,e_0,516,562,602,26.5,6,6,11.0,4,0,1,46,40,86
p_101,0,8,e_0,511,562,608,27.5,7,7,12.5,4,0,1,51,46,97
p_100,0,9,e_0,513,562,614,27.0,6,6,12.0,4,0,1,49,52,101
p_65,0,1,e_1,573,609,617,15.0,0,0,8.5,4,0,1,36,8,44
p_103,0,11,e_0,508,562,624,28.0,7,7,13.5,4,0,1,54,62,116
p_72,0,3,e_1,562,609,627,17.0,2,2,11.0,3,0,0,47,18,65
p_71,0,3,e_1,564,609,627,16.5,2,2,11.0,4,0,1,45,18,63
p_70,0,3,e_1,565,609,627,16.5,2,2,10.5,4,0,1,44,18,62
p_67,0,3,e_1,568,609,627,16.0,1,1,10.0,4,0,1,41,18,59
p_66,0,3,e_1,569,609,627,15.5,1,1,10.0,4,0,1,40,18,58
p_105,0,12,e_0,502,562,630,29.0,8,8,15.0,4,0,1,60,68,128
p_64,0,4,e_1,574,609,633,15.0,0,0,8.5,4,0,1,35,24,59
p_93,0,13,e_0,520,562,636,25.5,6,6,10.5,4,0,1,42,74,116
p_104,0,14,e_0,503,562,642,28.5,8,8,14.5,4,0,1,59,80,139
p_95,0,14,e_0,518,562,642,26.0,6,6,10.5,4,0,1,44,80,124
p_61,0,6,e_1,579,609,643,15.0,0,0,7.0,4,0,1,30,34,64
p_60,0,10,e_1,580,609,661,15.0,0,0,7.0,4,0,1,29,52,81
p_58,0,11,e_1,582,609,667,15.0,0,0,6.5,4,0,1,27,58,85
p_68,0,13,e_1,567,609,677,16.0,1,1,10.5,4,0,1,42,68,110
p_63,0,13,e_1,577,609,677,15.0,0,0,8.0,4,0,1,32,68,100
p_62,0,13,e_1,578,609,677,15.0,0,0,7.5,4,0,1,31,68,99
p_69,0,14,e_1,566,609,683,16.0,2,2,10.5,4,0,1,43,74,117
p_59,0,14,e_1,581,609,683,15.0,0,0,6.5,4,0,1,28,74,102
p_167,0,1,e_2,413,678,686,19.0,3,3,5.5,4,0,1,265,8,273
p_178,0,3,e_2,401,678,696,20.5,5,5,8.5,4,0,1,277,18,295
p_176,0,4,e_2,403,678,702,20.0,5,5,8.0,4,0,1,275,24,299
p_165,0,4,e_2,417,678,702,18.0,2,2,4.5,4,0,1,261,24,285
p_179,0,8,e_2,400,678,720,21.0,5,5,9.0,4,0,1,278,42,320
p_177,0,9,e_2,402,678,726,20.5,5,5,8.5,4,0,1,276,48,324
p_169,0,9,e_2,411,678,726,19.0,3,3,6.0,4,0,1,267,48,315
p_173,0,11,e_2,407,678,736,20.0,4,4,7.0,4,0,1,271,58,329
p_166,0,12,e_2,416,678,742,18.0,3,3,4.5,4,0,1,262,64,326
p_171,0,13,e_2,409,678,748,19.0,4,4,6.5,4,0,1,269,70,339
p_168,0,13,e_2,412,678,748,19.0,3,3,5.5,4,0,1,266,70,336
p_86,0,2,e_0,544,743,753,20.5,4,4,4.5,4,0,1,199,10,209
p_175,0,14,e_2,405,678,754,20.0,4,4,7.5,4,0,1,273,76,349
p_174,0,14,e_2,406,678,754,20.0,4,4,7.5,4,0,1,272,76,348
p_170,0,14,e_2,410,678,754,19.0,4,4,6.5,4,0,1,268,76,344
p_45,0,2,e_1,595,744,754,15.0,0,0,3.0,4,0,1,149,10,159
p_77,0,3,e_0,557,743,759,18.0,2,2,1.0,4,0,1,186,16,202
p_172,0,15,e_2,408,678,760,19.5,4,4,6.5,4,0,1,270,82,352
p_55,0,3,e_1,585,744,760,15.0,0,0,5.5,4,0,1,159,16,175
p_54,0,3,e_1,586,744,760,15.0,0,0,5.5,4,0,1,158,16,174
p_52,0,3,e_1,588,744,760,15.0,0,0,5.0,4,0,1,156,16,172
p_48,0,4,e_1,592,744,766,15.0,0,0,4.0,4,0,1,152,22,174
p_46,0,4,e_1,594,744,766,15.0,0,0,3.5,4,0,1,150,22,172
p_88,0,5,e_0,538,743,769,22.0,4,4,6.0,4,0,1,205,26,231
p_56,0,6,e_1,584,744,776,15.0,0,0,6.0,4,0,1,160,32,192
p_80,0,7,e_0,552,743,779,19.0,3,3,2.5,4,0,1,191,36,227
p_50,0,7,e_1,590,744,782,15.0,0,0,4.5,4,0,1,154,38,192
p_43,0,7,e_1,597,744,782,15.0,0,0,3.0,4,0,1,147,38,185
p_87,0,8,e_0,539,743,785,21.5,4,4,5.5,4,0,1,204,42,246
p_83,0,8,e_0,549,743,785,19.0,4,4,3.0,4,0,1,194,42,236
p_44,0,8,e_1,596,744,788,15.0,0,0,3.0,4,0,1,148,44,192
p_89,0,9,e_0,535,743,791,22.5,4,4,6.5,4,0,1,208,48,256
p_53,0,9,e_1,587,744,794,15.0,0,0,5.0,4,0,1,157,50,207
p_51,0,9,e_1,589,744,794,15.0,0,0,5.0,4,0,1,155,50,205
p_47,0,9,e_1,593,744,794,15.0,0,0,3.5,4,0,1,151,50,201
p_57,0,11,e_1,583,744,804,15.0,0,0,6.0,4,0,1,161,60,221
p_91,0,12,e_0,526,743,805,24.0,5,5,8.5,4,0,1,217,62,279
p_84,0,12,e_0,546,743,805,20.0,4,4,4.0,4,0,1,197,62,259
p_78,0,12,e_0,556,743,805,18.0,2,2,1.0,4,0,1,187,62,249
p_90,0,13,e_0,527,743,811,24.0,5,5,8.5,4,0,1,216,68,284
p_82,0,14,e_0,550,743,817,19.0,3,3,3.0,4,0,1,193,74,267
p_81,0,14,e_0,551,743,817,19.0,3,3,2.5,4,0,1,192,74,266
p_79,0,14,e_0,553,743,817,18.5,3,3,2.0,4,0,1,190,74,264
p_49,0,14,e_1,591,744,818,15.0,0,0,4.0,4,0,1,153,74,227
p_85,0,15,e_0,545,743,823,20.0,4,4,4.0,4,0,1,198,80,278
p_146,0,1,e_3,453,817,823,10.5,1,0,10.5,4,0,1,364,6,370
p_200,0,4,e_3,367,817,837,0.5,1,0,0.5,4,0,1,450,20,470
p_201,0,5,e_3,366,817,843,0.5,1,0,0.5,4,0,1,451,26,477
p_150,0,6,e_3,443,817,849,12.5,1,0,12.5,4,0,1,374,32,406
p_148,0,8,e_3,449,817,859,11.5,1,0,11.5,4,0,1,368,42,410
p_198,0,9,e_3,369,817,865,0.0,0,0,0.0,3,0,0,448,48,496
p_147,0,9,e_3,452,817,865,10.5,1,0,10.5,4,0,1,365,48,413
p_144,0,9,e_3,455,817,865,9.5,1,0,9.5,4,0,1,362,48,410
p_145,0,11,e_3,454,817,875,10.0,1,0,10.0,4,0,1,363,58,421
p_203,0,12,e_3,364,817,881,1.0,1,0,1.0,4,0,1,453,64,517
p_202,0,15,e_3,365,817,895,0.5,1,0,0.5,4,0,1,452,78,530
p_199,0,15,e_3,368,817,895,0.0,1,0,0.0,4,0,1,449,78,527
p_152,0,15,e_3,441,817,895,13.0,0,0,13.0,2,1,0,376,78,454
p_151,0,15,e_3,442,817,895,13.0,1,0,13.0,4,0,1,375,78,453
p_149,0,15,e_3,444,817,895,12.5,1,0,12.5,4,0,1,373,78,451
p_4,0,1,e_1,886,893,899,17.0,1,1,1.5,4,0,1,7,6,13
p_9,0,2,e_1,846,893,905,24.5,6,6,11.5,4,0,1,47,12,59
p_6,0,3,e_1,877,893,911,19.0,2,2,3.5,4,0,1,16,18,34
p_7,0,5,e_1,875,893,921,19.0,2,2,4.0,4,0,1,18,28,46
p_42,0,6,e_1,598,893,927,15.0,0,0,2.5,4,0,1,295,34,329
p_25,0,8,e_1,686,893,937,15.0,0,0,14.0,3,0,0,207,44,251
p_10,0,8,e_1,835,893,937,26.5,8,8,14.0,3,0,0,58,44,102
p_5,0,8,e_1,883,893,937,18.0,1,1,2.5,4,0,1,10,44,54
p_3,0,8,e_1,888,893,937,16.5,1,1,1.0,4,0,1,5,44,49
p_41,0,11,e_1,600,893,951,15.0,0,0,2.0,4,0,1,293,58,351
p_8,0,11,e_1,874,893,951,19.0,2,2,4.5,4,0,1,19,58,77
p_2,0,11,e_1,892,893,951,15.5,1,1,0.0,4,0,1,1,58,59
p_39,0,12,e_1,607,893,957,15.0,0,0,0.0,4,0,1,286,64,350
p_40,0,13,e_1,602,893,963,15.0,0,0,1.5,4,0,1,291,70,361
p_38,0,13,e_1,608,893,963,15.0,0,0,0.0,3,0,0,285,70,355
p_24,0,2,e_0,695,956,966,15.0,0,0,11.5,4,0,1,261,10,271
p_22,0,3,e_0,719,956,972,15.0,0,0,5.5,4,0,1,237,16,253
p_21,0,4,e_0,731,956,978,15.0,0,0,2.5,4,0,1,225,22,247
p_75,0,5,e_0,559,956,984,17.5,2,2,0.5,4,0,1,397,28,425
p_1,0,5,e_0,894,956,984,15.0,0,0,15.0,3,0,0,62,28,90
p_76,0,6,e_0,558,956,990,18.0,2,2,1.0,4,0,1,398,34,432
p_74,0,7,e_0,560,956,996,17.5,2,2,0.5,4,0,1,396,40,436
p_26,0,8,e_0,684,956,1002,15.0,0,0,14.0,3,0,0,272,46,318
p_73,0,11,e_0,561,956,1016,17.5,2,2,0.0,3,0,0,395,60,455
p_23,0,12,e_0,711,956,1022,15.0,0,0,7.5,4,0,1,245,66,311
p_20,0,14,e_0,734,956,1032,15.0,0,0,2.0,4,0,1,222,76,298
p_296,1,0,e_3,20,26,32,1.0,0,0,0.0,3,0,0,6,6,12
p_299,3,0,e_1,7,22,36,3.0,0,0,0.0,3,0,0,15,14,29
p_286,3,0,e_1,51,57,85,7.5,2,2,2.0,5,0,2,6,28,34
p_290,4,0,e_1,43,63,85,6.5,1,1,0.0,3,0,0,20,22,42
p_285,2,0,e_1,54,73,85,8.0,2,2,2.5,5,0,3,19,12,31
p_288,1,0,e_1,49,79,85,10.0,2,2,1.0,5,0,1,30,6,36
p_282,6,0,e_1,62,111,137,8.0,3,2,4.0,3,1,2,49,26,75
p_298,4,0,e_2,10,29,139,4.0,0,0,0.0,3,0,0,19,110,129
p_295,5,0,e_2,22,35,139,4.5,1,0,2.5,5,0,1,13,104,117
p_292,11,0,e_2,30,61,139,19.0,1,1,4.0,5,1,1,31,78,109
p_287,12,0,e_2,51,67,139,8.5,2,0,8.5,5,1,1,16,72,88
p_284,14,0,e_2,55,77,139,9.5,3,0,10.0,5,1,2,22,62,84
p_277,10,0,e_2,81,95,139,10.0,4,1,13.5,4,1,0,14,44,58
p_275,2,0,e_2,84,129,139,18.0,3,1,12.5,4,1,1,45,10,55
p_300,8,0,e_0,4,39,141,8.0,0,0,0.0,3,0,0,35,102,137
p_297,12,0,e_0,18,57,141,12.0,0,0,3.0,5,0,1,39,84,123
p_294,13,0,e_0,23,63,141,12.5,1,0,4.5,5,0,2,40,78,118
p_293,15,0,e_0,26,73,141,16.0,1,1,5.0,5,0,3,47,68,115
p_280,12,0,e_0,65,87,141,5.5,3,0,13.0,5,1,1,22,54,76
p_276,5,0,e_0,82,117,141,15.0,3,1,13.0,4,1,1,35,24,59
p_274,4,0,e_0,84,123,141,15.5,3,1,12.5,4,1,2,39,18,57
p_267,1,0,e_2,153,159,165,3.0,3,1,0.0,3,0,0,6,6,12
p_291,6,0,e_3,35,62,174,6.0,0,0,0.0,3,0,0,27,112,139
p_289,7,0,e_3,47,68,174,4.5,1,0,2.5,5,0,1,21,106,127
p_283,10,0,e_3,55,82,174,5.5,2,0,4.5,5,0,2,27,92,119
p_281,10,0,e_3,63,82,174,4.0,3,0,6.0,5,1,2,19,92,111
p_273,13,0,e_3,95,96,174,4.0,3,1,13.0,5,1,2,1,78,79
p_278,15,0,e_3,80,106,174,5.5,3,0,9.5,5,1,2,26,68,94
p_272,15,0,e_3,105,106,174,0.0,3,0,15.0,5,1,2,1,68,69
p_270,7,0,e_3,133,140,174,1.0,2,0,8.5,4,1,1,7,34,41
p_269,4,0,e_3,146,154,174,1.0,2,0,5.5,4,1,1,8,20,28
p_279,2,0,e_3,76,164,174,9.5,2,1,8.5,5,1,1,88,10,98
p_258,5,0,e_3,175,197,265,5.0,0,0,0.0,3,0,0,22,68,90
p_256,8,0,e_3,191,211,265,4.0,1,0,4.0,5,0,1,20,54,74
p_255,10,0,e_3,192,221,265,6.0,2,0,4.0,5,0,2,29,44,73
p_251,4,0,e_3,228,247,265,4.0,1,0,8.5,4,1,0,19,18,37
p_271,11,0,e_1,127,183,267,29.0,2,2,2.5,4,1,0,56,84,140
p_266,15,0,e_1,155,201,267,19.0,2,2,4.5,5,0,1,46,66,112
p_254,3,0,e_1,199,251,267,12.0,3,2,14.5,5,1,1,52,16,68
p_252,2,0,e_1,212,257,267,10.0,2,1,12.5,4,1,1,45,10,55
p_262,6,0,e_2,164,191,269,26.0,1,1,0.0,3,1,0,27,78,105
p_259,6,0,e_2,174,191,269,6.0,0,0,2.0,5,0,1,17,78,95
p_257,12,0,e_2,179,217,269,11.5,1,0,3.5,5,0,1,38,52,90
p_250,7,0,e_2,236,239,269,29.5,2,2,7.5,4,1,0,3,30,33
p_264,5,0,e_0,162,172,286,27.0,2,2,3.0,5,0,2,10,114,124
p_268,10,0,e_0,150,194,286,25.0,3,3,0.0,3,0,0,44,92,136
p_265,12,0,e_0,157,204,286,21.5,2,2,1.5,5,0,1,47,82,129
p_263,12,0,e_0,163,204,286,20.0,2,2,3.0,5,0,3,41,82,123
p_261,12,0,e_0,170,204,286,18.5,1,1,5.0,5,0,3,34,82,116
p_260,13,0,e_0,171,210,286,17.5,1,1,5.0,2,0,2,39,76,115
p_253,15,0,e_0,208,220,286,7.5,3,0,13.0,5,1,1,12,66,78
p_249,7,0,e_0,238,254,286,29.0,2,2,11.0,4,1,0,16,32,48
p_248,7,0,e_0,246,254,286,27.0,1,1,8.5,4,1,1,8,32,40
p_244,2,0,e_0,271,276,286,21.0,1,1,3.0,4,1,0,5,10,15
p_242,4,0,e_0,287,306,326,14.5,1,1,0.0,3,0,0,19,20,39
p_238,2,0,e_0,311,316,326,12.5,2,2,3.0,4,1,0,5,10,15
p_243,8,0,e_2,285,303,355,11.5,1,1,3.5,5,0,1,18,52,70
p_245,9,0,e_2,269,309,355,14.0,1,1,0.0,3,1,0,40,46,86
p_236,8,0,e_2,313,315,355,6.5,2,2,8.5,4,1,0,2,40,42
p_237,5,0,e_2,313,329,355,9.5,2,2,8.5,4,1,1,16,26,42
p_232,5,0,e_2,320,329,355,10.0,3,1,7.0,4,1,2,9,26,35
p_230,5,0,e_2,323,329,355,10.0,3,1,6.0,4,1,2,6,26,32
p_233,2,0,e_2,319,343,355,13.0,4,1,7.0,4,1,1,24,12,36
p_216,1,0,e_2,346,349,355,9.0,5,4,1.5,4,1,0,3,6,9
p_247,12,0,e_3,248,315,397,22.0,1,1,4.0,4,1,0,67,82,149
p_241,13,0,e_3,300,321,397,4.5,1,0,8.5,5,0,1,21,76,97
p_239,13,0,e_3,305,321,397,3.0,2,0,10.0,5,0,2,16,76,92
p_234,14,0,e_3,314,327,397,2.0,1,0,12.0,2,0,1,13,70,83
p_228,11,0,e_3,325,341,397,3.0,3,0,14.0,5,1,2,16,56,72
p_220,9,0,e_3,342,351,397,2.0,4,0,11.0,4,1,3,9,46,55
p_212,9,0,e_3,348,351,397,0.0,5,0,9.5,4,1,4,3,46,49
p_235,8,0,e_3,314,357,397,8.0,2,2,12.0,2,0,2,43,40,83
p_221,4,0,e_3,341,375,397,7.0,3,1,11.0,1,1,2,34,22,56
p_214,4,0,e_3,346,375,397,6.0,5,2,10.0,4,1,4,29,22,51
p_210,4,0,e_3,353,375,397,4.0,4,0,8.5,4,1,3,22,22,44
p_222,3,0,e_3,339,381,397,8.0,3,1,11.0,4,1,2,42,16,58
p_209,2,0,e_3,354,387,397,6.0,4,2,8.5,4,1,3,33,10,43
p_246,12,0,e_1,257,317,399,20.0,2,2,2.0,1,1,0,60,82,142
p_240,14,0,e_1,301,327,399,5.5,2,0,8.0,5,0,1,26,72,98
p_226,12,0,e_1,331,337,399,1.0,3,0,13.0,4,1,2,6,62,68
p_231,10,0,e_1,320,347,399,5.0,3,1,12.5,5,1,1,27,52,79
p_225,10,0,e_1,333,347,399,3.0,3,1,12.5,4,1,3,14,52,66
p_229,9,0,e_1,323,353,399,6.0,3,1,13.0,5,1,2,30,46,76
p_227,9,0,e_1,326,353,399,5.0,4,0,14.0,5,1,3,27,46,73
p_218,9,0,e_1,343,353,399,1.0,5,0,10.5,4,1,2,10,46,56
p_217,8,0,e_1,345,359,399,2.0,5,1,10.5,4,1,2,14,40,54
p_215,6,0,e_1,346,369,399,4.0,5,2,10.0,4,1,3,23,30,53
p_206,6,0,e_1,362,369,399,1.0,4,0,7.5,4,1,2,7,30,37
p_199,2,0,e_1,368,387,399,3.0,4,2,6.0,1,1,1,19,12,31
p_205,1,0,e_1,362,393,399,6.0,4,3,7.5,4,1,1,31,6,37
p_198,9,0,e_0,368,373,475,26.5,4,4,8.0,5,0,4,5,102,107
p_219,11,0,e_0,342,383,475,30.0,5,5,1.5,5,0,1,41,92,133
p_194,11,0,e_0,377,383,475,23.0,3,3,9.5,5,1,5,6,92,98
p_213,12,0,e_0,347,389,475,28.0,5,5,2.5,5,0,2,42,86,128
p_203,12,0,e_0,365,389,475,24.0,4,4,7.5,5,0,4,24,86,110
p_200,12,0,e_0,367,389,475,23.5,4,4,7.5,5,0,4,22,86,108
p_193,12,0,e_0,378,389,475,21.5,3,3,10.0,5,1,5,11,86,97
p_224,13,0,e_0,335,395,475,29.0,3,3,0.0,3,0,0,60,80,140
p_223,13,0,e_0,339,395,475,28.5,3,3,1.0,5,0,1,56,80,136
p_202,13,0,e_0,365,395,475,23.0,4,4,7.5,5,0,4,30,80,110
p_201,13,0,e_0,366,395,475,23.0,4,4,7.5,5,0,4,29,80,109
p_211,14,0,e_0,348,401,475,25.5,5,5,3.0,5,0,3,53,74,127
p_190,14,0,e_0,382,401,475,19.0,2,2,11.0,5,1,5,19,74,93
p_180,14,0,e_0,396,401,475,16.0,1,1,13.0,5,1,7,5,74,79
p_181,11,0,e_0,395,415,475,19.5,1,1,13.0,5,1,6,20,60,80
p_204,8,0,e_2,364,389,507,28.5,4,4,2.0,5,0,2,25,118,143
p_197,8,0,e_2,375,389,507,26.0,3,3,5.0,5,0,3,14,118,132
p_195,9,0,e_2,376,395,507,25.0,3,3,5.0,5,0,3,19,112,131
p_207,12,0,e_2,355,409,507,26.0,5,5,0.0,3,1,0,54,98,152
p_183,12,0,e_2,393,409,507,18.5,1,1,9.0,5,1,3,16,98,114
p_208,13,0,e_2,355,415,507,25.0,5,5,0.0,5,0,1,60,92,152
p_172,14,0,e_2,405,421,507,12.5,2,0,11.0,5,1,3,16,86,102
p_165,14,0,e_2,416,421,507,10.0,2,0,13.0,5,1,3,5,86,91
p_162,14,0,e_2,417,421,507,9.5,3,0,13.5,5,1,3,4,86,90
p_168,15,0,e_2,412,427,507,12.0,2,0,12.5,5,1,3,15,80,95
p_158,14,0,e_2,426,433,507,8.0,3,0,15.0,5,1,5,7,74,81
p_161,13,0,e_2,418,439,507,8.5,3,0,13.5,5,1,3,21,68,89
p_157,12,0,e_2,427,445,507,5.5,3,0,15.0,2,1,5,18,62,80
p_159,11,0,e_2,424,451,507,7.0,3,1,14.5,5,1,4,27,56,83
p_160,10,0,e_2,421,457,507,8.5,3,1,14.0,5,1,3,36,50,86
p_175,2,0,e_1,399,409,531,16.0,2,2,0.0,3,1,2,10,122,132
p_174,3,0,e_1,402,415,531,14.5,2,2,0.5,5,0,3,13,116,129
p_171,3,0,e_1,408,415,531,13.0,2,2,2.0,5,0,4,7,116,123
p_163,4,0,e_1,417,421,531,15.5,3,3,3.5,5,1,3,4,110,114
p_178,5,0,e_1,398,427,531,5.0,1,1,0.0,3,1,0,29,104,133
p_166,5,0,e_1,415,427,531,9.0,2,2,3.0,2,1,3,12,104,116
p_176,6,0,e_1,398,433,531,6.0,1,1,0.0,3,1,1,35,98,133
p_167,7,0,e_1,412,439,531,8.0,2,1,2.5,5,1,3,27,92,119
p_154,7,0,e_1,438,439,531,8.0,2,1,7.0,2,1,3,1,92,93
p_153,8,0,e_1,438,447,531,7.0,2,1,7.0,5,1,3,9,84,93
p_152,10,0,e_1,439,457,531,5.0,2,1,7.0,5,1,4,18,74,92
p_145,12,0,e_1,451,467,531,6.0,2,1,8.5,5,1,4,16,64,80
p_134,12,0,e_1,462,467,531,5.0,2,1,11.0,5,1,4,5,64,69
p_128,10,0,e_1,471,477,531,5.0,2,0,11.5,4,1,4,6,54,60
p_130,9,0,e_1,469,483,531,6.0,2,0,11.5,4,1,3,14,48,62
p_179,6,0,e_3,397,424,546,6.0,0,0,0.0,3,0,0,27,122,149
p_177,9,0,e_3,398,438,546,9.0,1,0,0.0,5,0,1,40,108,148
p_164,12,0,e_3,416,452,546,8.0,2,0,4.0,5,0,2,36,94,130
p_140,13,0,e_3,455,458,546,4.5,2,1,12.5,5,1,1,3,88,91
p_139,13,0,e_3,456,458,546,4.0,3,1,13.0,5,1,2,2,88,90
p_137,13,0,e_3,458,458,546,4.0,2,1,13.0,2,1,1,0,88,88
p_151,15,0,e_3,443,470,546,5.0,2,0,10.0,5,1,1,27,76,103
p_149,15,0,e_3,444,470,546,5.0,3,0,10.0,5,1,2,26,76,102
p_142,15,0,e_3,452,470,546,3.0,2,0,12.0,5,1,1,18,76,94
p_141,15,0,e_3,455,470,546,2.5,2,0,12.5,5,1,1,15,76,91
p_123,12,0,e_3,474,484,546,2.0,2,0,14.5,4,1,1,10,62,72
p_120,10,0,e_3,481,494,546,2.0,3,0,12.5,4,1,2,13,52,65
p_131,9,0,e_3,467,500,546,6.5,2,1,14.5,5,1,1,33,46,79
p_114,9,0,e_3,494,500,546,1.0,2,0,10.0,1,1,1,6,46,52
p_108,5,0,e_3,509,518,546,2.0,2,0,7.0,4,1,1,9,28,37
p_173,10,0,e_0,405,517,629,8.5,2,0,13.5,4,1,6,112,112,224
p_170,10,0,e_0,408,517,629,8.0,2,0,12.5,4,1,7,109,112,221
p_115,10,0,e_0,494,517,629,30.0,2,2,4.5,5,0,3,23,112,135
p_169,11,0,e_0,410,523,629,8.5,2,0,12.0,4,1,7,113,106,219
p_113,11,0,e_0,496,523,629,28.5,2,2,5.0,5,0,4,27,106,133
p_117,12,0,e_0,490,529,629,28.5,3,3,3.5,5,0,2,39,100,139
p_103,13,0,e_0,517,535,629,22.0,3,3,10.0,5,1,4,18,94,112
p_92,13,0,e_0,533,535,629,19.0,3,3,13.0,5,1,6,2,94,96
p_91,13,0,e_0,535,535,629,19.0,2,2,13.0,2,1,5,0,94,94
p_124,14,0,e_0,474,543,629,30.0,3,3,0.0,3,1,1,69,86,155
p_109,14,0,e_0,506,543,629,23.5,2,2,7.5,5,0,5,37,86,123
p_88,14,0,e_0,538,543,629,17.5,2,2,13.0,5,1,5,5,86,91
p_127,15,0,e_0,473,549,629,29.5,2,2,0.0,4,1,0,76,80,156
p_112,15,0,e_0,497,549,629,24.5,2,2,5.0,5,0,5,52,80,132
p_111,15,0,e_0,501,549,629,24.0,1,1,6.5,5,0,5,48,80,128
p_107,1,0,e_2,512,518,652,5.0,3,1,0.0,3,0,0,6,134,140
p_133,4,0,e_2,463,532,652,12.5,2,1,8.5,4,1,2,69,120,189
p_125,4,0,e_2,474,532,652,10.0,3,2,6.5,4,1,3,58,120,178
p_106,4,0,e_2,512,532,652,2.0,3,1,0.0,5,0,1,20,120,140
p_147,7,0,e_2,450,546,652,11.5,3,2,11.0,4,1,3,96,106,202
p_138,7,0,e_2,456,546,652,10.5,3,2,10.0,1,1,2,90,106,196
p_135,7,0,e_2,461,546,652,10.0,2,1,9.0,4,1,2,85,106,191
p_132,7,0,e_2,463,546,652,9.5,2,1,8.5,4,1,2,83,106,189
p_104,7,0,e_2,516,546,652,28.5,4,4,1.0,5,0,2,30,106,136
p_146,10,0,e_2,451,560,652,8.0,3,1,11.0,1,1,3,109,92,201
p_100,10,0,e_2,522,560,652,24.0,4,4,2.0,5,1,3,38,92,130
p_97,10,0,e_2,526,560,652,24.0,3,3,3.0,5,1,4,34,92,126
p_101,12,0,e_2,521,570,652,22.5,3,3,1.5,5,1,2,49,82,131
p_75,14,0,e_2,563,580,652,11.0,3,0,10.5,5,1,1,17,72,89
p_68,14,0,e_2,574,580,652,8.5,5,0,13.0,5,1,2,6,72,78
p_102,2,0,e_3,521,556,652,2.0,3,0,4.5,4,1,2,35,96,131
p_81,2,0,e_3,547,556,652,8.0,2,2,0.0,5,0,2,9,96,105
p_84,3,0,e_3,546,562,652,3.0,1,1,0.0,3,1,1,16,90,106
p_82,3,0,e_3,547,562,652,7.0,2,1,0.0,5,0,2,15,90,105
p_83,5,0,e_3,546,572,652,5.0,0,0,0.0,3,1,0,26,80,106
p_80,6,0,e_3,548,578,652,5.5,3,0,0.5,5,0,3,30,74,104
p_73,6,0,e_3,568,578,652,2.0,3,0,4.0,5,1,2,10,74,84
p_63,8,0,e_3,581,588,652,5.5,4,1,6.5,5,1,3,7,64,71
p_60,9,0,e_3,584,594,652,4.0,5,1,7.0,5,1,4,10,58,68
p_69,10,0,e_3,573,600,652,5.0,4,0,5.0,5,1,3,27,52,79
p_58,10,0,e_3,586,600,652,2.5,6,0,7.5,5,1,5,14,52,66
p_47,6,0,e_3,594,618,652,5.0,4,1,9.0,5,1,3,24,34,58
p_45,5,0,e_3,597,624,652,5.5,5,1,9.5,5,1,4,27,28,55
p_105,4,0,e_3,515,630,652,1.0,3,0,5.5,4,1,2,115,22,137
p_38,4,0,e_3,627,630,652,0.0,3,0,4.5,4,1,2,3,22,25
p_90,2,0,e_1,536,546,684,30.0,2,2,0.0,3,0,0,10,138,148
p_155,3,0,e_1,434,552,684,13.0,3,2,6.0,5,1,2,118,132,250
p_85,3,0,e_1,542,552,684,27.5,1,1,1.5,5,0,3,10,132,142
p_144,4,0,e_1,451,558,684,14.0,2,1,8.5,5,1,3,107,126,233
p_118,4,0,e_1,488,558,684,7.0,3,2,8.0,4,1,4,70,126,196
p_78,4,0,e_1,555,558,684,6.0,4,2,3.5,5,1,2,3,126,129
p_86,6,0,e_1,541,568,684,25.0,1,1,1.0,5,0,2,27,116,143
p_77,6,0,e_1,557,568,684,4.0,4,0,4.0,3,1,2,11,116,127
p_116,7,0,e_1,490,574,684,3.0,3,1,7.5,4,1,4,84,110,194
p_89,7,0,e_1,537,574,684,24.5,2,2,0.0,5,0,1,37,110,147
p_76,7,0,e_1,559,574,684,4.5,4,0,4.0,5,1,2,15,110,125
p_74,11,0,e_1,567,592,684,7.0,3,0,6.0,2,1,1,25,92,117
p_52,11,0,e_1,591,592,684,2.5,5,0,11.0,2,1,1,1,92,93
p_66,12,0,e_1,577,600,684,6.0,5,0,7.5,5,1,1,23,84,107
p_65,12,0,e_1,578,600,684,6.0,4,0,7.5,5,1,2,22,84,106
p_27,2,0,e_1,693,703,713,2.0,0,0,0.0,3,0,0,10,10,20
p_184,5,0,e_2,393,684,718,25.5,1,1,9.0,5,1,3,291,34,325
p_129,5,0,e_2,470,684,718,10.0,2,1,7.0,1,1,2,214,34,248
p_122,5,0,e_2,477,684,718,8.0,3,2,6.0,4,1,2,207,34,241
p_31,5,0,e_2,662,684,718,5.0,0,0,0.0,3,0,0,22,34,56
p_30,5,0,e_2,676,684,718,5.0,0,0,3.5,5,0,1,8,34,42
p_126,6,0,e_2,473,690,718,8.0,2,1,6.5,4,1,2,217,28,245
p_28,6,0,e_2,679,690,718,6.0,0,0,4.0,5,0,1,11,28,39
p_26,3,0,e_2,698,704,718,3.0,0,0,4.0,4,1,0,6,14,20
p_188,8,0,e_0,390,669,767,23.5,1,1,12.0,5,1,4,279,98,377
p_67,8,0,e_0,574,669,767,6.5,5,1,9.5,4,1,3,95,98,193
p_33,8,0,e_0,647,669,767,23.0,1,1,2.5,5,0,2,22,98,120
p_36,11,0,e_0,635,683,767,22.0,2,2,0.0,3,0,0,48,84,132
p_87,15,0,e_0,539,701,767,16.0,1,1,13.5,5,1,5,162,66,228
p_34,15,0,e_0,643,701,767,17.0,1,1,1.5,5,0,1,58,66,124
p_29,15,0,e_0,678,701,767,15.0,0,0,10.0,5,1,2,23,66,89
p_22,10,0,e_0,712,723,767,8.5,1,0,12.5,4,1,1,11,44,55
p_196,5,0,e_0,376,745,767,29.0,3,3,9.5,5,1,4,369,22,391
p_192,5,0,e_0,380,745,767,28.0,3,3,10.5,5,1,5,365,22,387
p_182,5,0,e_0,394,745,767,25.5,1,1,13.0,5,1,7,351,22,373
p_96,5,0,e_0,527,745,767,28.5,3,3,11.5,5,1,5,218,22,240
p_62,5,0,e_0,582,745,767,8.0,5,2,8.0,4,1,4,163,22,185
p_61,5,0,e_0,583,745,767,8.0,5,2,7.5,4,1,4,162,22,184
p_49,5,0,e_0,592,745,767,6.0,5,1,6.0,1,1,4,153,22,175
p_25,7,0,e_3,703,734,810,7.0,0,0,0.0,3,0,0,31,76,107
p_20,9,0,e_3,737,744,810,3.5,2,1,7.5,5,1,1,7,66,73
p_21,10,0,e_3,732,750,810,3.0,1,0,7.0,5,0,1,18,60,78
p_19,12,0,e_3,740,760,810,3.5,3,0,8.5,5,1,2,20,50,70
p_13,11,0,e_2,794,841,891,22.5,1,1,0.0,3,0,0,47,50,97
p_11,11,0,e_2,810,841,891,11.0,0,0,3.5,5,0,1,31,50,81
p_5,5,0,e_2,860,867,891,21.0,3,2,6.5,4,1,0,7,24,31
p_4,1,0,e_2,864,885,891,23.5,3,2,5.5,4,1,1,21,6,27
p_185,2,0,e_0,392,779,891,29.0,1,1,12.5,5,1,6,387,112,499
p_143,2,0,e_0,451,779,891,16.0,3,1,4.5,4,1,3,328,112,440
p_136,2,0,e_0,460,779,891,15.0,2,1,2.5,4,1,2,319,112,431
p_56,2,0,e_0,588,779,891,10.0,5,2,7.0,4,1,3,191,112,303
p_48,2,0,e_0,593,779,891,9.0,5,1,6.0,1,1,4,186,112,298
p_18,2,0,e_0,768,779,891,8.0,1,0,0.0,3,0,0,11,112,123
p_16,13,0,e_0,774,825,891,25.5,1,1,1.0,5,0,1,51,66,117
p_12,13,0,e_0,796,825,891,20.5,1,1,6.0,5,1,1,29,66,95
p_79,14,0,e_0,549,831,891,13.5,4,0,15.0,4,1,3,282,60,342
p_10,14,0,e_0,810,831,891,14.0,0,0,9.5,5,1,1,21,60,81
p_186,1,0,e_0,391,885,891,30.0,1,1,12.5,5,1,5,494,6,500
p_64,1,0,e_0,579,885,891,13.0,4,1,8.0,4,1,4,306,6,312
p_51,1,0,e_0,591,885,891,10.5,5,2,6.5,4,1,5,294,6,300
p_3,1,0,e_0,876,885,891,20.5,3,2,3.0,4,1,0,9,6,15
p_44,15,0,e_1,598,834,898,5.0,6,0,12.0,5,1,2,236,64,300
p_39,15,0,e_1,609,834,898,23.0,5,5,13.5,5,1,1,225,64,289
p_17,15,0,e_1,772,834,898,24.5,1,1,0.0,3,0,0,62,64,126
p_15,15,0,e_1,782,834,898,22.0,1,1,2.0,5,0,1,52,64,116
p_14,15,0,e_1,790,834,898,20.0,1,1,4.5,5,0,1,44,64,108
p_2,3,0,e_1,878,884,898,18.5,3,2,4.0,4,1,0,6,14,20
p_110,1,0,e_3,501,852,970,8.0,1,0,9.0,4,1,0,351,118,469
p_8,1,0,e_3,847,852,970,3.0,1,1,0.0,5,0,1,5,118,123
p_71,2,0,e_3,569,858,970,5.5,3,2,4.5,5,1,2,289,112,401
p_9,2,0,e_3,845,858,970,2.0,0,0,0.0,3,0,0,13,112,125
p_7,12,0,e_3,851,900,970,11.0,2,0,1.0,5,0,2,49,70,119
p_6,14,0,e_3,858,910,970,12.0,2,0,2.0,5,1,1,52,60,112
p_1,2,0,e_3,889,960,970,16.5,3,2,9.5,5,1,2,71,10,81
p_7,2,0,e_3,55,66,76,2.0,0,0,0.0,3,0,0,11,10,21
p_3,4,0,e_2,25,43,107,4.0,0,0,0.0,3,0,0,18,64,82
p_4,5,0,e_2,34,49,107,5.0,0,0,2.0,5,0,1,15,58,73
p_5,9,0,e_2,41,67,107,9.0,0,0,3.5,5,0,2,26,40,66
p_6,9,0,e_2,45,67,107,9.0,0,0,4.5,5,1,2,22,40,62
p_11,4,0,e_2,84,89,107,4.0,0,0,5.0,4,1,0,5,18,23
p_2,11,0,e_1,19,65,113,11.0,0,0,0.0,3,0,0,46,48,94
p_9,10,0,e_1,67,71,113,22.0,1,1,11.0,4,1,0,4,42,46
p_12,0,8,e_3,86,86,122,0.0,0,0,0.0,3,0,0,0,36,36
p_1,13,0,e_0,13,68,148,13.0,0,0,0.0,3,0,0,55,80,135
p_8,15,0,e_0,62,78,148,13.5,1,0,12.0,5,0,1,16,70,86
p_10,9,0,e_0,77,104,148,9.0,0,0,15.0,5,1,1,27,44,71
p_13,8,0,e_0,87,110,148,8.0,2,0,13.0,4,1,1,23,38,61
p_15,5,0,e_0,99,124,148,18.5,2,2,10.0,4,1,2,25,24,49
p_16,4,0,e_0,101,130,148,19.0,2,2,9.5,4,1,3,29,18,47
p_19,0,7,e_1,125,125,159,21.5,2,2,0.0,3,0,0,0,34,34
p_21,0,10,e_0,142,148,190,17.5,2,2,1.5,4,1,0,6,42,48
p_22,6,0,e_1,146,153,191,10.5,2,1,4.5,5,1,1,7,38,45
p_20,3,0,e_1,142,177,191,14.0,2,1,3.5,5,1,0,35,14,49
p_17,10,0,e_2,112,154,198,10.5,2,1,0.0,3,0,0,42,44,86
p_26,6,0,e_2,169,172,198,6.0,2,1,6.5,4,1,0,3,26,29
p_30,2,0,e_1,200,210,222,3.0,2,0,0.0,3,0,0,10,12,22
p_33,1,0,e_1,213,216,222,1.0,1,0,1.5,4,1,0,3,6,9
p_14,13,0,e_3,87,144,224,13.0,2,0,0.0,5,1,1,57,80,137
p_18,15,0,e_3,120,154,224,7.5,2,0,7.5,5,1,1,34,70,104
p_23,15,0,e_3,150,154,224,0.5,2,0,14.5,5,1,1,4,70,74
p_24,14,0,e_3,157,160,224,0.0,1,0,14.5,4,1,0,3,64,67
p_25,9,0,e_3,163,182,224,4.0,1,0,13.5,4,1,0,19,42,61
p_28,7,0,e_3,184,192,224,1.0,2,0,8.5,4,1,1,8,32,40
p_27,5,0,e_3,180,202,224,4.0,2,0,9.5,4,1,1,22,22,44
p_31,5,0,e_2,203,226,250,30.0,1,1,0.0,3,0,0,23,24,47
p_36,1,0,e_2,225,244,250,11.0,1,1,5.0,2,0,0,19,6,25
p_35,0,6,e_3,222,224,250,0.0,1,0,0.0,4,1,0,2,26,28
p_32,0,10,e_1,209,222,264,3.5,1,0,2.0,5,0,1,13,42,55
p_29,14,0,e_0,192,211,271,23.0,2,2,10.0,3,0,0,19,60,79
p_34,11,0,e_0,217,225,271,20.5,1,1,13.0,4,1,0,8,46,54
p_43,4,0,e_0,270,289,307,11.5,2,2,0.0,3,1,0,19,18,37
p_44,4,0,e_0,275,289,307,10.0,1,1,1.0,5,0,1,14,18,32
p_42,4,0,e_2,269,275,321,11.5,2,2,2.5,5,0,1,6,46,52
p_41,7,0,e_2,257,289,321,11.5,2,2,0.0,3,0,0,32,32,64
p_47,3,0,e_2,293,307,321,7.0,2,1,6.5,4,1,0,14,14,28
p_49,3,0,e_2,298,307,321,6.0,3,1,5.0,4,1,1,9,14,23
p_51,0,4,e_0,309,309,329,7.5,1,0,0.0,3,0,0,0,20,20
p_38,12,0,e_3,240,276,342,8.0,1,0,4.0,5,1,0,36,66,102
p_39,13,0,e_3,247,282,342,7.5,2,0,5.5,5,1,1,35,60,95
p_48,9,0,e_3,294,300,342,1.0,2,0,10.5,4,1,1,6,42,48
p_46,8,0,e_3,291,306,342,3.0,1,0,11.0,4,1,0,15,36,51
p_57,1,0,e_3,327,336,342,2.0,1,0,3.0,4,1,0,9,6,15
p_37,15,0,e_1,228,286,360,14.5,1,0,1.0,5,1,0,58,74,132
p_40,15,0,e_1,255,286,360,8.0,2,0,8.0,5,1,1,31,74,105
p_45,11,0,e_1,290,304,360,30.0,1,1,14.0,4,1,0,14,56,70
p_50,11,0,e_1,299,304,360,28.0,3,3,12.0,4,1,1,5,56,61
p_53,8,0,e_1,313,318,360,28.5,1,1,9.0,4,1,0,5,42,47
p_54,7,0,e_1,313,324,360,29.5,1,1,9.0,4,1,1,11,36,47
p_59,3,0,e_1,335,342,360,28.0,2,2,4.5,4,1,0,7,18,25
p_60,2,0,e_1,338,348,360,28.5,1,1,3.5,4,1,1,10,12,22
p_62,1,0,e_1,345,354,360,10.5,1,1,2.5,4,1,1,9,6,15
p_58,0,6,e_3,330,342,368,2.5,2,0,2.5,4,1,1,12,26,38
p_65,0,7,e_3,369,395,427,6.0,0,0,6.0,3,0,0,26,32,58
p_56,8,0,e_2,324,358,430,25.5,1,1,0.0,3,0,0,34,72,106
p_61,12,0,e_2,341,376,430,12.0,0,0,4.0,5,0,1,35,54,89
p_70,3,0,e_2,398,414,430,10.5,1,1,7.0,4,1,1,16,16,32
p_68,2,0,e_2,389,420,430,29.5,1,1,9.0,4,1,0,31,10,41
p_69,2,0,e_2,391,420,430,29.0,1,1,8.5,4,1,1,29,10,39
p_64,0,15,e_1,365,365,431,6.5,1,1,0.0,3,0,1,0,66,66
p_52,14,0,e_0,312,371,433,23.0,1,1,0.0,5,1,0,59,62,121
p_55,14,0,e_0,314,371,433,22.5,1,1,0.5,5,1,1,57,62,119
p_67,12,0,e_0,377,381,433,22.0,1,1,13.0,4,1,1,4,52,56
p_66,11,0,e_0,376,387,433,23.5,1,1,13.0,4,1,0,11,46,57
p_75,3,0,e_0,438,453,467,7.5,3,1,0.0,3,0,0,15,14,29
p_72,6,0,e_3,417,421,487,2.5,1,1,5.5,5,1,0,4,66,70
p_71,7,0,e_3,403,427,487,5.0,1,0,2.0,5,1,0,24,60,84
p_74,10,0,e_3,424,441,487,3.5,3,0,6.5,5,2,1,17,46,63
p_77,4,0,e_3,455,467,487,2.0,2,0,6.5,4,1,1,12,20,32
p_73,3,0,e_3,423,473,487,4.5,2,1,6.5,5,2,0,50,14,64
p_63,3,0,e_1,364,381,497,3.5,1,1,0.0,3,0,0,17,116,133
p_76,10,0,e_1,440,453,497,14.0,2,0,13.0,4,1,0,13,44,57
p_79,9,0,e_1,457,459,497,27.0,3,3,9.5,4,1,0,2,38,40
p_81,1,0,e_0,493,500,506,1.0,0,0,0.0,3,0,0,7,6,13
p_82,0,12,e_3,494,495,547,0.0,0,0,0.0,3,0,0,1,52,53
p_87,3,0,e_0,528,542,558,17.5,2,2,0.0,3,0,0,14,16,30
p_90,1,0,e_0,538,552,558,17.0,2,2,2.5,5,0,1,14,6,20
p_83,0,12,e_1,501,502,558,23.5,1,1,0.0,3,0,0,1,56,57
p_78,12,0,e_2,455,505,573,25.0,2,2,0.0,3,0,0,50,68,118
p_84,12,0,e_2,504,505,573,10.5,1,0,12.0,2,0,1,1,68,69
p_80,13,0,e_2,474,513,573,20.0,1,1,4.5,5,0,1,39,60,99
p_89,5,0,e_2,535,547,573,14.0,2,2,8.0,4,1,0,12,26,38
p_93,4,0,e_2,543,553,573,12.5,2,2,5.5,4,1,1,10,20,30
p_94,3,0,e_2,546,559,573,13.0,1,1,5.0,1,1,1,13,14,27
p_88,10,0,e_1,531,546,620,10.0,2,2,6.5,5,1,0,15,74,89
p_92,10,0,e_1,540,546,620,7.5,2,2,8.5,5,1,1,6,74,80
p_95,10,0,e_1,547,548,620,6.0,1,1,10.0,5,2,0,1,72,73
p_100,10,0,e_1,557,568,620,12.0,1,0,12.0,5,2,3,11,52,63
p_99,9,0,e_1,556,574,620,11.0,1,0,12.0,5,2,2,18,46,64
p_96,7,0,e_1,551,584,620,8.5,1,1,10.5,5,2,0,33,36,69
p_97,5,0,e_1,552,594,620,10.0,1,1,10.5,5,2,1,42,26,68
p_106,5,0,e_1,583,594,620,3.0,2,1,7.0,4,1,2,11,26,37
p_107,3,0,e_1,584,604,620,5.0,3,2,7.0,1,1,1,20,16,36
p_111,2,0,e_1,607,610,620,1.0,1,0,2.5,4,1,0,3,10,13
p_85,14,0,e_3,517,557,621,9.5,1,0,4.5,5,1,0,40,64,104
p_86,14,0,e_3,518,557,621,9.0,2,0,5.0,5,1,1,39,64,103
p_91,14,0,e_3,539,557,621,4.0,2,0,10.0,5,1,1,18,64,82
p_101,9,0,e_3,566,579,621,3.0,2,0,12.0,4,1,1,13,42,55
p_108,7,0,e_3,584,589,621,1.0,2,0,8.0,4,1,1,5,32,37
p_98,6,0,e_3,555,595,621,8.0,1,0,14.0,5,0,1,40,26,66
p_117,0,2,e_3,636,636,648,0.0,0,0,0.0,3,0,0,0,12,12
p_121,3,0,e_3,656,663,677,1.0,0,0,2.0,3,0,0,7,14,21
p_123,0,2,e_3,661,677,687,3.0,1,1,3.0,5,0,1,16,10,26
p_109,10,0,e_2,590,624,694,27.0,2,2,2.0,5,0,1,34,70,104
p_105,12,0,e_2,582,634,694,26.5,2,2,0.0,3,0,0,52,60,112
p_110,12,0,e_2,590,634,694,25.0,2,2,1.5,5,0,1,44,60,104
p_114,13,0,e_2,632,640,694,13.0,0,0,12.0,5,1,1,8,54,62
p_112,11,0,e_0,613,614,696,20.5,1,1,11.0,5,0,1,1,82,83
p_102,14,0,e_0,568,628,696,27.5,3,3,0.0,3,0,0,60,68,128
p_103,14,0,e_0,577,628,696,25.5,3,3,2.0,5,0,1,51,68,119
p_104,14,0,e_0,581,628,696,24.5,2,2,3.0,5,0,1,47,68,115
p_113,9,0,e_0,629,650,696,9.0,0,0,14.0,4,1,0,21,46,67
p_115,9,0,e_0,632,650,696,9.0,0,0,13.5,4,1,1,18,46,64
p_118,8,0,e_0,649,656,696,6.0,0,0,9.0,1,1,0,7,40,47
p_119,8,0,e_0,650,656,696,6.0,0,0,9.0,1,1,1,6,40,46
p_122,7,0,e_0,657,662,696,5.0,1,0,8.0,4,1,0,5,34,39
p_125,2,0,e_0,668,684,696,30.0,1,1,6.0,4,1,0,16,12,28
p_126,1,0,e_0,681,690,696,2.5,1,1,2.5,4,1,1,9,6,15
p_116,7,0,e_1,633,663,745,7.0,0,0,0.0,3,0,0,30,82,112
p_120,13,0,e_1,653,689,745,11.0,0,0,5.0,5,0,1,36,56,92
p_124,7,0,e_1,664,715,745,26.0,1,1,7.0,5,1,1,51,30,81
p_127,7,0,e_1,701,715,745,5.0,0,0,10.0,4,1,1,14,30,44
p_128,0,15,e_0,705,706,770,2.0,0,0,0.0,3,0,0,1,64,65
p_139,0,15,e_1,758,758,822,14.0,4,4,0.0,3,0,0,0,64,64
p_132,4,0,e_2,730,741,823,11.0,2,1,1.5,5,0,1,11,82,93
p_133,6,0,e_2,734,751,823,13.5,3,2,2.5,5,0,2,17,72,89
p_131,7,0,e_2,722,757,823,9.5,2,1,0.0,3,0,0,35,66,101
p_135,11,0,e_2,739,775,823,7.5,3,1,4.0,5,0,3,36,48,84
p_140,5,0,e_2,768,801,823,8.0,2,1,9.5,5,1,1,33,22,55
p_129,5,0,e_3,705,720,824,3.0,0,0,2.0,3,0,0,15,104,119
p_130,11,0,e_3,705,746,824,9.0,1,1,2.0,3,0,1,41,78,119
p_134,14,0,e_3,734,760,824,6.0,2,0,8.0,5,1,1,26,64,90
p_136,14,0,e_3,749,760,824,2.5,2,0,11.5,5,1,1,11,64,75
p_137,13,0,e_3,755,766,824,2.0,2,1,13.0,5,1,1,11,58,69
p_138,12,0,e_3,756,772,824,2.5,3,1,13.5,5,1,2,16,52,68
p_141,12,0,e_3,770,772,824,0.0,2,0,12.5,4,1,1,2,52,54
p_143,5,0,e_3,780,802,824,5.0,1,0,10.0,4,1,0,22,22,44
p_142,13,0,e_0,773,784,840,29.0,1,1,15.0,3,0,0,11,56,67
p_145,1,0,e_0,820,834,840,29.5,1,1,4.0,4,1,0,14,6,20
p_144,6,0,e_1,815,860,890,26.0,1,1,13.5,5,1,0,45,30,75
p_147,6,0,e_1,849,860,890,6.0,0,0,8.5,4,0,1,11,30,41
p_150,3,0,e_1,860,874,890,9.0,1,1,6.0,4,1,0,14,16,30
p_152,2,0,e_1,868,880,890,8.5,1,1,4.5,4,1,1,12,10,22
p_154,4,0,e_3,874,878,914,4.5,1,1,3.5,5,0,1,4,36,40
p_149,6,0,e_3,859,888,914,6.0,0,0,0.0,3,0,0,29,26,55
p_153,6,0,e_3,872,888,914,3.5,1,0,2.5,5,0,1,16,26,42
p_146,10,0,e_0,846,889,953,10.0,0,0,0.0,3,0,0,43,64,107
p_155,11,0,e_0,884,895,953,6.0,2,0,9.0,5,0,2,11,58,69
p_151,12,0,e_0,863,901,953,11.5,1,0,4.0,5,0,1,38,52,90
p_156,12,0,e_0,884,901,953,6.5,2,0,9.0,5,0,3,17,52,69
p_157,7,0,e_0,889,923,953,29.0,1,1,10.0,5,1,2,34,30,64
p_158,7,0,e_1,892,922,962,28.5,1,1,0.0,3,0,0,30,40,70
p_159,8,0,e_1,893,928,962,27.0,1,1,0.0,5,0,1,35,34,69
p_148,15,0,e_2,849,911,973,15.0,0,0,0.0,3,0,0,62,62,124
p_306,3,4,e_0,2,17,23,3.0,0,0,0.0,3,0,0,15,6,21
p_550,6,9,e_1,28,33,47,2.0,1,0,5.0,5,1,1,5,14,19
p_551,6,11,e_2,10,31,55,6.0,0,0,1.0,5,0,1,21,24,45
p_70,0,11,e_1,4,5,57,0.0,0,0,0.0,3,0,0,1,52,53
p_622,7,14,e_2,5,37,69,7.0,0,0,0.0,3,0,0,32,32,64
p_69,0,6,e_0,13,41,69,18.0,1,1,2.0,5,0,1,28,28,56
p_763,9,15,e_3,10,49,75,9.0,0,0,0.0,3,0,0,39,26,65
p_549,6,10,e_0,51,69,87,27.0,2,2,2.0,5,1,1,18,18,36
p_1239,15,12,e_3,67,75,89,1.5,2,0,13.5,5,1,1,8,14,22
p_391,4,12,e_0,46,59,97,13.5,2,2,1.0,5,1,0,13,38,51
p_1240,15,10,e_2,31,75,97,10.5,1,0,6.0,2,0,1,44,22,66
p_1014,12,13,e_0,71,97,103,28.0,2,2,6.0,5,4,1,26,6,32
p_1013,12,13,e_0,89,97,103,22.0,2,2,10.5,5,3,1,8,6,14
p_1015,12,7,e_1,53,63,107,8.0,2,1,10.0,5,1,1,10,44,54
p_762,9,7,e_1,91,97,107,3.0,2,0,10.5,4,4,0,6,10,16
p_916,11,3,e_1,60,87,125,7.5,2,1,11.5,5,0,2,27,38,65
p_463,5,4,e_3,99,121,127,4.0,2,1,9.5,4,0,2,22,6,28
p_1161,14,2,e_1,25,73,131,11.0,1,0,4.0,5,1,0,48,58,106
p_621,7,2,e_2,27,37,137,7.0,1,1,5.5,5,0,2,10,100,110
p_1160,14,1,e_1,56,73,137,5.5,2,1,11.0,5,1,2,17,64,81
p_689,8,5,e_0,108,127,141,28.5,3,3,12.0,4,2,1,19,14,33
p_141,1,0,e_1,104,137,143,7.0,3,2,7.5,4,4,0,33,6,39
p_144,1,0,e_3,40,141,147,10.0,1,1,7.0,5,0,1,101,6,107
p_915,11,4,e_0,109,113,147,25.0,3,3,12.0,4,2,2,4,34,38
p_688,8,4,e_0,124,127,147,25.5,3,3,8.5,4,3,2,3,20,23
p_223,2,4,e_2,92,137,147,11.5,2,1,11.0,4,2,2,45,10,55
p_547,6,3,e_0,59,69,153,13.0,2,1,4.0,3,1,2,10,84,94
p_389,4,2,e_0,131,147,159,28.5,2,2,7.5,4,4,1,16,12,28
p_460,5,7,e_2,141,153,163,6.0,2,1,3.0,5,5,1,12,10,22
p_222,2,8,e_2,112,137,169,6.5,3,1,7.0,4,2,1,25,32,57
p_548,6,0,e_0,55,69,173,14.0,2,1,3.0,5,1,2,14,104,118
p_465,5,10,e_2,79,121,179,17.0,2,1,14.0,4,2,0,42,58,100
p_142,1,9,e_1,73,137,185,16.5,2,2,14.0,2,1,1,64,48,112
p_464,5,11,e_2,97,121,185,13.5,2,1,10.0,1,2,2,24,64,88
p_390,4,11,e_2,113,127,185,8.5,3,1,6.5,4,2,1,14,58,72
p_139,1,3,e_0,166,167,187,26.5,4,4,1.0,4,3,0,1,20,21
p_461,5,12,e_2,129,153,191,6.5,2,1,3.5,4,4,0,24,38,62
p_761,9,10,e_3,159,185,191,6.0,3,0,3.0,5,2,1,26,6,32
p_690,8,14,e_2,83,107,201,19.5,2,1,13.5,4,2,1,24,94,118
p_462,5,14,e_2,120,121,201,8.0,3,1,5.0,4,2,2,1,80,81
p_140,1,12,e_1,124,137,201,3.5,3,0,3.0,4,3,1,13,64,77
p_619,7,13,e_1,169,173,207,2.0,4,0,6.0,5,2,3,4,34,38
p_620,7,15,e_2,149,163,207,7.0,2,0,4.0,5,4,2,14,44,58
p_68,0,14,e_3,135,147,211,2.0,2,0,2.0,4,1,1,12,64,76
p_305,3,8,e_0,58,153,213,22.0,2,2,4.0,5,1,2,95,60,155
p_1094,13,12,e_1,146,207,213,17.0,2,2,0.5,5,2,3,61,6,67
p_546,6,15,e_3,88,115,217,16.0,1,1,12.0,1,1,1,27,102,129
p_760,9,15,e_3,182,185,217,1.0,4,0,8.5,5,2,2,3,32,35
p_1012,12,15,e_3,149,201,217,12.0,2,0,0.5,5,2,0,52,16,68
p_1159,14,15,e_3,199,211,217,3.0,3,1,11.5,5,2,1,12,6,18
p_143,1,9,e_0,53,165,219,21.5,2,2,2.5,5,1,1,112,54,166
p_618,7,9,e_0,189,207,219,27.0,4,4,3.5,5,2,0,18,12,30
p_1095,13,10,e_1,144,207,223,17.5,2,2,0.0,5,2,2,63,16,79
p_1091,13,9,e_1,191,207,229,7.0,3,2,10.0,5,4,0,16,22,38
p_686,8,13,e_0,194,213,237,27.5,3,3,4.5,5,2,3,19,24,43
p_829,10,7,e_1,120,191,239,24.0,3,3,4.0,4,3,0,71,48,119
p_1237,15,8,e_2,160,207,239,12.0,4,0,6.5,5,6,1,47,32,79
p_687,8,6,e_1,125,179,245,25.5,3,3,3.0,1,3,1,54,66,120
p_1090,13,6,e_1,196,207,245,6.0,3,2,11.0,5,4,0,11,38,49
p_1235,15,7,e_2,191,207,245,5.0,3,0,12.0,5,3,0,16,38,54
p_459,5,15,e_0,194,197,247,24.5,3,3,4.5,5,2,1,3,50,53
p_1158,14,7,e_3,215,223,253,1.5,1,1,14.5,5,1,0,8,30,38
p_1234,15,5,e_2,197,207,255,3.5,3,0,13.0,5,3,0,10,48,58
p_1010,12,5,e_2,215,221,255,3.5,2,1,13.5,4,5,0,6,34,40
p_1232,15,13,e_0,237,247,257,21.5,2,2,13.0,5,2,1,10,10,20
p_1011,12,3,e_1,187,201,259,9.0,4,2,9.5,5,3,1,14,58,72
p_1093,13,3,e_1,177,207,259,9.5,4,2,7.5,5,3,2,30,52,82
p_617,7,4,e_2,239,245,261,3.0,4,0,8.0,1,5,0,6,16,22
p_1092,13,2,e_1,179,207,265,9.0,4,2,8.0,5,4,1,28,58,86
p_914,11,3,e_2,141,185,267,20.0,2,2,2.5,5,5,1,44,82,126
p_1236,15,3,e_2,170,207,267,9.5,4,0,8.0,5,5,0,37,60,97
p_218,2,1,e_1,250,265,271,5.0,4,3,5.0,4,2,1,15,6,21
p_1238,15,1,e_2,142,207,277,16.0,2,2,3.0,5,5,1,65,70,135
p_219,2,0,e_1,243,265,277,7.0,4,4,6.0,4,3,1,22,12,34
p_386,4,1,e_3,221,271,285,10.0,2,0,14.5,4,0,2,50,14,64
p_828,10,6,e_0,252,273,295,23.0,4,4,14.0,4,3,2,21,22,43
p_138,1,4,e_1,231,271,295,11.5,2,0,9.0,4,4,0,40,24,64
p_1233,15,5,e_0,228,247,301,24.0,2,2,11.0,5,2,1,19,54,73
p_220,2,6,e_1,219,265,305,12.5,1,0,10.5,4,6,0,46,40,86
p_913,11,4,e_0,250,267,307,22.5,4,4,14.5,4,3,1,17,40,57
p_685,8,4,e_0,265,285,307,23.0,4,4,11.0,4,2,4,20,22,42
p_221,2,7,e_1,199,265,311,20.5,3,3,12.0,5,4,0,66,46,112
p_615,7,8,e_2,299,305,311,3.0,5,1,6.0,2,0,4,6,6,12
p_1089,13,3,e_0,235,237,313,24.5,2,2,12.5,5,2,1,2,76,78
p_457,5,3,e_0,265,301,313,26.0,4,4,11.0,4,2,5,36,12,48
p_543,6,9,e_2,288,299,317,5.0,5,1,3.5,5,0,3,11,18,29
p_66,0,9,e_1,271,277,321,6.0,4,0,1.0,1,4,0,6,44,50
p_759,9,1,e_0,263,279,323,22.0,4,4,11.5,4,2,3,16,44,60
p_757,9,11,e_2,309,317,327,3.0,5,1,8.0,5,2,3,8,10,18
p_545,6,10,e_3,237,259,327,8.5,2,1,10.5,4,1,1,22,68,90
p_387,4,10,e_3,219,271,327,10.5,1,0,14.5,4,0,1,52,56,108
p_67,0,11,e_1,261,277,331,5.5,4,0,3.0,4,1,1,16,54,70
p_758,9,12,e_2,295,317,333,6.0,5,2,5.0,5,0,4,22,16,38
p_544,6,11,e_3,245,259,333,6.5,4,2,8.5,4,1,3,14,74,88
p_458,5,11,e_3,238,265,333,7.5,3,1,10.5,4,1,2,27,68,95
p_616,7,12,e_3,264,313,339,4.0,3,1,5.0,1,2,1,49,26,75
p_304,3,4,e_0,321,333,339,24.0,5,5,1.0,4,2,1,12,6,18
p_385,4,13,e_3,222,271,345,10.0,1,0,14.0,1,0,1,49,74,123
p_614,7,13,e_3,310,313,345,1.0,5,0,6.5,5,4,1,3,32,35
p_456,5,15,e_3,267,303,355,1.5,4,0,4.5,4,2,2,36,52,88
p_383,4,7,e_0,324,339,355,24.5,5,5,1.0,5,1,2,15,16,31
p_455,5,7,e_0,334,345,355,24.0,3,3,3.0,5,2,1,11,10,21
p_1088,13,11,e_2,277,339,369,19.0,6,6,1.0,5,0,1,62,30,92
p_1231,15,10,e_2,342,351,375,2.5,2,0,13.5,5,2,1,9,24,33
p_217,2,1,e_1,325,371,377,18.5,5,5,9.5,5,1,1,46,6,52
p_912,11,9,e_2,273,327,381,22.0,6,6,2.0,4,1,0,54,54,108
p_911,11,0,e_1,297,331,383,11.5,5,1,4.5,5,4,0,34,52,86
p_384,4,0,e_1,307,361,383,20.0,5,5,6.0,5,3,0,54,22,76
p_388,4,14,e_0,194,307,387,23.5,3,3,4.5,5,2,2,113,80,193
p_613,7,14,e_0,321,355,387,28.0,5,5,1.0,4,2,0,34,32,66
p_1087,13,11,e_0,366,381,401,19.5,1,1,9.5,5,1,0,15,20,35
p_1156,14,4,e_2,341,345,403,3.5,2,1,13.0,5,2,1,4,58,62
p_1157,14,2,e_2,282,345,413,16.5,6,6,2.0,5,0,2,63,68,131
p_1155,14,2,e_2,343,345,413,3.5,2,1,14.0,5,2,2,2,68,70
p_827,10,1,e_3,348,377,419,6.5,1,1,13.5,5,1,0,29,42,71
p_65,0,9,e_1,375,383,425,10.0,1,0,1.0,4,2,0,8,42,50
p_454,5,9,e_1,377,407,425,13.0,2,1,1.0,1,2,0,30,18,48
p_542,6,0,e_3,376,395,425,4.0,0,0,10.0,1,0,0,19,30,49
p_136,1,0,e_3,399,419,425,4.0,2,0,5.5,4,2,0,20,6,26
p_63,0,1,e_3,388,425,431,7.5,2,0,7.5,4,1,1,37,6,43
p_64,0,3,e_2,384,423,437,8.5,2,0,8.5,4,2,0,39,14,53
p_453,5,4,e_0,423,431,437,25.0,3,3,6.5,4,2,1,8,6,14
p_1009,12,13,e_1,395,441,447,18.0,2,2,2.5,5,1,3,46,6,52
p_910,11,14,e_1,387,435,453,17.0,2,2,0.5,5,1,2,48,18,66
p_1008,12,14,e_1,416,441,453,13.5,3,1,7.0,5,2,2,25,12,37
p_756,9,1,e_0,405,413,453,24.5,2,2,10.0,4,1,1,8,40,48
p_452,5,1,e_0,425,431,453,5.0,2,2,6.5,4,2,2,6,22,28
p_382,4,15,e_1,381,401,459,11.5,2,1,0.0,4,1,1,20,58,78
p_1152,14,15,e_1,450,453,459,9.0,3,3,13.5,5,2,0,3,6,9
p_1086,13,0,e_0,369,381,459,19.0,1,1,10.0,5,1,1,12,78,90
p_826,10,0,e_0,386,407,459,27.0,2,2,14.0,5,3,0,21,52,73
p_825,10,0,e_0,392,407,459,26.5,3,3,13.0,4,2,1,15,52,67
p_215,2,0,e_0,419,447,459,29.0,3,3,8.0,4,2,0,28,12,40
p_216,2,9,e_3,411,413,467,4.0,2,2,2.0,4,2,0,2,54,56
p_62,0,9,e_3,397,425,467,6.0,2,0,6.0,4,2,0,28,42,70
p_137,1,11,e_3,398,419,477,6.5,2,1,5.5,4,2,0,21,58,79
p_303,3,12,e_2,410,437,479,5.5,2,2,2.5,4,1,1,27,42,69
p_684,8,12,e_2,420,459,479,9.0,3,1,0.5,4,0,2,39,20,59
p_824,10,13,e_2,463,469,485,2.0,3,1,8.5,5,1,0,6,16,22
p_1230,15,9,e_1,438,459,485,12.5,2,0,11.5,5,2,1,21,26,47
p_135,1,6,e_0,441,453,487,19.5,2,2,3.5,4,2,1,12,34,46
p_133,1,6,e_0,449,453,487,18.0,3,3,2.0,4,2,1,4,34,38
p_754,9,8,e_1,463,485,491,5.0,3,1,14.0,4,3,0,22,6,28
p_1154,14,7,e_1,425,453,497,14.0,2,2,9.0,5,1,2,28,44,72
p_134,1,10,e_0,446,453,505,18.5,3,3,2.0,4,2,2,7,52,59
p_1151,14,13,e_2,468,491,507,5.0,3,0,10.0,2,1,0,23,16,39
p_541,6,11,e_0,477,487,511,13.0,2,2,4.0,3,2,0,10,24,34
p_683,8,4,e_3,444,461,511,10.0,2,2,4.0,5,2,0,17,50,67
p_1153,14,3,e_1,427,453,515,14.0,3,0,9.5,5,1,3,26,62,88
p_682,8,2,e_1,482,491,521,2.0,2,0,9.5,4,3,0,9,30,39
p_381,4,13,e_0,444,477,521,22.0,2,2,2.5,4,2,1,33,44,77
p_380,4,13,e_0,445,477,521,21.5,3,3,2.5,4,2,2,32,44,76
p_755,9,2,e_3,455,467,521,6.5,3,1,6.5,5,2,1,12,54,66
p_1007,12,9,e_2,441,479,527,8.5,2,0,4.0,5,1,1,38,48,86
p_61,0,4,e_1,509,531,551,4.0,5,0,4.5,4,3,1,22,20,42
p_301,3,5,e_1,530,545,557,3.0,4,0,0.0,4,2,2,15,12,27
p_1229,15,2,e_2,476,497,559,4.0,3,0,11.5,5,2,1,21,62,83
p_539,6,2,e_2,527,541,559,25.0,4,4,9.0,1,3,0,14,18,32
p_451,5,6,e_3,492,505,559,8.5,3,2,7.5,4,2,1,13,54,67
p_1228,15,8,e_0,502,531,565,18.5,4,4,9.5,5,3,0,29,34,63
p_302,3,7,e_1,471,515,567,15.0,3,3,12.5,4,3,0,44,52,96
p_909,11,0,e_2,506,517,569,22.0,4,4,13.0,4,3,0,11,52,63
p_60,0,8,e_3,512,531,569,4.0,4,0,4.0,4,3,1,19,38,57
p_379,4,9,e_3,533,549,575,4.0,4,0,0.0,5,3,1,16,26,42
p_59,0,10,e_1,517,531,583,2.5,5,0,2.5,4,3,2,14,52,66
p_449,5,10,e_1,546,557,583,2.0,6,1,3.0,5,5,1,11,26,37
p_540,6,11,e_3,491,499,585,9.5,2,2,7.5,4,2,0,8,86,94
p_450,5,11,e_1,544,557,589,2.0,6,1,3.0,2,4,1,13,32,45
p_378,4,2,e_0,562,583,593,19.5,4,4,8.5,4,3,0,21,10,31
p_908,11,13,e_3,517,585,595,13.5,5,1,2.5,4,3,2,68,10,78
p_612,7,12,e_1,495,497,597,10.0,4,4,7.5,4,3,0,2,100,102
p_753,9,12,e_1,500,577,597,11.0,4,3,6.5,4,3,0,77,20,97
p_752,9,15,e_3,508,575,605,9.5,4,1,4.5,4,4,0,67,30,97
p_611,7,14,e_1,530,567,609,7.0,4,0,0.0,4,2,2,37,42,79
p_132,1,9,e_2,572,575,611,22.5,3,3,0.5,5,0,1,3,36,39
p_1150,14,13,e_1,580,609,615,6.0,2,1,9.5,5,5,0,29,6,35
p_1085,13,12,e_1,601,603,621,3.0,3,1,13.0,5,3,0,2,18,20
p_377,4,9,e_0,590,603,625,22.0,2,2,2.5,4,3,0,13,22,35
p_300,3,13,e_2,566,585,631,25.5,4,4,0.5,4,1,0,19,46,65
p_299,3,13,e_2,575,585,631,24.0,2,2,1.0,2,0,1,10,46,56
p_1084,13,9,e_3,604,615,635,4.0,2,0,15.0,2,1,2,11,20,31
p_749,9,14,e_2,607,611,637,21.5,5,3,8.5,5,2,1,4,26,30
p_823,10,11,e_0,542,553,637,8.0,6,4,12.5,4,1,1,11,84,95
p_750,9,8,e_1,557,577,641,15.0,5,2,5.0,2,4,1,20,64,84
p_907,11,12,e_0,560,637,643,5.0,4,2,9.0,4,3,0,77,6,83
p_1006,12,7,e_3,599,621,645,4.0,2,1,14.0,5,1,1,22,24,46
p_751,9,13,e_0,535,559,649,8.0,5,3,14.0,4,1,0,24,90,114
p_904,11,6,e_1,589,591,653,7.0,2,2,11.0,5,3,0,2,62,64
p_822,10,14,e_0,629,631,655,18.5,5,5,9.5,5,2,0,2,24,26
p_906,11,14,e_0,561,637,655,5.0,4,2,8.5,4,3,0,76,18,94
p_538,6,5,e_3,640,651,657,2.0,5,1,8.0,4,3,2,11,6,17
p_1226,15,4,e_3,559,605,663,9.0,4,0,6.0,5,3,1,46,58,104
p_609,7,3,e_1,615,647,667,6.0,5,2,13.0,4,3,0,32,20,52
p_903,11,2,e_1,620,627,673,1.0,4,0,12.0,1,3,2,7,46,53
p_1004,12,6,e_2,630,647,673,27.0,5,5,13.0,2,3,0,17,26,43
p_610,7,2,e_3,593,645,675,10.5,2,2,12.5,5,2,0,52,30,82
p_536,6,5,e_2,670,673,679,27.0,3,3,6.5,4,2,1,3,6,9
p_1227,15,1,e_3,536,605,681,14.0,5,0,1.0,5,3,2,69,76,145
p_298,3,0,e_3,623,669,687,8.0,4,3,11.5,4,4,0,46,18,64
p_905,11,3,e_2,575,621,689,10.0,2,1,1.0,5,1,1,46,68,114
p_1005,12,4,e_0,629,643,699,27.5,5,5,10.0,5,2,1,14,56,70
p_131,1,3,e_1,619,679,699,11.5,5,0,12.5,4,3,1,60,20,80
p_128,1,4,e_1,677,679,705,3.0,2,1,1.5,4,0,2,2,26,28
p_56,0,6,e_1,675,685,715,2.0,2,0,1.5,4,0,2,10,30,40
p_608,7,10,e_0,677,685,725,9.0,2,2,9.0,4,1,1,8,40,48
p_901,11,12,e_0,694,731,737,10.0,4,1,5.0,4,2,2,37,6,43
p_448,5,7,e_2,719,729,741,27.5,4,4,3.0,5,4,0,10,12,22
p_58,0,12,e_1,625,685,741,11.0,5,0,11.0,4,2,3,60,56,116
p_57,0,13,e_3,631,687,745,10.0,5,0,10.0,4,4,1,56,58,114
p_1001,12,13,e_3,712,739,745,6.0,4,1,6.0,5,2,2,27,6,33
p_902,11,14,e_0,686,731,749,11.0,3,0,7.0,4,2,1,45,18,63
p_297,3,9,e_2,699,719,753,30.0,4,4,1.0,4,2,1,20,34,54
p_1149,14,15,e_0,676,749,755,16.0,2,2,9.0,4,1,0,73,6,79
p_130,1,15,e_3,627,681,755,9.5,5,0,10.5,4,4,1,54,74,128
p_535,6,10,e_2,729,735,759,26.5,4,4,5.0,2,4,0,6,24,30
p_681,8,11,e_2,732,747,765,27.5,4,4,5.5,5,5,1,15,18,33
p_55,0,12,e_2,695,705,771,28.5,4,4,1.5,4,1,1,10,66,76
p_129,1,14,e_2,641,699,781,8.5,6,1,13.0,4,1,1,58,82,140
p_537,6,15,e_2,648,673,787,12.5,6,5,12.0,4,2,1,25,114,139
p_998,12,8,e_0,759,769,789,2.0,6,1,14.5,4,3,2,10,20,30
p_820,10,8,e_0,765,779,789,3.0,5,0,12.5,4,3,3,14,10,24
p_748,9,8,e_1,767,785,791,4.0,5,1,12.5,4,3,2,18,6,24
p_1219,15,14,e_2,786,787,793,23.0,5,5,15.0,5,1,1,1,6,7
p_1003,12,7,e_3,684,739,795,18.5,2,2,0.5,4,2,0,55,56,111
p_1225,15,7,e_1,684,755,797,15.5,3,3,0.0,4,2,1,71,42,113
p_900,11,7,e_1,751,773,797,5.0,4,1,14.5,5,1,3,22,24,46
p_899,11,5,e_3,771,775,805,1.0,5,0,12.0,4,4,1,4,30,34
p_821,10,5,e_3,754,781,805,5.0,4,0,15.0,2,3,2,27,24,51
p_819,10,5,e_1,770,779,807,2.0,5,0,11.5,4,3,3,9,28,37
p_1002,12,3,e_0,708,737,815,13.0,4,2,6.0,5,1,3,29,78,107
p_1000,12,3,e_0,716,737,815,11.0,4,2,8.0,5,1,5,21,78,99
p_446,5,3,e_0,789,803,815,3.0,5,1,8.0,1,4,2,14,12,26
p_376,4,3,e_0,700,809,815,23.0,4,4,4.0,5,1,2,109,6,115
p_607,7,3,e_3,692,717,815,22.0,3,3,1.0,5,2,1,25,98,123
p_1081,13,3,e_3,753,765,815,2.5,4,1,14.5,5,3,1,12,50,62
p_1221,15,9,e_2,773,787,819,25.0,6,6,12.0,5,2,0,14,32,46
p_1222,15,2,e_3,749,755,821,1.5,3,0,13.5,5,3,0,6,66,72
p_1083,13,2,e_0,721,743,821,9.5,4,1,9.0,5,1,6,22,78,100
p_999,12,1,e_1,739,741,827,6.0,4,2,12.0,5,1,3,2,86,88
p_213,2,1,e_1,728,821,827,18.5,4,3,9.0,5,1,3,93,6,99
p_1082,13,1,e_0,735,743,827,5.5,4,1,12.0,5,2,4,8,84,92
p_375,4,1,e_0,730,809,827,16.0,4,3,11.0,2,0,6,79,18,97
p_1224,15,1,e_3,717,755,827,8.0,3,0,7.0,2,2,1,38,72,110
p_212,2,1,e_3,750,821,827,14.0,3,1,14.0,5,3,0,71,6,77
p_897,11,7,e_2,791,807,829,25.5,5,5,14.5,4,3,1,16,22,38
p_747,9,7,e_2,800,819,829,26.0,6,6,12.5,4,2,1,19,10,29
p_126,1,0,e_0,719,827,833,21.5,4,3,8.5,5,1,5,108,6,114
p_1223,15,0,e_1,718,755,833,8.0,4,0,6.5,5,1,2,37,78,115
p_1220,15,5,e_2,781,787,839,24.0,5,5,14.0,2,2,0,6,52,58
p_818,10,4,e_2,809,813,845,23.5,6,6,11.0,4,4,0,4,32,36
p_211,2,3,e_1,751,821,847,18.0,4,4,14.5,5,1,3,70,26,96
p_52,0,3,e_1,812,833,847,3.5,7,0,4.0,4,2,2,21,14,35
p_374,4,5,e_3,815,841,847,5.0,6,2,3.0,4,5,1,26,6,32
p_898,11,3,e_2,783,807,851,27.5,5,5,14.0,5,1,0,24,44,68
p_606,7,8,e_3,748,795,861,23.5,3,3,13.5,5,3,0,47,66,113
p_604,7,8,e_3,783,795,861,14.5,5,4,9.5,4,5,0,12,66,78
p_210,2,8,e_3,769,821,861,12.0,5,1,12.0,4,4,1,52,40,92
p_209,2,10,e_3,770,821,871,12.0,5,1,12.0,4,4,1,51,50,101
p_125,1,10,e_3,794,827,871,6.0,5,0,7.0,4,5,0,33,44,77
p_54,0,8,e_0,709,833,873,25.0,4,4,6.5,5,1,4,124,40,164
p_123,1,11,e_3,802,827,877,4.5,6,0,5.5,4,6,0,25,50,75
p_214,2,11,e_1,705,821,881,27.5,4,4,4.0,3,3,1,116,60,176
p_605,7,12,e_3,773,795,883,16.0,6,3,11.0,4,4,2,22,88,110
p_122,1,3,e_2,855,861,883,24.5,7,7,2.0,4,1,1,6,22,28
p_53,0,12,e_1,741,833,887,17.5,4,4,12.0,5,1,2,92,54,146
p_447,5,13,e_3,785,805,889,12.0,5,3,9.0,4,5,0,20,84,104
p_208,2,14,e_3,801,821,895,5.5,6,1,5.5,4,6,0,20,74,94
p_817,10,14,e_3,810,871,895,12.0,6,3,4.0,4,6,0,61,24,85
p_127,1,14,e_1,718,827,899,24.0,4,4,6.5,5,1,2,109,72,181
p_124,1,15,e_3,800,827,901,5.0,6,0,6.0,4,6,0,27,74,101
p_532,6,8,e_2,864,897,907,27.5,6,6,0.5,4,2,2,33,10,43
p_1218,15,13,e_3,832,901,911,13.0,8,0,2.0,5,7,1,69,10,79
p_51,0,9,e_2,843,867,913,25.5,8,8,4.5,4,3,0,24,46,70
p_531,6,11,e_2,873,897,923,25.5,6,6,1.5,5,3,2,24,26,50
p_896,11,9,e_0,881,889,927,7.5,5,4,9.5,5,3,3,8,38,46
p_445,5,12,e_2,790,839,929,11.0,5,3,14.5,4,3,1,49,90,139
p_1079,13,8,e_3,905,911,935,1.0,6,0,14.5,4,2,4,6,24,30
p_997,12,7,e_0,809,895,939,21.0,6,6,4.0,4,3,1,86,44,130
p_996,12,7,e_0,865,895,939,9.5,6,3,6.5,5,3,4,30,44,74
p_1148,14,7,e_0,842,905,939,12.0,8,1,2.0,5,1,3,63,34,97
p_678,8,6,e_0,912,933,945,5.0,5,1,12.5,4,5,0,21,12,33
p_600,7,6,e_0,916,939,945,5.0,5,2,11.5,4,5,1,23,6,29
p_207,2,15,e_2,861,877,945,24.0,6,6,1.0,1,1,1,16,68,84
p_994,12,15,e_2,913,929,945,23.0,5,5,9.0,5,3,0,16,16,32
p_1080,13,6,e_1,808,893,947,20.5,6,6,5.0,4,2,1,85,54,139
p_602,7,5,e_3,890,941,951,10.0,4,2,13.0,5,2,2,51,10,61
p_530,6,5,e_0,929,945,951,3.0,4,2,8.5,4,4,1,16,6,22
p_1147,14,4,e_3,871,895,957,6.0,5,1,10.0,5,5,0,24,62,86
p_895,11,4,e_3,896,921,957,5.0,5,1,14.0,5,2,3,25,36,61
p_533,6,3,e_0,859,859,961,16.5,7,7,6.0,2,1,3,0,102,102
p_995,12,3,e_0,888,895,961,5.0,4,2,11.0,2,3,2,7,66,73
p_1217,15,3,e_1,847,905,963,10.0,7,0,3.0,5,3,1,58,58,116
p_601,7,3,e_1,908,941,963,6.0,6,2,14.5,4,2,2,33,22,55
p_372,4,2,e_3,924,957,967,6.0,4,2,10.5,4,2,2,33,10,43
p_603,7,2,e_0,862,867,967,15.0,6,6,6.0,5,3,3,5,100,105
p_816,10,2,e_0,828,883,967,19.0,8,5,1.0,4,1,1,55,84,139
p_373,4,2,e_1,903,957,971,11.0,6,4,15.0,5,1,2,54,14,68
p_680,8,1,e_3,885,935,973,9.5,4,3,12.5,5,3,1,50,38,88
p_444,5,1,e_3,941,951,973,2.0,4,0,7.0,4,4,0,10,22,32
p_534,6,1,e_0,837,859,973,21.0,8,7,0.5,5,1,2,22,114,136
p_206,2,3,e_1,891,971,977,19.0,5,5,12.5,5,1,2,80,6,86
p_205,2,4,e_1,929,971,983,9.5,4,1,9.5,4,2,4,42,12,54
p_1216,15,7,e_2,908,945,983,27.5,6,6,8.0,5,4,0,37,38,75
p_993,12,6,e_2,929,929,989,26.0,4,4,12.0,2,2,0,0,60,60
p_992,12,6,e_2,951,959,989,22.0,3,3,13.5,4,2,1,8,30,38
p_745,9,6,e_2,939,973,989,27.5,4,4,14.0,5,2,0,34,16,50
p_121,1,5,e_3,873,973,991,21.0,5,5,10.0,5,5,0,100,18,118
p_120,1,3,e_0,906,973,995,13.0,6,0,14.0,4,5,0,67,22,89
p_202,2,3,e_0,983,989,995,25.0,3,3,0.5,5,3,1,6,6,12
p_204,2,9,e_1,937,971,1005,8.0,4,1,8.0,4,3,3,34,34,68
p_599,7,8,e_3,990,1001,1007,2.0,3,0,5.0,2,2,2,11,6,17
p_529,6,2,e_2,951,989,1007,28.0,3,3,13.5,4,2,1,38,18,56
p_528,6,2,e_2,967,989,1007,25.0,2,2,10.5,4,2,1,22,18,40
p_119,1,7,e_0,925,973,1013,9.5,4,0,9.0,4,5,1,48,40,88
p_746,9,11,e_1,916,931,1017,19.0,5,4,12.5,4,2,3,15,86,101
p_443,5,10,e_3,982,991,1019,2.0,3,0,3.0,5,2,1,9,28,37
p_203,2,12,e_1,941,971,1023,7.0,4,1,7.0,4,3,2,30,52,82
p_48,0,3,e_2,998,1017,1031,19.5,5,5,4.0,4,1,1,19,14,33
p_296,3,14,e_1,963,963,1033,3.5,3,1,3.0,1,3,0,0,70,70
p_814,10,14,e_1,993,1011,1033,5.0,5,2,6.5,5,4,0,18,22,40
p_679,8,13,e_3,910,935,1035,19.0,5,3,13.0,1,2,4,25,100,125
p_201,2,4,e_2,993,1007,1037,23.0,5,5,5.5,4,1,1,14,30,44
p_295,3,4,e_2,1019,1031,1037,19.0,5,5,0.5,5,3,0,12,6,18
p_894,11,12,e_0,1027,1035,1041,25.0,5,5,9.5,5,2,1,8,6,14
p_50,0,13,e_0,951,979,1047,5.0,3,0,5.0,4,3,0,28,68,96
p_990,12,14,e_0,1031,1041,1053,26.0,4,4,10.5,5,3,1,10,12,22
p_1076,13,14,e_0,1040,1047,1053,23.0,5,5,12.0,5,4,0,7,6,13
p_815,10,9,e_3,985,1019,1055,12.0,3,1,4.0,5,2,1,34,36,70
p_893,11,9,e_1,1040,1047,1057,1.0,5,0,12.5,4,0,4,7,10,17
p_597,7,8,e_2,1050,1053,1059,15.0,5,3,6.5,5,2,1,3,6,9
p_813,10,7,e_3,997,1019,1065,10.0,5,2,6.0,5,2,3,22,46,68
p_991,12,7,e_3,992,1029,1065,9.0,4,1,5.0,5,2,2,37,36,73
p_1146,14,11,e_0,1042,1053,1069,26.5,6,6,12.0,5,4,0,11,16,27
p_49,0,10,e_2,980,1017,1069,23.5,3,3,7.5,4,2,0,37,52,89
p_442,5,10,e_2,1021,1043,1069,20.5,5,5,0.5,5,3,0,22,26,48
p_675,8,11,e_2,1052,1059,1075,15.5,5,4,7.0,5,2,2,7,16,23
p_1078,13,5,e_3,1013,1035,1075,4.0,4,0,9.0,5,3,1,22,40,62
p_892,11,5,e_3,1041,1045,1075,0.0,5,0,11.5,4,5,0,4,30,34
p_294,3,12,e_2,1027,1031,1081,17.5,5,5,2.0,5,3,2,4,50,54
p_598,7,4,e_1,1017,1067,1085,9.0,4,2,11.0,5,2,0,50,18,68
p_744,9,3,e_3,974,1013,1085,16.0,2,1,1.0,5,2,0,39,72,111
p_676,8,13,e_2,1021,1059,1087,23.5,5,5,0.5,5,3,1,38,28,66
p_293,3,2,e_3,1051,1085,1091,7.0,5,3,10.0,4,5,0,34,6,40
p_812,10,7,e_0,1015,1029,1091,6.5,4,2,7.5,5,1,1,14,62,76
p_527,6,3,e_1,1025,1073,1091,8.5,5,2,12.5,5,1,1,48,18,66
p_441,5,3,e_1,1071,1079,1091,1.0,4,0,6.5,4,1,2,8,12,20
p_1077,13,1,e_3,1027,1035,1097,1.0,5,0,12.0,5,4,1,8,62,70
p_371,4,1,e_1,1039,1085,1101,8.0,5,3,13.0,4,0,2,46,16,62
p_1215,15,14,e_2,1062,1099,1105,21.5,5,5,8.5,5,4,0,37,6,43
p_677,8,3,e_0,979,1019,1111,16.0,3,2,0.0,3,2,0,40,92,132
p_811,10,3,e_0,1068,1075,1111,25.5,4,4,11.0,4,4,1,7,36,43
p_743,9,3,e_0,1060,1081,1111,28.0,4,4,12.5,4,3,1,21,30,51
p_370,4,3,e_0,1085,1105,1111,29.0,3,3,8.5,4,3,0,20,6,26
p_989,12,0,e_0,1049,1063,1125,27.5,5,5,13.0,5,3,0,14,62,76
p_292,3,5,e_3,1059,1085,1129,9.0,4,1,8.0,4,4,0,26,44,70
p_1145,14,9,e_2,1081,1093,1131,19.5,4,4,12.0,2,2,2,12,38,50
p_1214,15,9,e_2,1069,1099,1131,20.0,4,4,10.0,5,3,1,30,32,62
p_890,11,9,e_2,1090,1121,1131,21.0,3,3,13.5,5,0,4,31,10,41
p_291,3,5,e_1,1084,1091,1131,6.0,3,3,4.0,1,2,1,7,40,47
p_45,0,2,e_0,1111,1125,1135,20.0,5,5,3.0,4,1,0,14,10,24
p_46,0,7,e_3,1074,1103,1139,5.0,3,0,5.0,1,3,1,29,36,65
p_368,4,7,e_3,1113,1123,1139,2.0,5,1,2.5,5,3,2,10,16,26
p_199,2,7,e_1,1115,1117,1143,21.5,5,5,1.5,5,2,3,2,26,28
p_889,11,7,e_2,1100,1121,1143,19.5,3,3,15.0,4,3,2,21,22,43
p_594,7,8,e_3,1123,1139,1145,3.0,5,1,4.0,5,5,0,16,6,22
p_740,9,6,e_2,1126,1131,1149,16.5,5,3,10.0,4,3,2,5,18,23
p_674,8,6,e_2,1090,1137,1149,24.0,4,4,13.5,5,0,3,47,12,59
p_525,6,5,e_2,1143,1149,1155,16.5,5,5,7.0,1,3,3,6,6,12
p_1144,14,4,e_2,1082,1093,1161,19.5,4,4,12.0,5,1,3,11,68,79
p_988,12,4,e_2,1101,1115,1161,18.0,3,3,15.0,4,3,2,14,46,60
p_891,11,4,e_2,1077,1121,1161,24.0,4,4,11.0,5,2,1,44,40,84
p_595,7,4,e_2,1118,1143,1161,16.0,5,2,11.5,4,2,3,25,18,43
p_596,7,10,e_1,1113,1143,1161,5.0,5,3,1.0,5,2,2,30,18,48
p_200,2,11,e_3,1061,1091,1161,8.0,4,1,8.0,4,4,0,30,70,100
p_739,9,11,e_3,1131,1151,1161,4.0,4,1,5.5,5,4,0,20,10,30
p_526,6,11,e_1,1127,1137,1167,2.0,5,1,4.5,5,3,2,10,30,40
p_741,9,10,e_0,1119,1165,1171,6.0,5,3,1.5,4,1,0,46,6,52
p_290,3,13,e_3,1108,1117,1171,2.0,4,0,1.0,5,3,1,9,54,63
p_673,8,13,e_1,1105,1149,1177,8.0,3,2,0.5,4,1,1,44,28,72
p_738,9,14,e_3,1137,1151,1177,3.0,5,1,6.5,5,4,1,14,26,40
p_44,0,11,e_0,1113,1125,1177,19.5,5,5,3.0,4,1,0,12,52,64
p_369,4,15,e_3,1107,1123,1183,4.0,3,0,0.5,5,3,0,16,60,76
p_47,0,14,e_1,1040,1107,1183,12.0,5,0,12.5,4,0,3,67,76,143
p_742,9,14,e_1,1110,1155,1183,8.0,5,4,0.5,5,2,1,45,28,73
p_289,3,0,e_2,1114,1167,1185,16.5,5,4,12.0,4,2,3,53,18,71
p_810,10,14,e_0,1123,1171,1191,6.0,4,4,0.5,4,1,1,48,20,68
p_198,2,3,e_2,1139,1173,1199,25.0,5,5,8.0,4,3,2,34,26,60
p_42,0,3,e_2,1146,1185,1199,22.0,4,4,6.5,4,2,3,39,14,53
p_43,0,4,e_2,1127,1185,1205,25.0,5,5,9.5,4,3,2,58,20,78
p_288,3,5,e_2,1157,1167,1211,22.5,4,4,4.5,4,1,4,10,44,54
p_1213,15,7,e_3,1176,1183,1221,1.0,2,0,14.0,5,2,0,7,38,45
p_670,8,6,e_3,1207,1215,1227,1.0,3,0,9.5,4,2,1,8,12,20
p_523,6,8,e_2,1212,1217,1229,12.5,4,1,5.0,5,4,1,5,12,17
p_366,4,9,e_2,1197,1205,1235,8.0,2,0,2.5,5,6,2,8,30,38
p_672,8,4,e_0,1170,1217,1237,9.0,2,2,10.0,2,2,0,47,20,67
p_593,7,4,e_3,1212,1221,1237,1.0,4,0,8.5,4,2,2,9,16,25
p_1143,14,6,e_1,1200,1200,1238,20.0,2,2,14.0,3,0,0,0,38,38
p_591,7,6,e_1,1225,1232,1238,28.0,4,4,8.5,4,2,1,7,6,13
p_671,8,10,e_2,1182,1229,1241,23.0,1,1,0.5,4,6,1,47,12,59
p_440,5,2,e_0,1208,1231,1249,4.0,4,3,10.0,4,0,2,23,18,41
p_287,3,2,e_0,1238,1243,1249,1.0,3,0,4.0,4,1,1,5,6,11
p_367,4,12,e_2,1159,1161,1253,23.5,4,4,4.5,4,1,4,2,92,94
p_809,10,1,e_3,1193,1205,1253,3.0,1,0,13.0,4,1,0,12,48,60
p_1142,14,3,e_1,1201,1202,1256,20.5,3,3,14.0,5,1,1,1,54,55
p_592,7,13,e_2,1216,1223,1259,13.0,3,2,6.0,2,4,1,7,36,43
p_736,9,13,e_2,1220,1235,1259,14.0,4,3,6.5,5,5,2,15,24,39
p_197,2,14,e_2,1151,1173,1265,23.0,3,3,5.5,4,2,3,22,92,114
p_808,10,14,e_2,1232,1241,1265,13.0,4,3,8.5,5,6,1,9,24,33
p_196,2,3,e_3,1219,1247,1265,7.0,3,1,7.0,4,3,0,28,18,46
p_118,1,15,e_2,1153,1179,1271,22.0,4,4,5.0,4,2,3,26,92,118
p_737,9,15,e_2,1168,1235,1271,26.5,3,3,3.0,4,3,2,67,36,103
p_364,4,6,e_0,1256,1269,1279,3.0,2,1,1.0,5,2,0,13,10,23
p_524,6,7,e_3,1201,1227,1283,5.0,2,0,11.0,4,1,1,26,56,82
p_117,1,7,e_0,1204,1255,1285,9.0,3,0,11.0,4,0,1,51,30,81
p_522,6,11,e_1,1221,1238,1290,11.0,3,2,9.5,4,2,1,17,52,69
p_365,4,11,e_1,1241,1250,1290,5.0,3,2,5.5,4,2,1,9,40,49
p_1141,14,10,e_2,1204,1265,1297,20.0,3,3,4.0,5,5,2,61,32,93
p_1212,15,10,e_2,1254,1271,1297,14.0,2,0,12.0,5,6,0,17,26,43
p_195,2,10,e_3,1256,1259,1299,1.0,2,0,1.5,5,2,0,3,40,43
p_590,7,10,e_3,1274,1283,1299,2.0,4,0,5.0,5,2,2,9,16,25
p_886,11,9,e_2,1230,1247,1303,23.5,4,4,8.0,5,6,1,17,56,73
p_987,12,9,e_2,1240,1253,1303,20.5,3,3,10.0,2,5,1,13,50,63
p_521,6,12,e_0,1274,1279,1307,1.0,4,0,5.0,5,3,0,5,28,33
p_439,5,15,e_1,1213,1244,1308,11.5,4,1,11.5,4,2,0,31,64,95
p_883,11,15,e_1,1284,1290,1308,4.0,4,2,9.5,5,2,0,6,18,24
p_887,11,8,e_2,1229,1247,1309,24.0,4,4,8.0,5,6,1,18,62,80
p_116,1,14,e_0,1237,1255,1317,3.0,3,0,4.0,4,1,1,18,62,80
p_1075,13,4,e_2,1226,1259,1329,22.0,4,4,7.5,5,6,1,33,70,103
p_807,10,4,e_2,1265,1297,1329,9.0,3,1,14.0,5,7,0,32,32,64
p_734,9,6,e_3,1283,1293,1329,6.0,3,2,7.0,2,2,2,10,36,46
p_885,11,5,e_3,1264,1305,1335,8.0,2,0,3.0,2,3,0,41,30,71
p_1140,14,3,e_2,1215,1265,1335,23.0,3,3,5.5,5,4,2,50,70,120
p_888,11,2,e_2,1219,1247,1341,25.0,3,3,6.5,5,5,1,28,94,122
p_1139,14,2,e_2,1253,1265,1341,18.0,2,2,12.0,2,7,0,12,76,88
p_882,11,2,e_2,1285,1291,1341,4.0,4,0,12.0,1,6,2,6,50,56
p_735,9,2,e_2,1249,1303,1341,22.0,3,3,11.5,5,7,0,54,38,92
p_1073,13,9,e_0,1313,1323,1343,26.0,5,5,13.5,5,1,0,10,20,30
p_986,12,1,e_2,1274,1285,1347,7.0,4,0,14.5,4,6,0,11,62,73
p_1211,15,6,e_1,1294,1308,1350,6.0,4,0,12.0,5,1,0,14,42,56
p_884,11,2,e_3,1283,1305,1351,4.0,3,0,7.0,2,2,2,22,46,68
p_667,8,5,e_1,1330,1340,1356,28.0,4,4,10.0,4,2,2,10,16,26
p_669,8,1,e_3,1309,1319,1357,2.0,4,0,10.0,4,3,1,10,38,48
p_985,12,6,e_0,1315,1329,1359,26.5,5,5,14.0,5,1,1,14,30,44
p_193,2,0,e_3,1344,1351,1363,1.0,4,0,3.5,4,3,1,7,12,19
p_40,0,4,e_2,1317,1353,1373,8.0,5,0,6.0,4,4,1,36,20,56
p_360,4,5,e_2,1342,1373,1379,8.0,4,3,2.0,4,4,1,31,6,37
p_1074,13,0,e_1,1312,1318,1380,26.5,5,5,14.5,4,1,0,6,62,68
p_283,3,4,e_0,1372,1375,1381,1.0,6,0,3.5,4,4,2,3,6,9
p_284,3,5,e_0,1333,1375,1387,8.5,4,3,11.5,4,3,2,42,12,54
p_437,5,7,e_0,1367,1387,1399,4.0,5,0,4.0,4,2,2,20,12,32
p_520,6,9,e_2,1280,1319,1399,21.5,4,4,13.0,4,6,1,39,80,119
p_282,3,4,e_1,1380,1394,1402,29.0,6,6,0.0,5,3,0,14,8,22
p_115,1,10,e_2,1282,1347,1405,16.0,3,3,12.5,4,6,2,65,58,123
p_664,8,10,e_2,1378,1393,1405,5.0,6,2,5.0,5,6,1,15,12,27
p_362,4,9,e_0,1322,1369,1409,11.5,5,3,13.0,1,0,2,47,40,87
p_363,4,12,e_2,1296,1329,1415,16.5,4,4,10.0,4,7,1,33,86,119
p_589,7,11,e_0,1317,1353,1419,15.5,5,4,14.0,4,0,2,36,66,102
p_41,0,12,e_3,1269,1363,1419,18.0,3,3,4.0,5,2,1,94,56,150
p_285,3,8,e_1,1314,1366,1420,12.0,5,2,14.0,4,1,2,52,54,106
p_982,12,13,e_2,1412,1415,1421,2.0,5,0,11.5,5,3,1,3,6,9
p_114,1,13,e_3,1352,1357,1425,3.0,3,1,2.0,4,3,0,5,68,73
p_192,2,14,e_2,1354,1363,1427,3.5,4,1,0.0,5,5,1,9,64,73
p_668,8,10,e_1,1315,1340,1430,16.5,5,4,13.5,4,1,2,25,90,115
p_361,4,14,e_0,1325,1369,1433,11.0,5,3,13.0,4,2,3,44,64,108
p_194,2,15,e_2,1333,1341,1433,7.5,4,2,3.5,4,5,1,8,92,100
p_438,5,15,e_3,1334,1335,1435,10.0,3,3,5.0,1,3,1,1,100,101
p_984,12,15,e_3,1353,1419,1435,13.5,3,1,1.5,4,3,0,66,16,82
p_1072,13,15,e_0,1317,1323,1439,21.0,5,4,14.0,4,0,3,6,116,122
p_286,3,12,e_1,1312,1366,1442,12.5,5,2,14.0,4,1,1,54,76,130
p_1210,15,11,e_3,1344,1435,1453,18.5,4,4,3.5,4,3,1,91,18,109
p_1070,13,10,e_2,1403,1421,1457,8.5,5,1,10.0,5,4,1,18,36,54
p_1138,14,10,e_2,1354,1427,1457,17.5,4,4,0.0,5,5,0,73,30,103
p_1207,15,9,e_2,1414,1433,1463,4.0,5,0,12.0,2,3,2,19,30,49
p_1209,15,9,e_3,1363,1435,1463,15.0,4,0,0.0,5,3,1,72,28,100
p_880,11,6,e_1,1386,1436,1468,13.5,6,3,1.0,5,3,2,50,32,82
p_1068,13,9,e_0,1440,1449,1469,1.0,4,0,15.0,4,1,1,9,20,29
p_1071,13,7,e_2,1358,1421,1473,18.0,4,4,1.0,5,5,2,63,52,115
p_879,11,6,e_2,1414,1451,1479,8.0,5,3,12.0,2,3,1,37,28,65
p_519,6,4,e_3,1367,1389,1487,23.0,5,5,1.0,5,3,2,22,98,120
p_665,8,4,e_3,1377,1401,1487,19.0,6,3,3.0,5,3,3,24,86,110
p_281,3,2,e_1,1394,1396,1490,20.0,5,4,3.0,5,4,1,2,94,96
p_518,6,4,e_0,1380,1393,1495,20.0,6,5,4.0,3,6,0,13,102,115
p_1206,15,4,e_0,1434,1439,1495,8.0,3,0,14.0,5,2,1,5,56,61
p_663,8,1,e_1,1406,1420,1496,13.0,5,3,5.0,5,4,2,14,76,90
p_881,11,1,e_1,1383,1436,1496,14.5,6,3,0.5,5,3,1,53,60,113
p_588,7,2,e_3,1366,1395,1497,22.5,4,4,0.5,5,3,1,29,102,131
p_666,8,2,e_3,1362,1401,1497,22.0,4,4,0.0,4,3,1,39,96,135
p_1069,13,2,e_3,1422,1425,1497,4.5,4,1,12.5,5,4,0,3,72,75
p_434,5,2,e_3,1477,1481,1497,1.0,4,0,6.0,4,3,1,4,16,20
p_983,12,0,e_1,1397,1442,1502,10.5,6,2,3.0,5,5,1,45,60,105
p_280,3,0,e_1,1470,1484,1502,4.0,4,1,5.5,4,3,2,14,18,32
p_1208,15,1,e_2,1370,1433,1503,13.5,6,0,3.5,5,6,1,63,70,133
p_878,11,0,e_3,1434,1453,1507,4.0,3,0,15.0,5,3,0,19,54,73
p_187,2,4,e_0,1460,1507,1517,11.5,5,1,10.5,4,2,5,47,10,57
p_190,2,3,e_3,1438,1497,1521,12.5,4,0,14.5,4,4,0,59,24,83
p_359,4,6,e_0,1448,1495,1527,12.0,4,1,13.0,1,1,3,47,32,79
p_435,5,7,e_0,1446,1489,1533,13.5,4,2,13.5,4,1,2,43,44,87
p_191,2,8,e_2,1419,1497,1535,20.0,4,4,13.0,5,3,1,78,38,116
p_112,1,8,e_2,1461,1503,1535,10.0,5,1,9.5,4,4,1,42,32,74
p_189,2,6,e_3,1444,1497,1535,11.0,4,0,13.0,4,4,0,53,38,91
p_436,5,8,e_1,1429,1474,1538,21.0,3,3,10.0,2,4,1,45,64,109
p_516,6,8,e_0,1456,1483,1539,16.5,4,3,11.5,4,2,4,27,56,83
p_188,2,7,e_3,1446,1497,1541,10.5,4,0,12.5,4,4,0,51,44,95
p_113,1,10,e_1,1401,1496,1548,23.0,5,5,4.0,3,5,1,95,52,147
p_279,3,11,e_0,1482,1501,1553,8.0,4,2,6.0,1,2,4,19,52,71
p_806,10,13,e_0,1447,1463,1565,18.5,4,3,13.5,4,1,3,16,102,118
p_585,7,13,e_1,1522,1532,1566,4.0,5,1,5.0,5,2,3,10,34,44
p_876,11,13,e_1,1498,1554,1566,13.0,7,1,0.5,4,3,2,56,12,68
p_1066,13,14,e_2,1516,1561,1567,11.0,6,5,4.0,5,2,4,45,6,51
p_111,1,15,e_2,1466,1503,1573,9.5,4,1,8.5,4,3,1,37,70,107
p_587,7,15,e_2,1479,1529,1573,12.0,5,3,6.0,1,2,3,50,44,94
p_1067,13,15,e_2,1501,1561,1573,14.0,7,1,1.0,4,2,4,60,12,72
p_517,6,15,e_0,1419,1483,1577,24.0,4,4,11.0,5,3,0,64,94,158
p_1133,14,12,e_3,1548,1575,1585,5.5,6,0,8.5,5,2,4,27,10,37
p_1205,15,11,e_1,1457,1576,1594,25.5,4,4,8.5,4,4,1,119,18,137
p_1203,15,10,e_1,1504,1576,1600,15.5,7,7,0.5,5,2,3,72,24,96
p_874,11,10,e_1,1590,1594,1600,30.0,7,7,11.5,4,4,2,4,6,10
p_733,9,8,e_2,1477,1541,1607,27.0,4,4,6.5,4,2,2,64,66,130
p_877,11,7,e_3,1495,1559,1609,21.5,4,4,2.5,4,2,2,64,50,114
p_662,8,7,e_3,1558,1603,1609,9.0,6,2,11.0,5,2,4,45,6,51
p_731,9,6,e_2,1599,1601,1617,29.5,7,7,9.5,4,3,3,2,16,18
p_586,7,5,e_3,1509,1541,1619,20.5,6,3,0.5,5,3,3,32,78,110
p_875,11,5,e_3,1540,1559,1619,10.0,5,2,7.0,2,2,4,19,60,79
p_981,12,5,e_3,1459,1565,1619,27.5,4,4,9.5,4,4,0,106,54,160
p_1134,14,5,e_3,1519,1575,1619,11.0,6,0,3.0,5,3,3,56,44,100
p_975,12,4,e_3,1525,1565,1625,12.0,5,1,4.0,5,2,3,40,60,100
p_1136,14,4,e_3,1485,1575,1625,20.5,4,4,4.5,4,3,1,90,50,140
p_1135,14,4,e_3,1517,1575,1625,11.5,6,0,2.5,5,3,3,58,50,108
p_979,12,4,e_1,1488,1560,1630,22.0,4,4,2.0,4,4,1,72,70,142
p_805,10,4,e_0,1582,1601,1631,2.0,8,0,14.0,4,1,3,19,30,49
p_976,12,3,e_3,1524,1565,1631,12.5,5,1,3.5,5,2,3,41,66,107
p_978,12,3,e_2,1497,1555,1633,20.0,7,7,2.0,1,1,3,58,78,136
p_1204,15,3,e_2,1469,1573,1633,22.5,4,4,7.5,4,3,1,104,60,164
p_732,9,3,e_1,1559,1606,1636,8.0,7,2,12.0,5,1,3,47,30,77
p_515,6,2,e_3,1508,1535,1637,22.0,6,4,0.0,5,3,3,27,102,129
p_973,12,3,e_0,1588,1591,1637,29.5,7,7,12.5,4,1,4,3,46,49
p_358,4,2,e_2,1623,1627,1639,30.0,5,5,4.5,4,3,2,4,12,16
p_977,12,2,e_1,1502,1560,1642,19.0,7,7,0.0,3,3,3,58,82,140
p_980,12,2,e_0,1460,1559,1643,27.5,5,5,10.5,4,2,4,99,84,183
p_1137,14,2,e_0,1455,1571,1643,26.5,4,4,11.5,4,2,3,116,72,188
p_661,8,0,e_1,1607,1612,1652,29.5,6,6,9.0,4,3,1,5,40,45
p_512,6,0,e_0,1600,1619,1655,2.0,7,1,10.0,1,2,2,19,36,55
p_110,1,0,e_0,1573,1649,1655,13.0,8,0,14.5,5,2,2,76,6,82
p_36,0,1,e_1,1604,1652,1658,8.0,6,0,9.0,4,2,2,48,6,54
p_183,2,3,e_0,1595,1643,1669,12.0,7,1,11.5,4,2,3,48,26,74
p_184,2,5,e_2,1576,1639,1671,16.0,8,1,14.5,4,2,2,63,32,95
p_278,3,4,e_0,1559,1637,1675,20.0,7,7,12.0,2,2,2,78,38,116
p_37,0,7,e_2,1587,1649,1681,12.0,7,0,12.0,4,3,2,62,32,94
p_186,2,10,e_2,1527,1639,1695,25.5,6,6,7.0,5,2,4,112,56,168
p_35,0,9,e_1,1611,1652,1698,7.0,6,0,8.0,1,3,1,41,46,87
p_185,2,11,e_2,1529,1639,1701,25.0,6,6,7.0,5,2,4,110,62,172
p_870,11,12,e_3,1658,1695,1701,9.0,4,0,2.5,5,2,2,37,6,43
p_34,0,13,e_3,1622,1647,1707,4.5,5,0,4.5,4,3,2,25,60,85
p_38,0,11,e_1,1532,1652,1710,22.5,6,6,7.0,2,2,3,120,58,178
p_513,6,12,e_0,1553,1619,1713,24.0,6,6,11.0,2,3,2,66,94,160
p_39,0,14,e_3,1527,1647,1713,24.0,5,5,4.0,5,2,3,120,66,186
p_974,12,14,e_2,1578,1587,1715,25.5,8,7,14.0,4,2,2,9,128,137
p_730,9,13,e_0,1689,1699,1719,29.5,5,5,6.5,5,3,0,10,20,30
p_660,8,15,e_3,1666,1681,1719,4.0,4,0,4.5,5,2,2,15,38,53
p_514,6,15,e_2,1551,1617,1721,25.0,6,6,11.0,5,2,3,66,104,170
p_510,6,13,e_1,1649,1682,1722,6.0,4,0,0.5,4,1,1,33,40,73
p_511,6,14,e_0,1607,1619,1725,13.0,6,5,8.5,4,3,2,12,106,118
p_509,6,14,e_0,1676,1685,1725,29.0,6,6,4.0,5,3,0,9,40,49
p_433,5,15,e_0,1616,1625,1731,10.5,6,4,6.5,4,3,2,9,106,115
p_871,11,15,e_1,1651,1710,1732,11.0,4,0,0.0,4,1,2,59,22,81
p_1202,15,11,e_3,1637,1719,1737,17.0,2,2,2.0,4,0,2,82,18,100
p_1201,15,10,e_3,1688,1719,1743,5.5,5,0,9.5,5,3,2,31,24,55
p_868,11,10,e_2,1715,1739,1745,5.0,6,1,14.0,5,2,4,24,6,30
p_972,12,11,e_1,1661,1716,1750,14.5,4,3,1.5,5,2,3,55,34,89
p_866,11,9,e_2,1724,1739,1751,3.0,7,0,14.5,4,1,5,15,12,27
p_971,12,10,e_1,1669,1716,1756,13.0,5,3,3.0,5,3,5,47,40,87
p_1132,14,7,e_2,1618,1715,1761,21.0,6,6,6.0,4,3,2,97,46,143
p_804,10,8,e_1,1618,1704,1766,25.0,6,6,6.5,4,4,0,86,62,148
p_970,12,8,e_1,1699,1716,1766,6.0,7,3,9.0,5,4,3,17,50,67
p_873,11,6,e_3,1608,1695,1767,26.0,5,5,7.0,1,5,1,87,72,159
p_1064,13,6,e_0,1738,1741,1775,27.0,8,8,13.5,4,0,3,3,34,37
p_872,11,4,e_3,1637,1695,1779,21.0,2,2,2.0,1,1,2,58,84,142
p_803,10,5,e_1,1683,1704,1780,12.0,5,4,6.0,5,4,4,21,76,97
p_869,11,5,e_1,1680,1710,1780,11.0,5,3,6.0,5,3,5,30,70,100
p_969,12,5,e_1,1702,1716,1780,6.0,6,3,10.0,5,4,3,14,64,78
p_867,11,2,e_3,1716,1737,1789,4.5,7,1,14.5,5,4,3,21,52,73
p_583,7,2,e_3,1715,1761,1789,9.0,6,1,14.0,5,4,2,46,28,74
p_429,5,2,e_3,1762,1773,1789,2.0,6,1,7.0,4,6,0,11,16,27
p_1065,13,3,e_1,1686,1722,1792,8.0,5,2,6.5,5,4,4,36,70,106
p_1131,14,1,e_3,1695,1713,1795,5.0,6,1,11.0,2,3,3,18,82,100
p_729,9,1,e_3,1712,1749,1795,7.0,6,1,14.0,5,4,2,37,46,83
p_582,7,2,e_0,1764,1769,1795,29.5,7,7,8.0,4,2,3,5,26,31
p_505,6,2,e_0,1768,1775,1795,30.0,7,7,7.0,4,2,4,7,20,27
p_356,4,2,e_1,1703,1786,1798,14.0,6,3,10.0,5,4,3,83,12,95
p_802,10,0,e_3,1707,1743,1801,7.0,5,2,13.0,5,4,1,36,58,94
p_357,4,0,e_3,1692,1779,1801,15.5,5,4,10.5,5,3,2,87,22,109
p_351,4,0,e_2,1771,1779,1803,1.0,7,0,5.0,4,1,6,8,24,32
p_584,7,1,e_1,1668,1688,1804,18.0,5,5,3.0,2,2,4,20,116,136
p_277,3,0,e_1,1652,1668,1810,26.0,4,4,0.0,5,3,2,16,142,158
p_108,1,2,e_2,1700,1797,1813,19.0,7,7,11.0,5,3,2,97,16,113
p_350,4,6,e_3,1788,1819,1829,6.0,5,2,2.0,1,5,1,31,10,41
p_432,5,6,e_2,1693,1773,1831,24.0,6,6,10.0,5,4,1,80,58,138
p_181,2,6,e_2,1778,1791,1831,6.0,5,2,4.0,1,3,4,13,40,53
p_506,6,7,e_3,1719,1767,1835,19.0,7,2,15.0,4,5,2,48,68,116
p_109,1,7,e_3,1672,1795,1835,25.0,5,5,6.0,5,2,3,123,40,163
p_182,2,6,e_1,1667,1798,1836,27.5,5,5,3.0,5,2,4,131,38,169
p_352,4,8,e_2,1725,1779,1841,16.0,7,1,14.0,4,1,5,54,62,116
p_107,1,8,e_2,1768,1797,1841,7.0,7,1,6.0,4,1,6,29,44,73
p_349,4,9,e_0,1801,1823,1845,4.0,4,4,0.5,4,2,2,22,22,44
p_275,3,9,e_2,1763,1785,1847,10.0,7,3,7.0,4,0,7,22,62,84
p_355,4,11,e_0,1710,1785,1855,20.5,6,6,11.5,5,4,0,75,70,145
p_659,8,12,e_3,1730,1755,1861,18.5,7,4,12.5,4,5,2,25,106,131
p_507,6,12,e_3,1694,1767,1861,25.0,5,5,11.0,2,3,2,73,94,167
p_431,5,12,e_2,1732,1773,1863,15.0,8,2,12.5,4,1,5,41,90,131
p_430,5,12,e_2,1734,1773,1863,14.5,8,2,12.0,4,1,5,39,90,129
p_354,4,12,e_2,1711,1779,1863,20.0,6,6,13.0,5,2,3,68,84,152
p_353,4,12,e_2,1722,1779,1863,16.5,7,1,15.0,4,1,5,57,84,141
p_968,12,13,e_0,1721,1747,1865,24.5,7,7,13.0,5,2,2,26,118,144
p_965,12,13,e_3,1840,1861,1867,4.0,5,1,8.0,5,2,3,21,6,27
p_964,12,13,e_3,1842,1861,1867,4.0,5,1,8.0,5,3,2,19,6,25
p_276,3,13,e_2,1737,1785,1869,12.0,8,2,11.0,4,1,5,48,84,132
p_33,0,14,e_0,1713,1805,1871,16.0,6,6,12.0,2,4,1,92,66,158
p_967,12,14,e_2,1756,1863,1875,20.0,7,6,8.0,4,1,6,107,12,119
p_508,6,15,e_2,1693,1767,1881,25.5,6,6,9.5,5,4,0,74,114,188
p_966,12,15,e_1,1811,1866,1884,10.0,5,3,0.0,5,1,2,55,18,73
p_1199,15,13,e_3,1807,1877,1887,13.5,4,0,1.5,5,2,2,70,10,80
p_1061,13,11,e_1,1828,1872,1902,11.0,6,1,4.0,5,1,5,44,30,74
p_963,12,9,e_3,1845,1861,1905,9.0,5,1,9.0,5,3,2,16,44,60
p_864,11,10,e_2,1875,1899,1905,4.5,6,1,14.0,2,4,0,24,6,30
p_1129,14,10,e_1,1848,1878,1908,6.5,5,1,8.0,5,2,3,30,30,60
p_962,12,7,e_0,1873,1891,1913,3.5,6,1,14.5,5,1,3,18,22,40
p_800,10,7,e_3,1779,1851,1917,24.0,5,5,4.0,4,5,0,72,66,138
p_1060,13,7,e_1,1855,1872,1922,6.0,5,1,9.5,5,2,3,17,50,67
p_1130,14,7,e_1,1816,1878,1922,12.5,5,1,1.0,5,1,3,62,44,106
p_657,8,6,e_3,1817,1841,1923,18.0,5,3,4.0,5,2,3,24,82,106
p_656,8,6,e_3,1857,1911,1923,10.5,5,2,11.5,5,4,1,54,12,66
p_801,10,5,e_2,1773,1853,1927,25.0,6,6,5.0,1,1,5,80,74,154
p_581,7,6,e_1,1825,1842,1928,17.5,6,4,3.5,5,1,4,17,86,103
p_1059,13,6,e_1,1864,1872,1928,4.5,7,1,12.0,5,2,4,8,56,64
p_580,7,5,e_3,1832,1835,1929,16.5,5,4,6.5,5,2,3,3,94,97
p_1198,15,5,e_3,1827,1877,1929,9.0,6,0,6.0,5,3,3,50,52,102
p_1197,15,4,e_0,1837,1877,1929,7.5,5,0,7.5,5,4,1,40,52,92
p_1063,13,4,e_2,1750,1869,1933,26.0,7,7,9.0,4,2,5,119,64,183
p_865,11,3,e_0,1775,1855,1935,24.0,6,6,6.0,1,3,3,80,80,160
p_579,7,3,e_0,1869,1913,1935,9.5,6,1,14.0,5,2,2,44,22,66
p_799,10,3,e_2,1898,1905,1939,0.0,6,0,11.0,1,2,1,7,34,41
p_1200,15,2,e_0,1740,1877,1941,24.5,8,8,13.0,4,0,4,137,64,201
p_428,5,2,e_0,1857,1923,1941,13.5,6,2,11.5,5,3,1,66,18,84
p_347,4,1,e_0,1894,1929,1947,7.0,6,5,11.5,4,4,1,35,18,53
p_1062,13,2,e_1,1809,1872,1948,15.5,5,1,0.0,3,2,1,63,76,139
p_274,3,5,e_3,1884,1939,1949,10.5,6,0,13.5,4,5,1,55,10,65
p_427,5,1,e_2,1888,1927,1949,8.0,6,4,13.5,4,2,2,39,22,61
p_426,5,6,e_3,1896,1929,1955,10.0,6,1,11.0,4,4,2,33,26,59
p_658,8,0,e_1,1795,1848,1958,23.0,5,5,2.5,4,3,0,53,110,163
p_348,4,0,e_1,1864,1938,1958,13.5,7,2,12.0,5,2,3,74,20,94
p_655,8,9,e_3,1950,1967,1973,3.0,6,2,5.0,5,4,2,17,6,23
p_272,3,10,e_3,1930,1939,1979,2.0,4,0,5.0,4,2,2,9,40,49
p_273,3,12,e_3,1904,1939,1989,6.0,5,0,9.0,1,4,2,35,50,85
p_106,1,10,e_2,1883,1949,1991,13.0,6,0,15.0,4,2,1,66,42,108
p_306,3,4,e_0,2,16,22,3.0,0,0,0.0,3,0,0,14,6,20
p_550,6,9,e_1,28,33,47,2.0,1,0,5.0,5,1,1,5,14,19
p_551,6,11,e_2,10,32,56,6.0,0,0,1.0,5,0,1,22,24,46
p_70,0,11,e_1,4,5,57,0.0,0,0,0.0,3,0,0,1,52,53
p_622,7,14,e_2,5,38,70,7.0,0,0,0.0,3,0,0,33,32,65
p_69,0,6,e_0,13,40,70,18.0,1,1,2.5,5,0,1,27,30,57
p_763,9,15,e_3,10,49,75,9.0,0,0,0.0,3,0,0,39,26,65
p_549,6,10,e_0,51,70,88,26.5,1,1,2.0,5,2,1,19,18,37
p_1239,15,12,e_3,67,75,89,1.5,1,0,13.5,5,1,0,8,14,22
p_1240,15,10,e_2,31,76,98,10.0,1,0,6.0,2,0,1,45,22,67
p_391,4,12,e_0,46,60,98,13.5,1,1,1.0,2,1,0,14,38,52
p_1014,12,13,e_0,71,98,104,27.5,1,1,6.0,5,4,1,27,6,33
p_1013,12,13,e_0,89,98,104,14.0,3,3,10.0,5,3,1,9,6,15
p_1015,12,7,e_1,53,63,107,8.5,1,1,10.0,5,1,1,10,44,54
p_762,9,7,e_1,91,97,107,2.0,3,0,10.0,4,4,0,6,10,16
p_916,11,3,e_1,60,87,125,7.5,1,1,11.5,5,0,2,27,38,65
p_463,5,4,e_2,99,120,126,4.0,3,2,10.0,4,1,0,21,6,27
p_1161,14,2,e_1,25,73,131,11.0,1,0,4.5,5,1,0,48,58,106
p_621,7,2,e_2,27,38,136,7.5,1,1,5.0,5,0,2,11,98,109
p_1160,14,1,e_1,56,73,137,5.5,1,1,11.0,5,1,2,17,64,81
p_687,8,6,e_0,125,128,138,22.5,5,5,8.5,4,3,2,3,10,13
p_141,1,0,e_1,104,137,143,7.0,3,2,7.5,4,4,0,33,6,39
p_689,8,5,e_0,108,128,144,25.0,3,3,12.0,4,2,1,20,16,36
p_223,2,4,e_2,92,136,146,9.5,3,0,11.0,4,2,0,44,10,54
p_915,11,4,e_0,109,114,150,21.5,3,3,12.0,4,2,2,5,36,41
p_688,8,4,e_0,124,128,150,23.0,5,5,9.0,4,3,2,4,22,26
p_465,5,10,e_3,79,123,155,9.5,1,0,14.5,4,1,0,44,32,76
p_547,6,3,e_0,59,70,156,13.0,1,1,4.0,3,2,2,11,86,97
p_464,5,11,e_3,97,123,161,5.0,3,0,10.0,4,0,3,26,38,64
p_390,4,11,e_3,113,129,161,3.0,3,0,7.0,4,1,2,16,32,48
p_460,5,7,e_2,141,152,162,28.5,4,4,3.0,5,2,3,11,10,21
p_389,4,2,e_0,131,150,162,21.5,4,4,7.5,4,5,1,19,12,31
p_222,2,8,e_2,112,136,168,5.0,3,0,6.5,4,1,1,24,32,56
p_144,1,0,e_0,40,46,174,10.0,1,1,0.0,3,0,0,6,128,134
p_548,6,0,e_0,55,70,174,13.5,1,1,3.0,5,2,2,15,104,119
p_690,8,14,e_3,83,107,179,11.5,2,1,13.5,4,1,1,24,72,96
p_462,5,14,e_3,120,123,179,2.5,4,1,5.5,4,2,2,3,56,59
p_142,1,9,e_1,73,137,183,16.5,1,1,14.0,4,3,1,64,46,110
p_546,6,15,e_3,88,117,185,8.0,2,1,12.0,1,1,2,29,68,97
p_1012,12,15,e_3,149,167,185,4.0,5,2,8.5,5,4,1,18,18,36
p_139,1,3,e_0,166,168,188,19.0,3,3,1.0,4,2,1,2,20,22
p_761,9,10,e_1,159,183,189,28.0,5,5,4.0,5,3,0,24,6,30
p_461,5,12,e_2,129,152,190,11.0,4,0,3.5,4,1,1,23,38,61
p_140,1,12,e_1,124,137,199,4.0,5,0,3.0,4,3,0,13,62,75
p_1094,13,12,e_3,146,173,201,9.0,4,2,8.0,5,4,0,27,28,55
p_619,7,13,e_1,169,173,205,24.5,3,3,6.0,5,3,0,4,32,36
p_620,7,15,e_2,149,162,208,28.5,6,6,4.5,5,1,4,13,46,59
p_1159,14,15,e_2,199,202,208,24.0,7,6,13.5,5,4,0,3,6,9
p_68,0,14,e_1,135,143,211,24.5,4,4,1.0,4,1,0,8,68,76
p_305,3,8,e_0,58,156,214,22.0,1,1,4.0,5,2,2,98,58,156
p_1091,13,9,e_3,191,195,215,1.0,5,0,14.0,4,4,1,4,20,24
p_143,1,9,e_0,53,168,220,21.5,1,1,2.5,5,2,1,115,52,167
p_618,7,9,e_0,189,208,220,19.0,5,2,3.0,5,2,0,19,12,31
p_1237,15,8,e_3,160,185,221,4.0,5,0,11.0,5,3,2,25,36,61
p_1095,13,10,e_2,144,196,230,9.5,4,2,4.0,5,2,3,52,34,86
p_686,8,13,e_0,194,214,238,19.0,5,3,4.5,5,2,2,20,24,44
p_829,10,7,e_2,120,178,244,21.5,4,4,5.0,4,2,0,58,66,124
p_1235,15,7,e_2,191,208,244,27.5,5,5,12.0,5,3,1,17,36,53
p_1236,15,3,e_3,170,185,245,2.5,3,0,12.5,5,2,1,15,60,75
p_1093,13,3,e_3,177,195,245,3.5,3,2,13.5,5,3,0,18,50,68
p_1011,12,3,e_3,187,201,245,3.0,5,1,15.0,4,4,1,14,44,58
p_1090,13,6,e_1,196,205,249,29.0,7,7,11.5,5,3,0,9,44,53
p_459,5,15,e_0,194,198,250,16.0,5,3,4.0,5,2,1,4,52,56
p_760,9,15,e_0,182,220,250,24.5,3,3,1.5,5,3,0,38,30,68
p_1092,13,2,e_3,179,195,251,3.0,3,1,14.0,5,2,1,16,56,72
p_1234,15,5,e_2,197,208,254,27.0,7,7,13.0,5,4,0,11,46,57
p_1010,12,5,e_1,215,221,255,26.0,5,5,13.0,4,1,0,6,34,40
p_1238,15,1,e_3,142,185,257,8.0,4,0,7.0,5,4,0,43,72,115
p_386,4,1,e_3,221,239,257,4.0,4,0,8.0,4,3,1,18,18,36
p_1232,15,13,e_0,237,250,260,18.0,5,5,13.0,2,2,1,13,10,23
p_617,7,4,e_1,239,243,261,26.0,4,4,8.0,4,2,1,4,18,22
p_219,2,0,e_3,243,251,263,1.0,5,0,3.5,4,4,1,8,12,20
p_914,11,3,e_2,141,184,266,12.5,4,2,3.0,5,2,2,43,82,125
p_218,2,1,e_2,250,272,278,29.0,3,3,5.5,4,2,1,22,6,28
p_138,1,4,e_3,231,257,281,4.5,4,0,5.5,4,3,1,26,24,50
p_220,2,6,e_1,219,271,291,8.5,5,1,12.5,4,1,1,52,20,72
p_1158,14,7,e_0,215,244,294,24.0,5,5,8.0,5,3,0,29,50,79
p_221,2,7,e_3,199,251,297,12.5,7,1,12.5,4,6,1,52,46,98
p_828,10,6,e_0,252,276,300,22.0,5,5,14.5,4,4,1,24,24,48
p_1233,15,5,e_0,228,250,306,20.5,4,4,10.5,5,2,1,22,56,78
p_543,6,9,e_3,288,291,307,1.0,4,0,5.5,5,3,1,3,16,19
p_615,7,8,e_2,299,304,310,27.5,4,4,6.0,5,3,0,5,6,11
p_913,11,4,e_0,250,270,312,20.0,3,3,15.0,2,3,0,20,42,62
p_685,8,4,e_0,265,288,312,19.5,5,2,12.0,4,3,3,23,24,47
p_545,6,10,e_3,237,291,313,8.0,4,3,4.0,4,3,1,54,22,76
p_1089,13,3,e_0,235,238,318,21.0,4,4,12.5,5,2,1,3,80,83
p_457,5,3,e_0,265,306,318,23.0,5,4,12.0,4,3,3,41,12,53
p_67,0,11,e_3,261,263,319,0.5,5,0,0.5,4,4,1,2,56,58
p_544,6,11,e_3,245,291,319,7.0,4,2,3.0,4,3,1,46,28,74
p_616,7,12,e_1,264,297,321,7.0,5,2,3.5,4,0,1,33,24,57
p_387,4,10,e_2,219,260,322,10.5,5,3,12.5,4,4,0,41,62,103
p_758,9,12,e_3,295,307,325,2.0,5,0,7.0,5,5,0,12,18,30
p_759,9,1,e_0,263,282,328,9.0,4,4,12.5,4,3,2,19,46,65
p_458,5,11,e_2,238,254,328,7.0,4,3,8.0,4,3,1,16,74,90
p_757,9,11,e_2,309,316,328,27.5,4,4,8.0,5,4,0,7,12,19
p_384,4,0,e_0,307,312,334,15.0,4,4,5.0,4,3,1,5,22,27
p_388,4,14,e_3,194,239,335,15.0,5,2,13.0,4,4,1,45,96,141
p_456,5,15,e_1,267,285,337,5.0,5,1,3.0,4,0,2,18,52,70
p_385,4,13,e_2,222,260,338,10.0,4,3,11.5,4,4,1,38,78,116
p_304,3,4,e_0,321,348,354,19.5,2,2,2.5,4,2,1,27,6,33
p_1088,13,11,e_1,277,327,355,12.0,5,1,3.0,5,1,3,50,28,78
p_912,11,9,e_1,273,315,365,14.5,5,1,2.0,5,1,2,42,50,92
p_383,4,7,e_0,324,354,370,20.0,1,1,1.5,4,2,2,30,16,46
p_455,5,7,e_0,334,360,370,19.0,1,1,0.0,5,1,3,26,10,36
p_66,0,9,e_0,271,334,380,26.0,5,5,11.0,4,4,3,63,46,109
p_1157,14,2,e_3,282,335,385,10.0,4,0,4.0,5,3,1,53,50,103
p_827,10,1,e_2,348,352,390,1.0,1,0,11.0,4,1,0,4,38,42
p_217,2,1,e_3,325,385,391,14.0,1,1,12.0,5,1,0,60,6,66
p_1087,13,11,e_1,366,384,394,21.5,1,1,9.0,3,0,0,18,10,28
p_911,11,0,e_2,297,328,396,10.0,4,1,5.5,5,3,0,31,68,99
p_614,7,13,e_0,310,370,400,25.5,4,4,4.0,4,3,1,60,30,90
p_63,0,1,e_2,388,396,402,1.5,3,0,1.5,4,2,1,8,6,14
p_613,7,14,e_0,321,370,406,24.0,2,2,2.5,4,2,1,49,36,85
p_910,11,14,e_0,387,390,406,12.5,3,1,10.5,5,2,1,3,16,19
p_64,0,3,e_3,384,397,413,2.0,2,0,2.0,1,1,2,13,16,29
p_1231,15,10,e_0,342,412,434,25.5,1,1,2.0,5,1,5,70,22,92
p_454,5,9,e_2,377,420,440,9.0,2,2,4.0,4,2,0,43,20,63
p_65,0,9,e_3,375,397,441,4.5,1,0,4.5,4,1,0,22,44,66
p_62,0,9,e_3,397,397,441,0.0,1,1,0.0,3,0,1,0,44,44
p_1086,13,0,e_1,369,384,450,21.0,1,1,9.5,5,0,1,15,66,81
p_826,10,0,e_1,386,400,450,22.0,3,3,13.0,4,2,1,14,50,64
p_825,10,0,e_1,392,400,450,21.0,2,2,11.5,4,2,2,8,50,58
p_542,6,0,e_1,376,418,450,28.0,2,2,11.0,5,0,1,42,32,74
p_136,1,0,e_1,399,442,450,17.0,3,3,10.0,4,1,2,43,8,51
p_137,1,11,e_2,398,402,450,1.0,3,0,0.5,5,1,2,4,48,52
p_303,3,12,e_3,410,413,455,1.0,3,0,2.5,5,2,1,3,42,45
p_684,8,12,e_2,420,434,456,4.0,4,0,5.0,2,1,1,14,22,36
p_1009,12,13,e_2,395,456,462,12.5,2,0,0.0,4,1,1,61,6,67
p_1156,14,4,e_0,341,406,464,27.0,1,1,1.5,5,1,4,65,58,123
p_453,5,4,e_0,423,458,464,20.5,4,3,12.5,4,3,1,35,6,41
p_1008,12,14,e_2,416,456,468,9.0,3,2,4.0,5,1,2,40,12,52
p_382,4,15,e_3,381,419,469,7.0,2,2,3.0,4,1,1,38,50,88
p_1155,14,2,e_0,343,406,474,26.0,1,1,2.0,5,1,6,63,68,131
p_1152,14,15,e_2,450,468,476,3.0,4,1,11.0,2,2,2,18,8,26
p_135,1,6,e_1,441,442,480,22.0,3,3,1.0,1,2,0,1,38,39
p_133,1,6,e_1,449,456,480,20.5,4,4,0.0,4,3,2,7,24,31
p_756,9,1,e_0,405,440,480,7.5,3,0,14.0,2,1,1,35,40,75
p_452,5,1,e_0,425,458,480,20.0,4,3,12.0,4,3,2,33,22,55
p_1151,14,13,e_2,468,468,488,1.0,4,0,14.0,2,1,1,0,20,20
p_216,2,9,e_1,411,436,494,17.0,3,3,7.5,4,1,2,25,58,83
p_1007,12,9,e_3,441,455,495,9.0,3,1,9.0,5,2,1,14,40,54
p_134,1,10,e_1,446,456,500,21.0,4,4,0.5,4,3,1,10,44,54
p_754,9,8,e_3,463,495,501,7.0,4,1,14.0,5,2,2,32,6,38
p_541,6,11,e_1,477,480,506,15.0,3,1,5.5,5,4,0,3,26,29
p_1230,15,9,e_2,438,476,506,6.5,4,0,8.5,5,3,1,38,30,68
p_451,5,6,e_0,492,500,506,10.5,3,1,3.5,5,1,1,8,6,14
p_302,3,7,e_0,471,490,512,14.0,3,1,2.5,4,2,0,19,22,41
p_1154,14,7,e_2,425,468,516,11.0,4,1,6.0,5,2,2,43,48,91
p_381,4,13,e_1,444,470,516,24.5,3,3,1.0,1,3,0,26,46,72
p_380,4,13,e_1,445,470,516,24.0,4,4,1.0,4,3,1,25,46,71
p_824,10,13,e_1,463,500,516,26.0,4,4,2.5,5,3,1,37,16,53
p_683,8,4,e_3,444,501,519,12.5,3,2,9.5,5,2,1,57,18,75
p_682,8,2,e_3,482,501,529,4.0,3,1,12.0,4,1,2,19,28,47
p_540,6,11,e_0,491,506,532,12.0,3,1,3.0,5,1,0,15,26,41
p_1153,14,3,e_2,427,468,534,10.5,4,1,6.5,5,2,3,41,66,107
p_612,7,12,e_0,495,512,538,12.0,2,1,4.0,5,1,2,17,26,43
p_753,9,12,e_0,500,522,538,13.0,2,1,5.0,2,1,1,22,16,38
p_215,2,0,e_3,419,529,539,2.0,2,2,4.0,3,2,0,110,10,120
p_1229,15,2,e_2,476,476,540,26.5,3,3,15.0,2,4,0,0,64,64
p_908,11,13,e_0,517,532,544,15.5,3,2,8.0,5,2,1,15,12,27
p_752,9,15,e_0,508,522,554,11.5,2,2,6.0,5,2,1,14,32,46
p_301,3,5,e_2,530,534,556,5.0,1,1,4.0,4,2,0,4,22,26
p_1228,15,8,e_1,502,526,556,21.0,2,2,10.5,5,3,0,24,30,54
p_61,0,4,e_3,509,539,557,6.0,2,0,6.0,4,2,0,30,18,48
p_60,0,8,e_3,512,539,575,5.5,3,0,5.5,4,2,1,27,36,63
p_379,4,9,e_2,533,550,576,5.5,1,1,3.0,1,2,1,17,26,43
p_449,5,10,e_2,546,556,582,4.0,4,1,3.5,5,1,3,10,26,36
p_750,9,8,e_0,557,580,586,7.0,3,1,14.5,4,2,0,23,6,29
p_59,0,10,e_3,517,539,587,4.0,3,0,4.0,4,2,1,22,48,70
p_755,9,2,e_1,455,494,588,9.0,3,1,1.0,5,2,2,39,94,133
p_539,6,2,e_1,527,566,588,26.0,2,2,15.0,4,2,0,39,22,61
p_378,4,2,e_1,562,576,588,11.0,3,3,6.5,4,1,1,14,12,26
p_450,5,11,e_2,544,556,588,4.0,4,1,2.5,5,1,3,12,32,44
p_823,10,11,e_2,542,582,588,10.0,4,3,2.5,5,1,2,40,6,46
p_907,11,12,e_2,560,588,594,7.0,3,3,6.0,5,3,2,28,6,34
p_751,9,13,e_3,535,581,603,10.0,1,1,1.0,4,1,0,46,22,68
p_611,7,14,e_2,530,566,604,9.0,1,1,4.0,4,2,0,36,38,74
p_906,11,14,e_2,561,588,604,7.0,3,3,6.0,5,3,2,27,16,43
p_1150,14,13,e_3,580,609,615,5.0,3,0,9.0,5,1,2,29,6,35
p_1227,15,1,e_0,536,554,616,15.5,2,2,12.0,5,4,0,18,62,80
p_1085,13,12,e_3,601,603,621,2.5,5,1,12.5,5,3,2,2,18,20
p_909,11,0,e_0,506,532,622,24.0,2,2,6.0,5,2,1,26,90,116
p_132,1,9,e_1,572,594,630,13.5,3,3,4.5,4,1,2,22,36,58
p_377,4,9,e_1,590,608,630,21.5,3,3,2.0,4,1,1,18,22,40
p_131,1,3,e_0,619,628,638,11.5,4,0,0.5,4,1,0,9,10,19
p_1084,13,9,e_2,604,620,640,2.0,4,1,14.0,2,1,2,16,20,36
p_1006,12,7,e_3,599,621,643,3.5,4,2,12.5,5,3,1,22,22,44
p_904,11,6,e_3,589,593,649,6.5,3,2,10.5,5,1,2,4,56,60
p_300,3,13,e_1,566,582,652,17.0,3,3,6.0,1,1,1,16,70,86
p_299,3,13,e_1,575,582,652,15.0,2,2,4.0,4,1,3,7,70,77
p_538,6,5,e_3,640,649,655,1.0,4,0,7.5,4,3,1,9,6,15
p_749,9,14,e_1,607,630,658,23.0,4,4,4.0,3,2,0,23,28,51
p_822,10,14,e_1,629,636,658,14.0,3,3,9.0,5,2,1,7,22,29
p_1226,15,4,e_2,559,610,664,10.5,3,0,5.5,5,3,1,51,54,105
p_905,11,3,e_3,575,593,665,3.0,2,0,8.0,5,1,1,18,72,90
p_609,7,3,e_3,615,643,665,6.0,3,1,13.0,1,4,0,28,22,50
p_903,11,2,e_2,620,630,674,1.0,4,0,13.0,1,1,1,10,44,54
p_610,7,2,e_2,593,650,674,10.0,4,2,12.0,2,2,1,57,24,81
p_1004,12,6,e_1,630,646,692,25.0,3,3,9.0,5,2,2,16,46,62
p_130,1,15,e_0,627,628,692,9.5,3,0,1.0,5,0,3,1,64,65
p_537,6,15,e_0,648,652,692,12.0,2,2,5.5,5,2,0,4,40,44
p_1149,14,15,e_0,676,686,692,14.5,1,0,11.5,5,2,0,10,6,16
p_128,1,4,e_2,677,680,694,1.5,1,0,1.5,4,0,1,3,14,17
p_536,6,5,e_1,670,692,698,26.0,1,1,11.5,4,2,0,22,6,28
p_1005,12,4,e_1,629,646,704,25.5,3,3,9.0,5,2,0,17,58,75
p_56,0,6,e_3,675,679,705,0.5,1,0,0.5,4,0,1,4,26,30
p_376,4,3,e_1,700,704,710,17.0,3,3,5.0,4,1,2,4,6,10
p_608,7,10,e_2,677,708,722,7.5,1,0,1.5,4,0,1,31,14,45
p_1225,15,7,e_0,684,692,728,14.0,2,0,13.5,5,2,1,8,36,44
p_1003,12,7,e_0,684,706,728,13.0,2,1,13.5,5,2,1,22,22,44
p_126,1,0,e_1,719,722,728,19.5,4,4,1.5,4,2,2,3,6,9
p_901,11,12,e_2,694,728,734,8.0,3,1,4.0,3,2,1,34,6,40
p_57,0,13,e_3,631,679,739,9.5,3,0,9.5,4,3,0,48,60,108
p_1001,12,13,e_2,712,734,740,5.0,3,1,8.0,5,2,1,22,6,28
p_902,11,14,e_3,686,727,745,10.0,2,1,1.5,5,2,0,41,18,59
p_129,1,14,e_2,641,680,746,8.5,4,1,9.0,4,2,1,39,66,105
p_607,7,3,e_0,692,728,748,16.0,3,2,15.0,2,2,1,36,20,56
p_375,4,1,e_0,730,742,760,14.5,4,4,6.5,4,2,1,12,18,30
p_213,2,1,e_0,728,754,760,17.0,4,4,7.0,4,2,0,26,6,32
p_212,2,1,e_0,750,754,760,13.0,2,0,3.0,4,2,1,4,6,10
p_448,5,7,e_1,719,750,762,25.5,4,4,1.5,4,2,2,31,12,43
p_298,3,0,e_0,623,638,766,8.0,3,2,0.0,5,0,1,15,128,143
p_54,0,8,e_1,709,728,768,19.5,3,3,3.0,1,1,2,19,40,59
p_606,7,8,e_1,748,762,768,22.5,3,3,4.5,5,5,2,14,6,20
p_297,3,9,e_1,699,710,774,24.0,3,3,5.0,4,1,1,11,64,75
p_535,6,10,e_1,729,756,780,24.5,4,4,0.0,5,5,1,27,24,51
p_211,2,3,e_0,751,754,782,17.0,2,2,2.5,4,2,1,3,28,31
p_214,2,11,e_1,705,716,786,22.0,2,2,4.0,4,1,1,11,70,81
p_681,8,11,e_1,732,768,786,26.0,3,3,1.0,5,5,2,36,18,54
p_820,10,8,e_3,765,775,787,2.0,4,0,12.5,4,3,1,10,12,22
p_748,9,8,e_3,767,781,787,2.0,4,1,11.5,4,3,1,14,6,20
p_998,12,8,e_2,759,766,788,1.0,5,0,13.5,4,3,2,7,22,29
p_55,0,12,e_1,695,728,792,22.0,3,3,5.5,4,2,0,33,64,97
p_900,11,7,e_2,751,772,794,20.0,2,0,15.0,5,1,2,21,22,43
p_821,10,5,e_3,754,775,801,4.0,4,1,14.5,4,3,1,21,26,47
p_127,1,14,e_1,718,722,802,22.0,4,4,2.0,4,2,1,4,80,84
p_819,10,5,e_2,770,778,804,1.0,5,0,11.5,4,4,1,8,26,34
p_210,2,8,e_0,769,776,808,11.0,5,1,0.5,5,2,0,7,32,39
p_604,7,8,e_0,783,802,808,13.5,5,4,3.0,5,3,1,19,6,25
p_1002,12,3,e_3,708,733,811,7.5,2,1,6.5,5,1,1,25,78,103
p_1000,12,3,e_3,716,733,811,5.5,3,1,8.5,5,1,2,17,78,95
p_1081,13,3,e_3,753,761,811,1.0,3,0,14.5,4,3,0,8,50,58
p_446,5,3,e_3,789,801,811,3.0,4,0,8.0,4,4,0,12,10,22
p_1219,15,14,e_1,786,808,814,22.0,5,5,11.0,5,3,1,22,6,28
p_1083,13,2,e_3,721,739,817,7.5,4,1,9.5,5,1,3,18,78,96
p_1222,15,2,e_2,749,752,818,0.5,3,0,14.5,5,1,2,3,66,69
p_209,2,10,e_0,770,776,818,11.0,5,1,0.5,5,2,1,6,42,48
p_1224,15,1,e_3,717,751,823,6.0,3,0,9.0,5,1,2,34,72,106
p_1082,13,1,e_2,735,740,824,4.5,4,2,12.0,5,2,1,5,84,89
p_999,12,1,e_2,739,766,824,5.0,3,2,13.0,5,2,1,27,58,85
p_1223,15,0,e_2,718,752,830,6.0,4,0,9.0,5,2,2,34,78,112
p_58,0,12,e_0,625,766,830,11.5,3,0,0.5,5,0,2,141,64,205
p_53,0,12,e_0,741,766,830,17.0,4,4,4.0,4,2,2,25,64,89
p_445,5,12,e_0,790,792,830,10.5,4,3,4.5,5,3,3,2,38,40
p_605,7,12,e_0,773,802,830,15.5,5,3,1.5,5,2,1,29,28,57
p_447,5,13,e_0,785,792,836,11.5,5,3,3.5,5,3,2,7,44,51
p_817,10,14,e_0,810,818,842,11.0,3,2,8.5,5,3,1,8,24,32
p_52,0,3,e_3,812,829,843,3.0,2,0,3.0,4,2,0,17,14,31
p_1221,15,9,e_1,773,808,844,24.0,5,5,9.0,2,5,0,35,36,71
p_997,12,7,e_1,809,826,854,20.0,3,3,15.0,4,3,3,17,28,45
p_897,11,7,e_1,791,832,854,25.5,4,4,12.0,5,3,1,41,22,63
p_747,9,7,e_1,800,844,854,25.0,4,4,14.0,5,2,2,44,10,54
p_374,4,5,e_3,815,849,855,6.0,3,2,2.0,4,2,1,34,6,40
p_1218,15,13,e_0,832,850,860,14.5,6,0,12.5,5,3,0,18,10,28
p_1080,13,6,e_1,808,820,860,19.5,3,3,15.0,4,3,1,12,40,52
p_899,11,5,e_1,771,786,866,28.5,5,5,8.5,5,5,0,15,80,95
p_1220,15,5,e_1,781,808,866,23.0,5,5,10.0,5,3,1,27,58,85
p_818,10,4,e_1,809,838,872,22.0,3,3,15.0,4,3,2,29,34,63
p_125,1,10,e_3,794,823,877,5.5,4,0,6.5,4,4,0,29,54,83
p_816,10,2,e_1,828,838,882,10.0,5,5,11.5,4,4,2,10,44,54
p_123,1,11,e_3,802,823,883,4.0,3,0,5.0,4,3,0,21,60,81
p_1148,14,7,e_0,842,844,886,13.0,6,1,14.0,5,1,1,2,42,44
p_208,2,14,e_3,801,817,897,5.0,3,1,5.0,4,3,0,16,80,96
p_122,1,3,e_1,855,888,900,26.0,4,4,7.0,4,4,0,33,12,45
p_206,2,3,e_1,891,894,900,19.0,5,5,1.5,5,3,1,3,6,9
p_124,1,15,e_3,800,823,903,4.0,3,0,5.0,1,4,0,23,80,103
p_898,11,3,e_0,783,824,906,26.5,5,5,3.0,5,3,1,41,82,123
p_1217,15,3,e_0,847,850,906,11.0,5,0,14.5,5,2,1,3,56,59
p_121,1,5,e_1,873,888,910,21.5,4,4,4.0,4,1,1,15,22,37
p_1079,13,8,e_2,905,908,930,2.0,4,0,13.5,4,5,1,3,22,25
p_532,6,8,e_0,864,892,930,29.0,4,4,12.0,4,2,0,28,38,66
p_896,11,9,e_3,881,883,931,8.5,3,2,10.5,5,3,0,2,48,50
p_996,12,7,e_2,865,892,936,11.0,4,2,6.0,5,2,2,27,44,71
p_531,6,11,e_1,873,916,942,26.5,4,4,4.0,4,1,1,43,26,69
p_746,9,11,e_1,916,932,942,7.0,4,2,6.0,2,1,2,16,10,26
p_1147,14,4,e_2,871,902,952,7.0,4,1,7.0,5,3,2,31,50,81
p_602,7,5,e_3,890,943,953,10.5,4,2,12.5,5,3,1,53,10,63
p_679,8,13,e_1,910,926,954,7.5,4,1,5.0,2,2,1,16,28,44
p_533,6,3,e_2,859,864,958,18.5,4,4,5.0,5,0,2,5,94,99
p_995,12,3,e_2,888,892,958,6.0,4,2,11.5,5,3,3,4,66,70
p_895,11,4,e_3,896,921,959,5.0,4,1,14.0,2,3,2,25,38,63
p_207,2,15,e_1,861,882,964,26.0,4,4,6.0,4,3,1,21,82,103
p_994,12,15,e_1,913,948,964,11.0,4,4,5.5,5,1,2,35,16,51
p_603,7,2,e_2,862,870,964,16.5,4,4,6.0,5,0,2,8,94,102
p_373,4,2,e_2,903,952,964,11.0,4,4,14.0,4,5,1,49,12,61
p_534,6,1,e_2,837,864,970,22.0,6,4,0.0,3,0,0,27,106,133
p_444,5,1,e_2,941,946,970,2.0,4,0,6.0,4,4,1,5,24,29
p_600,7,6,e_0,916,924,976,5.0,4,3,5.5,5,1,2,8,52,60
p_678,8,6,e_0,912,930,976,5.0,4,2,4.5,5,1,2,18,46,64
p_993,12,6,e_0,929,948,976,26.0,6,6,8.0,2,3,2,19,28,47
p_745,9,6,e_0,939,962,976,27.5,4,4,10.0,5,2,3,23,14,37
p_680,8,1,e_3,885,937,977,10.5,3,2,11.5,5,3,0,52,40,92
p_530,6,5,e_0,929,976,982,3.0,5,2,8.0,5,3,2,47,6,53
p_205,2,4,e_3,929,971,991,9.0,5,1,9.0,4,2,3,42,20,62
p_202,2,3,e_2,983,986,992,28.0,5,5,1.5,5,2,1,3,6,9
p_815,10,9,e_1,985,988,994,15.0,5,2,10.5,4,2,2,3,6,9
p_601,7,3,e_0,908,924,994,7.0,4,3,3.5,5,1,1,16,70,86
p_529,6,2,e_0,951,976,1000,28.0,4,4,11.5,4,2,3,25,24,49
p_528,6,2,e_0,967,976,1000,25.5,3,3,8.0,4,2,2,9,24,33
p_372,4,2,e_0,924,988,1000,6.0,4,3,7.0,2,1,1,64,12,76
p_119,1,7,e_3,925,977,1005,9.0,4,0,10.0,4,2,2,52,28,80
p_1216,15,7,e_1,908,964,1006,22.0,4,4,5.0,5,2,1,56,42,98
p_599,7,8,e_3,990,1005,1011,3.0,5,0,4.0,5,5,0,15,6,21
p_992,12,6,e_1,951,978,1012,22.0,4,4,12.5,5,2,0,27,34,61
p_204,2,9,e_3,937,971,1017,8.0,4,1,8.0,1,1,3,34,46,80
p_51,0,9,e_2,843,976,1020,27.0,5,5,1.0,5,0,1,133,44,177
p_744,9,3,e_1,974,994,1026,21.5,5,5,12.5,4,1,1,20,32,52
p_677,8,3,e_1,979,1000,1026,19.0,5,3,12.0,4,2,1,21,26,47
p_443,5,10,e_2,982,1002,1026,3.0,5,1,1.5,5,2,0,20,24,44
p_120,1,3,e_0,906,1006,1026,13.5,4,0,3.0,5,1,0,100,20,120
p_48,0,3,e_0,998,1012,1026,22.5,5,5,2.5,4,1,2,14,14,28
p_201,2,4,e_0,993,1000,1032,25.5,5,5,3.0,1,2,2,7,32,39
p_295,3,4,e_1,1019,1026,1032,22.0,3,3,4.5,4,1,0,7,6,13
p_203,2,12,e_3,941,971,1035,7.0,4,1,7.0,4,2,2,30,64,94
p_894,11,12,e_3,1027,1029,1035,1.0,2,0,10.5,5,2,0,2,6,8
p_50,0,13,e_2,951,976,1042,5.5,4,0,4.0,1,4,1,25,66,91
p_296,3,14,e_3,963,965,1045,4.0,2,2,3.0,4,1,1,2,80,82
p_814,10,14,e_3,993,1023,1045,6.0,4,2,4.5,5,4,0,30,22,52
p_990,12,14,e_3,1031,1035,1045,1.0,2,0,11.5,5,2,0,4,10,14
p_49,0,10,e_0,980,1012,1060,26.5,5,5,5.5,4,3,2,32,48,80
p_1146,14,11,e_3,1042,1045,1061,0.5,2,0,13.5,5,1,1,3,16,19
p_442,5,10,e_1,1021,1038,1062,23.5,3,3,4.0,4,1,1,17,24,41
p_893,11,9,e_2,1040,1052,1062,4.0,1,1,13.0,5,2,2,12,10,22
p_813,10,7,e_2,997,1026,1074,12.5,5,2,4.0,5,2,2,29,48,77
p_991,12,7,e_2,992,1036,1074,12.0,4,1,3.0,2,3,1,44,38,82
p_676,8,13,e_1,1021,1052,1076,26.5,3,3,4.0,4,1,0,31,24,55
p_1076,13,14,e_0,1040,1074,1080,28.0,2,2,6.0,5,1,1,34,6,40
p_1078,13,5,e_2,1013,1042,1086,7.0,4,1,7.5,5,3,1,29,44,73
p_892,11,5,e_2,1041,1052,1086,3.5,2,1,13.0,5,2,3,11,34,45
p_1215,15,14,e_1,1062,1086,1092,26.0,3,3,10.0,5,1,1,24,6,30
p_527,6,3,e_2,1025,1080,1098,12.0,2,2,10.0,5,2,1,55,18,73
p_370,4,3,e_2,1085,1092,1098,2.0,4,1,5.0,4,4,2,7,6,13
p_743,9,3,e_3,1060,1071,1101,2.0,3,0,11.0,4,2,1,11,30,41
p_441,5,3,e_3,1071,1091,1101,4.0,3,1,9.0,4,2,1,20,10,30
p_890,11,9,e_0,1090,1094,1106,24.0,4,4,11.5,4,2,3,4,12,16
p_1077,13,1,e_2,1027,1042,1110,4.5,2,1,10.0,5,2,2,15,68,83
p_371,4,1,e_2,1039,1092,1110,11.0,1,1,12.5,5,2,1,53,18,71
p_989,12,0,e_3,1049,1055,1115,1.0,2,0,13.0,4,1,1,6,60,66
p_1214,15,9,e_1,1069,1086,1116,24.0,3,3,11.5,5,1,2,17,30,47
p_1145,14,9,e_1,1081,1092,1116,23.0,3,3,14.0,5,0,2,11,24,35
p_812,10,7,e_0,1015,1060,1118,9.5,4,2,0.5,5,3,0,45,58,103
p_674,8,6,e_0,1090,1112,1124,27.0,4,4,12.0,4,2,2,22,12,34
p_45,0,2,e_3,1111,1115,1125,1.0,4,0,1.0,4,2,2,4,10,14
p_889,11,7,e_1,1100,1106,1126,22.0,2,2,12.0,4,2,1,6,20,26
p_292,3,5,e_2,1059,1098,1132,14.0,3,1,9.5,4,4,3,39,34,73
p_291,3,5,e_2,1084,1098,1132,9.5,4,1,5.0,4,4,2,14,34,48
p_598,7,4,e_0,1017,1046,1134,12.0,3,3,1.0,5,3,0,29,88,117
p_891,11,4,e_0,1077,1094,1134,26.5,4,4,13.5,5,3,1,17,40,57
p_811,10,3,e_0,1068,1100,1140,29.5,3,3,12.0,5,2,1,32,40,72
p_1144,14,4,e_1,1082,1092,1140,23.0,4,4,14.5,5,0,3,10,48,58
p_595,7,4,e_1,1118,1126,1140,20.5,7,5,9.0,4,2,1,8,14,22
p_368,4,7,e_2,1113,1126,1144,4.5,5,0,1.5,5,2,3,13,18,31
p_46,0,7,e_3,1074,1115,1147,8.5,4,0,8.5,4,2,2,41,32,73
p_199,2,7,e_3,1115,1125,1147,2.0,7,0,0.0,5,5,2,10,22,32
p_594,7,8,e_2,1123,1144,1150,6.0,7,1,3.5,5,3,3,21,6,27
p_293,3,2,e_1,1051,1146,1152,9.0,4,2,8.0,2,1,1,95,6,101
p_597,7,8,e_3,1050,1081,1153,20.0,3,1,13.0,4,1,2,31,72,103
p_289,3,0,e_0,1114,1140,1154,27.0,5,5,8.0,4,4,0,26,14,40
p_198,2,3,e_1,1139,1152,1158,25.0,6,6,4.0,1,1,1,13,6,19
p_741,9,10,e_2,1119,1156,1162,9.0,7,3,3.0,2,2,2,37,6,43
p_596,7,10,e_3,1113,1147,1165,7.5,4,0,0.5,4,2,2,34,18,52
p_675,8,11,e_2,1052,1068,1168,20.5,4,2,11.0,1,3,2,16,100,116
p_200,2,11,e_2,1061,1104,1168,13.0,3,1,9.0,4,4,4,43,64,107
p_526,6,11,e_2,1127,1138,1168,4.0,6,0,4.0,5,5,2,11,30,41
p_42,0,3,e_0,1146,1154,1170,21.0,7,7,2.0,4,1,1,8,16,24
p_44,0,11,e_3,1113,1115,1171,0.5,5,0,0.5,4,2,3,2,56,58
p_739,9,11,e_3,1131,1159,1171,6.0,6,2,3.5,5,4,2,28,12,40
p_43,0,4,e_0,1127,1154,1176,26.0,6,6,5.5,4,2,1,27,22,49
p_290,3,13,e_2,1108,1120,1178,4.5,3,1,1.5,4,3,2,12,58,70
p_673,8,13,e_2,1105,1150,1178,10.0,3,1,2.0,4,3,0,45,28,73
p_288,3,5,e_0,1157,1170,1182,22.5,6,6,0.5,5,2,2,13,12,25
p_738,9,14,e_2,1137,1156,1184,4.0,6,2,6.0,2,4,2,19,28,47
p_47,0,14,e_3,1040,1115,1187,15.0,1,1,13.0,5,1,0,75,72,147
p_742,9,14,e_3,1110,1159,1187,10.0,3,1,1.0,4,2,1,49,28,77
p_369,4,15,e_2,1107,1126,1190,6.0,3,1,1.5,4,3,1,19,64,83
p_294,3,12,e_1,1027,1146,1200,20.0,3,3,3.0,5,1,2,119,54,173
p_367,4,12,e_1,1159,1164,1200,23.0,5,5,3.0,5,2,0,5,36,41
p_671,8,10,e_0,1182,1196,1206,23.0,4,4,5.0,5,1,1,14,10,24
p_197,2,14,e_1,1151,1152,1210,22.5,7,7,2.0,4,2,0,1,58,59
p_737,9,15,e_1,1168,1186,1216,26.5,4,4,5.0,5,2,0,18,30,48
p_810,10,14,e_0,1123,1206,1224,8.0,7,3,6.0,1,3,0,83,18,101
p_1213,15,7,e_2,1176,1190,1226,3.0,4,0,12.5,5,4,0,14,36,50
p_118,1,15,e_0,1153,1160,1230,21.0,6,6,0.0,3,1,1,7,70,77
p_740,9,6,e_2,1126,1156,1232,17.0,6,3,4.0,3,3,3,30,76,106
p_670,8,6,e_2,1207,1220,1232,2.0,4,0,11.0,4,2,0,13,12,25
p_525,6,5,e_3,1143,1227,1233,16.0,6,6,6.0,5,4,2,84,6,90
p_988,12,4,e_3,1101,1177,1239,21.0,2,2,3.0,4,2,0,76,62,138
p_672,8,4,e_3,1170,1215,1239,9.0,3,2,11.0,2,2,2,45,24,69
p_593,7,4,e_3,1212,1221,1239,1.0,5,0,8.5,4,2,3,9,18,27
p_1141,14,10,e_1,1204,1210,1244,25.0,4,4,13.0,5,2,0,6,34,40
p_886,11,9,e_1,1230,1238,1250,23.5,3,3,12.5,4,4,1,8,12,20
p_440,5,2,e_3,1208,1233,1251,4.0,4,2,9.5,4,2,2,25,18,43
p_287,3,2,e_3,1238,1245,1251,1.0,3,0,4.0,4,3,0,7,6,13
p_887,11,8,e_1,1229,1238,1256,23.5,3,3,13.0,4,4,1,9,18,27
p_809,10,1,e_3,1193,1205,1257,3.0,3,0,13.0,4,1,2,12,52,64
p_196,2,3,e_2,1219,1254,1260,7.0,5,1,8.0,1,2,1,35,6,41
p_987,12,9,e_0,1240,1244,1260,21.0,4,4,13.0,4,0,2,4,16,20
p_1143,14,6,e_1,1200,1210,1266,23.0,4,4,12.0,2,3,0,10,56,66
p_1075,13,4,e_1,1226,1228,1276,22.0,4,4,13.5,4,3,1,2,48,50
p_591,7,6,e_0,1225,1270,1276,28.5,4,4,14.0,5,1,0,45,6,51
p_524,6,7,e_2,1201,1232,1278,9.0,4,1,12.5,4,2,0,31,46,77
p_1142,14,3,e_1,1201,1210,1282,23.0,4,4,12.0,5,2,0,9,72,81
p_1140,14,3,e_1,1215,1222,1282,23.0,5,5,15.0,5,4,0,7,60,67
p_523,6,8,e_2,1212,1232,1284,12.5,5,3,9.5,4,2,1,20,52,72
p_117,1,7,e_3,1204,1257,1285,9.0,4,0,10.0,4,1,3,53,28,81
p_888,11,2,e_1,1219,1238,1288,25.5,5,5,14.5,4,3,1,19,50,69
p_366,4,9,e_3,1197,1239,1295,8.0,4,0,12.0,4,1,3,42,56,98
p_590,7,10,e_2,1274,1278,1296,2.0,6,1,6.5,5,5,3,4,18,22
p_735,9,2,e_0,1249,1260,1296,22.5,3,3,11.0,4,1,2,11,36,47
p_522,6,11,e_2,1221,1232,1302,11.0,4,3,8.0,4,2,3,11,70,81
p_365,4,11,e_2,1241,1244,1302,6.0,4,3,4.5,4,5,2,3,58,61
p_521,6,12,e_3,1274,1279,1311,1.0,5,0,5.0,5,3,2,5,32,37
p_364,4,6,e_0,1256,1286,1314,13.0,3,0,9.5,4,2,1,30,28,58
p_592,7,13,e_2,1216,1226,1314,13.0,5,4,8.5,4,2,2,10,88,98
p_736,9,13,e_2,1220,1290,1314,14.0,4,4,8.0,4,2,2,70,24,94
p_116,1,14,e_3,1237,1257,1321,3.5,3,0,4.5,4,3,0,20,64,84
p_439,5,15,e_2,1213,1238,1326,11.0,6,2,9.5,4,2,1,25,88,113
p_883,11,15,e_3,1284,1305,1327,4.0,5,1,7.0,2,4,2,21,22,43
p_520,6,9,e_0,1280,1314,1332,30.0,6,6,5.0,4,2,1,34,18,52
p_668,8,10,e_0,1315,1326,1338,25.0,5,5,6.0,5,2,1,11,12,23
p_195,2,10,e_1,1256,1288,1344,15.0,3,0,8.0,4,4,0,32,56,88
p_115,1,10,e_1,1282,1294,1344,24.5,6,6,3.0,4,1,1,12,50,62
p_589,7,11,e_0,1317,1320,1344,23.5,5,5,6.5,5,2,3,3,24,27
p_1212,15,10,e_3,1254,1327,1349,15.5,3,3,1.5,4,2,1,73,22,95
p_1073,13,9,e_2,1313,1314,1352,5.0,5,2,13.0,2,5,1,1,38,39
p_41,0,12,e_1,1269,1300,1354,26.0,5,5,5.5,4,3,0,31,54,85
p_363,4,12,e_1,1296,1318,1354,25.0,5,5,0.5,4,1,1,22,36,58
p_808,10,14,e_0,1232,1254,1360,13.0,2,2,15.0,4,0,1,22,106,128
p_1072,13,15,e_0,1317,1354,1366,29.5,5,5,6.5,5,2,2,37,12,49
p_1211,15,6,e_2,1294,1326,1368,6.0,4,0,10.0,5,4,1,32,42,74
p_734,9,6,e_3,1283,1295,1369,14.5,6,4,6.5,5,4,2,12,74,86
p_885,11,5,e_3,1264,1305,1375,16.5,4,2,2.5,5,3,1,41,70,111
p_667,8,5,e_3,1330,1359,1375,6.0,6,1,14.5,4,4,2,29,16,45
p_807,10,4,e_2,1265,1296,1380,17.0,5,3,4.0,5,5,1,31,84,115
p_985,12,6,e_1,1315,1354,1384,5.5,5,2,3.5,5,2,1,39,30,69
p_1210,15,11,e_0,1344,1366,1386,24.0,7,7,11.0,5,1,2,22,20,42
p_884,11,2,e_2,1283,1302,1390,12.5,6,3,8.0,2,5,2,19,88,107
p_882,11,2,e_2,1285,1302,1390,12.0,5,3,8.0,5,4,2,17,88,105
p_1138,14,10,e_0,1354,1360,1392,24.0,8,8,13.0,2,1,2,6,32,38
p_1139,14,2,e_3,1253,1321,1393,16.5,2,2,1.5,4,2,0,68,72,140
p_519,6,4,e_1,1367,1384,1394,29.0,7,7,9.0,4,1,5,17,10,27
p_518,6,4,e_1,1380,1384,1394,27.0,7,7,7.0,4,2,2,4,10,14
p_986,12,1,e_2,1274,1308,1396,13.0,5,2,6.5,5,5,2,34,88,122
p_669,8,1,e_2,1309,1358,1396,10.0,5,2,12.0,5,5,0,49,38,87
p_1209,15,9,e_0,1363,1366,1398,21.0,7,7,14.5,5,2,2,3,32,35
p_1074,13,0,e_2,1312,1314,1402,5.0,5,2,13.0,5,5,1,2,88,90
p_666,8,2,e_1,1362,1372,1406,28.5,7,7,10.0,4,1,3,10,34,44
p_588,7,2,e_1,1366,1378,1406,28.5,7,7,9.5,4,1,4,12,28,40
p_281,3,2,e_1,1394,1400,1406,28.0,8,8,4.0,1,2,2,6,6,12
p_1071,13,7,e_0,1358,1376,1410,24.0,8,8,13.5,5,2,1,18,34,52
p_283,3,4,e_3,1372,1387,1413,6.5,6,2,5.5,4,2,4,15,26,41
p_282,3,4,e_3,1380,1387,1413,5.0,6,2,4.0,1,2,4,7,26,33
p_193,2,0,e_1,1344,1406,1416,9.0,7,6,10.0,5,1,2,62,10,72
p_360,4,5,e_3,1342,1381,1419,11.5,7,2,11.5,4,4,3,39,38,77
p_284,3,5,e_3,1333,1387,1419,13.0,7,1,14.0,4,4,3,54,32,86
p_665,8,4,e_0,1377,1404,1424,25.5,6,6,13.0,4,4,1,27,20,47
p_437,5,7,e_2,1367,1374,1434,9.0,7,4,6.0,1,5,0,7,60,67
p_40,0,4,e_1,1317,1416,1436,16.5,5,5,4.0,3,2,0,99,20,119
p_881,11,1,e_0,1383,1386,1440,22.0,8,8,11.5,4,4,2,3,54,57
p_362,4,9,e_3,1322,1381,1441,20.0,5,5,14.0,5,4,1,59,60,119
p_664,8,10,e_3,1378,1435,1447,10.5,6,3,4.5,4,2,4,57,12,69
p_113,1,10,e_2,1401,1408,1450,30.0,8,8,0.0,3,2,2,7,42,49
p_190,2,3,e_0,1438,1446,1454,23.5,7,7,1.5,4,2,0,8,8,16
p_191,2,8,e_1,1419,1426,1456,27.0,8,8,0.5,5,2,2,7,30,37
p_436,5,8,e_1,1429,1442,1456,28.0,7,7,2.5,5,3,3,13,14,27
p_286,3,12,e_3,1312,1387,1459,21.0,4,4,12.0,5,4,0,75,72,147
p_114,1,13,e_3,1352,1399,1467,8.5,6,0,9.5,4,3,3,47,68,115
p_806,10,13,e_2,1447,1450,1468,30.0,5,5,9.5,5,2,4,3,18,21
p_189,2,6,e_0,1444,1446,1472,22.5,6,6,1.5,5,1,1,2,26,28
p_359,4,6,e_0,1448,1460,1472,24.0,5,5,2.0,2,4,1,12,12,24
p_192,2,14,e_3,1354,1393,1473,9.0,8,1,9.0,4,3,5,39,80,119
p_188,2,7,e_0,1446,1446,1478,22.0,6,6,2.0,2,1,0,0,32,32
p_435,5,7,e_0,1446,1466,1478,25.0,5,5,2.0,5,4,1,20,12,32
p_438,5,15,e_3,1334,1375,1479,14.5,7,3,13.5,4,4,3,41,104,145
p_194,2,15,e_3,1333,1393,1479,11.5,7,0,13.5,4,4,3,60,86,146
p_517,6,15,e_3,1419,1425,1479,1.0,7,0,5.0,2,6,2,6,54,60
p_984,12,15,e_3,1353,1459,1479,19.0,7,7,9.0,4,3,4,106,20,126
p_982,12,13,e_1,1412,1476,1482,8.0,8,3,1.0,4,2,1,64,6,70
p_285,3,8,e_0,1314,1430,1484,20.5,5,5,6.0,5,2,0,116,54,170
p_516,6,8,e_0,1456,1472,1484,24.5,5,5,3.0,5,3,2,16,12,28
p_361,4,14,e_1,1325,1394,1488,19.0,6,6,5.5,5,2,1,69,94,163
p_1205,15,11,e_3,1457,1479,1497,3.0,5,0,12.0,5,5,0,22,18,40
p_1070,13,10,e_2,1403,1468,1504,15.5,8,2,0.0,5,1,3,65,36,101
p_1207,15,9,e_3,1414,1479,1507,11.0,8,0,4.0,5,6,2,65,28,93
p_1068,13,9,e_2,1440,1468,1510,8.0,6,2,8.0,2,1,4,28,42,70
p_733,9,8,e_3,1477,1507,1513,6.5,5,1,14.5,5,3,2,30,6,36
p_1067,13,15,e_0,1501,1510,1520,21.5,6,6,12.0,5,0,3,9,10,19
p_877,11,7,e_1,1495,1502,1520,0.0,7,0,12.5,4,3,1,7,18,25
p_879,11,6,e_3,1414,1453,1523,15.0,7,4,4.0,5,6,1,39,70,109
p_880,11,6,e_1,1386,1470,1526,21.0,7,7,6.0,4,2,1,84,56,140
p_981,12,5,e_3,1459,1459,1529,6.0,4,3,12.0,2,5,0,0,70,70
p_586,7,5,e_1,1509,1520,1532,2.0,6,1,9.5,4,5,1,11,12,23
p_979,12,4,e_2,1488,1494,1534,1.0,7,0,13.5,4,5,0,6,40,46
p_1206,15,4,e_3,1434,1479,1535,7.0,6,0,8.0,2,5,1,45,56,101
p_1136,14,4,e_1,1485,1488,1538,28.5,7,7,13.5,5,3,1,3,50,53
p_1204,15,3,e_3,1469,1479,1541,1.5,5,0,13.5,5,4,1,10,62,72
p_1137,14,2,e_2,1455,1474,1544,5.0,5,1,11.0,5,2,3,19,70,89
p_515,6,2,e_2,1508,1524,1544,3.0,6,1,9.0,4,5,0,16,20,36
p_1203,15,10,e_0,1504,1520,1546,23.5,6,6,12.0,2,2,3,16,26,42
p_1069,13,2,e_1,1422,1482,1548,11.5,8,2,1.5,5,2,3,60,66,126
p_434,5,2,e_1,1477,1532,1548,10.5,6,1,12.0,5,3,1,55,16,71
p_663,8,1,e_2,1406,1440,1550,19.5,8,5,1.0,5,1,4,34,110,144
p_1208,15,1,e_2,1370,1480,1550,20.0,6,6,5.5,4,4,1,110,70,180
p_878,11,0,e_2,1434,1456,1556,11.0,6,4,7.0,5,1,4,22,100,122
p_983,12,0,e_2,1397,1462,1556,18.5,8,8,1.0,4,2,1,65,94,159
p_280,3,0,e_3,1470,1541,1557,13.5,5,2,13.5,5,4,1,71,16,87
p_187,2,4,e_1,1460,1548,1558,20.0,5,5,9.0,5,1,3,88,10,98
p_1134,14,5,e_0,1519,1526,1570,21.5,5,5,15.0,5,3,3,7,44,51
p_1135,14,4,e_0,1517,1526,1576,22.5,5,5,14.5,5,3,2,9,50,59
p_975,12,4,e_0,1525,1536,1576,23.0,4,4,14.0,4,3,4,11,40,51
p_278,3,4,e_2,1559,1570,1576,3.0,2,0,0.5,5,1,1,11,6,17
p_978,12,3,e_0,1497,1502,1582,28.0,6,6,11.0,5,0,3,5,80,85
p_976,12,3,e_0,1524,1536,1582,23.0,4,4,14.5,4,3,3,12,46,58
p_186,2,10,e_1,1527,1548,1588,5.5,4,1,6.0,4,4,1,21,40,61
p_980,12,2,e_0,1460,1502,1588,6.0,5,3,4.0,5,3,1,42,86,128
p_977,12,2,e_0,1502,1502,1588,27.0,6,6,12.0,2,0,3,0,86,86
p_112,1,8,e_3,1461,1551,1591,19.0,5,5,12.0,5,5,0,90,40,130
p_185,2,11,e_1,1529,1548,1594,5.0,3,1,5.5,4,4,1,19,46,65
p_110,1,0,e_0,1573,1594,1600,17.5,3,3,4.5,4,4,1,21,6,27
p_876,11,13,e_1,1498,1502,1606,20.0,6,6,11.5,4,3,2,4,104,108
p_585,7,13,e_1,1522,1574,1606,11.0,4,4,6.5,4,5,0,52,32,84
p_279,3,11,e_3,1482,1541,1609,15.5,7,1,14.5,4,6,1,59,68,127
p_38,0,11,e_3,1532,1557,1609,4.5,3,0,4.5,4,2,1,25,52,77
p_974,12,14,e_1,1578,1600,1612,7.0,3,3,7.5,5,4,0,22,12,34
p_1066,13,14,e_1,1516,1606,1612,18.5,5,5,7.5,4,5,1,90,6,96
p_513,6,12,e_2,1553,1586,1612,7.0,3,1,0.5,4,1,1,33,26,59
p_183,2,3,e_0,1595,1610,1616,17.0,5,5,1.0,4,3,0,15,6,21
p_514,6,15,e_1,1551,1568,1618,7.0,3,1,2.5,5,4,1,17,50,67
p_39,0,14,e_2,1527,1556,1622,5.5,4,0,5.5,4,4,0,29,66,95
p_874,11,10,e_3,1590,1609,1625,5.0,5,1,8.0,5,2,3,19,16,35
p_184,2,5,e_0,1576,1588,1626,19.5,3,3,4.0,4,3,1,12,38,50
p_1133,14,12,e_2,1548,1622,1632,17.5,3,3,1.5,4,2,0,74,10,84
p_804,10,8,e_3,1618,1625,1637,1.0,8,0,11.5,4,6,2,7,12,19
p_37,0,7,e_0,1587,1600,1638,15.0,4,4,2.0,4,2,1,13,38,51
p_662,8,7,e_3,1558,1591,1643,14.0,2,1,0.0,5,2,0,33,52,85
p_873,11,6,e_3,1608,1609,1649,2.0,7,1,11.0,5,4,3,1,40,41
p_731,9,6,e_3,1599,1631,1649,6.0,5,3,9.0,5,3,2,32,18,50
p_1132,14,7,e_2,1618,1622,1654,24.5,8,8,13.0,5,1,1,4,32,36
p_875,11,5,e_3,1540,1609,1655,22.0,2,2,3.0,1,1,2,69,46,115
p_805,10,4,e_3,1582,1603,1661,6.0,3,1,6.0,5,2,1,21,58,79
p_732,9,3,e_3,1559,1597,1667,13.0,2,1,0.0,5,2,0,38,70,108
p_973,12,3,e_3,1588,1615,1667,4.5,4,0,7.5,5,2,2,27,52,79
p_511,6,14,e_0,1607,1632,1670,19.0,6,6,1.5,5,3,2,25,38,63
p_358,4,2,e_1,1623,1664,1674,6.0,8,5,14.0,4,0,1,41,10,51
p_587,7,15,e_0,1479,1560,1676,20.0,7,5,7.0,5,1,2,81,116,197
p_111,1,15,e_0,1466,1594,1676,18.0,6,6,5.0,2,3,1,128,82,210
p_433,5,15,e_0,1616,1626,1676,11.0,8,2,3.0,5,3,1,10,50,60
p_871,11,15,e_0,1651,1656,1676,17.0,4,4,10.0,5,3,1,5,20,25
p_661,8,0,e_3,1607,1637,1685,5.0,6,1,11.0,5,4,2,30,48,78
p_277,3,0,e_3,1652,1667,1685,2.0,4,1,5.5,4,4,0,15,18,33
p_36,0,1,e_2,1604,1686,1692,14.0,6,6,10.5,5,2,0,82,6,88
p_1202,15,11,e_0,1637,1676,1696,23.0,6,6,7.0,2,4,1,39,20,59
p_972,12,11,e_0,1661,1690,1696,22.0,2,2,12.0,5,4,0,29,6,35
p_971,12,10,e_0,1669,1690,1702,21.0,3,3,14.0,5,4,2,21,12,33
p_182,2,6,e_3,1667,1673,1713,5.0,2,1,3.0,1,2,1,6,40,46
p_432,5,6,e_3,1693,1707,1713,3.0,3,0,2.0,5,2,1,14,6,20
p_109,1,7,e_3,1672,1679,1719,3.0,2,1,2.0,1,1,1,7,40,47
p_35,0,9,e_1,1611,1684,1726,12.5,9,9,14.0,5,2,0,73,42,115
p_869,11,5,e_0,1680,1696,1728,20.0,4,4,14.5,4,3,2,16,32,48
p_803,10,5,e_0,1683,1702,1728,20.0,4,4,13.5,4,3,2,19,26,45
p_872,11,4,e_0,1637,1656,1734,27.0,6,6,7.0,2,4,0,19,78,97
p_507,6,12,e_2,1694,1714,1740,4.0,4,1,1.0,5,1,1,20,26,46
p_870,11,12,e_1,1658,1736,1742,15.5,3,2,5.0,4,0,2,78,6,84
p_510,6,13,e_2,1649,1660,1746,12.0,4,4,8.0,4,1,1,11,86,97
p_968,12,13,e_2,1721,1740,1746,5.0,5,3,7.5,5,2,1,19,6,25
p_356,4,2,e_0,1703,1734,1746,15.5,5,5,10.0,4,3,2,31,12,43
p_34,0,13,e_1,1622,1684,1748,10.5,8,0,14.0,4,0,1,62,64,126
p_730,9,13,e_1,1689,1726,1748,8.0,3,3,1.0,5,2,2,37,22,59
p_584,7,1,e_0,1668,1716,1752,26.0,3,3,13.5,5,4,1,48,36,84
p_509,6,14,e_1,1676,1710,1754,7.5,4,1,2.0,4,0,2,34,44,78
p_512,6,0,e_0,1600,1632,1758,8.5,6,3,0.0,3,3,1,32,126,158
p_357,4,0,e_0,1692,1734,1758,10.5,3,3,12.0,4,4,1,42,24,66
p_508,6,15,e_3,1693,1713,1761,4.0,3,0,2.0,5,2,1,20,48,68
p_660,8,15,e_3,1666,1725,1761,11.0,1,1,3.0,1,2,0,59,36,95
p_108,1,2,e_0,1700,1752,1768,21.5,5,5,10.0,4,4,1,52,16,68
p_868,11,10,e_1,1715,1736,1774,13.0,6,2,7.0,5,3,2,21,38,59
p_1201,15,10,e_2,1688,1756,1778,14.5,3,0,0.0,5,2,0,68,22,90
p_866,11,9,e_1,1724,1736,1780,11.0,5,2,8.5,5,4,1,12,44,56
p_506,6,7,e_0,1719,1722,1794,29.0,5,5,6.5,4,4,0,3,72,75
p_970,12,8,e_3,1699,1747,1795,9.0,4,0,3.0,5,2,2,48,48,96
p_1064,13,6,e_2,1738,1746,1798,7.0,4,1,12.0,5,2,1,8,52,60
p_352,4,8,e_0,1725,1734,1800,26.0,4,4,5.5,4,5,0,9,66,75
p_800,10,7,e_3,1779,1785,1801,1.0,6,0,11.0,4,5,1,6,16,22
p_1063,13,4,e_1,1750,1760,1804,4.5,5,1,13.0,5,4,0,10,44,54
p_801,10,5,e_2,1773,1778,1804,2.0,5,0,11.0,4,4,1,5,26,31
p_275,3,9,e_0,1763,1774,1806,17.5,4,2,1.0,5,7,1,11,32,43
p_969,12,5,e_3,1702,1747,1813,8.0,5,0,4.0,5,2,3,45,66,111
p_583,7,2,e_1,1715,1716,1814,17.0,6,5,7.0,5,3,1,1,98,99
p_867,11,2,e_1,1716,1736,1814,12.5,6,2,7.0,2,3,1,20,78,98
p_429,5,2,e_1,1762,1798,1814,10.0,4,1,13.0,4,5,0,36,16,52
p_1065,13,3,e_2,1686,1746,1816,13.0,3,0,0.0,3,1,0,60,70,130
p_355,4,11,e_0,1710,1734,1816,22.5,5,5,8.5,4,3,2,24,82,106
p_1131,14,1,e_1,1695,1754,1820,11.5,4,0,2.5,5,2,2,59,66,125
p_1200,15,2,e_2,1740,1756,1822,4.5,4,0,12.0,5,1,1,16,66,82
p_582,7,2,e_2,1764,1792,1822,7.0,4,1,13.5,4,4,0,28,30,58
p_354,4,12,e_0,1711,1734,1822,22.0,5,5,8.0,4,3,2,23,88,111
p_353,4,12,e_0,1722,1734,1822,26.5,5,5,6.0,1,4,0,12,88,100
p_431,5,12,e_0,1732,1784,1822,26.0,4,4,4.5,4,4,1,52,38,90
p_430,5,12,e_0,1734,1784,1822,25.5,4,4,4.0,1,4,2,50,38,88
p_659,8,12,e_0,1730,1800,1822,29.0,4,4,4.5,4,4,0,70,22,92
p_865,11,3,e_3,1775,1779,1823,1.0,5,0,12.0,4,4,1,4,44,48
p_351,4,0,e_1,1771,1804,1826,8.0,5,3,10.5,4,5,1,33,22,55
p_276,3,13,e_0,1737,1740,1828,23.0,3,3,3.5,4,7,1,3,88,91
p_505,6,2,e_3,1768,1807,1829,7.0,4,1,13.5,4,4,0,39,22,61
p_729,9,1,e_3,1712,1731,1835,9.0,4,2,6.0,2,2,3,19,104,123
p_33,0,14,e_0,1713,1758,1836,18.0,5,5,7.5,4,3,2,45,78,123
p_967,12,14,e_0,1756,1822,1836,28.0,5,5,0.5,4,7,1,66,14,80
p_350,4,6,e_2,1788,1810,1840,13.5,7,3,8.0,4,4,1,22,30,52
p_181,2,6,e_2,1778,1822,1840,13.0,6,2,10.0,1,4,1,44,18,62
p_802,10,0,e_3,1707,1737,1841,9.0,4,1,5.0,2,2,2,30,104,134
p_966,12,15,e_0,1811,1822,1842,17.5,5,4,10.0,5,5,1,11,20,31
p_1199,15,13,e_0,1807,1842,1852,21.0,4,4,9.0,5,5,0,35,10,45
p_349,4,9,e_2,1801,1810,1856,11.0,5,3,5.5,4,3,1,9,46,55
p_1061,13,11,e_0,1828,1830,1862,19.0,3,3,13.0,5,4,1,2,32,34
p_107,1,8,e_1,1768,1820,1862,14.5,4,1,11.0,4,5,1,52,42,94
p_965,12,13,e_2,1840,1870,1876,12.0,1,0,6.0,2,2,1,30,6,36
p_964,12,13,e_2,1842,1870,1876,12.0,1,1,6.0,5,1,2,28,6,34
p_1130,14,7,e_0,1816,1836,1882,20.5,4,4,11.0,2,5,1,20,46,66
p_32,0,9,e_3,1841,1842,1886,0.0,0,0,0.0,3,0,0,1,44,45
p_657,8,6,e_0,1817,1876,1888,26.0,4,4,11.0,5,4,1,59,12,71
p_1198,15,5,e_0,1827,1842,1894,17.0,3,3,13.0,2,4,1,15,52,67
p_1197,15,4,e_0,1837,1842,1900,15.5,1,1,14.0,5,5,1,5,58,63
p_1129,14,10,e_2,1848,1882,1900,13.5,1,0,7.0,5,2,1,34,18,52
p_864,11,10,e_3,1875,1896,1902,4.0,4,0,7.0,5,2,2,21,6,27
p_579,7,3,e_0,1869,1882,1906,5.5,4,2,9.5,4,5,1,13,24,37
p_963,12,9,e_2,1845,1870,1906,12.0,1,0,7.0,5,1,2,25,36,61
p_1062,13,2,e_0,1809,1828,1912,22.5,5,5,9.5,5,5,1,19,84,103
p_962,12,7,e_1,1873,1880,1912,5.5,4,0,10.5,5,1,1,7,32,39
p_1060,13,7,e_1,1855,1886,1912,10.5,1,0,7.0,5,1,1,31,26,57
p_581,7,6,e_1,1825,1856,1918,26.0,3,3,0.0,3,2,0,31,62,93
p_1059,13,6,e_1,1864,1886,1918,8.0,3,0,8.0,5,1,1,22,32,54
p_427,5,1,e_0,1888,1894,1918,8.0,4,1,6.0,1,6,1,6,24,30
p_347,4,1,e_0,1894,1900,1918,7.5,4,1,5.0,1,5,1,6,18,24
p_656,8,6,e_3,1857,1880,1920,7.0,2,1,3.0,5,1,1,23,40,63
p_658,8,0,e_0,1795,1800,1924,30.0,6,6,7.0,5,6,0,5,124,129
p_580,7,5,e_2,1832,1846,1924,24.5,2,2,4.0,5,2,0,14,78,92
p_799,10,3,e_3,1898,1902,1936,1.0,4,0,11.0,4,3,1,4,34,38
p_428,5,2,e_3,1857,1866,1942,10.0,1,1,3.0,5,1,0,9,76,85
p_274,3,5,e_2,1884,1934,1944,16.0,5,5,13.5,4,3,0,50,10,60
p_426,5,6,e_1,1896,1924,1948,16.0,3,3,11.0,4,2,0,28,24,52
p_348,4,0,e_3,1864,1930,1952,9.0,3,2,5.0,5,1,2,66,22,88
p_655,8,9,e_0,1950,1958,1964,8.0,1,0,6.5,5,2,0,8,6,14
p_272,3,10,e_2,1930,1934,1966,7.0,3,2,3.5,4,1,1,4,32,36
p_106,1,10,e_0,1883,1918,1970,14.5,5,5,7.0,4,6,0,35,52,87
p_273,3,12,e_1,1904,1934,1978,8.5,4,1,8.5,4,2,1,30,44,74
p_425,5,14,e_2,1914,1924,1984,8.5,4,3,7.5,4,1,1,10,60,70
p_31,0,15,e_0,1906,1924,1994,9.0,4,0,3.0,4,3,0,18,70,88
p_306,3,4,e_0,2,17,23,3.0,0,0,0.0,3,0,0,15,6,21
p_550,6,9,e_1,28,33,47,2.0,1,0,5.0,5,1,1,5,14,19
p_551,6,11,e_2,10,31,55,6.0,1,1,1.0,5,0,1,21,24,45
p_70,0,11,e_1,4,5,57,0.0,0,0,0.0,3,0,0,1,52,53
p_622,7,14,e_2,5,37,69,7.0,0,0,0.0,3,0,0,32,32,64
p_69,0,6,e_0,13,41,71,17.5,1,1,2.0,5,0,1,28,30,58
p_763,9,15,e_3,10,48,74,9.0,0,0,0.0,3,0,0,38,26,64
p_1239,15,12,e_3,67,74,88,1.5,2,0,13.5,5,1,1,7,14,21
p_549,6,10,e_0,51,71,89,26.5,1,1,1.5,5,2,1,20,18,38
p_1240,15,10,e_2,31,75,97,10.0,1,0,6.0,5,1,1,44,22,66
p_391,4,12,e_0,46,61,99,13.0,1,1,1.0,2,1,0,15,38,53
p_1014,12,13,e_0,71,99,105,27.5,2,2,6.0,5,4,1,28,6,34
p_1013,12,13,e_0,89,99,105,14.0,4,4,10.0,5,3,1,10,6,16
p_1015,12,7,e_1,53,63,105,8.0,1,1,10.5,5,1,1,10,42,52
p_762,9,7,e_1,91,95,105,2.0,4,0,9.5,4,3,0,4,10,14
p_463,5,4,e_1,99,115,121,5.0,4,2,8.5,4,3,0,16,6,22
p_1161,14,2,e_1,25,73,131,10.5,1,0,4.5,5,1,0,48,58,106
p_916,11,3,e_3,60,94,134,7.0,1,1,12.0,5,1,0,34,40,74
p_621,7,2,e_2,27,37,135,7.0,1,1,5.5,5,0,2,10,98,108
p_1160,14,1,e_1,56,73,137,5.0,1,1,11.0,2,1,2,17,64,81
p_687,8,6,e_0,125,129,139,24.0,4,4,9.0,4,3,2,4,10,14
p_141,1,0,e_1,104,137,143,8.0,4,4,7.0,1,3,1,33,6,39
p_689,8,5,e_0,108,129,145,27.0,4,4,12.5,4,2,1,21,16,37
p_915,11,4,e_0,109,115,151,24.0,4,4,12.0,4,2,2,6,36,42
p_688,8,4,e_0,124,129,151,24.0,3,3,9.0,4,3,2,5,22,27
p_460,5,7,e_3,141,144,154,1.0,4,0,4.5,5,3,1,3,10,13
p_223,2,4,e_2,92,135,155,9.5,4,0,11.0,4,2,0,43,20,63
p_547,6,3,e_0,59,71,157,12.5,1,1,3.5,5,2,3,12,86,98
p_389,4,2,e_0,131,151,163,26.5,5,5,8.0,4,5,1,20,12,32
p_465,5,10,e_3,79,124,170,9.0,2,0,14.0,4,1,1,45,46,91
p_761,9,10,e_3,159,164,170,1.0,4,0,8.0,5,4,0,5,6,11
p_222,2,8,e_2,112,135,173,5.0,4,0,6.5,4,1,1,23,38,61
p_144,1,0,e_0,40,47,175,9.5,1,1,0.0,3,0,0,7,128,135
p_548,6,0,e_0,55,71,175,13.5,1,1,2.5,5,2,2,16,104,120
p_461,5,12,e_3,129,144,180,3.0,4,1,4.0,4,4,0,15,36,51
p_142,1,9,e_1,73,137,183,16.0,1,1,14.0,2,1,0,64,46,110
p_464,5,11,e_2,97,119,187,9.5,4,1,10.0,1,2,0,22,68,90
p_390,4,11,e_2,113,125,187,5.0,4,1,6.0,4,1,1,12,62,74
p_139,1,3,e_0,166,169,189,21.5,4,4,1.5,4,2,1,3,20,23
p_690,8,14,e_3,83,108,190,11.0,3,1,13.0,4,1,2,25,82,107
p_462,5,14,e_3,120,124,190,4.5,4,1,5.5,4,3,1,4,66,70
p_140,1,12,e_2,124,141,193,4.0,3,0,4.0,1,2,0,17,52,69
p_546,6,15,e_3,88,118,196,8.0,3,1,12.0,4,0,3,30,78,108
p_620,7,15,e_3,149,154,196,1.0,5,0,6.0,5,5,0,5,42,47
p_1012,12,15,e_3,149,180,196,6.0,5,2,6.0,5,5,0,31,16,47
p_619,7,13,e_1,169,173,203,27.0,3,3,6.5,5,2,1,4,30,34
p_68,0,14,e_1,135,143,209,27.0,4,4,1.5,4,1,1,8,66,74
p_1159,14,15,e_2,199,205,211,26.5,6,6,13.0,2,1,1,6,6,12
p_305,3,8,e_0,58,157,215,22.0,1,1,3.5,5,2,2,99,58,157
p_143,1,9,e_0,53,169,221,21.0,1,1,2.5,5,2,1,116,52,168
p_618,7,9,e_0,189,209,221,23.0,1,1,3.0,5,2,0,20,12,32
p_1237,15,8,e_3,160,196,226,7.0,5,0,8.0,5,4,1,36,30,66
p_1094,13,12,e_2,146,199,227,12.0,5,2,2.0,5,4,1,53,28,81
p_1235,15,7,e_3,191,196,232,1.0,1,0,14.0,5,1,0,5,36,41
p_1095,13,10,e_2,144,199,237,12.0,5,2,1.5,5,4,0,55,38,93
p_686,8,13,e_0,194,215,239,23.5,1,1,4.0,5,2,1,21,24,45
p_829,10,7,e_1,120,189,241,22.5,4,4,4.0,1,3,0,69,52,121
p_1091,13,9,e_2,191,199,243,3.0,1,1,12.0,5,2,1,8,44,52
p_459,5,15,e_0,194,199,249,20.5,2,2,4.0,5,2,1,5,50,55
p_760,9,15,e_0,182,221,249,27.0,2,2,1.5,5,3,0,39,28,67
p_1236,15,3,e_3,170,196,252,5.0,3,0,10.0,2,4,0,26,56,82
p_1158,14,7,e_2,215,217,253,25.5,6,6,14.5,4,7,0,2,36,38
p_1010,12,5,e_1,215,219,253,27.5,6,6,13.0,4,1,0,4,34,38
p_1090,13,6,e_2,196,199,259,2.0,5,0,12.5,5,1,1,3,60,63
p_617,7,4,e_1,239,241,259,27.5,4,4,7.5,4,2,3,2,18,20
p_1232,15,13,e_0,237,249,259,20.0,4,4,13.0,5,2,0,12,10,22
p_1238,15,1,e_3,142,196,264,10.0,4,0,5.0,5,3,1,54,68,122
p_386,4,1,e_3,221,246,264,5.0,6,2,9.0,4,4,2,25,18,43
p_218,2,1,e_3,250,258,264,1.0,5,0,3.5,4,3,2,8,6,14
p_1234,15,5,e_2,197,211,265,29.0,5,5,12.5,5,1,1,14,54,68
p_219,2,0,e_3,243,258,270,2.0,4,1,4.5,4,2,2,15,12,27
p_914,11,3,e_2,141,187,275,14.5,4,2,1.0,5,4,0,46,88,134
p_1011,12,3,e_2,187,193,275,4.5,2,2,11.0,2,2,1,6,82,88
p_1093,13,3,e_2,177,199,275,5.5,3,2,8.5,5,2,1,22,76,98
p_1092,13,2,e_2,179,199,281,5.0,3,2,9.5,5,2,1,20,82,102
p_138,1,4,e_3,231,264,288,6.0,4,0,7.0,1,3,2,33,24,57
p_220,2,6,e_1,219,269,289,9.5,6,1,12.0,1,1,1,50,20,70
p_828,10,6,e_0,252,275,297,22.0,4,4,14.5,4,3,1,23,22,45
p_1233,15,5,e_0,228,249,303,22.0,5,5,10.5,5,2,0,21,54,75
p_221,2,7,e_3,199,258,304,14.5,5,1,14.5,4,4,1,59,46,105
p_913,11,4,e_0,250,269,309,21.0,5,5,15.0,4,3,0,19,40,59
p_685,8,4,e_0,265,287,309,23.0,5,5,12.0,4,2,3,22,22,44
p_615,7,8,e_3,299,304,310,1.0,3,0,6.0,5,3,0,5,6,11
p_545,6,10,e_1,237,247,311,10.0,4,4,7.5,4,2,2,10,64,74
p_387,4,10,e_1,219,259,311,11.5,6,3,12.0,1,1,0,40,52,92
p_1089,13,3,e_0,235,239,315,22.5,4,4,12.0,5,2,0,4,76,80
p_457,5,3,e_0,265,303,315,26.0,5,5,11.5,4,2,4,38,12,50
p_458,5,11,e_1,238,253,317,8.5,4,4,7.5,4,2,3,15,64,79
p_616,7,12,e_1,264,295,323,8.0,5,1,3.0,4,3,1,31,28,59
p_758,9,12,e_1,295,305,323,4.0,4,2,7.0,5,5,1,10,18,28
p_759,9,1,e_0,263,281,325,22.0,4,4,12.0,4,2,2,18,44,62
p_67,0,11,e_3,261,270,326,1.5,5,0,1.5,4,4,1,9,56,65
p_544,6,11,e_3,245,298,326,8.0,4,3,4.0,4,2,2,53,28,81
p_757,9,11,e_3,309,316,326,1.0,3,0,8.0,5,3,0,7,10,17
p_385,4,13,e_1,222,259,329,10.5,6,3,11.5,4,2,2,37,70,107
p_384,4,0,e_0,307,309,331,16.5,3,3,4.5,4,3,0,2,22,24
p_66,0,9,e_2,271,291,333,28.0,5,5,4.0,4,2,0,20,42,62
p_543,6,9,e_2,288,317,333,2.0,4,4,0.5,4,0,1,29,16,45
p_388,4,14,e_3,194,246,340,19.5,1,1,14.5,5,1,0,52,94,146
p_456,5,15,e_1,267,283,341,5.5,5,0,2.0,4,3,2,16,58,74
p_304,3,4,e_0,321,345,351,21.0,2,2,1.5,4,2,0,24,6,30
p_614,7,13,e_2,310,323,353,27.0,3,3,4.5,5,1,2,13,30,43
p_1088,13,11,e_1,277,329,361,13.5,5,1,3.5,5,4,2,52,32,84
p_383,4,7,e_0,324,351,367,21.0,2,2,1.0,1,2,2,27,16,43
p_455,5,7,e_0,334,357,367,20.5,2,2,0.5,5,0,3,23,10,33
p_912,11,9,e_1,273,317,371,16.5,5,1,2.5,5,4,2,44,54,98
p_1087,13,11,e_2,366,375,385,24.0,2,2,15.0,4,3,0,9,10,19
p_1231,15,10,e_2,342,365,391,26.5,1,1,11.0,2,1,1,23,26,49
p_613,7,14,e_0,321,367,397,25.0,2,2,1.5,4,2,1,46,30,76
p_827,10,1,e_3,348,358,398,2.0,1,0,12.5,4,0,1,10,40,50
p_217,2,1,e_3,325,392,398,15.0,2,1,11.0,5,2,0,67,6,73
p_1157,14,2,e_1,282,335,407,11.5,5,0,5.0,2,4,1,53,72,125
p_1155,14,2,e_1,343,347,407,27.5,1,1,15.0,4,3,0,4,60,64
p_63,0,1,e_3,388,406,412,2.5,4,0,2.5,4,1,3,18,6,24
p_1156,14,4,e_2,341,359,417,28.0,1,1,10.5,5,1,1,18,58,76
p_542,6,0,e_1,376,385,419,30.0,3,3,8.0,4,1,0,9,34,43
p_136,1,0,e_1,399,413,419,30.0,4,4,4.0,4,4,0,14,6,20
p_64,0,3,e_3,384,406,424,3.5,3,0,3.5,4,1,2,22,18,40
p_911,11,0,e_2,297,343,437,11.0,3,1,1.0,5,1,1,46,94,140
p_1086,13,0,e_2,369,375,437,23.5,2,2,14.0,4,3,1,6,62,68
p_826,10,0,e_2,386,391,437,23.5,3,3,11.0,4,3,0,5,46,51
p_215,2,0,e_2,419,427,437,20.0,4,4,4.0,4,1,0,8,10,18
p_453,5,4,e_0,423,439,445,16.0,4,4,8.5,4,2,0,16,6,22
p_65,0,9,e_3,375,406,452,6.0,2,0,6.0,4,1,1,31,46,77
p_62,0,9,e_3,397,406,452,1.0,3,0,1.0,1,1,3,9,46,55
p_216,2,9,e_3,411,418,452,1.0,5,0,1.0,5,4,1,7,34,41
p_454,5,9,e_1,377,391,457,10.5,3,3,8.0,4,1,1,14,66,80
p_756,9,1,e_0,405,421,459,21.0,3,3,12.5,4,0,1,16,38,54
p_452,5,1,e_0,425,439,459,20.0,5,5,8.5,4,2,1,14,20,34
p_137,1,11,e_3,398,400,462,2.0,3,1,1.0,4,0,3,2,62,64
p_825,10,0,e_0,392,415,465,22.0,3,3,13.0,5,1,0,23,50,73
p_303,3,12,e_3,410,424,468,2.0,5,0,1.0,5,4,1,14,44,58
p_684,8,12,e_3,420,446,468,6.0,4,1,2.0,5,3,1,26,22,48
p_135,1,6,e_2,441,448,472,24.0,6,6,0.0,3,0,1,7,24,31
p_1009,12,13,e_3,395,468,474,13.5,3,1,1.5,4,1,2,73,6,79
p_910,11,14,e_3,387,462,480,14.0,3,3,3.0,4,1,2,75,18,93
p_1008,12,14,e_1,416,471,481,10.0,5,3,0.5,4,3,0,55,10,65
p_1152,14,15,e_3,450,480,486,5.0,5,2,9.0,5,3,2,30,6,36
p_382,4,15,e_1,381,397,487,8.5,3,3,7.0,4,1,2,16,90,106
p_134,1,10,e_2,446,448,492,23.0,5,5,0.5,5,0,4,2,44,46
p_133,1,6,e_0,449,459,493,22.5,5,5,3.5,4,2,0,10,34,44
p_1151,14,13,e_1,468,481,497,4.0,4,1,11.5,5,2,1,13,16,29
p_302,3,7,e_0,471,479,499,20.5,4,4,1.0,5,1,0,8,20,28
p_381,4,13,e_2,444,462,508,26.5,6,6,0.0,5,0,2,18,46,64
p_380,4,13,e_2,445,462,508,26.0,5,5,0.5,5,0,4,17,46,63
p_824,10,13,e_2,463,492,508,29.0,4,4,4.0,5,3,2,29,16,45
p_1230,15,9,e_3,438,486,512,9.0,5,0,6.0,5,3,2,48,26,74
p_754,9,8,e_3,463,512,518,10.0,3,3,11.0,5,2,1,49,6,55
p_541,6,11,e_0,477,493,521,22.5,3,3,2.5,5,1,1,16,28,44
p_1154,14,7,e_3,425,480,524,11.0,4,0,3.0,5,3,1,55,44,99
p_612,7,12,e_0,495,499,527,16.0,4,2,6.0,5,2,1,4,28,32
p_753,9,12,e_0,500,511,527,17.0,4,3,7.0,5,2,1,11,16,27
p_908,11,13,e_0,517,521,533,19.0,4,4,10.5,5,4,0,4,12,16
p_752,9,15,e_0,508,511,543,14.5,4,3,8.5,5,3,1,3,32,35
p_1007,12,9,e_2,441,502,544,11.0,6,2,0.0,3,0,0,61,42,103
p_1153,14,3,e_3,427,480,544,10.5,5,0,3.5,5,3,2,53,64,117
p_755,9,2,e_1,455,457,549,11.5,4,4,9.0,5,2,1,2,92,94
p_1229,15,2,e_3,476,486,550,1.5,3,0,13.5,5,1,2,10,64,74
p_539,6,2,e_3,527,530,550,0.0,3,0,6.5,4,2,1,3,20,23
p_1228,15,8,e_2,502,518,550,24.0,4,4,12.0,2,2,0,16,32,48
p_683,8,4,e_2,444,482,572,14.5,6,5,0.0,5,0,3,38,90,128
p_750,9,8,e_0,557,569,575,21.5,3,3,12.0,4,3,0,12,6,18
p_61,0,4,e_1,509,559,577,9.5,4,0,10.0,4,1,2,50,18,68
p_378,4,2,e_2,562,572,584,25.5,5,5,5.5,4,2,3,10,12,22
p_451,5,6,e_1,492,533,589,14.5,4,2,14.0,4,2,1,41,56,97
p_60,0,8,e_3,512,560,594,9.0,3,0,9.0,1,4,0,48,34,82
p_682,8,2,e_0,482,505,601,7.5,4,1,3.5,5,2,0,23,96,119
p_379,4,9,e_1,533,539,605,9.5,3,3,5.0,1,2,1,6,66,72
p_1227,15,1,e_0,536,543,607,20.0,4,4,13.5,5,3,0,7,64,71
p_301,3,5,e_2,530,578,610,9.0,3,2,12.5,4,3,1,48,32,80
p_59,0,10,e_1,517,559,611,8.0,4,0,8.0,4,1,3,42,52,94
p_449,5,10,e_1,546,583,611,8.0,4,2,2.5,4,4,1,37,28,65
p_823,10,11,e_3,542,606,612,13.0,4,2,3.0,4,2,2,64,6,70
p_909,11,0,e_0,506,521,613,27.0,4,4,8.0,5,3,1,15,92,107
p_540,6,11,e_1,491,527,617,16.0,4,2,14.0,4,2,0,36,90,126
p_751,9,13,e_3,535,600,624,14.0,3,3,5.0,4,2,1,65,24,89
p_132,1,9,e_2,572,590,628,28.0,5,5,4.0,4,3,1,18,38,56
p_377,4,9,e_2,590,604,628,27.0,5,5,1.0,5,5,0,14,24,38
p_906,11,14,e_3,561,612,630,11.0,4,3,0.0,5,1,3,51,18,69
p_131,1,3,e_0,619,622,632,19.0,4,4,0.5,5,0,1,3,10,13
p_1150,14,13,e_1,580,633,639,11.0,5,1,4.5,5,4,1,53,6,59
p_450,5,11,e_2,544,566,640,8.0,4,2,9.0,4,2,2,22,74,96
p_1085,13,12,e_1,601,627,645,8.0,5,1,8.0,5,4,1,26,18,44
p_907,11,12,e_2,560,640,646,11.0,4,3,6.0,4,2,2,80,6,86
p_300,3,13,e_2,566,578,652,2.0,5,0,5.0,4,3,1,12,74,86
p_299,3,13,e_2,575,578,652,29.5,5,5,3.5,4,3,2,3,74,77
p_611,7,14,e_2,530,556,658,13.0,3,3,12.5,4,3,0,26,102,128
p_749,9,14,e_2,607,628,658,29.0,4,4,4.5,5,5,0,21,30,51
p_822,10,14,e_2,629,634,658,26.0,2,2,9.0,5,3,0,5,24,29
p_1084,13,9,e_1,604,627,661,7.0,5,1,9.0,2,4,2,23,34,57
p_538,6,5,e_0,640,646,662,8.0,3,2,5.0,5,1,2,6,16,22
p_609,7,3,e_0,615,652,672,11.5,4,4,0.0,3,0,0,37,20,57
p_1006,12,7,e_3,599,618,672,9.0,3,1,9.0,2,0,3,19,54,73
p_904,11,6,e_1,589,617,675,12.0,5,1,6.0,2,4,1,28,58,86
p_1004,12,6,e_3,630,650,678,4.0,3,1,14.0,2,2,2,20,28,48
p_536,6,5,e_1,670,675,681,1.0,4,0,7.0,4,3,0,5,6,11
p_1149,14,15,e_2,676,676,684,18.0,3,2,14.0,3,0,0,0,8,8
p_298,3,0,e_0,623,632,688,14.0,4,2,1.0,5,1,1,9,56,65
p_1226,15,4,e_3,559,636,688,15.0,2,2,0.0,3,0,2,77,52,129
p_1005,12,4,e_3,629,650,688,4.0,2,1,14.0,2,2,1,21,38,59
p_905,11,3,e_1,575,617,691,15.5,5,1,4.0,5,5,1,42,74,116
p_610,7,2,e_1,593,595,697,15.0,4,4,6.5,5,3,1,2,102,104
p_903,11,2,e_1,620,651,697,6.5,4,3,11.5,5,3,2,31,46,77
p_128,1,4,e_0,677,682,706,5.0,2,0,2.0,4,1,1,5,24,29
p_56,0,6,e_0,675,688,716,6.5,3,0,2.5,4,1,1,13,28,41
p_1225,15,7,e_2,684,685,723,18.5,2,2,15.0,3,0,1,1,38,39
p_1003,12,7,e_2,684,701,723,22.0,2,2,15.0,3,0,0,17,22,39
p_297,3,9,e_1,699,703,729,4.5,2,1,2.5,5,1,1,4,26,30
p_608,7,10,e_0,677,722,736,11.0,2,2,2.0,4,1,1,45,14,59
p_607,7,3,e_2,692,723,743,25.5,1,1,14.0,4,1,1,31,20,51
p_376,4,3,e_2,700,737,743,27.5,2,2,12.0,4,1,1,37,6,43
p_448,5,7,e_3,719,732,744,3.0,3,0,2.0,5,3,0,13,12,25
p_901,11,12,e_1,694,739,745,12.0,1,1,2.5,4,2,0,45,6,51
p_58,0,12,e_0,625,688,748,17.0,3,3,1.5,5,1,1,63,60,123
p_1001,12,13,e_1,712,745,751,12.0,3,1,5.0,5,2,1,33,6,39
p_57,0,13,e_0,631,688,754,16.0,3,3,3.0,2,1,3,57,66,123
p_375,4,1,e_2,730,737,755,19.5,5,5,5.5,4,1,4,7,18,25
p_213,2,1,e_2,728,749,755,22.0,4,4,6.0,4,1,3,21,6,27
p_535,6,10,e_3,729,738,760,2.0,4,1,4.5,5,3,1,9,22,31
p_902,11,14,e_0,686,742,760,13.0,2,1,0.0,4,3,1,56,18,74
p_126,1,0,e_2,719,755,761,25.0,3,3,7.5,4,1,3,36,6,42
p_537,6,15,e_1,648,675,761,16.5,4,2,11.5,4,4,1,27,86,113
p_130,1,15,e_0,627,682,766,17.5,3,3,2.0,5,1,2,55,84,139
p_214,2,11,e_3,705,718,766,2.5,2,0,0.5,4,1,1,13,48,61
p_681,8,11,e_3,732,750,766,3.0,5,2,5.0,5,4,1,18,16,34
p_55,0,12,e_3,695,708,772,2.5,1,0,2.5,4,0,1,13,64,77
p_211,2,3,e_2,751,771,777,22.0,4,4,2.0,4,1,2,20,6,26
p_129,1,14,e_3,641,702,782,13.0,3,0,14.0,4,2,1,61,80,141
p_1219,15,14,e_3,786,788,794,0.5,2,0,14.5,5,1,1,2,6,8
p_900,11,7,e_1,751,779,799,9.0,4,2,13.0,5,3,1,28,20,48
p_54,0,8,e_2,709,761,801,28.0,3,3,10.5,4,1,1,52,40,92
p_210,2,8,e_2,769,771,801,18.5,2,2,1.5,5,3,2,2,30,32
p_606,7,8,e_2,748,795,801,27.5,5,5,2.0,1,1,1,47,6,53
p_604,7,8,e_2,783,795,801,23.0,2,2,4.0,5,3,1,12,6,18
p_998,12,8,e_0,759,780,804,6.0,4,1,14.0,2,4,0,21,24,45
p_820,10,8,e_0,765,792,804,7.0,3,2,15.0,5,3,1,27,12,39
p_748,9,8,e_0,767,798,804,8.0,2,2,15.0,4,2,2,31,6,37
p_899,11,5,e_1,771,779,809,5.0,2,1,13.0,4,4,2,8,30,38
p_821,10,5,e_1,754,785,809,9.0,4,3,13.5,5,3,2,31,24,55
p_819,10,5,e_1,770,785,809,6.0,2,1,13.0,4,4,2,15,24,39
p_1000,12,3,e_1,716,745,819,14.0,3,1,6.0,5,2,2,29,74,103
p_446,5,3,e_1,789,809,819,10.0,4,2,9.0,4,6,0,20,10,30
p_53,0,12,e_2,741,761,819,21.5,6,6,3.5,4,2,2,20,58,78
p_605,7,12,e_2,773,795,819,23.0,2,2,2.0,5,4,1,22,24,46
p_1221,15,9,e_3,773,788,820,3.0,2,0,12.0,5,2,0,15,32,47
p_1222,15,2,e_1,749,761,825,7.0,4,0,13.0,5,4,0,12,64,76
p_1081,13,3,e_0,753,754,828,6.5,4,1,13.0,5,3,0,1,74,75
p_898,11,3,e_0,783,786,828,5.0,2,1,11.5,4,3,2,3,42,45
p_897,11,7,e_3,791,808,830,3.0,4,0,14.5,4,4,0,17,22,39
p_747,9,7,e_3,800,820,830,3.0,4,1,12.5,4,3,1,20,10,30
p_127,1,14,e_2,718,755,831,27.0,3,3,8.0,4,1,2,37,76,113
p_999,12,1,e_1,739,745,831,10.0,6,1,11.0,2,1,2,6,86,92
p_1082,13,1,e_1,735,751,831,9.5,6,1,10.0,5,1,2,16,80,96
p_1224,15,1,e_1,717,761,831,13.0,3,0,6.5,5,2,2,44,70,114
p_212,2,1,e_1,750,825,831,18.0,4,4,13.0,2,4,0,75,6,81
p_1083,13,2,e_0,721,754,834,12.5,4,1,7.0,2,3,1,33,80,113
p_1223,15,0,e_1,718,761,837,13.0,3,0,6.5,5,2,2,43,76,119
p_1220,15,5,e_3,781,788,840,1.0,3,0,14.0,5,2,1,7,52,59
p_818,10,4,e_3,809,814,846,1.0,4,0,11.0,4,4,0,5,32,37
p_52,0,3,e_1,812,837,851,10.5,5,0,4.5,4,4,0,25,14,39
p_1002,12,3,e_3,708,772,852,12.0,2,2,0.0,3,1,1,64,80,144
p_997,12,7,e_2,809,819,863,26.0,4,4,9.5,5,2,1,10,44,54
p_1080,13,6,e_2,808,825,869,25.0,3,3,9.5,5,2,0,17,44,61
p_209,2,10,e_0,770,834,878,18.0,2,2,14.0,4,2,3,64,44,108
p_125,1,10,e_0,794,840,878,13.0,4,0,9.5,4,3,2,46,38,84
p_533,6,3,e_2,859,869,883,25.5,4,4,8.0,4,3,0,10,14,24
p_123,1,11,e_0,802,840,884,11.5,4,0,8.0,4,3,2,38,44,82
p_122,1,3,e_3,855,862,884,3.5,3,1,2.5,4,2,1,7,22,29
p_816,10,2,e_2,828,849,889,24.0,4,4,13.5,5,3,0,21,40,61
p_447,5,13,e_0,785,818,894,20.5,2,2,11.0,1,3,2,33,76,109
p_374,4,5,e_3,815,846,894,8.0,5,1,10.0,4,5,0,31,48,79
p_534,6,1,e_2,837,869,895,26.5,3,3,13.0,4,2,1,32,26,58
p_208,2,14,e_0,801,834,900,10.5,4,0,8.5,4,3,2,33,66,99
p_817,10,14,e_0,810,878,900,14.5,5,4,7.0,4,2,2,68,22,90
p_124,1,15,e_0,800,840,906,12.0,4,0,9.0,4,3,2,40,66,106
p_206,2,3,e_2,891,901,907,27.5,5,5,2.0,4,1,0,10,6,16
p_532,6,8,e_3,864,900,910,6.5,5,0,0.5,4,3,2,36,10,46
p_51,0,9,e_3,843,868,916,4.5,3,0,4.5,4,3,0,25,48,73
p_1218,15,13,e_1,832,907,917,19.0,3,3,1.0,4,1,0,75,10,85
p_121,1,5,e_2,873,895,919,24.0,6,6,5.0,4,3,0,22,24,46
p_531,6,11,e_3,873,900,926,5.0,6,3,1.0,5,4,2,27,26,53
p_445,5,12,e_3,790,840,932,13.5,4,1,14.5,4,4,0,50,92,142
p_896,11,9,e_0,881,884,936,16.5,6,2,10.5,5,4,0,3,52,55
p_1079,13,8,e_0,905,916,942,10.0,5,1,15.0,5,3,2,11,26,37
p_996,12,7,e_1,865,891,945,18.5,6,6,6.5,5,0,3,26,54,80
p_1148,14,7,e_1,842,901,945,18.0,3,3,1.0,5,1,1,59,44,103
p_207,2,15,e_3,861,878,946,3.0,3,1,1.0,1,2,1,17,68,85
p_994,12,15,e_3,913,932,946,4.0,4,2,8.5,5,4,0,19,14,33
p_678,8,6,e_1,912,939,951,14.0,4,4,14.0,4,4,0,27,12,39
p_746,9,11,e_2,916,941,951,30.0,3,3,4.5,5,2,3,25,10,35
p_602,7,5,e_1,890,945,957,18.5,5,3,12.0,2,1,2,55,12,67
p_530,6,5,e_0,929,952,958,12.5,2,2,10.5,4,3,1,23,6,29
p_679,8,13,e_2,910,935,963,30.0,4,4,3.5,5,1,3,25,28,53
p_1147,14,4,e_0,871,900,964,13.5,6,0,8.5,5,5,0,29,64,93
p_895,11,4,e_0,896,926,964,14.0,4,2,13.5,5,3,1,30,38,68
p_995,12,3,e_1,888,891,967,14.5,5,1,11.5,5,1,3,3,76,79
p_1217,15,3,e_1,847,907,967,19.0,4,4,2.5,5,1,2,60,60,120
p_603,7,2,e_1,862,869,973,24.0,5,5,5.5,5,0,2,7,104,111
p_372,4,2,e_0,924,964,976,15.5,3,3,11.0,4,3,1,40,12,52
p_680,8,1,e_0,885,942,982,19.0,5,3,11.0,5,4,0,57,40,97
p_444,5,1,e_0,941,958,982,11.0,2,1,8.0,4,2,2,17,24,41
p_1216,15,7,e_3,908,946,984,7.5,5,0,7.5,5,5,0,38,38,76
p_992,12,6,e_3,951,960,990,2.0,3,0,14.0,4,1,2,9,30,39
p_745,9,6,e_3,939,974,990,7.5,1,1,13.5,5,1,0,35,16,51
p_600,7,6,e_2,916,929,997,14.0,3,3,4.5,5,2,3,13,68,81
p_993,12,6,e_2,929,957,997,6.5,2,1,7.0,2,1,3,28,40,68
p_202,2,3,e_1,983,993,999,5.0,2,0,0.0,5,4,0,10,6,16
p_205,2,4,e_1,929,973,1005,20.5,2,2,10.0,4,3,1,44,32,76
p_201,2,4,e_0,993,998,1008,3.5,2,0,1.0,5,3,0,5,10,15
p_529,6,2,e_3,951,990,1010,8.0,2,2,14.0,4,1,1,39,20,59
p_528,6,2,e_3,967,990,1010,4.0,3,2,10.5,4,2,1,23,20,43
p_601,7,3,e_2,908,929,1011,15.0,5,4,3.0,5,1,2,21,82,103
p_744,9,3,e_2,974,981,1011,24.0,2,2,10.5,4,3,1,7,30,37
p_677,8,3,e_2,979,987,1011,24.0,2,2,9.5,4,3,2,8,24,32
p_373,4,2,e_2,903,913,1017,19.5,5,5,2.0,5,2,0,10,104,114
p_119,1,7,e_0,925,982,1022,20.0,3,3,11.0,1,3,0,57,40,97
p_599,7,8,e_0,990,1022,1028,9.0,2,2,0.5,5,3,0,32,6,38
p_204,2,9,e_1,937,973,1029,19.0,1,1,8.0,4,3,1,36,56,92
p_120,1,3,e_2,906,1023,1033,23.5,5,5,3.0,2,2,1,117,10,127
p_48,0,3,e_3,998,1020,1034,5.0,2,0,5.0,4,2,0,22,14,36
p_49,0,10,e_0,980,988,1038,8.0,2,0,1.5,4,2,0,8,50,58
p_295,3,4,e_2,1019,1033,1039,3.0,1,1,1.5,4,0,1,14,6,20
p_203,2,12,e_1,941,973,1045,18.0,2,2,8.0,4,4,0,32,72,104
p_894,11,12,e_0,1027,1044,1050,10.0,2,2,8.0,2,3,0,17,6,23
p_50,0,13,e_1,951,983,1051,14.0,3,0,6.0,1,4,0,32,68,100
p_676,8,13,e_0,1021,1028,1056,8.0,2,1,7.0,5,3,0,7,28,35
p_990,12,14,e_1,1031,1045,1057,10.0,2,2,9.5,5,3,1,14,12,26
p_296,3,14,e_0,963,970,1062,8.5,3,0,4.0,1,2,0,7,92,99
p_814,10,14,e_0,993,1038,1062,11.5,2,1,1.0,5,3,1,45,24,69
p_1076,13,14,e_0,1040,1056,1062,9.0,2,2,10.0,5,2,1,16,6,22
p_597,7,8,e_2,1050,1059,1065,24.0,2,2,5.5,5,2,3,9,6,15
p_443,5,10,e_3,982,996,1066,2.0,2,0,7.0,4,2,0,14,70,84
p_675,8,11,e_3,1052,1056,1072,1.0,2,0,7.5,5,2,0,4,16,20
p_442,5,10,e_2,1021,1047,1075,5.0,2,1,1.5,4,0,2,26,28,54
p_1146,14,11,e_0,1042,1062,1076,9.0,2,0,11.0,5,2,1,20,14,34
p_294,3,12,e_3,1027,1034,1078,2.0,2,0,1.5,5,2,0,7,44,51
p_815,10,9,e_1,985,1035,1081,22.0,2,2,0.0,5,4,1,50,46,96
p_893,11,9,e_1,1040,1071,1081,9.0,2,1,11.0,5,5,0,31,10,41
p_813,10,7,e_1,997,1035,1091,23.0,2,2,2.5,5,5,1,38,56,94
p_812,10,7,e_1,1015,1035,1091,21.0,2,2,6.0,5,3,1,20,56,76
p_991,12,7,e_1,992,1045,1091,22.0,2,2,2.0,5,4,2,53,46,99
p_1215,15,14,e_3,1062,1094,1100,5.5,3,0,9.5,5,3,0,32,6,38
p_1078,13,5,e_1,1013,1051,1101,18.5,2,2,5.5,5,3,1,38,50,88
p_674,8,6,e_0,1090,1094,1104,8.0,5,1,9.0,4,1,3,4,10,14
p_892,11,5,e_2,1041,1081,1107,8.5,2,1,4.0,5,1,3,40,26,66
p_598,7,4,e_1,1017,1019,1107,23.5,2,2,6.5,5,3,1,2,88,90
p_891,11,4,e_2,1077,1081,1113,7.0,1,1,10.5,5,2,2,4,32,36
p_527,6,3,e_2,1025,1053,1119,13.0,2,1,1.5,5,1,1,28,66,94
p_811,10,3,e_0,1068,1082,1122,10.0,3,3,13.0,4,1,2,14,40,54
p_743,9,3,e_0,1060,1088,1122,6.5,3,3,13.5,5,1,1,28,34,62
p_441,5,3,e_0,1071,1110,1122,14.0,3,2,12.0,4,1,3,39,12,51
p_370,4,3,e_0,1085,1116,1122,12.5,3,2,9.5,4,1,3,31,6,37
p_1145,14,9,e_3,1081,1088,1126,3.5,2,1,12.5,5,1,1,7,38,45
p_1214,15,9,e_3,1069,1094,1126,4.5,3,0,10.5,5,2,1,25,32,57
p_890,11,9,e_3,1090,1116,1126,5.0,4,1,14.0,5,3,1,26,10,36
p_1077,13,1,e_1,1027,1051,1127,11.5,2,0,8.5,5,4,1,24,76,100
p_293,3,2,e_0,1051,1122,1128,14.0,2,2,12.0,5,2,0,71,6,77
p_371,4,1,e_2,1039,1041,1129,16.0,2,2,4.0,5,0,2,2,88,90
p_889,11,7,e_3,1100,1116,1136,3.0,4,0,14.0,1,4,1,16,20,36
p_289,3,0,e_0,1114,1122,1138,8.0,4,2,4.0,4,1,2,8,16,24
p_45,0,2,e_2,1111,1135,1145,12.0,4,0,4.0,4,3,1,24,10,34
p_292,3,5,e_1,1059,1115,1147,18.5,3,3,13.5,4,5,1,56,32,88
p_291,3,5,e_1,1084,1115,1147,19.5,3,3,8.5,4,4,2,31,32,63
p_1144,14,4,e_3,1082,1088,1150,3.0,3,1,13.0,5,1,2,6,62,68
p_988,12,4,e_3,1101,1110,1150,2.0,4,0,14.0,4,3,1,9,40,49
p_595,7,4,e_3,1118,1136,1150,3.0,4,1,10.5,4,4,0,18,14,32
p_198,2,3,e_0,1139,1148,1154,8.5,2,1,0.0,5,1,2,9,6,15
p_43,0,4,e_2,1127,1135,1155,9.0,3,0,1.0,4,1,2,8,20,28
p_368,4,7,e_1,1113,1141,1157,15.5,4,1,3.0,4,2,4,28,16,44
p_594,7,8,e_1,1123,1157,1163,16.5,4,2,1.5,4,5,4,34,6,40
p_989,12,0,e_3,1049,1078,1172,5.5,2,0,6.5,5,2,0,29,94,123
p_199,2,7,e_0,1115,1128,1174,13.0,3,1,4.0,4,1,2,13,46,59
p_46,0,7,e_0,1074,1138,1174,18.5,2,2,11.5,4,1,4,64,36,100
p_596,7,10,e_1,1113,1157,1175,18.5,4,2,3.0,4,2,5,44,18,62
p_200,2,11,e_1,1061,1121,1181,17.0,3,3,13.0,4,5,2,60,60,120
p_741,9,10,e_2,1119,1179,1185,19.5,4,3,3.0,4,1,1,60,6,66
p_42,0,3,e_3,1146,1172,1186,4.5,2,0,4.5,4,2,0,26,14,40
p_290,3,13,e_1,1108,1115,1191,15.0,5,1,4.0,4,2,4,7,76,83
p_673,8,13,e_1,1105,1163,1191,21.0,5,2,4.0,4,2,2,58,28,86
p_44,0,11,e_2,1113,1135,1191,11.5,4,0,4.0,4,2,1,22,56,78
p_526,6,11,e_2,1127,1165,1191,15.0,3,2,1.0,4,1,2,38,26,64
p_739,9,11,e_2,1131,1179,1191,17.0,3,3,0.5,4,0,3,48,12,60
p_742,9,14,e_1,1110,1169,1197,21.0,4,2,4.0,4,2,3,59,28,87
p_288,3,5,e_3,1157,1186,1198,5.5,3,2,2.5,4,1,2,29,12,41
p_369,4,15,e_1,1107,1107,1203,16.5,5,1,4.0,1,2,3,0,96,96
p_47,0,14,e_2,1040,1135,1205,20.0,2,2,4.0,3,0,2,95,70,165
p_524,6,7,e_3,1201,1204,1210,1.0,4,0,5.5,5,3,1,3,6,9
p_738,9,14,e_0,1137,1186,1210,16.0,2,2,0.0,3,2,1,49,24,73
p_810,10,14,e_0,1123,1192,1210,19.5,4,3,3.0,4,2,0,69,18,87
p_737,9,15,e_2,1168,1179,1211,9.5,5,0,6.5,5,2,1,11,32,43
p_671,8,10,e_3,1182,1216,1228,6.0,4,2,2.5,5,3,1,34,12,46
p_1141,14,10,e_0,1204,1210,1230,10.0,5,1,13.0,5,3,0,6,20,26
p_367,4,12,e_3,1159,1192,1240,6.0,3,2,2.0,1,1,2,33,48,81
p_1213,15,7,e_1,1176,1203,1241,14.0,4,0,10.0,5,4,0,27,38,65
p_591,7,6,e_1,1225,1241,1247,13.5,5,5,10.5,4,2,3,16,6,22
p_736,9,13,e_3,1220,1222,1248,1.0,4,0,8.5,5,4,0,2,26,28
p_1143,14,6,e_0,1200,1210,1250,10.5,4,1,12.0,5,3,0,10,40,50
p_670,8,6,e_0,1207,1240,1250,15.5,5,3,13.5,5,3,0,33,10,43
p_740,9,6,e_2,1126,1179,1251,30.0,3,3,1.5,4,1,2,53,72,125
p_197,2,14,e_3,1151,1160,1254,6.0,1,1,4.0,4,1,0,9,94,103
p_525,6,5,e_0,1143,1168,1256,29.5,2,2,1.0,5,1,3,25,88,113
p_672,8,4,e_0,1170,1180,1262,22.5,5,5,6.0,5,2,2,10,82,92
p_118,1,15,e_3,1153,1166,1262,4.5,2,1,3.5,4,1,1,13,96,109
p_593,7,4,e_2,1212,1245,1263,15.5,4,4,15.0,4,1,0,33,18,51
p_1142,14,3,e_1,1201,1209,1263,10.5,5,1,15.0,5,1,2,8,54,62
p_287,3,2,e_1,1238,1263,1269,15.0,6,3,7.5,4,3,1,25,6,31
p_888,11,2,e_0,1219,1224,1272,10.5,4,3,12.0,4,4,1,5,48,53
p_440,5,2,e_0,1208,1256,1272,18.0,5,4,14.0,5,3,1,48,16,64
p_809,10,1,e_1,1193,1227,1275,16.0,5,3,13.5,5,2,0,34,48,82
p_196,2,3,e_2,1219,1273,1279,23.5,4,4,13.0,4,1,2,54,6,60
p_1212,15,10,e_3,1254,1262,1288,1.0,5,0,14.0,2,5,0,8,26,34
p_364,4,6,e_0,1256,1262,1290,20.0,6,6,5.0,4,3,0,6,28,34
p_886,11,9,e_3,1230,1234,1294,9.0,5,4,10.0,5,4,1,4,60,64
p_987,12,9,e_3,1240,1240,1294,6.0,5,3,12.0,2,6,0,0,54,54
p_887,11,8,e_3,1229,1234,1300,9.0,4,4,10.0,5,4,0,5,66,71
p_523,6,8,e_2,1212,1251,1301,28.5,4,4,15.0,4,1,1,39,50,89
p_520,6,9,e_0,1280,1290,1306,15.0,8,4,4.0,5,3,1,10,16,26
p_734,9,6,e_3,1283,1294,1310,2.0,8,1,11.0,4,8,0,11,16,27
p_195,2,10,e_0,1256,1272,1312,18.0,6,6,5.0,1,4,0,16,40,56
p_590,7,10,e_0,1274,1296,1312,15.5,8,3,2.0,5,3,0,22,16,38
p_117,1,7,e_1,1204,1275,1315,25.0,4,4,15.0,4,1,3,71,40,111
p_885,11,5,e_3,1264,1282,1316,3.0,6,0,14.5,4,6,0,18,34,52
p_522,6,11,e_0,1221,1250,1318,27.0,5,5,11.5,4,4,2,29,68,97
p_365,4,11,e_0,1241,1262,1318,22.0,5,5,8.0,4,4,0,21,56,77
p_1075,13,4,e_3,1226,1248,1322,7.0,5,2,10.0,5,5,0,22,74,96
p_807,10,4,e_3,1265,1288,1322,4.0,7,1,14.5,4,6,1,23,34,57
p_521,6,12,e_0,1274,1290,1324,14.5,8,3,2.0,5,3,0,16,34,50
p_366,4,9,e_1,1197,1257,1327,29.0,4,4,14.0,5,1,1,60,70,130
p_592,7,13,e_2,1216,1245,1327,29.0,4,4,14.0,4,1,2,29,82,111
p_1140,14,3,e_3,1215,1254,1332,8.0,3,1,8.0,2,3,0,39,78,117
p_808,10,14,e_2,1232,1311,1333,29.0,5,5,10.0,4,1,3,79,22,101
p_115,1,10,e_1,1282,1287,1333,10.0,8,0,0.0,5,4,0,5,46,51
p_668,8,10,e_1,1315,1321,1333,11.0,5,4,7.0,2,5,0,6,12,18
p_439,5,15,e_2,1213,1257,1339,27.5,4,4,15.0,4,1,1,44,82,126
p_883,11,15,e_2,1284,1317,1339,20.0,8,8,4.0,5,3,1,33,22,55
p_1072,13,15,e_2,1317,1327,1339,18.0,6,5,11.0,5,3,1,10,12,22
p_1139,14,2,e_3,1253,1254,1340,2.0,4,1,14.0,2,5,0,1,86,87
p_735,9,2,e_3,1249,1294,1340,8.0,5,2,13.0,5,5,0,45,46,91
p_41,0,12,e_1,1269,1281,1343,13.5,7,0,2.0,1,3,0,12,62,74
p_363,4,12,e_1,1296,1301,1343,11.0,7,3,3.0,5,5,0,5,42,47
p_986,12,1,e_3,1274,1276,1346,0.0,7,0,12.5,4,6,1,2,70,72
p_116,1,14,e_1,1237,1275,1353,19.5,6,6,7.5,4,3,1,38,78,116
p_1073,13,9,e_0,1313,1330,1366,21.5,5,5,10.0,5,2,2,17,36,53
p_40,0,4,e_3,1317,1352,1374,5.0,5,0,5.0,4,4,1,35,22,57
p_284,3,5,e_3,1333,1334,1380,6.0,8,3,3.0,4,6,2,1,46,47
p_985,12,6,e_0,1315,1324,1380,22.0,4,4,10.5,5,2,2,9,56,65
p_1211,15,6,e_0,1294,1340,1380,23.0,7,7,7.0,5,4,1,46,40,86
p_1210,15,11,e_1,1344,1361,1381,16.0,9,9,12.0,5,1,0,17,20,37
p_667,8,5,e_2,1330,1369,1385,25.0,7,7,13.5,5,2,1,39,16,55
p_1138,14,10,e_1,1354,1355,1387,16.0,9,1,14.0,5,0,1,1,32,33
p_437,5,7,e_3,1367,1380,1390,3.0,9,1,2.5,5,8,1,13,10,23
p_519,6,4,e_0,1367,1380,1390,21.5,9,7,9.0,4,3,0,13,10,23
p_285,3,8,e_3,1314,1332,1396,6.5,5,2,5.5,4,5,0,18,64,82
p_884,11,2,e_0,1283,1318,1400,29.0,8,8,4.5,5,3,1,35,82,117
p_882,11,2,e_0,1285,1318,1400,28.5,8,8,5.0,5,3,1,33,82,115
p_362,4,9,e_3,1322,1322,1402,8.0,5,4,4.0,1,4,2,0,80,80
p_666,8,2,e_2,1362,1369,1403,20.0,10,5,9.5,4,0,3,7,34,41
p_588,7,2,e_2,1366,1375,1403,20.5,9,6,8.5,4,0,3,9,28,37
p_281,3,2,e_2,1394,1397,1403,19.5,7,7,3.5,4,3,1,3,6,9
p_1071,13,7,e_1,1358,1371,1403,16.0,9,2,14.5,5,1,1,13,32,45
p_664,8,10,e_3,1378,1396,1408,4.0,8,2,4.5,5,7,1,18,12,30
p_669,8,1,e_2,1309,1369,1409,27.0,5,5,10.0,5,2,2,60,40,100
p_1074,13,0,e_0,1312,1330,1410,21.5,5,5,10.0,5,2,1,18,80,98
p_589,7,11,e_3,1317,1390,1414,10.0,4,4,5.0,4,4,0,73,24,97
p_193,2,0,e_2,1344,1403,1415,29.0,9,9,14.0,4,0,2,59,12,71
p_665,8,4,e_1,1377,1397,1419,17.5,8,5,12.0,4,3,1,20,22,42
p_518,6,4,e_1,1380,1409,1419,19.0,7,7,11.0,4,3,2,29,10,39
p_286,3,12,e_3,1312,1332,1420,6.5,5,2,5.5,4,5,0,20,88,108
p_114,1,13,e_3,1352,1358,1426,1.0,8,0,0.0,5,7,1,6,68,74
p_982,12,13,e_3,1412,1420,1426,2.0,6,1,10.5,5,5,1,8,6,14
p_283,3,4,e_1,1372,1425,1431,29.0,9,9,13.0,4,3,0,53,6,59
p_361,4,14,e_3,1325,1326,1432,8.0,6,4,4.0,4,4,2,1,106,107
p_192,2,14,e_3,1354,1364,1432,2.0,9,1,0.0,5,7,2,10,68,78
p_282,3,4,e_2,1380,1397,1433,28.0,7,7,6.0,4,3,1,17,36,53
p_194,2,15,e_3,1333,1340,1438,5.0,8,2,3.0,1,6,2,7,98,105
p_438,5,15,e_3,1334,1380,1438,8.0,9,3,3.0,4,7,2,46,58,104
p_984,12,15,e_3,1353,1420,1438,12.0,9,6,0.0,5,7,2,67,18,85
p_360,4,5,e_2,1342,1391,1439,5.5,9,1,14.5,4,0,1,49,48,97
p_191,2,8,e_0,1419,1425,1451,20.0,6,6,1.0,5,0,1,6,26,32
p_436,5,8,e_1,1429,1437,1453,21.5,8,8,3.5,5,1,1,8,16,24
p_113,1,10,e_2,1401,1409,1461,22.0,6,6,2.5,4,4,0,8,52,60
p_1070,13,10,e_3,1403,1426,1462,8.0,6,2,9.0,5,6,0,23,36,59
p_1209,15,9,e_3,1363,1438,1468,13.0,10,0,2.0,5,8,2,75,30,105
p_1207,15,9,e_3,1414,1438,1468,4.0,5,0,11.0,2,5,1,24,30,54
p_1068,13,9,e_3,1440,1448,1468,2.0,8,0,15.0,4,7,1,8,20,28
p_806,10,13,e_2,1447,1461,1477,23.0,9,7,7.0,5,1,2,14,16,30
p_880,11,6,e_3,1386,1414,1484,12.5,8,4,6.5,5,7,1,28,70,98
p_517,6,15,e_1,1419,1443,1485,24.0,6,6,4.0,4,0,1,24,42,66
p_1206,15,4,e_3,1434,1438,1496,1.0,7,0,14.0,5,6,1,4,58,62
p_733,9,8,e_2,1477,1495,1501,28.5,7,7,13.0,4,2,1,18,6,24
p_1205,15,11,e_1,1457,1485,1507,26.0,8,8,8.5,5,1,1,28,22,50
p_1069,13,2,e_3,1422,1426,1508,5.0,7,2,12.0,5,6,1,4,82,86
p_434,5,2,e_3,1477,1490,1508,2.0,6,1,7.5,4,5,1,13,18,31
p_879,11,6,e_0,1414,1465,1513,8.0,5,4,0.0,3,0,0,51,48,99
p_881,11,1,e_3,1383,1414,1514,13.5,7,4,5.5,5,7,0,31,100,131
p_1208,15,1,e_3,1370,1438,1514,11.5,9,0,3.5,5,8,1,68,76,144
p_663,8,1,e_3,1406,1474,1514,12.5,6,6,9.5,5,6,0,68,40,108
p_981,12,5,e_2,1459,1471,1519,28.5,8,8,10.0,5,1,3,12,48,60
p_983,12,0,e_3,1397,1420,1520,10.0,7,3,8.0,5,7,0,23,100,123
p_280,3,0,e_3,1470,1502,1520,5.0,6,2,8.5,4,5,1,32,18,50
p_877,11,7,e_1,1495,1507,1525,23.0,5,5,13.5,4,4,1,12,18,30
p_1137,14,2,e_0,1455,1479,1533,27.5,8,8,8.5,5,0,2,24,54,78
p_515,6,2,e_0,1508,1513,1533,26.0,6,6,7.0,4,2,2,5,20,25
p_586,7,5,e_1,1509,1525,1535,25.0,6,6,10.5,4,4,0,16,10,26
p_980,12,2,e_2,1460,1471,1535,28.5,8,8,10.0,2,1,4,11,64,75
p_187,2,4,e_3,1460,1508,1540,12.5,8,2,10.5,4,7,1,48,32,80
p_1136,14,4,e_1,1485,1491,1541,22.0,6,6,15.0,2,2,0,6,50,56
p_979,12,4,e_1,1488,1501,1541,23.5,6,6,14.5,4,3,1,13,40,53
p_1204,15,3,e_1,1469,1485,1547,24.0,6,6,11.0,5,2,0,16,62,78
p_978,12,3,e_1,1497,1501,1547,22.0,4,4,12.5,4,4,1,4,46,50
p_112,1,8,e_3,1461,1514,1558,11.0,8,1,10.0,4,7,1,53,44,97
p_190,2,3,e_2,1438,1535,1559,17.0,8,2,5.0,2,2,0,97,24,121
p_878,11,0,e_1,1434,1467,1561,4.5,7,1,4.5,5,0,2,33,94,127
p_359,4,6,e_0,1448,1523,1569,17.0,8,3,7.5,5,1,1,75,46,121
p_186,2,10,e_3,1527,1530,1572,1.0,6,0,1.5,5,3,3,3,42,45
p_189,2,6,e_2,1444,1535,1573,15.5,9,2,6.0,5,1,1,91,38,129
p_435,5,7,e_2,1446,1519,1579,18.5,9,4,6.5,5,1,1,73,60,133
p_188,2,7,e_2,1446,1535,1579,15.5,9,2,6.5,5,1,1,89,44,133
p_278,3,4,e_1,1559,1575,1581,25.0,7,7,0.5,4,1,0,16,6,22
p_516,6,8,e_2,1456,1513,1585,17.5,8,4,9.0,5,1,2,57,72,129
p_876,11,13,e_3,1498,1578,1590,14.5,4,3,3.5,4,3,1,80,12,92
p_974,12,14,e_3,1578,1584,1596,1.0,6,0,11.0,2,3,3,6,12,18
p_513,6,12,e_0,1553,1569,1597,29.0,7,7,2.0,5,2,3,16,28,44
p_279,3,11,e_2,1482,1529,1599,9.5,7,3,12.0,4,2,3,47,70,117
p_185,2,11,e_2,1529,1535,1599,30.0,7,7,3.0,1,4,1,6,64,70
p_38,0,11,e_2,1532,1545,1599,28.0,7,7,2.5,4,5,1,13,54,67
p_111,1,15,e_3,1466,1514,1602,10.0,7,1,9.0,4,6,1,48,88,136
p_1067,13,15,e_3,1501,1590,1602,16.0,5,3,3.0,4,3,2,89,12,101
p_585,7,13,e_0,1522,1575,1603,7.0,6,1,4.0,4,1,4,53,28,81
p_110,1,0,e_1,1573,1597,1603,19.0,7,5,3.0,5,0,1,24,6,30
p_39,0,14,e_0,1527,1543,1609,28.5,7,7,3.5,4,2,4,16,66,82
p_1066,13,14,e_0,1516,1603,1609,13.5,7,0,5.5,4,1,2,87,6,93
p_514,6,15,e_0,1551,1569,1615,29.5,7,7,2.0,5,2,3,18,46,64
p_1133,14,12,e_3,1548,1596,1616,10.0,6,1,6.0,5,3,3,48,20,68
p_587,7,15,e_2,1479,1507,1619,14.0,7,7,12.5,4,2,2,28,112,140
p_183,2,3,e_1,1595,1613,1619,18.0,9,9,1.0,4,1,2,18,6,24
p_184,2,5,e_1,1576,1591,1629,21.5,7,7,3.0,5,1,1,15,38,53
p_662,8,7,e_3,1558,1560,1640,14.0,6,6,8.0,5,2,4,2,80,82
p_874,11,10,e_2,1590,1599,1641,6.0,9,2,9.0,5,2,1,9,42,51
p_37,0,7,e_1,1587,1603,1641,17.5,9,9,3.0,4,0,2,16,38,54
p_1203,15,10,e_0,1504,1615,1641,17.5,6,6,8.0,4,2,1,111,26,137
p_804,10,8,e_2,1618,1641,1651,1.0,8,0,15.0,2,3,0,23,10,33
p_875,11,5,e_3,1540,1578,1652,15.0,6,3,4.0,5,3,3,38,74,112
p_1132,14,7,e_0,1618,1621,1657,28.0,8,8,14.5,4,2,2,3,36,39
p_975,12,4,e_3,1525,1584,1658,17.0,6,2,1.0,5,3,3,59,74,133
p_805,10,4,e_3,1582,1626,1658,8.0,7,3,12.0,5,5,2,44,32,76
p_873,11,6,e_0,1608,1635,1663,2.0,8,1,14.0,5,2,1,27,28,55
p_731,9,6,e_0,1599,1647,1663,6.5,8,1,12.5,5,3,0,48,16,64
p_732,9,3,e_3,1559,1566,1664,13.0,7,6,8.0,5,2,5,7,98,105
p_976,12,3,e_3,1524,1584,1664,17.5,6,2,0.5,5,3,3,60,80,140
p_973,12,3,e_3,1588,1616,1664,5.0,9,2,13.0,5,8,1,28,48,76
p_1134,14,5,e_2,1519,1613,1665,16.0,7,7,5.0,1,4,1,94,52,146
p_870,11,12,e_1,1658,1661,1667,15.0,3,3,10.5,5,3,1,3,6,9
p_977,12,2,e_3,1502,1584,1670,21.0,5,5,3.0,4,3,2,82,86,168
p_1135,14,4,e_0,1517,1609,1673,16.5,7,7,5.5,4,1,3,92,64,156
p_511,6,14,e_1,1607,1635,1677,16.0,8,4,0.5,5,2,3,28,42,70
p_358,4,2,e_2,1623,1671,1681,6.0,8,3,14.5,4,2,1,48,10,58
p_512,6,0,e_3,1600,1646,1682,9.0,8,0,15.0,5,7,1,46,36,82
p_277,3,0,e_3,1652,1664,1682,2.0,4,1,5.0,4,4,0,12,18,30
p_433,5,15,e_1,1616,1629,1683,17.0,8,4,2.5,5,3,3,13,54,67
p_871,11,15,e_1,1651,1661,1683,16.0,4,4,8.5,5,3,1,10,22,32
p_182,2,6,e_0,1667,1683,1703,4.5,2,1,5.5,4,2,1,16,20,36
p_432,5,6,e_0,1693,1697,1703,3.0,3,1,4.5,5,2,2,4,6,10
p_972,12,11,e_1,1661,1667,1705,21.5,3,3,11.0,5,5,0,6,38,44
p_1202,15,11,e_1,1637,1683,1705,22.5,7,7,6.0,5,3,2,46,22,68
p_971,12,10,e_1,1669,1699,1711,20.0,2,2,12.5,5,5,1,30,12,42
p_109,1,7,e_3,1672,1676,1714,3.0,1,1,2.0,4,1,0,4,38,42
p_35,0,9,e_3,1611,1682,1724,13.0,8,0,13.0,4,6,2,71,42,113
p_507,6,12,e_0,1694,1703,1731,4.0,3,1,4.5,5,2,3,9,28,37
p_510,6,13,e_0,1649,1663,1737,11.5,5,4,8.5,4,3,0,14,74,88
p_968,12,13,e_0,1721,1731,1737,4.0,4,1,9.5,5,4,0,10,6,16
p_869,11,5,e_1,1680,1705,1739,19.5,2,2,14.5,5,4,2,25,34,59
p_803,10,5,e_1,1683,1711,1739,10.0,2,0,15.0,2,4,2,28,28,56
p_509,6,14,e_0,1676,1703,1743,7.0,2,1,3.5,4,1,2,27,40,67
p_872,11,4,e_1,1637,1661,1745,26.5,7,7,6.5,5,3,2,24,84,108
p_508,6,15,e_0,1693,1703,1749,4.0,3,1,4.5,5,2,2,10,46,56
p_660,8,15,e_0,1666,1713,1749,10.5,2,1,5.5,4,2,0,47,36,83
p_1065,13,3,e_1,1686,1693,1751,12.0,2,0,14.5,4,3,3,7,58,65
p_34,0,13,e_2,1622,1691,1751,10.5,8,0,14.5,4,2,0,69,60,129
p_730,9,13,e_2,1689,1729,1751,8.0,2,1,0.5,4,0,1,40,22,62
p_583,7,2,e_1,1715,1727,1757,14.0,4,2,9.0,4,4,2,12,30,42
p_356,4,2,e_1,1703,1745,1757,19.5,5,3,11.5,4,5,1,42,12,54
p_729,9,1,e_1,1712,1717,1763,12.0,5,1,10.0,4,4,1,5,46,51
p_584,7,1,e_1,1668,1727,1763,25.0,2,2,12.0,5,5,0,59,36,95
p_868,11,10,e_2,1715,1739,1765,10.0,4,1,6.0,5,1,2,24,26,50
p_661,8,0,e_1,1607,1647,1769,6.0,8,2,0.5,5,2,2,40,122,162
p_802,10,0,e_1,1707,1711,1769,12.5,5,1,11.0,4,5,1,4,58,62
p_1201,15,10,e_0,1688,1749,1771,14.0,2,0,3.0,5,2,1,61,22,83
p_866,11,9,e_3,1724,1734,1772,8.0,3,1,9.0,2,2,2,10,38,48
p_36,0,1,e_1,1604,1769,1775,14.5,8,0,0.0,5,2,1,165,6,171
p_970,12,8,e_2,1699,1745,1775,12.0,4,1,1.5,5,1,1,46,30,76
p_1064,13,6,e_2,1738,1751,1785,3.5,4,1,11.0,5,1,2,13,34,47
p_969,12,5,e_2,1702,1745,1791,11.5,5,1,2.5,5,1,2,43,46,89
p_1063,13,4,e_3,1750,1754,1796,0.0,3,0,13.5,4,3,0,4,42,46
p_181,2,6,e_1,1778,1781,1803,9.5,4,2,1.5,5,6,2,3,22,25
p_350,4,6,e_1,1788,1793,1803,9.5,4,3,3.0,5,8,1,5,10,15
p_505,6,2,e_3,1768,1786,1806,3.0,4,0,9.5,4,4,0,18,20,38
p_867,11,2,e_2,1716,1739,1807,10.0,4,1,6.0,5,1,3,23,68,91
p_1200,15,2,e_0,1740,1749,1809,3.0,4,0,13.5,5,2,0,9,60,69
p_582,7,2,e_0,1764,1785,1809,4.0,4,1,11.5,4,2,1,21,24,45
p_429,5,2,e_0,1762,1795,1809,6.0,4,1,12.0,4,2,0,33,14,47
p_506,6,7,e_1,1719,1733,1809,26.0,4,4,8.5,4,5,1,14,76,90
p_1131,14,1,e_3,1695,1748,1812,11.0,3,0,3.0,5,2,1,53,64,117
p_352,4,8,e_1,1725,1745,1815,23.0,4,4,7.5,4,5,2,20,70,90
p_107,1,8,e_1,1768,1775,1815,10.5,4,1,0.0,4,6,1,7,40,47
p_351,4,0,e_2,1771,1797,1817,5.0,4,1,8.5,4,4,0,26,20,46
p_357,4,0,e_3,1692,1700,1818,11.5,2,2,2.5,5,2,0,8,118,126
p_275,3,9,e_1,1763,1787,1821,14.0,4,2,1.0,1,7,0,24,34,58
p_108,1,2,e_3,1700,1812,1828,3.0,3,3,4.0,3,2,1,112,16,128
p_355,4,11,e_1,1710,1745,1833,26.0,5,5,10.0,1,5,1,35,88,123
p_431,5,12,e_1,1732,1739,1839,22.5,4,4,6.0,1,6,1,7,100,107
p_430,5,12,e_1,1734,1739,1839,22.0,4,4,6.0,4,7,1,5,100,105
p_354,4,12,e_1,1711,1745,1839,25.5,5,5,10.0,4,4,1,34,94,128
p_353,4,12,e_1,1722,1745,1839,23.5,4,4,8.0,4,5,2,23,94,117
p_659,8,12,e_1,1730,1815,1839,26.0,4,4,6.5,4,6,1,85,24,109
p_349,4,9,e_0,1801,1819,1843,7.0,3,3,3.5,4,1,1,18,24,42
p_276,3,13,e_1,1737,1751,1845,19.5,4,4,5.5,4,7,1,14,94,108
p_33,0,14,e_1,1713,1769,1851,21.0,4,4,9.5,4,4,2,56,82,138
p_967,12,14,e_1,1756,1839,1851,24.5,4,4,2.0,1,8,0,83,12,95
p_965,12,13,e_0,1840,1857,1863,8.0,1,1,8.5,5,2,3,17,6,23
p_964,12,13,e_0,1842,1857,1863,7.0,2,1,9.0,2,2,3,15,6,21
p_1199,15,13,e_1,1807,1857,1867,17.0,2,2,6.5,5,7,1,50,10,60
p_966,12,15,e_0,1811,1857,1875,13.0,1,1,2.5,5,0,3,46,18,64
p_864,11,10,e_1,1875,1877,1883,0.0,5,0,11.5,4,4,1,2,6,8
p_1061,13,11,e_2,1828,1874,1886,11.0,1,0,2.5,5,0,1,46,12,58
p_963,12,9,e_3,1845,1872,1886,6.0,2,0,6.0,5,0,2,27,14,41
p_1129,14,10,e_0,1848,1869,1897,7.0,3,0,10.0,5,1,3,21,28,49
p_800,10,7,e_1,1779,1827,1899,27.5,4,4,1.5,5,6,3,48,72,120
p_1060,13,7,e_1,1855,1867,1899,5.0,4,0,15.0,5,3,1,12,32,44
p_581,7,6,e_3,1825,1850,1900,5.5,1,0,1.5,5,1,0,25,50,75
p_962,12,7,e_2,1873,1880,1904,30.0,5,5,13.0,5,1,2,7,24,31
p_656,8,6,e_1,1857,1893,1905,7.5,4,1,15.0,2,3,1,36,12,48
p_580,7,5,e_3,1832,1850,1906,4.5,1,0,2.5,5,0,1,18,56,74
p_657,8,6,e_2,1817,1852,1910,8.0,1,1,0.0,3,0,0,35,58,93
p_1059,13,6,e_2,1864,1874,1910,2.5,5,0,11.0,5,1,1,10,36,46
p_1130,14,7,e_0,1816,1869,1911,16.0,2,2,3.5,5,0,4,53,42,95
p_801,10,5,e_1,1773,1827,1911,29.0,4,4,1.0,5,7,1,54,84,138
p_1198,15,5,e_1,1827,1857,1911,13.0,2,0,10.0,5,6,1,30,54,84
p_1197,15,4,e_1,1837,1857,1917,11.0,1,0,12.0,5,6,1,20,60,80
p_865,11,3,e_1,1775,1833,1923,27.5,4,4,1.0,2,7,2,58,90,148
p_579,7,3,e_2,1869,1904,1926,5.5,5,1,12.0,5,1,1,35,22,57
p_427,5,1,e_3,1888,1906,1926,4.0,4,1,9.0,4,2,2,18,20,38
p_347,4,1,e_3,1894,1912,1926,3.0,4,2,7.5,4,2,2,18,14,32
p_428,5,2,e_1,1857,1911,1929,10.5,4,1,15.0,2,3,1,54,18,72
p_348,4,0,e_3,1864,1912,1932,9.5,4,1,10.5,5,2,2,48,20,68
p_1062,13,2,e_0,1809,1863,1933,18.5,2,2,2.0,5,0,2,54,70,124
p_274,3,5,e_2,1884,1926,1936,12.0,5,1,11.5,4,3,0,42,10,52
p_426,5,6,e_2,1896,1916,1942,11.5,4,2,8.5,4,2,1,20,26,46
p_658,8,0,e_0,1795,1837,1943,26.0,3,3,5.0,4,1,0,42,106,148
p_273,3,12,e_2,1904,1926,1970,8.0,3,1,7.0,1,2,3,22,44,66
p_32,0,9,e_3,1841,1932,1974,9.0,1,1,5.0,5,0,1,91,42,133
p_655,8,9,e_3,1950,1968,1974,4.0,3,0,4.0,5,3,0,18,6,24
p_106,1,10,e_1,1883,1935,1975,10.5,5,1,10.0,4,4,1,52,40,92
p_272,3,10,e_3,1930,1946,1980,3.0,2,0,0.0,4,1,1,16,34,50
p_425,5,14,e_2,1914,1916,1980,9.0,2,2,5.5,4,1,2,2,64,66
p_423,5,10,e_0,1968,1970,1994,27.0,3,3,4.5,5,1,5,2,24,26
p_296,1,0,e_3,20,26,32,1.0,0,0,0.0,3,0,0,6,6,12
p_299,3,0,e_1,7,21,35,3.0,0,0,0.0,3,0,0,14,14,28
p_286,3,0,e_3,51,58,86,3.5,2,1,1.5,5,0,2,7,28,35
p_290,4,0,e_3,43,64,86,4.0,0,0,0.0,3,0,0,21,22,43
p_285,2,0,e_3,54,74,86,3.5,3,2,2.5,5,0,3,20,12,32
p_288,1,0,e_3,49,80,86,6.0,1,1,1.0,5,0,1,31,6,37
p_298,4,0,e_2,10,29,139,4.0,0,0,0.0,3,0,0,19,110,129
p_295,5,0,e_2,22,35,139,4.5,1,0,2.5,5,0,1,13,104,117
p_292,11,0,e_2,30,61,139,19.5,1,1,4.0,5,1,1,31,78,109
p_287,12,0,e_2,51,67,139,10.5,3,0,9.0,5,1,1,16,72,88
p_284,14,0,e_2,55,77,139,11.5,4,0,10.0,5,1,2,22,62,84
p_277,10,0,e_2,81,95,139,21.0,2,2,13.5,4,1,0,14,44,58
p_275,2,0,e_2,84,129,139,28.5,2,2,12.5,4,1,1,45,10,55
p_300,8,0,e_0,4,38,140,8.0,0,0,0.0,3,0,0,34,102,136
p_297,12,0,e_0,18,56,140,12.0,0,0,3.5,5,0,1,38,84,122
p_294,13,0,e_0,23,62,140,12.5,1,0,4.5,5,0,2,39,78,117
p_293,15,0,e_0,26,72,140,16.0,0,0,5.5,5,0,3,46,68,114
p_280,12,0,e_0,65,86,140,22.0,4,4,13.5,5,1,1,21,54,75
p_276,5,0,e_0,82,116,140,25.5,2,2,12.5,4,1,1,34,24,58
p_274,4,0,e_0,84,122,140,26.5,2,2,12.5,4,1,2,38,18,56
p_267,1,0,e_0,153,160,166,14.0,2,1,0.0,3,0,0,7,6,13
p_291,6,0,e_1,35,62,174,6.0,0,0,0.0,3,0,0,27,112,139
p_289,7,0,e_1,47,68,174,6.5,1,0,2.5,5,0,1,21,106,127
p_283,10,0,e_1,55,82,174,7.5,4,0,4.5,5,0,2,27,92,119
p_281,10,0,e_1,63,82,174,6.0,5,0,6.0,5,1,2,19,92,111
p_278,15,0,e_1,80,104,174,16.0,2,2,9.5,5,1,2,24,70,94
p_273,13,0,e_1,95,114,174,11.0,1,0,13.0,5,1,2,19,60,79
p_270,7,0,e_1,133,140,174,12.0,2,1,8.5,4,1,1,7,34,41
p_269,4,0,e_1,146,154,174,12.0,2,1,5.5,4,1,1,8,20,28
p_279,2,0,e_1,76,164,174,30.0,3,3,8.5,5,1,1,88,10,98
p_282,6,0,e_3,62,112,226,2.0,4,0,4.0,5,1,3,50,114,164
p_271,11,0,e_3,127,134,226,9.5,2,1,9.5,5,1,1,7,92,99
p_272,15,0,e_3,105,152,226,10.5,1,0,4.5,5,0,1,47,74,121
p_265,12,0,e_3,157,166,226,2.0,2,0,14.0,4,1,1,9,60,69
p_263,12,0,e_3,163,166,226,0.0,4,0,12.5,4,1,3,3,60,63
p_268,10,0,e_3,150,176,226,5.5,2,1,14.5,5,1,1,26,50,76
p_262,6,0,e_3,164,194,226,6.0,4,1,12.5,4,1,3,30,32,62
p_264,5,0,e_3,162,200,226,7.0,3,1,12.5,4,1,2,38,26,64
p_258,5,0,e_3,175,200,226,5.0,3,1,10.0,1,1,2,25,26,51
p_254,3,0,e_3,199,210,226,2.0,1,0,5.0,1,1,0,11,16,27
p_252,2,0,e_3,212,216,226,1.0,1,0,3.0,4,1,0,4,10,14
p_251,4,0,e_3,228,247,265,4.0,0,0,0.0,3,0,0,19,18,37
p_259,6,0,e_1,174,200,280,4.0,4,0,0.0,3,1,0,26,80,106
p_256,8,0,e_1,191,210,280,28.5,3,3,4.0,5,0,2,19,70,89
p_257,12,0,e_1,179,228,280,27.5,3,3,1.0,5,0,1,49,52,101
p_250,7,0,e_1,236,250,280,5.5,1,0,10.0,4,1,0,14,30,44
p_249,7,0,e_1,238,250,280,5.0,1,0,9.5,4,1,1,12,30,42
p_248,7,0,e_1,246,250,280,3.0,1,0,7.5,4,1,1,4,30,34
p_255,10,0,e_2,192,197,281,26.5,3,3,9.0,5,0,1,5,84,89
p_266,15,0,e_2,155,219,281,29.5,2,2,0.0,3,0,0,64,62,126
p_253,15,0,e_2,208,219,281,18.5,2,2,12.5,5,1,1,11,62,73
p_261,12,0,e_0,170,221,283,29.0,4,4,0.0,3,0,0,51,62,113
p_260,13,0,e_0,171,227,283,28.0,4,4,0.0,5,0,1,56,56,112
p_244,2,0,e_0,271,273,283,21.0,2,2,2.5,4,1,0,2,10,12
p_242,4,0,e_1,287,306,326,14.5,2,2,0.0,3,0,0,19,20,39
p_238,2,0,e_1,311,316,326,15.0,4,3,3.0,4,1,0,5,10,15
p_245,9,0,e_3,269,303,403,14.5,1,1,0.5,5,0,1,34,100,134
p_247,12,0,e_3,248,317,403,22.0,1,1,4.0,4,1,0,69,86,155
p_246,12,0,e_3,257,317,403,19.5,2,2,1.5,4,1,1,60,86,146
p_241,13,0,e_3,300,323,403,4.5,2,0,8.5,5,0,2,23,80,103
p_240,14,0,e_3,301,329,403,5.5,3,0,8.5,5,0,3,28,74,102
p_234,14,0,e_3,314,329,403,2.5,4,0,11.5,5,1,3,15,74,89
p_226,12,0,e_3,331,339,403,1.0,3,0,13.5,4,1,2,8,64,72
p_228,11,0,e_3,325,345,403,3.5,3,1,13.5,5,1,2,20,58,78
p_219,11,0,e_3,342,345,403,0.0,4,0,11.5,4,1,3,3,58,61
p_231,10,0,e_3,320,351,403,5.5,3,2,12.5,5,1,2,31,52,83
p_212,9,0,e_3,348,357,403,1.0,4,0,10.5,4,1,3,9,46,55
p_217,8,0,e_3,345,363,403,3.0,3,1,11.0,4,1,2,18,40,58
p_221,4,0,e_3,341,381,403,7.0,3,1,11.5,4,1,2,40,22,62
p_210,4,0,e_3,353,381,403,5.0,4,1,9.5,4,1,3,28,22,50
p_209,2,0,e_3,354,391,403,7.0,4,2,9.5,4,1,3,37,12,49
p_243,8,0,e_0,285,319,409,11.5,2,2,0.0,3,0,0,34,90,124
p_239,13,0,e_0,305,341,409,6.0,4,1,4.5,5,0,1,36,68,104
p_224,13,0,e_0,335,341,409,29.5,4,4,12.0,5,1,2,6,68,74
p_223,13,0,e_0,339,341,409,29.0,3,3,12.5,5,1,2,2,68,70
p_225,10,0,e_0,333,355,409,3.0,4,2,11.0,5,1,1,22,54,76
p_206,6,0,e_0,362,373,409,2.0,4,0,8.5,4,1,3,11,36,47
p_196,5,0,e_0,376,379,409,30.0,3,3,5.5,4,1,3,3,30,33
p_214,4,0,e_0,346,385,409,7.0,4,2,12.0,4,1,2,39,24,63
p_222,3,0,e_0,339,391,409,9.0,3,2,13.0,5,1,2,52,18,70
p_185,2,0,e_0,392,397,409,30.0,2,2,3.0,4,1,1,5,12,17
p_205,1,0,e_0,362,403,409,7.0,4,2,8.5,4,1,2,41,6,47
p_233,2,0,e_2,319,324,458,14.0,3,2,1.0,5,0,2,5,134,139
p_237,5,0,e_2,313,338,458,12.0,4,3,0.0,3,0,0,25,120,145
p_232,5,0,e_2,320,338,458,10.5,4,2,1.0,5,0,3,18,120,138
p_230,5,0,e_2,323,338,458,10.0,3,1,2.0,5,0,3,15,120,135
p_236,8,0,e_2,313,352,458,9.0,4,3,0.0,3,0,1,39,106,145
p_235,8,0,e_2,314,352,458,8.5,4,3,0.0,5,0,2,38,106,144
p_229,9,0,e_2,323,358,458,6.0,3,1,2.0,2,0,2,35,100,135
p_220,9,0,e_2,342,358,458,2.0,4,1,6.0,5,1,2,16,100,116
p_218,9,0,e_2,343,358,458,2.0,4,1,6.0,5,1,2,15,100,115
p_213,12,0,e_2,347,372,458,29.0,4,4,7.0,5,1,3,25,86,111
p_200,12,0,e_2,367,372,458,25.5,3,3,11.0,5,1,3,5,86,91
p_211,14,0,e_2,348,382,458,26.5,5,5,7.5,5,1,4,34,76,110
p_194,11,0,e_2,377,396,458,23.5,3,3,13.0,5,1,4,19,62,81
p_198,9,0,e_2,368,406,458,28.0,3,3,11.0,5,1,3,38,52,90
p_177,9,0,e_2,398,406,458,22.0,2,2,10.5,4,1,5,8,52,60
p_227,9,0,e_1,326,365,469,5.5,4,1,0.0,3,0,0,39,104,143
p_207,12,0,e_1,355,379,469,27.0,5,5,7.0,5,0,2,24,90,114
p_203,12,0,e_1,365,379,469,26.0,3,3,9.0,2,0,4,14,90,104
p_193,12,0,e_1,378,379,469,22.5,3,3,12.0,2,1,4,1,90,91
p_208,13,0,e_1,355,387,469,26.0,5,5,7.0,5,0,3,32,82,114
p_202,13,0,e_1,365,387,469,25.0,3,3,9.0,2,0,4,22,82,104
p_201,13,0,e_1,366,387,469,24.5,3,3,9.0,5,1,4,21,82,103
p_190,14,0,e_1,382,393,469,20.0,2,2,12.0,5,1,5,11,76,87
p_183,12,0,e_1,393,403,469,19.5,2,2,14.0,4,1,4,10,66,76
p_181,11,0,e_1,395,409,469,20.0,2,2,13.5,4,1,5,14,60,74
p_173,10,0,e_1,405,415,469,17.5,1,1,11.5,4,1,5,10,54,64
p_170,10,0,e_1,408,415,469,17.0,1,1,11.0,4,1,6,7,54,61
p_195,9,0,e_1,376,421,469,26.0,3,3,11.5,5,1,4,45,48,93
p_204,8,0,e_1,364,427,469,30.0,3,3,9.0,2,0,3,63,42,105
p_192,5,0,e_1,380,441,469,29.0,3,3,12.0,2,1,4,61,28,89
p_160,10,0,e_3,421,445,551,15.5,2,2,4.5,5,0,2,24,106,130
p_152,10,0,e_3,439,445,551,11.5,5,3,8.5,5,0,5,6,106,112
p_159,11,0,e_3,424,451,551,14.0,3,2,5.0,5,0,3,27,100,127
p_180,14,0,e_3,396,465,551,17.0,2,2,1.0,4,1,1,69,86,155
p_172,14,0,e_3,405,465,551,14.0,1,0,0.0,5,0,1,60,86,146
p_168,15,0,e_3,412,471,551,13.0,1,0,2.0,5,0,1,59,80,139
p_151,15,0,e_3,443,471,551,5.5,5,0,9.5,5,0,5,28,80,108
p_149,15,0,e_3,444,471,551,5.0,4,0,10.0,2,0,4,27,80,107
p_142,15,0,e_3,452,471,551,4.0,6,0,11.0,5,1,5,19,80,99
p_141,15,0,e_3,455,471,551,3.0,6,0,12.0,5,1,5,16,80,96
p_124,14,0,e_3,474,477,551,0.0,5,0,14.5,4,1,4,3,74,77
p_123,12,0,e_3,474,487,551,2.0,4,0,14.5,4,1,3,13,64,77
p_146,10,0,e_3,451,497,551,9.0,5,2,11.0,2,1,4,46,54,100
p_128,10,0,e_3,471,497,551,5.0,4,0,15.0,4,1,3,26,54,80
p_120,10,0,e_3,481,497,551,3.0,5,1,13.5,4,1,4,16,54,70
p_153,8,0,e_0,438,445,555,13.5,4,4,6.5,5,0,4,7,110,117
p_169,11,0,e_0,410,459,555,15.5,1,1,0.0,3,0,0,49,96,145
p_164,12,0,e_0,416,465,555,15.0,2,2,1.0,5,0,2,49,90,139
p_157,12,0,e_0,427,465,555,12.0,4,2,4.0,5,0,4,38,90,128
p_145,12,0,e_0,451,465,555,7.0,6,2,9.0,5,1,4,14,90,104
p_134,12,0,e_0,462,465,555,4.5,6,2,11.5,5,1,3,3,90,93
p_161,13,0,e_0,418,471,555,13.5,2,2,1.5,5,0,3,53,84,137
p_140,13,0,e_0,455,471,555,5.0,6,2,10.5,5,1,4,16,84,100
p_139,13,0,e_0,456,471,555,5.0,6,2,10.5,5,1,4,15,84,99
p_137,13,0,e_0,458,471,555,4.5,6,2,11.0,5,1,4,13,84,97
p_165,14,0,e_0,416,477,555,13.0,2,1,1.0,5,0,1,61,78,139
p_162,14,0,e_0,417,477,555,13.0,2,1,1.0,5,0,3,60,78,138
p_158,14,0,e_0,426,477,555,10.5,4,1,3.5,5,0,4,51,78,129
p_127,15,0,e_0,473,483,555,29.5,4,4,13.5,5,1,3,10,72,82
p_117,12,0,e_0,490,497,555,29.5,4,4,13.5,4,1,2,7,58,65
p_125,4,0,e_1,474,487,609,10.0,4,2,1.0,5,0,1,13,122,135
p_122,5,0,e_1,477,493,609,9.0,5,3,1.5,5,0,2,16,116,132
p_130,9,0,e_1,469,511,609,6.0,5,0,0.0,3,1,0,42,98,140
p_121,9,0,e_1,480,511,609,4.0,5,2,2.5,5,0,3,31,98,129
p_103,13,0,e_1,517,529,609,23.0,4,4,10.5,5,1,2,12,80,92
p_109,14,0,e_1,506,535,609,24.5,3,3,8.0,5,1,2,29,74,103
p_92,13,0,e_1,533,541,609,20.0,3,3,13.5,5,1,4,8,68,76
p_91,13,0,e_1,535,541,609,19.5,3,3,14.0,4,1,4,6,68,74
p_97,10,0,e_1,526,555,609,24.5,4,4,12.5,5,1,3,29,54,83
p_89,7,0,e_1,537,569,609,25.5,3,3,14.0,4,1,4,32,40,72
p_95,6,0,e_1,527,575,609,28.0,4,4,13.0,5,1,4,48,34,82
p_78,4,0,e_1,555,585,609,25.0,2,2,10.0,4,1,5,30,24,54
p_150,3,0,e_1,444,591,609,17.0,5,3,4.5,4,1,1,147,18,165
p_148,3,0,e_1,447,591,609,16.5,5,3,4.0,4,1,2,144,18,162
p_85,3,0,e_1,542,591,609,28.5,3,3,13.0,4,1,4,49,18,67
p_175,2,0,e_2,399,471,609,28.5,2,2,10.5,4,1,5,72,138,210
p_136,2,0,e_2,460,471,609,15.0,6,2,0.0,3,0,0,11,138,149
p_163,4,0,e_2,417,481,609,23.0,2,2,7.0,4,1,5,64,128,192
p_133,4,0,e_2,463,481,609,12.0,6,1,0.0,5,0,2,18,128,146
p_191,7,0,e_2,382,495,609,27.0,2,2,14.0,2,1,4,113,114,227
p_189,7,0,e_2,387,495,609,26.0,2,2,13.0,4,1,5,108,114,222
p_187,7,0,e_2,391,495,609,25.0,2,2,12.0,4,1,5,104,114,218
p_167,7,0,e_2,412,495,609,21.0,2,2,8.0,1,1,5,83,114,197
p_135,7,0,e_2,461,495,609,9.5,6,2,0.0,5,0,1,34,114,148
p_132,7,0,e_2,463,495,609,9.0,6,1,0.0,5,0,2,32,114,146
p_131,9,0,e_2,467,505,609,7.0,5,1,1.5,5,0,3,38,104,142
p_112,15,0,e_2,497,531,609,25.0,4,4,7.0,5,1,2,34,78,112
p_111,15,0,e_2,501,531,609,24.5,4,4,8.0,5,1,3,30,78,108
p_101,12,0,e_2,521,545,609,23.0,5,5,13.0,5,1,2,24,64,88
p_100,10,0,e_2,522,555,609,25.0,5,5,13.0,5,1,3,33,54,87
p_118,4,0,e_2,488,659,687,8.0,4,2,5.5,5,1,2,171,28,199
p_35,4,0,e_2,640,659,687,7.0,5,2,0.0,3,0,0,19,28,47
p_184,5,0,e_2,393,665,687,26.5,2,2,11.5,4,1,5,272,22,294
p_182,5,0,e_2,394,665,687,26.5,2,2,11.5,4,1,6,271,22,293
p_178,5,0,e_2,398,665,687,26.0,2,2,10.5,4,1,5,267,22,289
p_166,5,0,e_2,415,665,687,22.0,2,2,7.5,4,1,5,250,22,272
p_83,5,0,e_2,546,665,687,26.0,2,2,12.0,4,1,4,119,22,141
p_32,5,0,e_2,657,665,687,2.0,4,0,4.0,5,0,1,8,22,30
p_31,5,0,e_2,662,665,687,1.0,4,0,4.5,5,1,1,3,22,25
p_67,8,0,e_3,574,585,693,16.5,2,2,5.5,5,0,2,11,108,119
p_63,8,0,e_3,581,585,693,15.0,3,2,7.0,5,0,3,4,108,112
p_114,9,0,e_3,494,591,693,1.0,4,0,10.5,4,1,3,97,102,199
p_60,9,0,e_3,584,591,693,13.0,3,2,8.0,2,0,3,7,102,109
p_53,9,0,e_3,590,591,693,12.0,5,2,9.0,2,1,4,1,102,103
p_79,14,0,e_3,549,615,693,16.5,2,2,0.5,4,1,1,66,78,144
p_87,15,0,e_3,539,621,693,17.0,2,2,2.0,1,1,1,82,72,154
p_72,15,0,e_3,569,621,693,10.5,2,0,4.5,5,0,2,52,72,124
p_44,15,0,e_3,598,621,693,5.0,5,0,10.0,5,1,4,23,72,95
p_36,11,0,e_3,635,639,693,0.0,5,0,11.5,4,1,4,4,54,58
p_115,10,0,e_3,494,645,693,0.0,4,0,10.5,4,1,3,151,48,199
p_41,10,0,e_3,600,645,693,9.5,6,2,10.5,5,1,5,45,48,93
p_108,5,0,e_3,509,667,693,2.0,3,0,7.5,4,1,2,158,26,184
p_62,5,0,e_3,582,667,693,17.5,3,3,7.5,5,0,3,85,26,111
p_61,5,0,e_3,583,667,693,17.0,4,2,8.0,5,0,4,84,26,110
p_69,10,0,e_0,573,597,695,14.5,2,2,4.0,5,0,2,24,98,122
p_58,10,0,e_0,586,597,695,12.0,5,2,7.5,5,0,5,11,98,109
p_50,10,0,e_0,592,597,695,11.0,6,2,9.0,5,0,6,5,98,103
p_113,11,0,e_0,496,603,695,29.0,4,4,12.0,4,1,3,107,92,199
p_74,11,0,e_0,567,603,695,15.0,2,2,3.0,5,0,1,36,92,128
p_52,11,0,e_0,591,603,695,10.0,6,2,8.5,5,0,5,12,92,104
p_66,12,0,e_0,577,609,695,12.0,3,2,5.0,5,0,3,32,86,118
p_65,12,0,e_0,578,609,695,11.5,3,2,5.5,5,0,4,31,86,117
p_46,13,0,e_0,596,615,695,7.5,5,2,10.0,2,0,5,19,80,99
p_88,14,0,e_0,538,621,695,18.0,3,3,4.0,4,1,0,83,74,157
p_75,14,0,e_0,563,621,695,13.0,2,1,1.5,5,0,1,58,74,132
p_68,14,0,e_0,574,621,695,10.5,2,1,4.5,5,0,3,47,74,121
p_39,15,0,e_0,609,627,695,2.0,7,0,12.0,5,1,4,18,68,86
p_33,8,0,e_0,647,657,695,2.0,4,0,10.5,4,1,2,10,38,48
p_126,6,0,e_0,473,667,695,9.0,4,2,13.5,5,1,2,194,28,222
p_129,5,0,e_0,470,729,751,10.0,5,0,13.0,2,1,1,259,22,281
p_119,5,0,e_0,483,729,751,7.0,5,2,15.0,2,1,2,246,22,268
p_96,5,0,e_0,527,729,751,29.5,4,4,6.0,4,1,1,202,22,224
p_49,5,0,e_0,592,729,751,16.0,6,2,9.0,5,0,5,137,22,159
p_24,5,0,e_0,707,729,751,5.0,0,0,0.0,3,0,0,22,22,44
p_45,5,0,e_3,597,732,754,15.0,5,2,10.0,5,1,4,135,22,157
p_23,5,0,e_3,709,732,754,5.0,0,0,0.0,3,0,0,23,22,45
p_71,2,0,e_2,569,703,757,23.5,2,2,7.0,1,1,3,134,54,188
p_27,2,0,e_2,693,703,757,2.0,0,0,0.0,3,0,0,10,54,64
p_174,3,0,e_2,402,709,757,27.0,2,2,9.5,4,1,6,307,48,355
p_171,3,0,e_2,408,709,757,24.0,1,1,9.0,4,1,6,301,48,349
p_155,3,0,e_2,434,709,757,19.5,4,4,4.0,4,1,3,275,48,323
p_26,3,0,e_2,698,709,757,3.0,0,0,1.0,5,0,1,11,48,59
p_93,7,0,e_2,529,727,757,27.0,3,3,15.0,5,1,5,198,30,228
p_76,7,0,e_2,559,727,757,21.5,2,2,9.0,4,1,4,168,30,198
p_25,7,0,e_2,703,727,757,7.0,0,0,2.0,2,0,1,24,30,54
p_38,4,0,e_1,627,645,761,10.0,5,2,0.0,3,0,0,18,116,134
p_37,7,0,e_1,633,659,761,5.0,5,1,1.0,5,0,1,26,102,128
p_34,15,0,e_1,643,693,761,25.5,5,5,3.5,5,0,2,50,68,118
p_29,15,0,e_1,678,693,761,18.0,2,2,11.5,5,1,2,15,68,83
p_22,10,0,e_1,712,715,761,10.0,1,0,10.5,4,1,2,3,46,49
p_28,6,0,e_1,679,733,761,27.0,1,1,12.0,5,1,2,54,28,82
p_30,5,0,e_1,676,739,761,28.5,2,2,11.0,5,1,1,63,22,85
p_143,2,0,e_1,451,778,788,17.0,5,2,3.0,1,1,1,327,10,337
p_81,2,0,e_1,547,778,788,29.0,2,2,11.5,4,1,5,231,10,241
p_56,2,0,e_1,588,778,788,19.5,5,3,3.5,4,1,3,190,10,200
p_48,2,0,e_1,593,778,788,19.0,5,2,2.5,4,1,2,185,10,195
p_18,2,0,e_1,768,778,788,13.0,1,1,0.0,3,0,0,10,10,20
p_20,9,0,e_3,737,792,866,25.0,1,1,4.0,4,1,0,55,74,129
p_16,13,0,e_3,774,810,866,8.5,1,0,4.5,5,0,1,36,56,92
p_186,1,0,e_3,391,860,866,1.0,1,0,2.0,4,1,0,469,6,475
p_107,1,0,e_3,512,860,866,6.0,3,2,7.0,1,1,2,348,6,354
p_99,1,0,e_3,522,860,866,4.0,5,2,5.0,4,1,4,338,6,344
p_8,1,0,e_3,847,860,866,3.0,1,0,4.0,4,1,0,13,6,19
p_21,10,0,e_0,732,793,879,25.0,1,1,4.5,4,1,0,61,86,147
p_17,15,0,e_0,772,815,879,10.5,1,0,5.0,5,0,1,43,64,107
p_15,15,0,e_0,782,815,879,8.0,2,0,7.5,5,0,2,33,64,97
p_14,15,0,e_0,790,815,879,6.0,2,0,9.5,5,0,2,25,64,89
p_4,1,0,e_0,864,873,879,29.0,1,1,3.0,4,1,0,9,6,15
p_13,11,0,e_2,794,803,881,6.0,2,1,9.0,5,0,1,9,78,87
p_19,12,0,e_2,740,809,881,21.0,2,2,4.0,4,1,0,69,72,141
p_12,13,0,e_2,796,815,881,3.5,2,0,9.5,5,0,2,19,66,85
p_10,14,0,e_2,810,821,881,29.0,1,1,12.0,5,1,2,11,60,71
p_11,11,0,e_2,810,835,881,24.0,1,0,12.0,5,1,1,25,46,71
p_3,1,0,e_3,876,883,907,1.0,0,0,0.0,3,0,0,7,24,31
p_43,3,0,e_3,599,893,907,17.0,5,2,10.0,5,1,4,294,14,308
p_2,3,0,e_3,878,893,907,3.0,1,0,0.0,5,0,1,15,14,29
p_1,2,0,e_0,889,899,909,1.5,2,1,0.0,3,0,0,10,10,20
p_9,2,0,e_1,845,856,968,2.0,1,0,0.0,3,0,0,11,112,123
p_5,5,0,e_1,860,870,968,26.0,1,1,2.5,5,1,2,10,98,108
p_7,12,0,e_1,851,900,968,21.0,2,2,1.0,5,0,1,49,68,117
p_6,14,0,e_1,858,910,968,17.5,2,2,2.5,5,1,1,52,58,110
p_296,1,0,e_3,20,26,32,1.0,0,0,0.0,3,0,0,6,6,12
p_299,3,0,e_1,7,21,35,3.0,0,0,0.0,3,0,0,14,14,28
p_288,1,0,e_3,49,50,88,6.0,1,1,1.0,5,0,1,1,38,39
p_285,2,0,e_3,54,56,88,4.5,3,2,1.5,5,1,2,2,32,34
p_286,3,0,e_3,51,62,88,4.0,2,1,1.0,5,1,1,11,26,37
p_290,4,0,e_3,43,68,88,4.0,0,0,0.0,3,0,0,25,20,45
p_279,2,0,e_3,76,78,88,0.0,2,0,2.5,4,1,1,2,10,12
p_298,4,0,e_2,10,29,139,4.0,0,0,0.0,3,0,0,19,110,129
p_295,5,0,e_2,22,35,139,5.0,1,0,2.5,5,0,1,13,104,117
p_292,11,0,e_2,30,61,139,19.5,1,1,4.0,5,1,1,31,78,109
p_287,12,0,e_2,51,67,139,11.0,2,0,9.0,5,1,1,16,72,88
p_284,14,0,e_2,55,77,139,12.0,3,0,10.0,5,1,2,22,62,84
p_277,10,0,e_2,81,95,139,21.5,2,2,13.5,4,1,0,14,44,58
p_274,4,0,e_2,84,121,139,27.0,2,2,12.5,4,1,1,37,18,55
p_282,6,0,e_3,62,114,140,3.0,2,0,3.0,2,1,1,52,26,78
p_300,8,0,e_0,4,39,141,8.0,0,0,0.0,3,0,0,35,102,137
p_297,12,0,e_0,18,57,141,12.0,0,0,3.0,5,0,1,39,84,123
p_294,13,0,e_0,23,63,141,12.5,1,0,4.5,5,0,2,40,78,118
p_293,15,0,e_0,26,73,141,16.0,0,0,5.0,5,0,3,47,68,115
p_280,12,0,e_0,65,87,141,8.5,3,0,13.5,5,1,1,22,54,76
p_276,5,0,e_0,82,117,141,26.5,2,2,13.0,4,1,1,35,24,59
p_275,2,0,e_0,84,131,141,28.5,2,2,12.5,4,1,2,47,10,57
p_267,1,0,e_3,153,159,165,1.0,0,0,0.0,3,0,0,6,6,12
p_291,6,0,e_1,35,62,172,6.0,0,0,0.0,3,0,0,27,110,137
p_289,7,0,e_1,47,68,172,6.5,1,0,2.5,5,0,1,21,104,125
p_283,10,0,e_1,55,82,172,8.0,3,0,4.5,5,0,2,27,90,117
p_281,10,0,e_1,63,82,172,7.0,3,0,6.0,5,1,2,19,90,109
p_273,13,0,e_1,95,96,172,11.5,1,0,13.0,5,1,1,1,76,77
p_278,15,0,e_1,80,106,172,16.5,2,2,10.0,5,1,1,26,66,92
p_272,15,0,e_1,105,106,172,11.0,1,0,15.0,5,1,1,1,66,67
p_270,7,0,e_1,133,140,172,24.5,1,1,8.5,4,1,0,7,32,39
p_269,4,0,e_1,146,154,172,4.0,0,0,6.0,4,1,0,8,18,26
p_258,5,0,e_1,175,197,267,5.0,1,1,0.0,3,0,0,22,70,92
p_256,8,0,e_1,191,211,267,10.0,2,1,4.0,5,0,1,20,56,76
p_255,10,0,e_1,192,221,267,8.0,2,1,4.0,5,0,2,29,46,75
p_251,4,0,e_1,228,247,267,5.0,1,0,8.5,4,1,1,19,20,39
p_252,2,0,e_1,212,257,267,11.0,2,1,8.0,5,1,1,45,10,55
p_271,11,0,e_2,127,185,267,22.0,1,1,3.0,4,1,0,58,82,140
p_266,15,0,e_2,155,203,267,14.5,1,0,3.5,5,0,1,48,64,112
p_254,3,0,e_2,199,253,267,13.5,2,1,14.0,5,1,1,54,14,68
p_262,6,0,e_3,164,191,269,6.0,0,0,0.0,3,1,0,27,78,105
p_259,6,0,e_3,174,191,269,4.0,1,0,2.0,5,0,1,17,78,95
p_257,12,0,e_3,179,217,269,9.0,1,0,3.0,5,0,1,38,52,90
p_250,7,0,e_3,236,239,269,0.0,1,0,7.5,4,1,0,3,30,33
p_264,5,0,e_0,162,172,286,25.5,1,1,2.5,5,0,2,10,114,124
p_268,10,0,e_0,150,194,286,10.0,0,0,0.0,3,0,0,44,92,136
p_265,12,0,e_0,157,204,286,11.5,1,0,1.5,5,0,1,47,82,129
p_263,12,0,e_0,163,204,286,18.0,1,1,3.0,5,0,3,41,82,123
p_261,12,0,e_0,170,204,286,11.0,1,0,5.0,5,0,3,34,82,116
p_260,13,0,e_0,171,210,286,12.0,1,0,5.0,5,0,3,39,76,115
p_253,15,0,e_0,208,220,286,5.0,2,0,12.5,5,1,1,12,66,78
p_249,7,0,e_0,238,254,286,30.0,2,2,11.0,4,1,0,16,32,48
p_248,7,0,e_0,246,254,286,28.5,1,1,8.5,4,1,1,8,32,40
p_244,2,0,e_0,271,276,286,21.5,1,1,3.0,4,1,0,5,10,15
p_242,4,0,e_0,287,306,326,15.5,1,1,0.0,3,0,0,19,20,39
p_238,2,0,e_0,311,316,326,13.5,2,2,3.0,4,1,0,5,10,15
p_243,8,0,e_2,285,303,355,12.0,1,1,4.0,5,0,1,18,52,70
p_245,9,0,e_2,269,309,355,9.0,1,1,0.0,3,0,0,40,46,86
p_236,8,0,e_2,313,315,355,7.5,2,2,8.5,4,1,1,2,40,42
p_237,5,0,e_2,313,329,355,10.5,2,2,8.5,4,1,0,16,26,42
p_232,5,0,e_2,320,329,355,11.0,3,2,7.0,4,1,2,9,26,35
p_230,5,0,e_2,323,329,355,10.5,4,2,6.5,4,1,2,6,26,32
p_233,2,0,e_2,319,343,355,14.0,3,2,7.0,4,1,1,24,12,36
p_216,1,0,e_2,346,349,355,10.0,5,4,1.5,4,1,0,3,6,9
p_246,12,0,e_1,257,317,405,21.0,2,2,2.0,1,1,0,60,88,148
p_241,13,0,e_1,300,323,405,5.5,1,0,8.0,5,0,1,23,82,105
p_240,14,0,e_1,301,329,405,6.5,1,0,8.5,5,0,2,28,76,104
p_226,12,0,e_1,331,339,405,2.0,3,0,13.5,4,1,2,8,66,74
p_219,11,0,e_1,342,345,405,1.0,5,0,11.5,4,1,3,3,60,63
p_225,10,0,e_1,333,351,405,4.0,3,1,13.5,4,1,3,18,54,72
p_229,9,0,e_1,323,357,405,6.5,4,2,13.0,2,1,2,34,48,82
p_220,9,0,e_1,342,357,405,3.0,5,2,11.5,4,1,3,15,48,63
p_218,9,0,e_1,343,357,405,2.0,5,1,11.0,4,1,4,14,48,62
p_212,9,0,e_1,348,357,405,2.0,5,1,10.5,4,1,4,9,48,57
p_235,8,0,e_1,314,363,405,9.0,3,3,11.5,5,0,3,49,42,91
p_215,6,0,e_1,346,373,405,5.0,6,2,11.0,4,1,3,27,32,59
p_196,5,0,e_1,376,379,405,0.0,3,0,5.5,4,1,2,3,26,29
p_209,2,0,e_1,354,393,405,8.0,4,3,9.5,4,1,3,39,12,51
p_199,2,0,e_1,368,393,405,5.0,4,3,7.0,4,1,3,25,12,37
p_247,12,0,e_3,248,319,407,23.0,1,1,5.0,4,1,0,71,88,159
p_239,13,0,e_3,305,325,407,4.0,1,0,9.0,5,0,1,20,82,102
p_234,14,0,e_3,314,331,407,3.0,2,0,11.0,5,0,2,17,76,93
p_224,13,0,e_3,335,337,407,0.0,3,0,13.5,4,1,2,2,70,72
p_228,11,0,e_3,325,347,407,4.0,3,1,13.0,5,1,2,22,60,82
p_231,10,0,e_3,320,353,407,6.0,3,2,12.0,5,1,2,33,54,87
p_217,8,0,e_3,345,363,407,3.0,5,1,11.0,4,1,4,18,44,62
p_206,6,0,e_3,362,373,407,2.0,3,0,8.0,1,1,2,11,34,45
p_221,4,0,e_3,341,383,407,8.0,4,2,12.5,4,1,3,42,24,66
p_214,4,0,e_3,346,383,407,7.0,5,2,11.0,1,1,4,37,24,61
p_210,4,0,e_3,353,383,407,6.0,4,1,10.0,1,1,3,30,24,54
p_222,3,0,e_3,339,389,407,10.0,3,2,13.0,4,1,2,50,18,68
p_185,2,0,e_3,392,395,407,0.0,2,0,2.5,4,1,1,3,12,15
p_186,1,0,e_3,391,401,407,2.0,1,0,3.0,4,1,0,10,6,16
p_227,9,0,e_0,326,364,468,6.0,4,1,0.0,3,1,0,38,104,142
p_213,12,0,e_0,347,378,468,29.0,5,5,5.0,5,0,2,31,90,121
p_223,13,0,e_0,339,384,468,30.0,3,3,3.0,5,0,1,45,84,129
p_208,13,0,e_0,355,384,468,26.5,4,4,7.0,5,0,4,29,84,113
p_202,13,0,e_0,365,384,468,24.5,4,4,9.0,5,1,3,19,84,103
p_201,13,0,e_0,366,384,468,24.5,4,4,9.0,5,1,3,18,84,102
p_211,14,0,e_0,348,390,468,27.0,5,5,5.0,5,0,3,42,78,120
p_190,14,0,e_0,382,390,468,20.0,3,3,12.5,5,1,5,8,78,86
p_183,12,0,e_0,393,400,468,20.0,3,3,13.5,4,1,4,7,68,75
p_194,11,0,e_0,377,406,468,24.0,3,3,12.0,5,1,4,29,62,91
p_173,10,0,e_0,405,412,468,20.0,1,1,11.0,1,1,7,7,56,63
p_170,10,0,e_0,408,412,468,10.0,0,0,11.0,4,1,8,4,56,60
p_177,9,0,e_0,398,418,468,22.5,2,2,12.0,4,1,6,20,50,70
p_197,8,0,e_0,375,424,468,28.0,3,3,11.5,5,1,3,49,44,93
p_188,8,0,e_0,390,424,468,25.0,1,1,14.0,2,1,4,34,44,78
p_204,8,0,e_2,364,389,511,30.0,4,4,2.0,5,0,1,25,122,147
p_198,9,0,e_2,368,395,511,28.0,4,4,3.0,5,0,2,27,116,143
p_195,9,0,e_2,376,395,511,26.5,3,3,5.0,5,0,3,19,116,135
p_181,11,0,e_2,395,405,511,21.0,2,2,9.0,2,1,2,10,106,116
p_207,12,0,e_2,355,411,511,28.0,4,4,0.0,3,1,0,56,100,156
p_203,12,0,e_2,365,411,511,26.0,4,4,2.5,5,0,2,46,100,146
p_200,12,0,e_2,367,411,511,25.0,4,4,3.0,5,0,2,44,100,144
p_193,12,0,e_2,378,411,511,23.0,3,3,5.5,5,0,3,33,100,133
p_180,14,0,e_2,396,421,511,18.0,2,2,9.0,5,1,3,25,90,115
p_172,14,0,e_2,405,421,511,16.0,1,1,11.0,5,1,3,16,90,106
p_165,14,0,e_2,416,421,511,14.0,1,0,13.0,5,1,4,5,90,95
p_162,14,0,e_2,417,421,511,13.5,2,0,13.0,5,1,5,4,90,94
p_168,15,0,e_2,412,427,511,15.0,0,0,12.0,5,1,3,15,84,99
p_158,14,0,e_2,426,433,511,11.5,2,0,15.0,5,1,5,7,78,85
p_161,13,0,e_2,418,439,511,12.5,2,0,13.5,5,1,5,21,72,93
p_163,4,0,e_3,417,433,547,6.0,1,1,0.0,5,0,1,16,114,130
p_166,5,0,e_3,415,439,547,5.0,0,0,0.0,3,0,0,24,108,132
p_154,7,0,e_3,438,449,547,4.0,4,1,5.0,2,1,3,11,98,109
p_147,7,0,e_3,450,451,547,2.0,4,1,7.0,5,1,3,1,96,97
p_153,8,0,e_3,438,457,547,3.0,4,0,5.0,5,1,3,19,90,109
p_145,12,0,e_3,451,475,547,5.0,4,0,7.0,2,1,3,24,72,96
p_123,12,0,e_3,474,475,547,2.0,5,1,12.0,2,1,4,1,72,73
p_140,13,0,e_3,455,483,547,5.5,5,0,7.5,5,1,4,28,64,92
p_139,13,0,e_3,456,483,547,5.0,5,0,8.0,2,1,4,27,64,91
p_137,13,0,e_3,458,483,547,5.0,5,0,8.0,5,1,4,25,64,89
p_128,10,0,e_3,471,497,547,4.5,5,2,11.5,5,1,4,26,50,76
p_120,10,0,e_3,481,497,547,3.5,5,1,12.5,5,1,4,16,50,66
p_115,10,0,e_3,494,497,547,0.0,5,0,10.5,4,1,4,3,50,53
p_119,5,0,e_3,483,519,547,8.0,4,0,13.0,2,1,3,36,28,64
p_108,5,0,e_3,509,519,547,2.0,4,0,7.5,4,1,3,10,28,38
p_110,1,0,e_2,501,518,552,8.0,4,2,2.0,4,1,0,17,34,51
p_107,1,0,e_2,512,518,552,5.0,4,2,0.0,3,0,0,6,34,40
p_144,4,0,e_2,451,532,552,13.0,5,2,11.0,4,1,2,81,20,101
p_133,4,0,e_2,463,532,552,13.0,5,2,9.0,4,1,4,69,20,89
p_125,4,0,e_2,474,532,552,10.0,6,1,6.5,4,1,4,58,20,78
p_106,4,0,e_2,512,532,552,2.0,4,1,0.0,5,0,1,20,20,40
p_136,2,0,e_2,460,542,552,15.5,5,2,9.5,4,1,3,82,10,92
p_90,2,0,e_2,536,542,552,30.0,2,2,3.5,4,1,1,6,10,16
p_171,3,0,e_1,408,422,558,3.0,0,0,0.0,3,0,0,14,136,150
p_167,7,0,e_1,412,440,558,7.0,0,0,1.0,5,0,1,28,118,146
p_160,10,0,e_1,421,454,558,9.0,2,0,3.0,2,0,1,33,104,137
p_159,11,0,e_1,424,460,558,9.0,2,0,3.5,5,1,2,36,98,134
p_134,12,0,e_1,462,466,558,5.0,5,1,11.0,5,1,1,4,92,96
p_124,14,0,e_1,474,476,558,2.0,5,0,13.5,5,1,2,2,82,84
p_151,15,0,e_1,443,482,558,9.0,5,0,7.5,5,1,2,39,76,115
p_149,15,0,e_1,444,482,558,9.0,5,0,8.0,5,1,3,38,76,114
p_142,15,0,e_1,452,482,558,8.0,5,0,9.5,5,1,3,30,76,106
p_141,15,0,e_1,455,482,558,7.0,6,0,10.0,5,1,2,27,76,103
p_127,15,0,e_1,473,482,558,3.5,6,0,13.5,5,1,2,9,76,85
p_117,12,0,e_1,490,496,558,29.5,5,5,13.5,4,1,2,6,62,68
p_113,11,0,e_1,496,502,558,29.0,4,4,12.0,4,1,2,6,56,62
p_131,9,0,e_1,467,512,558,7.0,5,2,12.0,5,1,1,45,46,91
p_116,7,0,e_1,490,522,558,4.0,5,1,13.5,4,1,1,32,36,68
p_130,9,0,e_0,469,508,620,6.0,5,2,0.0,3,0,0,39,112,151
p_121,9,0,e_0,480,508,620,4.5,5,1,2.5,5,0,1,28,112,140
p_114,9,0,e_0,494,508,620,1.0,5,0,6.0,5,0,2,14,112,126
p_103,13,0,e_0,517,526,620,22.0,5,5,11.0,5,1,3,9,94,103
p_109,14,0,e_0,506,532,620,24.0,4,4,9.0,5,0,3,26,88,114
p_112,15,0,e_0,497,538,620,25.0,4,4,6.5,5,0,2,41,82,123
p_111,15,0,e_0,501,538,620,24.5,4,4,7.5,5,0,3,37,82,119
p_88,14,0,e_0,538,544,620,17.5,2,2,15.0,2,1,5,6,76,82
p_92,13,0,e_0,533,550,620,20.0,2,2,14.0,5,1,5,17,70,87
p_91,13,0,e_0,535,550,620,19.5,2,2,14.5,5,1,6,15,70,85
p_100,10,0,e_0,522,564,620,24.5,4,4,12.5,5,1,4,42,56,98
p_97,10,0,e_0,526,564,620,24.0,3,3,13.0,2,1,4,38,56,94
p_191,7,0,e_0,382,578,620,27.0,2,2,13.0,5,1,5,196,42,238
p_189,7,0,e_0,387,578,620,26.0,2,2,13.5,5,1,5,191,42,233
p_187,7,0,e_0,391,578,620,25.5,2,2,14.0,4,1,4,187,42,229
p_63,8,0,e_2,581,586,678,13.5,2,2,7.0,5,0,2,5,92,97
p_60,9,0,e_2,584,592,678,12.0,3,2,8.0,5,0,3,8,86,94
p_164,12,0,e_2,416,606,678,12.0,1,0,13.0,5,1,4,190,72,262
p_157,12,0,e_2,427,606,678,9.0,2,0,15.0,4,1,5,179,72,251
p_101,12,0,e_2,521,606,678,23.0,4,4,1.5,5,1,1,85,72,157
p_75,14,0,e_2,563,616,678,12.5,2,1,2.5,5,0,1,53,62,115
p_68,14,0,e_2,574,616,678,9.5,2,1,5.5,5,0,2,42,62,104
p_182,5,0,e_2,394,654,678,27.0,3,3,9.0,5,1,2,260,24,284
p_129,5,0,e_2,470,654,678,10.0,5,2,7.0,4,1,4,184,24,208
p_122,5,0,e_2,477,654,678,9.0,5,1,6.0,1,1,3,177,24,201
p_49,5,0,e_2,592,654,678,14.0,3,2,9.0,5,1,2,62,24,86
p_42,4,0,e_2,600,660,678,13.0,5,2,10.5,5,1,3,60,18,78
p_35,4,0,e_2,640,660,678,4.0,4,2,8.0,4,1,2,20,18,38
p_79,14,0,e_3,549,605,681,16.0,1,1,0.0,5,0,1,56,76,132
p_87,15,0,e_3,539,611,681,16.5,2,2,1.5,4,1,1,72,70,142
p_72,15,0,e_3,569,611,681,9.5,2,0,5.5,5,0,2,42,70,112
p_44,15,0,e_3,598,611,681,2.5,4,0,12.5,5,0,4,13,70,83
p_39,15,0,e_3,609,611,681,0.5,6,0,14.5,5,1,5,2,70,72
p_41,10,0,e_3,600,633,681,7.0,4,2,13.0,5,0,4,33,48,81
p_59,6,0,e_3,584,651,681,15.0,2,2,9.0,5,0,2,67,30,97
p_57,6,0,e_3,587,651,681,14.0,3,2,10.0,5,0,3,64,30,94
p_54,6,0,e_3,590,651,681,13.5,3,2,10.5,5,0,3,61,30,91
p_47,6,0,e_3,594,651,681,12.5,3,2,11.5,5,0,3,57,30,87
p_45,5,0,e_3,597,657,681,13.0,3,2,12.0,5,0,3,60,24,84
p_105,4,0,e_3,515,663,681,1.0,4,0,5.5,4,1,3,148,18,166
p_40,4,0,e_3,601,663,681,12.5,5,2,13.5,5,0,5,62,18,80
p_98,6,0,e_1,524,584,684,28.0,4,4,6.5,4,1,1,60,100,160
p_77,6,0,e_1,557,584,684,21.5,2,2,0.0,3,1,0,27,100,127
p_104,7,0,e_1,516,590,684,28.5,5,5,8.0,4,1,1,74,94,168
p_76,7,0,e_1,559,590,684,20.5,2,2,0.0,5,0,1,31,94,125
p_67,8,0,e_1,574,596,684,15.5,2,2,4.0,5,0,4,22,88,110
p_53,9,0,e_1,590,602,684,10.5,3,2,7.0,2,1,4,12,82,94
p_69,10,0,e_1,573,608,684,13.5,2,2,3.5,5,0,3,35,76,111
p_58,10,0,e_1,586,608,684,10.5,3,2,6.0,5,1,5,22,76,98
p_50,10,0,e_1,592,608,684,9.0,3,2,7.5,5,1,5,16,76,92
p_74,11,0,e_1,567,614,684,14.0,2,2,2.0,5,0,2,47,70,117
p_52,11,0,e_1,591,614,684,8.5,3,2,7.0,5,1,5,23,70,93
p_66,12,0,e_1,577,620,684,11.0,2,2,4.5,5,0,5,43,64,107
p_65,12,0,e_1,578,620,684,10.5,2,2,4.5,5,0,6,42,64,106
p_46,13,0,e_1,596,626,684,5.0,3,2,8.0,5,1,4,30,58,88
p_37,7,0,e_1,633,652,684,3.0,4,0,11.5,4,1,0,19,32,51
p_102,2,0,e_1,521,703,741,3.0,4,2,7.0,4,1,1,182,38,220
p_27,2,0,e_1,693,703,741,2.0,0,0,0.0,3,0,0,10,38,48
p_26,3,0,e_1,698,709,741,3.0,0,0,1.0,5,0,1,11,32,43
p_96,5,0,e_1,527,719,741,28.5,3,3,6.0,4,1,2,192,22,214
p_32,5,0,e_1,657,719,741,30.0,2,2,6.0,4,1,0,62,22,84
p_24,5,0,e_1,707,719,741,5.0,0,0,3.0,5,1,1,12,22,34
p_23,5,0,e_1,709,719,741,5.0,0,0,3.0,5,1,1,10,22,32
p_126,6,0,e_2,473,706,742,8.0,6,1,7.0,4,1,3,233,36,269
p_28,6,0,e_2,679,706,742,24.5,1,1,0.0,3,0,0,27,36,63
p_138,7,0,e_2,456,712,742,11.0,5,2,10.0,1,1,2,256,30,286
p_135,7,0,e_2,461,712,742,10.0,5,2,9.0,4,1,4,251,30,281
p_132,7,0,e_2,463,712,742,10.0,5,2,9.0,4,1,4,249,30,279
p_25,7,0,e_2,703,712,742,7.0,0,0,5.5,5,0,1,9,30,39
p_118,4,0,e_0,488,645,761,8.0,5,2,4.0,5,0,1,157,116,273
p_78,4,0,e_0,555,645,761,24.0,2,2,12.0,4,1,7,90,116,206
p_55,4,0,e_0,590,645,761,15.5,3,2,5.0,1,1,4,55,116,171
p_38,4,0,e_0,627,645,761,7.0,5,3,0.0,3,0,0,18,116,134
p_33,8,0,e_0,647,663,761,28.5,4,4,4.0,5,1,2,16,98,114
p_36,11,0,e_0,635,677,761,28.5,4,4,1.5,5,0,1,42,84,126
p_34,15,0,e_0,643,695,761,22.5,4,4,3.5,5,0,2,52,66,118
p_29,15,0,e_0,678,695,761,15.5,1,1,11.0,5,1,2,17,66,83
p_22,10,0,e_0,712,717,761,10.0,0,0,11.0,4,1,1,5,44,49
p_192,5,0,e_0,380,739,761,29.5,3,3,12.5,5,1,4,359,22,381
p_184,5,0,e_0,393,739,761,27.0,3,3,13.5,4,1,4,346,22,368
p_178,5,0,e_0,398,739,761,26.5,2,2,12.5,4,1,6,341,22,363
p_83,5,0,e_0,546,739,761,25.0,2,2,13.5,4,1,6,193,22,215
p_62,5,0,e_0,582,739,761,16.5,2,2,6.0,4,1,6,157,22,179
p_61,5,0,e_0,583,739,761,16.5,2,2,6.0,1,1,5,156,22,178
p_175,2,0,e_0,399,778,788,29.0,2,2,12.0,4,1,7,379,10,389
p_143,2,0,e_0,451,778,788,15.0,5,2,3.0,1,1,1,327,10,337
p_81,2,0,e_0,547,778,788,28.0,1,1,13.5,4,1,7,231,10,241
p_71,2,0,e_0,569,778,788,23.0,2,2,9.0,4,1,6,209,10,219
p_56,2,0,e_0,588,778,788,18.0,3,2,5.5,4,1,5,190,10,200
p_48,2,0,e_0,593,778,788,17.0,3,2,4.5,4,1,4,185,10,195
p_18,2,0,e_0,768,778,788,13.5,3,3,0.0,3,0,0,10,10,20
p_8,1,0,e_2,847,853,859,4.0,1,0,0.0,3,0,0,6,6,12
p_9,2,0,e_1,845,855,865,3.0,1,0,0.0,3,0,0,10,10,20
p_20,9,0,e_3,737,770,868,10.0,1,1,1.0,5,0,1,33,98,131
p_21,10,0,e_3,732,776,868,10.0,0,0,0.0,3,0,0,44,92,136
p_19,12,0,e_3,740,786,868,10.0,2,0,2.0,5,0,2,46,82,128
p_16,13,0,e_3,774,792,868,7.0,4,1,10.0,5,1,3,18,76,94
p_17,15,0,e_3,772,802,868,6.0,3,0,9.0,5,1,2,30,66,96
p_15,15,0,e_3,782,802,868,4.0,4,0,11.0,5,1,3,20,66,86
p_14,15,0,e_3,790,802,868,2.0,3,0,13.0,5,1,2,12,66,78
p_12,13,0,e_3,796,812,868,3.0,3,1,14.0,5,1,2,16,56,72
p_13,11,0,e_3,794,822,868,6.0,2,1,13.0,5,1,1,28,46,74
p_11,11,0,e_3,810,822,868,2.0,3,0,13.0,4,1,2,12,46,58
p_205,1,0,e_1,362,871,877,7.0,4,2,8.0,4,1,3,509,6,515
p_4,1,0,e_1,864,871,877,30.0,1,1,0.0,3,1,0,7,6,13
p_3,1,0,e_1,876,883,889,1.0,0,0,0.0,3,1,0,7,6,13
p_5,5,0,e_2,860,883,905,26.5,1,1,0.0,3,0,0,23,22,45
p_155,3,0,e_3,434,892,906,3.0,3,1,4.0,5,1,2,458,14,472
p_2,3,0,e_3,878,892,906,3.0,0,0,0.0,3,0,0,14,14,28
p_1,2,0,e_1,889,899,909,1.5,1,1,0.0,3,1,0,10,10,20
p_7,12,0,e_0,851,861,929,22.0,1,1,9.5,5,0,1,10,68,78
p_10,14,0,e_0,810,871,929,29.0,3,3,0.0,3,0,0,61,58,119
p_6,14,0,e_0,858,871,929,18.5,1,1,11.5,5,0,2,13,58,71
p_7,2,0,e_3,55,66,76,2.0,0,0,0.0,3,0,0,11,10,21
p_3,4,0,e_2,25,44,108,4.0,0,0,0.0,3,0,0,19,64,83
p_4,5,0,e_2,34,50,108,5.0,0,0,1.5,5,0,1,16,58,74
p_5,9,0,e_2,41,68,108,9.0,0,0,3.5,5,0,2,27,40,67
p_6,9,0,e_2,45,68,108,9.0,0,0,4.0,5,1,2,23,40,63
p_11,4,0,e_2,84,90,108,4.0,0,0,5.0,4,1,0,6,18,24
p_2,11,0,e_1,19,66,114,11.0,0,0,0.0,3,0,0,47,48,95
p_9,10,0,e_1,67,72,114,22.0,1,1,11.0,4,1,0,5,42,47
p_12,0,8,e_3,86,87,123,0.0,0,0,0.0,3,0,0,1,36,37
p_1,13,0,e_0,13,68,148,13.0,0,0,0.0,3,0,0,55,80,135
p_8,15,0,e_0,62,78,148,14.0,1,0,11.5,5,0,1,16,70,86
p_10,9,0,e_0,77,104,148,9.0,0,0,15.0,5,1,1,27,44,71
p_13,8,0,e_0,87,110,148,18.0,3,1,13.0,4,1,1,23,38,61
p_15,5,0,e_0,99,124,148,19.0,2,2,10.0,4,1,2,25,24,49
p_16,4,0,e_0,101,130,148,19.0,2,2,9.5,4,1,3,29,18,47
p_19,0,7,e_1,125,126,160,21.5,2,2,0.0,3,0,0,1,34,35
p_21,0,10,e_0,142,148,190,17.5,2,2,1.0,4,1,0,6,42,48
p_22,6,0,e_1,146,154,192,11.0,2,1,4.0,5,1,1,8,38,46
p_20,3,0,e_1,142,178,192,14.5,2,2,3.0,5,1,0,36,14,50
p_17,10,0,e_2,112,154,198,10.5,2,1,0.0,3,0,0,42,44,86
p_26,6,0,e_2,169,172,198,6.0,2,1,6.5,4,1,0,3,26,29
p_30,2,0,e_1,200,211,223,3.0,2,0,0.0,3,0,0,11,12,23
p_33,1,0,e_1,213,217,223,1.0,1,0,1.5,4,1,0,4,6,10
p_14,13,0,e_3,87,145,225,13.0,1,1,0.0,3,0,1,58,80,138
p_18,15,0,e_3,120,155,225,7.5,2,0,7.5,5,1,1,35,70,105
p_23,15,0,e_3,150,155,225,1.0,2,0,14.0,5,1,1,5,70,75
p_24,14,0,e_3,157,161,225,0.0,1,0,14.5,4,1,0,4,64,68
p_25,9,0,e_3,163,183,225,5.0,1,0,14.0,4,1,0,20,42,62
p_28,7,0,e_3,184,193,225,2.0,2,0,9.0,4,1,1,9,32,41
p_27,5,0,e_3,180,203,225,4.0,2,0,9.5,4,1,1,23,22,45
p_31,5,0,e_2,203,225,247,30.0,1,1,0.0,3,0,0,22,22,44
p_35,0,6,e_1,222,223,249,0.5,1,0,0.0,4,1,0,1,26,27
p_32,0,10,e_1,209,223,267,4.0,1,0,2.0,5,0,1,14,44,58
p_29,14,0,e_0,192,210,270,23.0,3,3,10.0,3,0,0,18,60,78
p_34,11,0,e_0,217,224,270,20.5,1,1,12.5,4,1,0,7,46,53
p_43,4,0,e_0,270,288,306,15.5,2,1,0.0,3,1,0,18,18,36
p_42,4,0,e_2,269,275,323,15.5,2,1,3.0,5,0,1,6,48,54
p_44,4,0,e_2,275,275,323,14.5,2,1,4.0,3,0,1,0,48,48
p_41,7,0,e_2,257,291,323,15.5,2,1,0.0,3,0,0,34,32,66
p_47,3,0,e_2,293,309,323,11.0,3,2,7.0,4,1,0,16,14,30
p_49,3,0,e_2,298,309,323,10.0,3,2,5.5,4,1,1,11,14,25
p_51,0,4,e_0,309,309,329,10.5,2,0,0.0,3,0,0,0,20,20
p_36,1,0,e_3,225,231,361,1.0,0,0,0.0,3,1,0,6,130,136
p_37,15,0,e_3,228,289,361,14.5,1,0,0.5,5,0,1,61,72,133
p_45,11,0,e_3,290,307,361,4.0,1,0,15.0,4,1,0,17,54,71
p_50,11,0,e_3,299,307,361,1.0,3,0,12.5,4,1,2,8,54,62
p_46,8,0,e_3,291,321,361,6.0,2,1,14.5,4,1,1,30,40,70
p_53,8,0,e_3,313,321,361,1.0,2,0,9.5,4,1,1,8,40,48
p_54,7,0,e_3,313,327,361,2.0,2,1,9.5,4,1,1,14,34,48
p_59,3,0,e_3,335,345,361,2.0,1,0,5.0,4,1,0,10,16,26
p_62,1,0,e_3,345,355,361,2.0,1,0,3.0,4,1,0,10,6,16
p_38,12,0,e_1,240,277,361,15.0,2,1,4.0,5,2,0,37,84,121
p_39,13,0,e_1,247,283,361,12.0,2,1,5.5,5,2,1,36,78,114
p_40,15,0,e_1,255,293,361,8.5,2,0,7.5,5,1,2,38,68,106
p_48,9,0,e_1,294,319,361,5.0,3,1,15.0,4,1,0,25,42,67
p_60,2,0,e_1,338,349,361,2.0,2,1,4.5,4,1,1,11,12,23
p_57,1,0,e_1,327,355,361,6.0,1,0,7.5,4,1,0,28,6,34
p_58,0,6,e_3,330,361,387,6.5,1,0,6.5,4,1,0,31,26,57
p_63,3,0,e_1,364,378,392,8.5,1,1,0.0,3,0,0,14,14,28
p_70,3,0,e_3,398,404,420,1.0,1,0,4.0,4,0,1,6,16,22
p_68,2,0,e_3,389,410,420,4.0,0,0,6.0,3,0,0,21,10,31
p_69,2,0,e_3,391,410,420,4.0,1,0,6.0,4,0,1,19,10,29
p_65,0,7,e_1,369,392,422,10.5,1,1,1.0,5,0,2,23,30,53
p_56,8,0,e_2,324,359,429,29.5,2,2,0.0,3,0,0,35,70,105
p_61,12,0,e_2,341,377,429,21.5,2,2,4.0,5,0,1,36,52,88
p_66,11,0,e_2,376,383,429,7.5,1,0,12.0,5,1,1,7,46,53
p_52,14,0,e_0,312,371,431,26.0,2,2,0.0,5,1,0,59,60,119
p_55,14,0,e_0,314,371,431,25.5,3,3,0.5,5,1,1,57,60,117
p_67,12,0,e_0,377,381,431,8.5,1,0,12.5,4,1,0,4,50,54
p_64,0,15,e_1,365,392,456,11.0,1,1,0.0,5,0,1,27,64,91
p_75,3,0,e_0,438,452,466,14.0,1,1,0.0,3,0,0,14,14,28
p_77,4,0,e_2,455,474,492,9.0,2,1,0.0,3,0,0,19,18,37
p_81,1,0,e_0,493,499,505,10.0,1,0,0.0,3,0,0,6,6,12
p_71,7,0,e_1,403,422,522,24.0,2,2,2.5,5,2,0,19,100,119
p_79,9,0,e_1,457,482,522,7.5,3,2,15.0,4,1,1,25,40,65
p_72,6,0,e_1,417,496,522,24.5,1,1,6.0,5,2,0,79,26,105
p_73,3,0,e_3,423,438,538,3.0,0,0,0.0,3,0,0,15,100,115
p_74,10,0,e_3,424,468,538,10.0,1,1,0.0,3,0,1,44,70,114
p_76,10,0,e_3,440,468,538,7.0,2,0,3.0,5,1,1,28,70,98
p_78,12,0,e_3,455,478,538,5.0,2,0,7.0,5,1,1,23,60,83
p_80,13,0,e_3,474,484,538,1.5,2,0,11.5,5,1,1,10,54,64
p_82,0,12,e_2,494,495,547,11.0,1,0,0.0,3,0,0,1,52,53
p_83,0,12,e_0,501,505,559,9.0,1,0,0.5,4,1,0,4,54,58
p_90,1,0,e_3,538,545,577,1.0,0,0,0.0,3,0,0,7,32,39
p_93,4,0,e_3,543,559,577,3.5,1,0,0.5,5,0,1,16,18,34
p_87,3,0,e_1,528,542,578,29.0,1,1,0.0,3,0,0,14,36,50
p_89,5,0,e_1,535,552,578,25.5,1,1,1.5,5,0,1,17,26,43
p_97,5,0,e_1,552,552,578,6.5,3,1,5.0,2,1,1,0,26,26
p_94,3,0,e_1,546,564,578,4.0,2,1,4.0,5,1,1,18,14,32
p_88,10,0,e_0,531,547,615,21.5,1,1,6.0,5,1,0,16,68,84
p_92,10,0,e_0,540,547,615,10.0,1,0,8.5,5,1,1,7,68,75
p_95,10,0,e_0,547,549,615,8.5,2,0,10.0,5,2,0,2,66,68
p_100,10,0,e_0,557,569,615,6.5,4,0,11.5,5,2,1,12,46,58
p_99,9,0,e_0,556,575,615,5.5,4,0,11.5,5,2,0,19,40,59
p_101,9,0,e_0,566,575,615,23.5,3,3,10.5,4,1,2,9,40,49
p_106,5,0,e_0,583,593,615,21.5,3,3,7.5,4,1,0,10,22,32
p_84,12,0,e_2,504,547,621,26.5,1,1,1.5,5,1,0,43,74,117
p_85,14,0,e_2,517,557,621,21.0,1,1,5.0,5,1,0,40,64,104
p_86,14,0,e_2,518,557,621,20.5,1,1,5.0,5,1,1,39,64,103
p_91,14,0,e_2,539,557,621,14.0,1,0,10.0,5,1,1,18,64,82
p_108,7,0,e_2,584,587,621,19.5,3,1,7.5,4,1,1,3,34,37
p_107,3,0,e_2,584,605,621,23.5,3,3,7.5,4,1,0,21,16,37
p_111,2,0,e_2,607,611,621,19.5,4,3,2.5,4,1,0,4,10,14
p_98,6,0,e_3,555,603,703,4.5,3,1,3.5,5,1,2,48,100,148
p_96,7,0,e_3,551,609,703,4.5,2,0,2.5,5,1,1,58,94,152
p_109,10,0,e_3,590,623,703,15.0,3,1,3.0,5,0,3,33,80,113
p_103,14,0,e_3,577,641,703,14.0,2,2,0.0,3,1,2,64,62,126
p_116,7,0,e_3,633,671,703,8.5,2,1,12.5,5,1,1,38,32,70
p_122,7,0,e_3,657,671,703,3.0,3,0,10.0,4,1,2,14,32,46
p_121,3,0,e_3,656,689,703,7.0,2,1,10.5,4,1,1,33,14,47
p_112,11,0,e_1,613,624,706,9.0,3,1,8.5,5,0,2,11,82,93
p_105,12,0,e_1,582,630,706,15.0,3,1,1.0,5,0,1,48,76,124
p_110,12,0,e_1,590,630,706,13.0,4,1,3.0,5,0,2,40,76,116
p_114,13,0,e_1,632,636,706,3.0,2,1,12.0,5,1,1,4,70,74
p_102,14,0,e_1,568,642,706,18.0,3,3,2.5,4,1,0,74,64,138
p_104,14,0,e_1,581,642,706,13.0,3,0,0.5,5,0,1,61,64,125
p_118,8,0,e_1,649,668,706,4.0,2,0,12.5,4,1,0,19,38,57
p_119,8,0,e_1,650,668,706,4.0,2,0,12.5,4,1,1,18,38,56
p_124,7,0,e_1,664,674,706,1.0,3,0,8.5,4,1,1,10,32,42
p_126,1,0,e_1,681,700,706,3.0,2,1,5.5,4,1,0,19,6,25
p_113,9,0,e_0,629,667,707,7.5,2,1,0.0,3,0,0,38,40,78
p_125,2,0,e_0,668,697,707,5.0,3,1,9.0,4,1,0,29,10,39
p_123,0,2,e_1,661,706,716,9.5,3,0,9.5,4,1,1,45,10,55
p_117,0,2,e_0,636,707,717,15.0,3,3,1.5,5,0,1,71,10,81
p_115,9,0,e_2,632,670,746,7.0,2,1,0.0,3,0,0,38,76,114
p_120,13,0,e_2,653,688,746,28.0,2,2,5.0,5,0,1,35,58,93
p_127,7,0,e_2,701,714,746,23.5,1,1,10.0,4,1,0,13,32,45
p_129,5,0,e_2,705,724,746,5.0,1,1,9.0,4,1,1,19,22,41
p_128,0,15,e_1,705,706,770,0.0,1,1,0.0,4,1,0,1,64,65
p_139,0,15,e_2,758,758,822,15.5,3,3,0.0,3,0,0,0,64,64
p_132,4,0,e_0,730,732,824,12.0,1,1,3.5,5,0,1,2,92,94
p_133,6,0,e_0,734,742,824,9.0,1,1,4.0,5,1,1,8,82,90
p_131,7,0,e_0,722,748,824,11.0,1,1,2.0,3,0,0,26,76,102
p_135,11,0,e_0,739,766,824,9.0,2,1,5.5,5,1,2,27,58,85
p_138,12,0,e_0,756,772,824,4.0,3,2,8.5,5,1,1,16,52,68
p_141,12,0,e_0,770,772,824,1.0,2,0,12.0,5,1,1,2,52,54
p_143,5,0,e_0,780,802,824,6.0,2,0,10.0,4,1,0,22,22,44
p_130,11,0,e_3,705,751,829,11.0,0,0,0.0,3,0,0,46,78,124
p_137,13,0,e_3,755,761,829,3.0,2,1,12.0,5,1,1,6,68,74
p_134,14,0,e_3,734,767,829,7.0,1,0,7.0,5,0,1,33,62,95
p_136,14,0,e_3,749,767,829,3.0,2,0,11.0,5,0,2,18,62,80
p_140,5,0,e_3,768,805,829,9.0,1,0,14.0,4,1,0,37,24,61
p_145,1,0,e_3,820,823,829,0.0,1,0,1.5,4,1,0,3,6,9
p_142,13,0,e_1,773,784,838,29.5,2,2,15.0,3,0,0,11,54,65
p_144,6,0,e_2,815,860,890,26.5,1,1,13.5,5,1,0,45,30,75
p_147,6,0,e_2,849,860,890,6.0,0,0,8.5,4,0,1,11,30,41
p_150,3,0,e_2,860,874,890,9.0,1,1,6.0,4,1,0,14,16,30
p_152,2,0,e_2,868,880,890,8.0,1,1,4.5,4,1,1,12,10,22
p_154,4,0,e_3,874,877,913,4.5,1,1,3.5,5,0,1,3,36,39
p_149,6,0,e_3,859,887,913,6.0,0,0,0.0,3,0,0,28,26,54
p_153,6,0,e_3,872,887,913,3.0,1,0,3.0,5,0,1,15,26,41
p_158,7,0,e_2,892,923,953,28.0,1,1,0.0,3,0,0,31,30,61
p_146,10,0,e_0,846,888,954,10.0,0,0,0.0,3,0,0,42,66,108
p_155,11,0,e_0,884,894,954,5.5,2,0,9.5,5,0,2,10,60,70
p_151,12,0,e_0,863,900,954,11.5,1,0,4.0,5,0,1,37,54,91
p_156,12,0,e_0,884,900,954,6.5,2,0,9.0,5,0,2,16,54,70
p_159,8,0,e_0,893,918,954,27.0,1,1,11.0,2,1,2,25,36,61
p_157,7,0,e_0,889,924,954,28.5,1,1,10.0,5,1,2,35,30,65
p_148,15,0,e_1,849,912,974,15.0,0,0,0.0,3,0,0,63,62,125
p_7,2,0,e_3,55,65,75,2.0,0,0,0.0,3,0,0,10,10,20
p_3,4,0,e_2,25,44,108,4.0,0,0,0.0,3,0,0,19,64,83
p_4,5,0,e_2,34,50,108,5.0,0,0,1.5,5,0,1,16,58,74
p_5,9,0,e_2,41,68,108,9.0,0,0,3.5,5,0,2,27,40,67
p_6,9,0,e_2,45,68,108,9.0,0,0,4.0,5,1,2,23,40,63
p_11,4,0,e_2,84,90,108,12.5,1,1,5.5,4,1,0,6,18,24
p_2,11,0,e_1,19,65,113,11.0,0,0,0.0,3,0,0,46,48,94
p_9,10,0,e_1,67,71,113,21.5,1,1,10.5,4,1,0,4,42,46
p_12,0,8,e_2,86,108,142,16.0,1,1,4.5,4,1,1,22,34,56
p_1,13,0,e_0,13,67,145,13.0,0,0,0.0,3,0,0,54,78,132
p_8,15,0,e_0,62,77,145,13.5,1,0,12.0,5,0,1,15,68,83
p_13,8,0,e_0,87,107,145,16.0,2,2,13.0,4,1,0,20,38,58
p_15,5,0,e_0,99,121,145,16.0,2,2,10.0,4,1,1,22,24,46
p_16,4,0,e_0,101,127,145,16.5,2,2,9.5,4,1,2,26,18,44
p_19,0,7,e_1,125,126,158,19.0,3,3,0.0,3,0,0,1,32,33
p_22,6,0,e_2,146,156,182,9.0,1,0,8.0,3,0,0,10,26,36
p_21,0,10,e_0,142,145,187,15.5,2,2,0.5,4,1,0,3,42,45
p_10,9,0,e_3,77,115,215,9.0,0,0,0.0,3,0,0,38,100,138
p_17,10,0,e_3,112,121,215,7.5,2,1,8.5,5,0,2,9,94,103
p_14,13,0,e_3,87,135,215,11.0,1,0,2.0,5,0,1,48,80,128
p_18,15,0,e_3,120,145,215,5.0,2,0,10.0,2,1,1,25,70,95
p_25,9,0,e_3,163,171,215,2.0,1,0,11.0,4,1,0,8,44,52
p_26,6,0,e_3,169,185,215,3.0,2,0,9.5,4,1,1,16,30,46
p_27,5,0,e_3,180,191,215,2.0,2,1,7.0,4,1,1,11,24,35
p_30,2,0,e_3,200,205,215,1.0,1,0,3.0,4,1,0,5,10,15
p_28,7,0,e_0,184,201,235,29.0,2,2,9.5,5,1,0,17,34,51
p_31,5,0,e_0,203,211,235,27.5,2,2,6.5,4,1,0,8,24,32
p_33,1,0,e_0,213,229,235,29.0,1,1,4.5,4,1,0,16,6,22
p_36,1,0,e_0,225,229,235,11.0,1,1,2.0,4,1,1,4,6,10
p_35,0,6,e_3,222,222,250,0.0,0,0,0.0,3,0,0,0,28,28
p_32,0,10,e_2,209,210,254,1.5,1,0,0.0,3,0,0,1,44,45
p_24,14,0,e_1,157,188,260,28.5,1,1,7.0,5,1,2,31,72,103
p_23,15,0,e_1,150,194,260,29.0,1,1,5.5,5,1,1,44,66,110
p_29,14,0,e_1,192,200,260,21.0,1,1,14.5,5,1,2,8,60,68
p_20,3,0,e_1,142,246,260,12.5,2,1,3.0,5,1,0,104,14,118
p_42,4,0,e_1,269,287,305,11.5,2,2,0.0,3,0,0,18,18,36
p_43,4,0,e_1,270,287,305,11.0,2,2,0.0,5,0,1,17,18,35
p_44,4,0,e_1,275,287,305,10.0,1,1,1.5,5,0,1,12,18,30
p_41,7,0,e_0,257,288,320,11.5,2,2,0.0,3,0,0,31,32,63
p_47,3,0,e_0,293,306,320,8.0,2,1,6.0,4,1,0,13,14,27
p_49,3,0,e_0,298,306,320,6.0,3,1,4.5,4,1,1,8,14,22
p_51,0,4,e_0,309,320,338,8.0,1,0,2.5,4,1,0,11,18,29
p_34,11,0,e_2,217,260,342,11.0,0,0,1.0,5,1,0,43,82,125
p_37,15,0,e_2,228,278,342,14.0,1,0,4.0,5,1,1,50,64,114
p_40,15,0,e_2,255,278,342,8.0,2,0,10.0,5,0,2,23,64,87
p_57,1,0,e_2,327,336,342,2.0,1,0,3.0,4,1,0,9,6,15
p_38,12,0,e_3,240,276,342,8.5,1,0,3.5,5,1,0,36,66,102
p_39,13,0,e_3,247,282,342,7.5,2,0,5.5,5,1,1,35,60,95
p_45,11,0,e_3,290,292,342,0.0,1,0,11.5,4,1,0,2,50,52
p_48,9,0,e_3,294,302,342,1.0,2,0,10.5,4,1,1,8,40,48
p_46,8,0,e_3,291,308,342,3.0,1,0,11.0,1,1,0,17,34,51
p_62,1,0,e_2,345,352,358,10.5,1,1,0.0,3,0,0,7,6,13
p_58,0,6,e_3,330,342,368,2.5,1,0,2.5,4,1,0,12,26,38
p_65,0,7,e_3,369,396,428,6.0,0,0,6.0,3,0,0,27,32,59
p_56,8,0,e_0,324,356,428,26.0,1,1,1.0,5,1,0,32,72,104
p_61,12,0,e_0,341,374,428,18.0,1,1,4.5,5,0,3,33,54,87
p_59,3,0,e_0,335,412,428,28.5,1,1,3.5,5,1,1,77,16,93
p_70,3,0,e_0,398,412,428,11.0,1,1,6.0,4,1,2,14,16,30
p_60,2,0,e_0,338,418,428,28.5,1,1,4.0,5,0,2,80,10,90
p_54,7,0,e_1,313,335,431,30.0,1,1,1.5,5,0,2,22,96,118
p_53,8,0,e_1,313,341,431,29.0,1,1,2.0,5,0,3,28,90,118
p_50,11,0,e_1,299,355,431,28.5,3,3,1.0,4,1,0,56,76,132
p_52,14,0,e_1,312,369,431,23.0,1,1,1.5,5,0,1,57,62,119
p_55,14,0,e_1,314,369,431,23.0,1,1,2.0,5,0,4,55,62,117
p_66,11,0,e_1,376,383,431,23.5,1,1,12.5,4,1,0,7,48,55
p_68,2,0,e_1,389,421,431,29.5,1,1,10.0,4,1,0,32,10,42
p_69,2,0,e_1,391,421,431,29.0,1,1,9.0,4,1,1,30,10,40
p_64,0,15,e_2,365,367,433,6.5,1,1,0.0,5,0,1,2,66,68
p_75,3,0,e_0,438,452,466,7.5,3,1,0.0,3,0,0,14,14,28
p_72,6,0,e_3,417,422,486,3.0,1,1,5.0,5,1,0,5,64,69
p_71,7,0,e_3,403,428,486,5.5,1,0,1.5,5,1,0,25,58,83
p_74,10,0,e_3,424,442,486,3.5,3,0,6.5,5,2,1,18,44,62
p_76,10,0,e_3,440,442,486,0.5,3,0,9.5,5,1,2,2,44,46
p_73,3,0,e_3,423,472,486,5.0,2,1,6.0,5,2,0,49,14,63
p_63,3,0,e_2,364,381,497,3.5,1,1,0.0,3,0,0,17,116,133
p_67,12,0,e_2,377,419,497,22.5,1,1,2.5,5,1,1,42,78,120
p_79,9,0,e_2,457,459,497,27.5,2,2,9.5,4,1,0,2,38,40
p_81,1,0,e_0,493,499,505,1.0,0,0,0.0,3,0,0,6,6,12
p_82,0,12,e_3,494,495,547,0.0,0,0,0.0,3,0,0,1,52,53
p_83,0,12,e_2,501,501,555,23.5,1,1,0.0,3,0,0,0,54,54
p_87,3,0,e_0,528,543,559,17.5,2,2,0.0,3,0,0,15,16,31
p_90,1,0,e_0,538,553,559,17.0,2,2,2.0,5,0,1,15,6,21
p_77,4,0,e_1,455,473,573,3.0,2,0,0.0,3,0,0,18,100,118
p_78,12,0,e_1,455,507,573,25.0,2,2,0.0,5,0,1,52,66,118
p_84,12,0,e_1,504,507,573,10.5,1,0,11.5,5,1,2,3,66,69
p_80,13,0,e_1,474,513,573,20.0,1,1,4.0,5,1,1,39,60,99
p_89,5,0,e_1,535,547,573,13.5,2,2,7.5,4,1,0,12,26,38
p_93,4,0,e_1,543,553,573,13.0,2,2,6.0,4,1,1,10,20,30
p_94,3,0,e_1,546,559,573,13.0,1,1,5.0,4,1,2,13,14,27
p_88,10,0,e_2,531,545,619,10.0,2,2,6.5,5,1,0,14,74,88
p_92,10,0,e_2,540,545,619,7.5,2,2,9.0,5,1,1,5,74,79
p_95,10,0,e_2,547,565,619,6.0,1,1,10.0,5,2,0,18,54,72
p_99,9,0,e_2,556,571,619,23.0,0,0,12.0,4,1,4,15,48,63
p_101,9,0,e_2,566,571,619,3.0,2,1,10.0,4,1,4,5,48,53
p_96,7,0,e_2,551,581,619,8.0,1,1,11.5,5,2,1,30,38,68
p_98,6,0,e_2,555,587,619,8.5,1,1,12.0,2,2,3,32,32,64
p_97,5,0,e_2,552,593,619,10.0,1,1,11.5,5,2,2,41,26,67
p_106,5,0,e_2,583,593,619,3.0,1,0,6.5,4,1,2,10,26,36
p_107,3,0,e_2,584,603,619,5.0,2,1,6.5,4,1,2,19,16,35
p_111,2,0,e_2,607,609,619,1.0,1,0,2.5,4,1,0,2,10,12
p_85,14,0,e_3,517,557,619,9.5,1,0,4.5,5,1,0,40,62,102
p_86,14,0,e_3,518,557,619,9.0,2,0,5.0,5,1,1,39,62,101
p_91,14,0,e_3,539,557,619,3.5,2,0,10.5,5,1,1,18,62,80
p_100,10,0,e_3,557,575,619,4.0,1,0,14.0,4,1,0,18,44,62
p_108,7,0,e_3,584,589,619,1.0,1,0,8.0,4,1,0,5,30,35
p_117,0,2,e_3,636,636,648,0.0,0,0,0.0,3,0,0,0,12,12
p_121,3,0,e_3,656,663,677,1.0,0,0,2.0,3,0,0,7,14,21
p_123,0,2,e_3,661,677,687,3.0,1,1,3.0,5,0,1,16,10,26
p_112,11,0,e_1,613,629,693,20.0,1,1,7.0,5,0,1,16,64,80
p_105,12,0,e_1,582,635,693,26.5,1,1,0.0,3,0,0,53,58,111
p_110,12,0,e_1,590,635,693,25.0,1,1,1.5,5,0,1,45,58,103
p_115,9,0,e_1,632,649,693,9.0,0,0,11.5,5,1,1,17,44,61
p_118,8,0,e_1,649,655,693,6.0,0,0,9.0,4,1,0,6,38,44
p_125,2,0,e_1,668,681,693,30.0,1,1,5.0,4,1,0,13,12,25
p_126,1,0,e_1,681,687,693,2.5,1,1,2.0,4,1,0,6,6,12
p_109,10,0,e_0,590,610,694,27.0,1,1,5.5,5,0,1,20,84,104
p_102,14,0,e_0,568,628,694,27.5,2,2,0.0,3,0,0,60,66,126
p_103,14,0,e_0,577,628,694,26.0,1,1,2.0,5,0,1,51,66,117
p_104,14,0,e_0,581,628,694,24.5,1,1,3.0,5,0,1,47,66,113
p_114,13,0,e_0,632,634,694,13.0,0,0,13.5,4,1,1,2,60,62
p_113,9,0,e_0,629,652,694,9.0,0,0,14.0,4,1,0,23,42,65
p_119,8,0,e_0,650,658,694,6.0,0,0,9.5,4,1,1,8,36,44
p_122,7,0,e_0,657,664,694,5.0,1,1,8.0,1,1,0,7,30,37
p_116,7,0,e_2,633,663,747,7.0,0,0,0.0,3,0,0,30,84,114
p_124,7,0,e_2,664,665,747,26.0,1,1,7.0,5,1,1,1,82,83
p_120,13,0,e_2,653,691,747,11.0,0,0,5.0,5,0,1,38,56,94
p_127,7,0,e_2,701,717,747,5.0,0,0,11.0,4,1,0,16,30,46
p_128,0,15,e_0,705,706,770,2.0,2,2,0.0,3,0,0,1,64,65
p_139,0,15,e_2,758,758,822,15.0,3,3,0.0,3,0,0,0,64,64
p_129,5,0,e_3,705,720,824,3.0,1,1,2.0,3,0,1,15,104,119
p_130,11,0,e_3,705,746,824,9.0,0,0,2.0,3,0,0,41,78,119
p_137,13,0,e_3,755,756,824,2.0,2,1,13.0,5,1,1,1,68,69
p_134,14,0,e_3,734,762,824,5.5,2,0,8.5,5,1,1,28,62,90
p_136,14,0,e_3,749,762,824,2.5,2,0,11.5,5,1,1,13,62,75
p_138,12,0,e_3,756,772,824,3.0,2,1,13.0,2,1,1,16,52,68
p_143,5,0,e_3,780,802,824,5.0,1,0,10.5,4,1,0,22,22,44
p_132,4,0,e_1,730,740,834,10.5,2,1,2.0,5,0,1,10,94,104
p_133,6,0,e_1,734,750,834,8.0,2,1,2.5,5,0,2,16,84,100
p_131,7,0,e_1,722,756,834,10.0,2,1,0.0,3,0,0,34,78,112
p_135,11,0,e_1,739,774,834,7.5,3,1,4.0,5,0,3,35,60,95
p_141,12,0,e_1,770,780,834,30.0,2,2,10.5,5,1,2,10,54,64
p_140,5,0,e_1,768,810,834,8.0,2,1,9.5,5,1,1,42,24,66
p_145,1,0,e_1,820,828,834,30.0,1,1,3.0,4,1,0,8,6,14
p_142,13,0,e_0,773,784,838,29.0,1,1,15.0,3,0,0,11,54,65
p_144,6,0,e_2,815,860,890,26.0,1,1,13.5,5,1,0,45,30,75
p_147,6,0,e_2,849,860,890,6.0,0,0,8.5,4,0,1,11,30,41
p_150,3,0,e_2,860,874,890,3.0,1,1,6.0,1,0,0,14,16,30
p_152,2,0,e_2,868,880,890,8.0,1,1,4.5,4,1,1,12,10,22
p_154,4,0,e_3,874,878,914,4.5,1,1,3.5,5,0,1,4,36,40
p_149,6,0,e_3,859,888,914,6.0,0,0,0.0,3,0,0,29,26,55
p_153,6,0,e_3,872,888,914,3.0,1,0,3.0,5,0,1,16,26,42
p_157,7,0,e_2,889,920,950,29.0,1,1,0.0,3,1,0,31,30,61
p_158,7,0,e_2,892,920,950,28.0,1,1,0.5,5,0,1,28,30,58
p_146,10,0,e_0,846,889,953,10.0,0,0,0.0,3,0,0,43,64,107
p_155,11,0,e_0,884,895,953,5.5,2,0,9.0,5,0,2,11,58,69
p_151,12,0,e_0,863,901,953,11.5,1,0,3.5,5,0,1,38,52,90
p_156,12,0,e_0,884,901,953,6.5,2,0,9.0,5,0,3,17,52,69
p_159,8,0,e_0,893,919,953,27.0,1,1,11.0,5,1,2,26,34,60
p_148,15,0,e_1,849,911,973,15.0,0,0,0.0,3,0,0,62,62,124
p_296,1,0,e_3,20,27,33,1.0,0,0,0.0,3,0,0,7,6,13
p_299,3,0,e_1,7,22,36,3.0,0,0,0.0,3,0,0,15,14,29
p_288,1,0,e_3,49,50,88,6.0,1,1,1.0,5,0,1,1,38,39
p_285,2,0,e_3,54,56,88,4.5,3,2,1.5,5,1,2,2,32,34
p_286,3,0,e_3,51,62,88,4.0,2,1,1.0,5,1,1,11,26,37
p_290,4,0,e_3,43,68,88,4.0,0,0,0.0,3,0,0,25,20,45
p_279,2,0,e_3,76,78,88,0.0,2,0,2.5,4,1,1,2,10,12
p_300,8,0,e_0,4,39,139,8.0,0,0,0.0,3,0,0,35,100,135
p_297,12,0,e_0,18,57,139,12.0,0,0,3.0,5,0,1,39,82,121
p_294,13,0,e_0,23,63,139,12.5,1,0,4.5,5,0,2,40,76,116
p_293,15,0,e_0,26,73,139,14.0,1,0,5.0,5,0,3,47,66,113
p_277,10,0,e_0,81,95,139,21.5,2,2,13.0,4,1,0,14,44,58
p_274,4,0,e_0,84,121,139,27.0,2,2,12.5,4,1,1,37,18,55
p_282,6,0,e_3,62,114,140,3.0,2,0,3.0,2,1,1,52,26,78
p_298,4,0,e_2,10,28,140,4.0,0,0,0.0,3,0,0,18,112,130
p_295,5,0,e_2,22,34,140,5.0,1,0,2.5,5,0,1,12,106,118
p_292,11,0,e_2,30,60,140,19.5,1,1,4.0,5,1,1,30,80,110
p_287,12,0,e_2,51,66,140,11.0,2,0,9.0,5,1,1,15,74,89
p_280,12,0,e_2,65,66,140,8.5,3,0,12.0,2,1,1,1,74,75
p_284,14,0,e_2,55,78,140,12.0,4,0,10.0,5,1,2,23,62,85
p_276,5,0,e_2,82,116,140,26.5,2,2,13.5,4,1,0,34,24,58
p_275,2,0,e_2,84,130,140,29.0,2,2,12.5,4,1,1,46,10,56
p_267,1,0,e_3,153,160,166,1.0,0,0,0.0,3,0,0,7,6,13
p_291,6,0,e_1,35,62,172,6.0,0,0,0.0,3,1,0,27,110,137
p_289,7,0,e_1,47,68,172,6.5,1,0,2.5,5,0,1,21,104,125
p_283,10,0,e_1,55,82,172,8.0,3,0,4.5,5,0,2,27,90,117
p_281,10,0,e_1,63,82,172,7.0,3,0,6.0,5,1,2,19,90,109
p_273,13,0,e_1,95,96,172,11.5,1,0,13.0,5,1,1,1,76,77
p_278,15,0,e_1,80,106,172,17.0,2,2,9.5,5,1,1,26,66,92
p_272,15,0,e_1,105,106,172,11.0,1,0,15.0,5,1,1,1,66,67
p_270,7,0,e_1,133,140,172,24.5,1,1,8.5,4,1,0,7,32,39
p_269,4,0,e_1,146,154,172,4.0,0,0,5.5,4,1,0,8,18,26
p_258,5,0,e_3,175,197,249,5.0,0,0,0.0,3,0,0,22,52,74
p_256,8,0,e_3,191,211,249,4.0,1,0,4.0,5,0,1,20,38,58
p_254,3,0,e_3,199,233,249,8.0,2,1,5.0,5,1,1,34,16,50
p_252,2,0,e_3,212,239,249,6.0,2,1,8.0,4,1,1,27,10,37
p_259,6,0,e_1,174,201,263,6.0,0,0,0.0,3,0,0,27,62,89
p_255,10,0,e_1,192,219,263,6.0,2,0,4.0,5,0,1,27,44,71
p_251,4,0,e_1,228,245,263,30.0,3,3,8.0,4,1,0,17,18,35
p_271,11,0,e_0,127,185,269,22.0,1,1,2.5,4,1,0,58,84,142
p_257,12,0,e_0,179,191,269,11.5,1,0,9.5,5,0,2,12,78,90
p_266,15,0,e_0,155,205,269,15.0,1,0,3.5,5,0,1,50,64,114
p_250,7,0,e_0,236,239,269,25.5,2,2,7.5,4,1,0,3,30,33
p_264,5,0,e_2,162,173,289,26.0,1,1,2.5,5,0,2,11,116,127
p_262,6,0,e_2,164,179,289,24.0,1,1,3.0,5,0,3,15,110,125
p_268,10,0,e_2,150,197,289,10.0,0,0,0.0,3,0,0,47,92,139
p_265,12,0,e_2,157,207,289,11.5,1,0,1.5,5,0,1,50,82,132
p_263,12,0,e_2,163,207,289,18.5,1,1,2.5,5,0,3,44,82,126
p_261,12,0,e_2,170,207,289,12.0,0,0,4.5,5,0,4,37,82,119
p_260,13,0,e_2,171,213,289,13.0,0,0,4.5,5,0,4,42,76,118
p_253,15,0,e_2,208,223,289,7.5,3,0,12.0,5,1,1,15,66,81
p_249,7,0,e_2,238,257,289,25.0,1,1,11.5,4,1,0,19,32,51
p_248,7,0,e_2,246,257,289,23.5,1,1,9.5,4,1,1,11,32,43
p_244,2,0,e_2,271,279,289,17.0,1,1,3.5,4,1,0,8,10,18
p_238,2,0,e_2,311,321,331,7.0,1,0,0.0,3,0,0,10,10,20
p_233,2,0,e_2,319,321,331,6.0,2,1,1.5,5,0,1,2,10,12
p_247,12,0,e_3,248,299,355,12.0,0,0,0.0,3,1,0,51,56,107
p_246,12,0,e_3,257,299,355,10.0,1,0,2.0,5,0,1,42,56,98
p_236,8,0,e_3,313,317,355,1.0,2,0,9.0,4,1,1,4,38,42
p_235,8,0,e_3,314,317,355,0.0,3,0,8.5,4,1,2,3,38,41
p_237,5,0,e_3,313,331,355,4.0,1,0,9.0,4,1,0,18,24,42
p_232,5,0,e_3,320,331,355,2.0,2,0,7.5,4,1,1,11,24,35
p_230,5,0,e_3,323,331,355,1.0,2,0,6.5,4,1,1,8,24,32
p_216,1,0,e_3,346,349,355,0.0,1,0,1.5,4,1,0,3,6,9
p_243,8,0,e_1,285,319,409,7.5,1,1,0.0,3,0,0,34,90,124
p_231,10,0,e_1,320,329,409,27.5,2,2,8.0,5,1,1,9,80,89
p_228,11,0,e_1,325,335,409,25.5,2,2,9.0,5,1,2,10,74,84
p_239,13,0,e_1,305,345,409,27.5,1,1,4.5,5,0,1,40,64,104
p_224,13,0,e_1,335,345,409,21.0,1,1,11.0,2,1,1,10,64,74
p_223,13,0,e_1,339,345,409,20.5,1,1,11.5,5,1,1,6,64,70
p_213,12,0,e_1,347,351,409,19.0,2,2,13.0,4,1,2,4,58,62
p_218,9,0,e_1,343,365,409,23.0,1,1,13.0,5,1,1,22,44,66
p_217,8,0,e_1,345,371,409,23.5,1,1,13.0,2,1,1,26,38,64
p_199,2,0,e_1,368,397,409,21.0,2,2,8.5,4,1,2,29,12,41
p_185,2,0,e_1,392,397,409,15.0,3,3,3.0,4,1,2,5,12,17
p_205,1,0,e_1,362,403,409,23.5,2,2,9.5,4,1,2,41,6,47
p_186,1,0,e_1,391,403,409,16.5,4,4,3.5,4,1,2,12,6,18
p_242,4,0,e_0,287,288,410,11.0,1,1,4.0,5,0,1,1,122,123
p_245,9,0,e_0,269,310,410,10.5,1,1,0.0,3,0,0,41,100,141
p_241,13,0,e_0,300,328,410,29.0,1,1,7.0,5,1,1,28,82,110
p_240,14,0,e_0,301,334,410,27.5,1,1,7.0,5,1,2,33,76,109
p_234,14,0,e_0,314,334,410,24.5,3,3,9.5,5,1,2,20,76,96
p_226,12,0,e_0,331,344,410,23.0,1,1,13.5,5,1,2,13,66,79
p_219,11,0,e_0,342,350,410,21.5,1,1,12.0,4,1,3,8,60,68
p_225,10,0,e_0,333,356,410,25.0,1,1,14.0,5,1,3,23,54,77
p_229,9,0,e_0,323,362,410,28.0,2,2,12.0,5,1,2,39,48,87
p_227,9,0,e_0,326,362,410,27.0,2,2,12.5,5,1,3,36,48,84
p_220,9,0,e_0,342,362,410,23.5,1,1,12.0,4,1,3,20,48,68
p_212,9,0,e_0,348,362,410,22.0,1,1,11.0,4,1,3,14,48,62
p_204,8,0,e_0,364,368,410,16.0,2,2,8.5,4,1,3,4,42,46
p_206,6,0,e_0,362,378,410,18.5,2,2,9.0,4,1,2,16,32,48
p_196,5,0,e_0,376,384,410,16.0,3,3,6.5,4,1,3,8,26,34
p_222,3,0,e_2,339,354,484,30.0,1,1,0.0,3,0,0,15,130,145
p_221,4,0,e_2,341,360,484,29.0,1,1,0.0,5,0,1,19,124,143
p_214,4,0,e_2,346,360,484,27.5,2,2,1.5,5,0,3,14,124,138
p_215,6,0,e_2,346,370,484,25.5,1,1,1.0,5,0,2,24,114,138
p_197,8,0,e_2,375,380,484,13.5,3,3,7.0,5,1,2,5,104,109
p_200,12,0,e_2,367,398,484,11.5,2,1,5.5,5,1,2,31,86,117
p_193,12,0,e_2,378,398,484,8.5,4,1,8.0,5,1,3,20,86,106
p_211,14,0,e_2,348,408,484,17.0,2,2,1.5,5,0,3,60,76,136
p_190,14,0,e_2,382,408,484,7.5,4,0,8.5,5,1,2,26,76,102
p_180,14,0,e_2,396,408,484,4.5,5,0,11.5,5,1,5,12,76,88
p_172,14,0,e_2,405,408,484,3.0,5,0,13.5,5,1,7,3,76,79
p_160,10,0,e_2,421,426,484,6.0,8,1,11.0,4,1,6,5,58,63
p_177,9,0,e_2,398,432,484,7.0,5,3,12.0,5,1,5,34,52,86
p_188,8,0,e_2,390,438,484,9.5,4,4,10.5,5,1,3,48,46,94
p_191,7,0,e_2,382,444,484,12.5,4,4,8.5,5,1,2,62,40,102
p_198,9,0,e_3,368,393,511,14.0,2,2,3.0,5,0,2,25,118,143
p_195,9,0,e_3,376,393,511,12.0,3,2,5.0,5,0,3,17,118,135
p_194,11,0,e_3,377,403,511,10.0,3,2,5.0,5,0,3,26,108,134
p_181,11,0,e_3,395,403,511,5.5,5,2,9.5,5,1,4,8,108,116
p_207,12,0,e_3,355,409,511,12.0,0,0,0.0,3,1,0,54,102,156
p_203,12,0,e_3,365,409,511,11.5,2,1,2.5,5,0,2,44,102,146
p_183,12,0,e_3,393,409,511,5.0,4,1,9.0,5,1,3,16,102,118
p_208,13,0,e_3,355,415,511,13.0,1,1,0.0,3,1,1,60,96,156
p_202,13,0,e_3,365,415,511,11.0,2,0,2.0,5,0,2,50,96,146
p_201,13,0,e_3,366,415,511,10.5,2,0,2.5,5,0,2,49,96,145
p_165,14,0,e_3,416,421,511,3.0,6,1,13.0,5,1,5,5,90,95
p_162,14,0,e_3,417,421,511,2.5,8,1,13.5,5,1,7,4,90,94
p_168,15,0,e_3,412,427,511,2.5,6,0,12.5,5,1,5,15,84,99
p_158,14,0,e_3,426,433,511,1.0,8,0,15.0,5,1,7,7,78,85
p_161,13,0,e_3,418,439,511,3.5,8,2,13.5,5,1,7,21,72,93
p_163,4,0,e_1,417,433,547,12.5,8,2,0.5,5,0,1,16,114,130
p_166,5,0,e_1,415,439,547,12.0,6,1,0.0,3,0,0,24,108,132
p_153,8,0,e_1,438,453,547,5.0,6,3,5.0,2,1,2,15,94,109
p_152,10,0,e_1,439,463,547,3.0,6,2,5.0,5,1,3,24,84,108
p_145,12,0,e_1,451,473,547,29.0,5,5,8.0,5,1,4,22,74,96
p_134,12,0,e_1,462,473,547,27.0,4,4,10.0,2,1,4,11,74,85
p_140,13,0,e_1,455,479,547,27.0,5,5,8.0,5,1,4,24,68,92
p_139,13,0,e_1,456,479,547,27.0,4,4,8.5,5,1,5,23,68,91
p_137,13,0,e_1,458,479,547,27.0,4,4,9.0,5,1,5,21,68,89
p_123,12,0,e_1,474,485,547,24.5,5,5,12.0,5,1,5,11,62,73
p_128,10,0,e_1,471,495,547,27.0,4,4,12.0,5,1,5,24,52,76
p_120,10,0,e_1,481,495,547,25.5,4,4,13.0,4,1,5,14,52,66
p_130,9,0,e_1,469,501,547,28.5,5,5,11.0,5,1,4,32,46,78
p_114,9,0,e_1,494,501,547,24.0,1,1,10.0,1,1,3,7,46,53
p_108,5,0,e_1,509,519,547,25.5,1,1,7.5,4,1,2,10,28,38
p_167,7,0,e_0,412,443,565,10.5,7,2,0.0,3,0,0,31,122,153
p_159,11,0,e_0,424,461,565,4.5,8,1,2.5,5,0,1,37,104,141
p_157,12,0,e_0,427,467,565,3.0,8,2,3.5,5,0,2,40,98,138
p_124,14,0,e_0,474,477,565,22.5,5,5,13.5,5,1,2,3,88,91
p_151,15,0,e_0,443,483,565,27.0,6,6,7.0,5,1,2,40,82,122
p_149,15,0,e_0,444,483,565,27.0,6,6,7.0,5,1,3,39,82,121
p_142,15,0,e_0,452,483,565,26.0,5,5,9.0,5,1,3,31,82,113
p_141,15,0,e_0,455,483,565,25.0,5,5,10.0,5,1,3,28,82,110
p_127,15,0,e_0,473,483,565,21.5,5,5,13.5,5,1,2,10,82,92
p_117,12,0,e_0,490,497,565,22.0,2,2,13.5,4,1,1,7,68,75
p_113,11,0,e_0,496,503,565,22.0,1,1,12.0,4,1,3,7,62,69
p_115,10,0,e_0,494,509,565,23.0,1,1,12.5,4,1,2,15,56,71
p_131,9,0,e_0,467,515,565,29.0,5,5,12.0,2,1,1,48,50,98
p_121,9,0,e_0,480,515,565,26.5,4,4,14.5,5,1,2,35,50,85
p_104,7,0,e_0,516,525,565,6.5,2,0,9.0,4,1,0,9,40,49
p_209,2,0,e_0,354,579,635,28.0,1,1,10.5,4,1,3,225,56,281
p_90,2,0,e_0,536,579,635,19.5,3,2,5.0,4,1,2,43,56,99
p_81,2,0,e_0,547,579,635,17.0,4,2,3.0,1,1,2,32,56,88
p_71,2,0,e_0,569,579,635,16.0,4,2,0.0,5,0,1,10,56,66
p_192,5,0,e_0,380,593,635,15.0,4,4,5.5,4,1,3,213,42,255
p_96,5,0,e_0,527,593,635,18.0,4,2,6.5,4,1,2,66,42,108
p_62,5,0,e_0,582,593,635,11.0,4,1,2.5,5,1,2,11,42,53
p_61,5,0,e_0,583,593,635,11.0,4,1,3.0,5,1,3,10,42,52
p_49,5,0,e_0,592,593,635,9.0,5,3,5.0,5,1,5,1,42,43
p_98,6,0,e_0,524,599,635,18.0,3,1,7.0,1,1,1,75,36,111
p_95,6,0,e_0,527,599,635,17.0,4,2,6.5,4,1,2,72,36,108
p_94,6,0,e_0,528,599,635,17.0,4,2,6.5,4,1,3,71,36,107
p_73,6,0,e_0,568,599,635,8.5,3,1,0.0,3,0,0,31,36,67
p_59,6,0,e_0,584,599,635,9.5,4,1,3.0,5,1,3,15,36,51
p_57,6,0,e_0,587,599,635,9.0,4,0,4.0,5,1,3,12,36,48
p_144,4,0,e_2,451,502,638,7.0,5,3,6.0,4,1,3,51,136,187
p_118,4,0,e_2,488,502,638,30.0,3,3,1.0,5,0,1,14,136,150
p_184,5,0,e_2,393,508,638,12.0,4,3,11.0,5,1,4,115,130,245
p_178,5,0,e_2,398,508,638,11.0,5,3,12.0,5,1,5,110,130,240
p_119,5,0,e_2,483,508,638,30.0,3,3,0.0,3,1,0,25,130,155
p_189,7,0,e_2,387,518,638,11.5,4,4,9.5,5,1,3,131,120,251
p_187,7,0,e_2,391,518,638,10.5,4,4,10.5,5,1,4,127,120,247
p_154,7,0,e_2,438,518,638,6.0,6,3,8.0,4,1,4,80,120,200
p_116,7,0,e_2,490,518,638,27.0,2,2,1.5,5,0,2,28,120,148
p_100,10,0,e_2,522,532,638,14.5,3,1,8.0,5,1,3,10,106,116
p_101,12,0,e_2,521,542,638,12.5,3,1,7.5,5,1,2,21,96,117
p_92,13,0,e_2,533,548,638,9.0,3,3,10.0,5,1,4,15,90,105
p_109,14,0,e_2,506,554,638,17.0,1,1,4.5,5,1,3,48,84,132
p_88,14,0,e_2,538,554,638,9.0,4,0,11.5,5,1,5,16,84,100
p_79,14,0,e_2,549,554,638,7.0,4,0,13.0,5,1,4,5,84,89
p_110,1,0,e_3,501,519,659,0.0,1,0,1.5,4,1,0,18,140,158
p_107,1,0,e_3,512,519,659,1.0,1,1,0.0,3,0,1,7,140,147
p_133,4,0,e_3,463,533,659,5.0,4,2,9.0,4,1,3,70,126,196
p_125,4,0,e_3,474,533,659,2.0,5,1,6.5,4,1,4,59,126,185
p_106,4,0,e_3,512,533,659,4.0,0,0,0.0,3,0,0,21,126,147
p_105,4,0,e_3,515,533,659,3.5,2,0,0.5,5,0,2,18,126,144
p_147,7,0,e_3,450,547,659,4.0,5,1,11.0,4,1,4,97,112,209
p_138,7,0,e_3,456,547,659,3.0,5,0,10.0,4,1,4,91,112,203
p_135,7,0,e_3,461,547,659,2.0,4,0,9.5,4,1,3,86,112,198
p_132,7,0,e_3,463,547,659,2.0,5,0,9.0,4,1,4,84,112,196
p_89,7,0,e_3,537,547,659,14.0,3,2,5.0,5,1,2,10,112,122
p_173,10,0,e_3,405,561,659,4.5,5,2,11.5,5,1,4,156,98,254
p_170,10,0,e_3,408,561,659,4.0,5,1,12.0,2,1,4,153,98,251
p_146,10,0,e_3,451,561,659,1.0,5,0,11.0,4,1,4,110,98,208
p_97,10,0,e_3,526,561,659,13.5,3,1,2.5,5,1,2,35,98,133
p_210,4,0,e_0,353,658,686,26.0,1,1,10.5,4,1,2,305,28,333
p_55,4,0,e_0,590,658,686,10.0,4,2,4.5,5,1,4,68,28,96
p_42,4,0,e_0,600,658,686,8.0,4,2,6.0,4,1,5,58,28,86
p_35,4,0,e_0,640,658,686,30.0,2,2,0.0,3,0,0,18,28,46
p_45,5,0,e_0,597,664,686,7.0,5,2,6.0,5,1,4,67,22,89
p_32,5,0,e_0,657,664,686,25.5,1,1,4.0,3,0,0,7,22,29
p_31,5,0,e_0,662,664,686,5.0,0,0,4.5,5,1,1,2,22,24
p_155,3,0,e_1,434,561,697,11.0,7,5,4.0,5,1,2,127,136,263
p_82,3,0,e_1,547,561,697,16.0,4,2,0.0,5,0,1,14,136,150
p_78,4,0,e_1,555,567,697,13.0,4,2,2.0,5,0,3,12,130,142
p_83,5,0,e_1,546,573,697,14.0,5,2,0.0,3,1,0,27,124,151
p_80,6,0,e_1,548,579,697,13.0,4,2,0.0,5,0,2,31,118,149
p_77,6,0,e_1,557,579,697,11.0,4,2,2.0,5,0,4,22,118,140
p_76,7,0,e_1,559,585,697,9.0,4,1,3.0,5,0,4,26,112,138
p_67,8,0,e_1,574,591,697,9.0,4,1,5.0,5,1,3,17,106,123
p_50,10,0,e_1,592,601,697,4.0,5,2,8.0,5,1,2,9,96,105
p_65,12,0,e_1,578,611,697,4.5,5,2,6.0,5,1,4,33,86,119
p_46,13,0,e_1,596,617,697,30.0,5,5,9.0,5,1,3,21,80,101
p_44,15,0,e_1,598,627,697,27.5,5,5,9.5,5,1,4,29,70,99
p_39,15,0,e_1,609,627,697,26.0,3,3,12.0,5,1,4,18,70,88
p_36,11,0,e_1,635,645,697,24.0,3,3,13.5,4,1,2,10,52,62
p_33,8,0,e_1,647,659,697,24.5,1,1,10.5,4,1,2,12,38,50
p_182,5,0,e_3,394,698,740,12.0,4,3,9.0,5,1,3,304,42,346
p_129,5,0,e_3,470,698,740,2.0,5,0,7.0,4,1,4,228,42,270
p_122,5,0,e_3,477,698,740,1.0,4,0,6.0,4,1,3,221,42,263
p_30,5,0,e_3,676,698,740,5.0,0,0,0.0,3,0,0,22,42,64
p_126,6,0,e_3,473,704,740,1.0,4,0,7.0,4,1,3,231,36,267
p_28,6,0,e_3,679,704,740,5.5,1,0,0.5,5,0,1,25,36,61
p_25,7,0,e_3,703,710,740,1.0,2,0,6.0,5,1,1,7,30,37
p_56,2,0,e_0,588,703,741,13.0,4,3,4.0,5,1,3,115,38,153
p_48,2,0,e_0,593,703,741,11.0,5,4,5.0,2,1,4,110,38,148
p_27,2,0,e_0,693,703,741,6.0,2,2,0.0,3,0,0,10,38,48
p_85,3,0,e_0,542,709,741,17.0,4,3,4.0,4,1,2,167,32,199
p_43,3,0,e_0,599,709,741,9.0,5,2,6.0,2,1,4,110,32,142
p_26,3,0,e_0,698,709,741,4.0,1,1,1.0,5,0,1,11,32,43
p_24,5,0,e_0,707,719,741,2.5,2,1,3.0,5,1,1,12,22,34
p_23,5,0,e_0,709,719,741,12.0,1,0,3.0,2,1,1,10,22,32
p_112,15,0,e_2,497,706,770,17.5,1,1,3.0,5,0,3,209,64,273
p_111,15,0,e_2,501,706,770,16.5,2,2,4.0,3,0,3,205,64,269
p_87,15,0,e_2,539,706,770,10.0,4,0,11.5,5,1,5,167,64,231
p_34,15,0,e_2,643,706,770,18.0,2,2,0.0,3,0,0,63,64,127
p_29,15,0,e_2,678,706,770,14.5,1,0,8.0,5,0,1,28,64,92
p_69,10,0,e_2,573,728,770,7.0,4,1,12.5,4,1,3,155,42,197
p_22,10,0,e_2,712,728,770,26.5,1,1,13.5,4,1,0,16,42,58
p_18,2,0,e_0,768,779,789,2.0,0,0,0.0,3,0,0,11,10,21
p_8,1,0,e_3,847,854,860,1.0,0,0,0.0,3,0,0,7,6,13
p_175,2,0,e_2,399,856,866,14.0,5,3,12.0,5,1,6,457,10,467
p_143,2,0,e_2,451,856,866,9.0,5,4,6.0,4,1,4,405,10,415
p_136,2,0,e_2,460,856,866,7.0,4,3,4.5,4,1,3,396,10,406
p_9,2,0,e_2,845,856,866,2.0,0,0,0.0,3,0,0,11,10,21
p_20,9,0,e_1,737,770,868,21.5,1,1,1.0,5,0,1,33,98,131
p_21,10,0,e_1,732,776,868,22.0,1,1,0.0,3,0,0,44,92,136
p_19,12,0,e_1,740,786,868,12.0,0,0,1.5,5,0,2,46,82,128
p_16,13,0,e_1,774,792,868,13.0,0,0,9.5,5,1,3,18,76,94
p_17,15,0,e_1,772,802,868,15.0,0,0,9.5,5,1,2,30,66,96
p_15,15,0,e_1,782,802,868,15.0,0,0,11.0,5,1,3,20,66,86
p_14,15,0,e_1,790,802,868,15.0,0,0,12.5,5,1,2,12,66,78
p_12,13,0,e_1,796,812,868,13.0,0,0,14.0,5,1,2,16,56,72
p_13,11,0,e_1,794,822,868,11.0,0,0,13.5,5,1,1,28,46,74
p_11,11,0,e_1,810,822,868,11.0,0,0,13.5,4,1,2,12,46,58
p_156,1,0,e_1,428,883,889,14.0,8,7,3.0,5,0,2,455,6,461
p_3,1,0,e_1,876,883,889,5.5,2,1,0.0,3,0,0,7,6,13
p_150,3,0,e_2,444,892,906,9.0,6,3,7.0,1,1,3,448,14,462
p_148,3,0,e_2,447,892,906,8.0,5,2,6.5,4,1,4,445,14,459
p_2,3,0,e_2,878,892,906,3.5,2,1,0.0,3,0,0,14,14,28
p_4,1,0,e_3,864,866,906,8.5,1,1,0.5,5,0,1,2,40,42
p_5,5,0,e_3,860,884,906,5.0,0,0,0.0,3,1,0,24,22,46
p_102,2,0,e_1,521,899,909,22.5,3,2,4.5,4,1,2,378,10,388
p_1,2,0,e_1,889,899,909,2.0,1,0,0.0,3,1,0,10,10,20
p_7,12,0,e_0,851,861,929,11.5,1,0,9.5,5,0,1,10,68,78
p_10,14,0,e_0,810,871,929,14.0,0,0,0.0,3,0,0,61,58,119
p_6,14,0,e_0,858,871,929,16.0,1,1,11.5,5,0,2,13,58,71
p_296,1,0,e_3,20,27,33,1.0,0,0,0.0,3,0,0,7,6,13
p_299,3,0,e_1,7,21,35,3.0,0,0,0.0,3,0,0,14,14,28
p_286,3,0,e_3,51,58,86,3.5,2,1,1.5,5,0,2,7,28,35
p_290,4,0,e_3,43,64,86,4.0,0,0,0.0,3,0,0,21,22,43
p_285,2,0,e_3,54,74,86,3.5,3,2,2.5,5,0,3,20,12,32
p_288,1,0,e_3,49,80,86,6.0,1,1,1.0,5,0,1,31,6,37
p_291,6,0,e_1,35,61,129,6.0,0,0,0.0,3,1,0,26,68,94
p_289,7,0,e_1,47,67,129,6.5,1,0,3.0,5,0,1,20,62,82
p_283,10,0,e_1,55,81,129,7.5,4,0,5.0,5,0,2,26,48,74
p_281,10,0,e_1,63,81,129,6.0,4,4,6.5,5,1,2,18,48,66
p_276,5,0,e_1,82,103,129,25.5,3,3,10.0,4,1,1,21,26,47
p_274,4,0,e_1,84,109,129,26.5,3,3,9.5,4,1,2,25,20,45
p_279,2,0,e_1,76,119,129,30.0,3,3,9.0,5,1,1,43,10,53
p_298,4,0,e_2,10,28,136,4.0,0,0,0.0,3,0,0,18,108,126
p_295,5,0,e_2,22,34,136,5.0,1,0,3.0,5,0,1,12,102,114
p_292,11,0,e_2,30,60,136,19.5,1,1,4.5,5,1,1,30,76,106
p_287,12,0,e_2,51,66,136,10.5,2,0,9.0,5,1,1,15,70,85
p_280,12,0,e_2,65,66,136,22.0,4,4,12.0,5,1,2,1,70,71
p_284,14,0,e_2,55,76,136,11.5,4,0,10.0,5,1,2,21,60,81
p_275,2,0,e_2,84,126,136,28.0,3,3,12.0,4,1,0,42,10,52
p_300,8,0,e_0,4,39,137,8.0,0,0,0.0,3,0,0,35,98,133
p_297,12,0,e_0,18,57,137,12.0,0,0,3.0,5,0,1,39,80,119
p_294,13,0,e_0,23,63,137,12.5,1,0,4.5,5,0,2,40,74,114
p_293,15,0,e_0,26,73,137,14.0,1,0,5.0,5,0,3,47,64,111
p_277,10,0,e_0,81,95,137,21.0,3,3,13.5,4,1,0,14,42,56
p_267,1,0,e_2,153,160,166,14.0,2,0,0.0,3,0,0,7,6,13
p_282,6,0,e_3,62,112,222,2.5,4,0,3.5,5,1,3,50,110,160
p_271,11,0,e_3,127,134,222,9.5,3,2,9.5,5,1,2,7,88,95
p_273,13,0,e_3,95,144,222,15.0,2,1,2.0,5,0,2,49,78,127
p_278,15,0,e_3,80,154,222,16.0,2,2,1.0,4,1,1,74,68,142
p_272,15,0,e_3,105,154,222,10.5,3,0,4.5,5,0,3,49,68,117
p_265,12,0,e_3,157,168,222,2.0,1,0,14.5,4,1,0,11,54,65
p_263,12,0,e_3,163,168,222,1.0,2,0,13.0,4,1,1,5,54,59
p_259,6,0,e_3,174,194,222,5.0,1,0,11.0,4,1,0,20,28,48
p_254,3,0,e_3,199,208,222,2.0,1,0,5.0,4,1,0,9,14,23
p_270,7,0,e_1,133,163,263,12.0,4,2,0.0,3,0,0,30,100,130
p_268,10,0,e_1,150,177,263,5.5,2,1,4.0,5,0,1,27,86,113
p_257,12,0,e_1,179,187,263,27.5,2,2,10.0,5,1,1,8,76,84
p_266,15,0,e_1,155,201,263,30.0,1,1,5.5,5,0,2,46,62,108
p_269,4,0,e_0,146,165,265,12.5,2,1,0.0,3,0,0,19,100,119
p_264,5,0,e_0,162,171,265,8.0,2,1,3.5,5,0,1,9,94,103
p_262,6,0,e_0,164,177,265,6.0,2,0,4.0,3,0,1,13,88,101
p_261,12,0,e_0,170,203,265,29.5,1,1,5.0,2,1,1,33,62,95
p_260,13,0,e_0,171,209,265,28.5,1,1,5.0,5,1,2,38,56,94
p_252,2,0,e_0,212,255,265,30.0,1,1,12.5,4,1,0,43,10,53
p_244,2,0,e_0,271,282,292,12.5,2,1,0.0,3,0,0,11,10,21
p_258,5,0,e_2,175,197,311,5.0,2,1,0.0,3,0,0,22,114,136
p_256,8,0,e_2,191,211,311,28.5,2,2,3.5,5,0,1,20,100,120
p_255,10,0,e_2,192,221,311,26.0,2,2,4.0,5,0,2,29,90,119
p_253,15,0,e_2,208,243,311,18.0,1,1,7.5,5,1,2,35,68,103
p_247,12,0,e_2,248,257,311,8.0,2,0,14.0,4,1,0,9,54,63
p_245,9,0,e_2,269,271,311,6.5,2,1,9.5,4,1,0,2,40,42
p_242,4,0,e_2,287,293,311,7.0,2,1,5.5,4,1,0,6,18,24
p_251,4,0,e_3,228,247,339,4.0,0,0,0.0,3,0,0,19,92,111
p_250,7,0,e_3,236,261,339,5.5,1,0,1.5,5,0,1,25,78,103
p_249,7,0,e_3,238,261,339,5.0,2,0,2.0,5,0,2,23,78,101
p_248,7,0,e_3,246,261,339,3.0,1,1,4.0,3,0,1,15,78,93
p_246,12,0,e_3,257,283,339,5.5,2,0,6.5,5,1,1,26,56,82
p_243,8,0,e_3,285,301,339,4.0,1,0,12.0,4,1,0,16,38,54
p_237,5,0,e_3,313,315,339,0.0,1,0,5.5,4,1,0,2,24,26
p_233,2,0,e_3,319,329,339,2.0,1,0,4.0,4,1,0,10,10,20
p_241,13,0,e_0,300,355,433,25.0,1,1,0.0,3,0,0,55,78,133
p_239,13,0,e_0,305,355,433,24.5,1,1,0.5,5,0,1,50,78,128
p_224,13,0,e_0,335,355,433,18.0,1,1,8.0,5,0,2,20,78,98
p_223,13,0,e_0,339,355,433,13.0,0,0,9.0,5,0,2,16,78,94
p_234,14,0,e_0,314,361,433,21.0,1,1,3.0,5,0,1,47,72,119
p_211,14,0,e_0,348,361,433,12.0,4,0,11.5,5,0,4,13,72,85
p_204,8,0,e_0,364,387,433,5.0,4,1,13.5,4,1,3,23,46,69
p_189,7,0,e_0,387,393,433,11.5,5,2,8.0,1,1,3,6,40,46
p_215,6,0,e_0,346,399,433,10.5,4,2,11.0,5,0,2,53,34,87
p_206,6,0,e_0,362,399,433,7.5,4,2,14.0,4,1,3,37,34,71
p_178,5,0,e_0,398,405,433,11.0,5,1,6.0,4,1,3,7,28,35
p_214,4,0,e_0,346,411,433,12.5,4,2,11.0,5,0,3,65,22,87
p_174,3,0,e_0,402,417,433,12.0,6,1,5.5,4,1,3,15,16,31
p_171,3,0,e_0,408,417,433,11.0,6,4,4.5,4,1,3,9,16,25
p_209,2,0,e_0,354,423,433,13.0,4,3,13.0,2,0,3,69,10,79
p_227,9,0,e_1,326,339,435,23.5,2,2,6.0,5,0,1,13,96,109
p_226,12,0,e_1,331,353,435,19.5,1,1,7.0,5,0,2,22,82,104
p_208,13,0,e_1,355,359,435,10.0,4,0,12.5,5,1,2,4,76,80
p_240,14,0,e_1,301,365,435,24.0,1,1,0.0,3,0,0,64,70,134
p_202,13,0,e_1,365,371,435,7.5,4,0,14.0,4,1,1,6,64,70
p_201,13,0,e_1,366,371,435,7.5,4,0,14.0,4,1,2,5,64,69
p_191,7,0,e_1,382,397,435,8.0,5,1,10.5,4,1,3,15,38,53
p_179,6,0,e_1,397,403,435,10.0,5,1,7.0,1,1,3,6,32,38
p_192,5,0,e_1,380,409,435,10.5,5,2,11.0,4,1,2,29,26,55
p_184,5,0,e_1,393,409,435,12.0,5,2,7.5,4,1,4,16,26,42
p_182,5,0,e_1,394,409,435,11.5,5,2,7.5,4,1,4,15,26,41
p_199,2,0,e_1,368,423,435,10.0,4,2,13.5,4,1,2,55,12,67
p_175,2,0,e_1,399,423,435,13.5,6,1,6.5,4,1,4,24,12,36
p_216,1,0,e_1,346,429,435,15.5,4,4,10.5,5,1,2,83,6,89
p_238,2,0,e_2,311,322,436,4.0,1,0,0.0,3,0,0,11,114,125
p_232,5,0,e_2,320,336,436,29.0,2,2,1.5,5,0,2,16,100,116
p_230,5,0,e_2,323,336,436,28.5,2,2,2.0,5,1,3,13,100,113
p_236,8,0,e_2,313,350,436,27.5,1,1,0.0,5,0,1,37,86,123
p_235,8,0,e_2,314,350,436,27.0,2,2,0.0,5,0,2,36,86,122
p_229,9,0,e_2,323,356,436,24.0,2,2,2.0,5,1,3,33,80,113
p_231,10,0,e_2,320,362,436,24.0,2,2,2.0,5,0,3,42,74,116
p_225,10,0,e_2,333,362,436,21.0,1,1,4.5,5,1,5,29,74,103
p_228,11,0,e_2,325,368,436,21.5,2,2,2.5,5,1,4,43,68,111
p_219,11,0,e_2,342,368,436,10.5,2,0,6.0,5,1,4,26,68,94
p_213,12,0,e_2,347,374,436,10.0,4,0,7.5,5,1,4,27,62,89
p_207,12,0,e_2,355,374,436,8.5,4,0,9.0,2,1,3,19,62,81
p_203,12,0,e_2,365,374,436,7.0,4,0,10.5,5,1,2,9,62,71
p_200,12,0,e_2,367,374,436,6.0,4,0,11.0,2,1,1,7,62,69
p_194,11,0,e_2,377,380,436,3.0,4,0,11.5,4,1,1,3,56,59
p_222,3,0,e_3,339,353,483,3.0,0,0,0.0,3,1,0,14,130,144
p_221,4,0,e_3,341,359,483,4.0,1,0,0.0,5,0,1,18,124,142
p_210,4,0,e_3,353,359,483,11.0,3,2,3.0,2,0,3,6,124,130
p_217,8,0,e_3,345,377,483,8.5,3,1,1.5,5,0,3,32,106,138
p_220,9,0,e_3,342,383,483,8.5,2,0,0.5,5,0,2,41,100,141
p_218,9,0,e_3,343,383,483,8.5,3,0,0.5,5,0,3,40,100,140
p_212,9,0,e_3,348,383,483,7.0,4,0,2.0,5,0,4,35,100,135
p_198,9,0,e_3,368,383,483,3.0,4,0,6.0,5,1,3,15,100,115
p_195,9,0,e_3,376,383,483,1.0,3,0,8.0,2,1,2,7,100,107
p_193,12,0,e_3,378,397,483,4.0,4,0,8.0,5,1,3,19,86,105
p_183,12,0,e_3,393,397,483,5.0,5,1,11.0,5,1,4,4,86,90
p_190,14,0,e_3,382,407,483,5.0,5,0,9.0,5,1,4,25,76,101
p_180,14,0,e_3,396,407,483,2.0,5,0,12.0,2,1,4,11,76,87
p_172,14,0,e_3,405,407,483,0.5,7,0,13.5,5,1,6,2,76,78
p_181,11,0,e_3,395,421,483,5.0,5,1,12.0,5,1,4,26,62,88
p_130,9,0,e_2,469,474,580,23.0,3,3,8.0,5,0,4,5,106,111
p_157,12,0,e_2,427,488,580,28.0,6,6,1.5,4,1,2,61,92,153
p_165,14,0,e_2,416,498,580,28.0,7,7,4.0,4,1,2,82,82,164
p_158,14,0,e_2,426,498,580,26.0,7,7,2.0,4,1,2,72,82,154
p_151,15,0,e_2,443,504,580,22.0,4,4,1.5,5,0,2,61,76,137
p_113,11,0,e_2,496,522,580,8.5,5,0,14.0,5,1,4,26,58,84
p_120,10,0,e_2,481,528,580,20.0,1,1,10.5,5,1,4,47,52,99
p_100,10,0,e_2,522,528,580,8.5,5,2,11.0,4,1,2,6,52,58
p_187,7,0,e_2,391,542,580,10.0,5,2,8.5,4,1,1,151,38,189
p_93,7,0,e_2,529,542,580,10.0,4,3,10.0,4,1,3,13,38,51
p_176,6,0,e_2,398,548,580,10.0,5,1,7.0,4,1,3,150,32,182
p_98,6,0,e_2,524,548,580,11.5,5,4,10.5,4,1,3,24,32,56
p_95,6,0,e_2,527,548,580,11.0,4,3,10.0,1,1,3,21,32,53
p_83,5,0,e_2,546,554,580,13.0,4,3,6.0,4,1,3,8,26,34
p_133,4,0,e_2,463,560,580,29.0,4,4,6.5,5,0,3,97,20,117
p_155,3,0,e_1,434,449,581,6.0,5,3,0.0,3,1,2,15,132,147
p_147,7,0,e_1,450,467,581,28.5,5,5,3.0,5,1,4,17,114,131
p_153,8,0,e_1,438,473,581,30.0,5,5,0.5,5,0,3,35,108,143
p_131,9,0,e_1,467,479,581,23.5,3,3,7.0,5,1,5,12,102,114
p_152,10,0,e_1,439,485,581,27.5,5,5,0.5,5,0,4,46,96,142
p_146,10,0,e_1,451,485,581,25.5,5,5,3.5,5,1,5,34,96,130
p_128,10,0,e_1,471,485,581,22.0,2,2,7.5,5,1,6,14,96,110
p_159,11,0,e_1,424,491,581,29.5,7,7,2.0,4,1,2,67,90,157
p_164,12,0,e_1,416,497,581,30.0,7,7,3.5,4,1,2,81,84,165
p_145,12,0,e_1,451,497,581,23.5,5,5,3.5,5,1,5,46,84,130
p_134,12,0,e_1,462,497,581,21.5,4,4,6.0,5,1,6,35,84,119
p_123,12,0,e_1,474,497,581,19.5,2,2,8.0,5,1,6,23,84,107
p_140,13,0,e_1,455,503,581,22.0,5,5,4.0,5,1,5,48,78,126
p_139,13,0,e_1,456,503,581,21.5,5,5,4.5,5,1,6,47,78,125
p_137,13,0,e_1,458,503,581,21.0,5,5,5.0,5,1,6,45,78,123
p_138,7,0,e_0,456,463,583,27.5,5,5,5.5,5,0,3,7,120,127
p_135,7,0,e_0,461,463,583,26.5,4,4,7.0,5,0,4,2,120,122
p_132,7,0,e_0,463,463,583,26.5,4,4,7.0,2,0,3,0,120,120
p_161,13,0,e_0,418,491,583,28.5,8,8,3.0,4,1,3,73,92,165
p_162,14,0,e_0,417,497,583,27.5,7,7,3.0,1,1,2,80,86,166
p_168,15,0,e_0,412,503,583,28.0,6,6,4.0,4,1,2,91,80,171
p_149,15,0,e_0,444,503,583,22.0,4,4,2.5,5,0,3,59,80,139
p_142,15,0,e_0,452,503,583,20.0,5,5,4.5,5,0,3,51,80,131
p_141,15,0,e_0,455,503,583,20.0,5,5,5.5,5,0,3,48,80,128
p_127,15,0,e_0,473,503,583,16.5,2,2,9.0,5,1,4,30,80,110
p_112,15,0,e_0,497,503,583,12.0,5,0,14.0,2,1,4,6,80,86
p_111,15,0,e_0,501,503,583,11.0,5,0,14.5,5,1,4,2,80,82
p_117,12,0,e_0,490,517,583,11.0,3,0,13.0,5,1,5,27,66,93
p_121,9,0,e_0,480,531,583,21.5,1,1,10.5,5,1,4,51,52,103
p_89,7,0,e_0,537,541,583,8.5,3,2,7.5,4,1,4,4,42,46
p_163,4,0,e_3,417,502,648,7.0,7,4,11.5,4,1,6,85,146,231
p_144,4,0,e_3,451,502,648,1.0,5,0,5.5,4,1,4,51,146,197
p_118,4,0,e_3,488,502,648,5.5,1,1,0.5,5,0,1,14,146,160
p_196,5,0,e_3,376,508,648,5.0,3,1,8.0,2,1,2,132,140,272
p_166,5,0,e_3,415,508,648,7.0,7,4,12.5,4,1,6,93,140,233
p_119,5,0,e_3,483,508,648,5.0,0,0,0.0,3,0,0,25,140,165
p_167,7,0,e_3,412,518,648,6.0,6,3,13.0,4,1,5,106,130,236
p_154,7,0,e_3,438,518,648,1.0,5,0,8.0,4,1,4,80,130,210
p_116,7,0,e_3,490,518,648,6.0,2,0,1.0,5,0,2,28,130,158
p_177,9,0,e_3,398,528,648,7.0,5,1,12.0,5,1,4,130,120,250
p_114,9,0,e_3,494,528,648,6.5,3,0,2.5,5,0,3,34,120,154
p_173,10,0,e_3,405,534,648,4.5,6,1,13.5,5,1,5,129,114,243
p_170,10,0,e_3,408,534,648,4.0,6,1,14.0,4,1,5,126,114,240
p_160,10,0,e_3,421,534,648,1.0,7,0,11.0,4,1,6,113,114,227
p_115,10,0,e_3,494,534,648,7.5,4,0,2.5,5,0,4,40,114,154
p_186,1,0,e_2,391,586,704,16.0,5,2,8.5,4,1,2,195,118,313
p_156,1,0,e_2,428,586,704,9.0,6,4,1.5,4,1,3,158,118,276
p_99,1,0,e_2,522,586,704,17.5,5,4,11.0,4,1,2,64,118,182
p_64,1,0,e_2,579,586,704,10.0,8,6,0.0,3,1,2,7,118,125
p_65,12,0,e_2,578,632,704,30.0,8,8,0.0,4,1,1,54,72,126
p_68,14,0,e_2,574,642,704,29.0,7,7,1.0,1,1,0,68,62,130
p_36,11,0,e_2,635,656,704,21.0,3,3,12.5,5,1,2,21,48,69
p_125,4,0,e_2,474,686,704,27.5,2,2,9.0,2,0,4,212,18,230
p_105,4,0,e_2,515,686,704,9.5,4,3,12.5,4,1,3,171,18,189
p_38,4,0,e_2,627,686,704,29.5,4,4,11.0,5,1,2,59,18,77
p_129,5,0,e_0,470,605,707,27.0,2,2,8.0,5,1,3,135,102,237
p_122,5,0,e_0,477,605,707,26.0,1,1,10.0,5,1,4,128,102,230
p_96,5,0,e_0,527,605,707,12.0,4,3,10.0,4,1,4,78,102,180
p_61,5,0,e_0,583,605,707,6.0,8,4,0.0,3,1,1,22,102,124
p_58,10,0,e_0,586,627,707,30.0,9,9,0.5,5,0,2,41,80,121
p_50,10,0,e_0,592,627,707,29.0,10,10,2.0,5,0,4,35,80,115
p_52,11,0,e_0,591,633,707,28.5,10,10,1.5,5,0,3,42,74,116
p_66,12,0,e_0,577,639,707,30.0,8,8,1.0,1,1,0,62,68,130
p_46,13,0,e_0,596,645,707,26.0,9,9,3.0,5,0,4,49,62,111
p_33,8,0,e_0,647,667,707,8.0,0,0,12.5,4,1,2,20,40,60
p_37,7,0,e_0,633,673,707,25.5,3,3,11.0,5,1,2,40,34,74
p_78,4,0,e_0,555,687,707,12.0,3,1,4.5,4,1,3,132,20,152
p_35,4,0,e_0,640,687,707,27.5,2,2,12.0,5,1,2,47,20,67
p_102,2,0,e_0,521,697,707,16.5,4,3,11.5,4,1,3,176,10,186
p_90,2,0,e_0,536,697,707,13.5,3,2,8.0,4,1,4,161,10,171
p_41,10,0,e_1,600,623,709,28.0,8,8,4.5,5,0,1,23,86,109
p_72,15,0,e_1,569,645,709,29.0,5,5,2.0,4,1,1,76,64,140
p_44,15,0,e_1,598,645,709,23.0,9,9,4.0,5,0,1,47,64,111
p_39,15,0,e_1,609,645,709,21.5,7,7,6.5,5,0,2,36,64,100
p_34,15,0,e_1,643,645,709,16.0,1,1,14.5,5,1,1,2,64,66
p_126,6,0,e_1,473,683,709,25.5,2,2,8.0,5,1,5,210,26,236
p_28,6,0,e_1,679,683,709,19.0,2,1,6.5,4,1,0,4,26,30
p_108,5,0,e_1,509,732,754,10.0,4,3,14.0,4,1,1,223,22,245
p_23,5,0,e_1,709,732,754,12.5,4,1,0.0,3,0,0,23,22,45
p_62,5,0,e_3,582,679,791,6.0,7,4,11.0,4,1,6,97,112,209
p_49,5,0,e_3,592,679,791,4.0,10,3,9.0,4,1,9,87,112,199
p_45,5,0,e_3,597,679,791,3.0,9,2,8.5,4,1,8,82,112,194
p_32,5,0,e_3,657,679,791,5.0,0,0,0.0,3,0,0,22,112,134
p_31,5,0,e_3,662,679,791,4.0,1,0,1.0,5,0,1,17,112,129
p_30,5,0,e_3,676,679,791,0.5,1,0,4.5,5,0,1,3,112,115
p_87,15,0,e_3,539,721,791,4.0,4,0,11.0,5,1,3,182,70,252
p_29,15,0,e_3,678,721,791,10.0,1,0,5.0,5,0,1,43,70,113
p_97,10,0,e_3,526,743,791,7.5,5,2,8.5,5,1,4,217,48,265
p_69,10,0,e_3,573,743,791,3.0,6,1,13.0,4,1,5,170,48,218
p_21,10,0,e_3,732,743,791,2.0,3,0,12.5,4,1,2,11,48,59
p_60,9,0,e_3,584,749,791,2.0,8,1,11.0,4,1,7,165,42,207
p_53,9,0,e_3,590,749,791,0.0,8,0,9.5,4,1,7,159,42,201
p_20,9,0,e_3,737,749,791,2.0,4,1,11.5,4,1,3,12,42,54
p_76,7,0,e_3,559,759,791,8.5,3,1,14.5,5,1,2,200,32,232
p_24,5,0,e_0,707,730,812,13.0,4,1,0.0,3,0,0,23,82,105
p_22,10,0,e_0,712,752,812,7.0,4,1,1.0,5,0,1,40,60,100
p_19,12,0,e_0,740,762,812,28.5,5,5,7.5,5,1,1,22,50,72
p_81,2,0,e_1,547,779,889,15.5,4,3,5.5,4,1,4,232,110,342
p_18,2,0,e_1,768,779,889,3.0,2,1,0.0,3,0,0,11,110,121
p_16,13,0,e_1,774,825,889,20.5,2,2,1.0,5,0,1,51,64,115
p_12,13,0,e_1,796,825,889,13.0,1,0,6.0,5,1,1,29,64,93
p_124,14,0,e_1,474,831,889,17.5,2,2,8.0,5,1,6,357,58,415
p_109,14,0,e_1,506,831,889,9.0,5,0,13.5,5,1,2,325,58,383
p_10,14,0,e_1,810,831,889,10.0,1,0,9.5,5,1,1,21,58,79
p_169,11,0,e_3,410,840,890,2.0,6,0,13.5,4,1,5,430,50,480
p_74,11,0,e_3,567,840,890,3.0,3,0,14.0,1,1,2,273,50,323
p_13,11,0,e_3,794,840,890,11.0,0,0,0.0,3,0,0,46,50,96
p_11,11,0,e_3,810,840,890,7.0,1,0,4.0,5,0,1,30,50,80
p_5,5,0,e_3,860,866,890,1.0,1,0,6.0,4,1,0,6,24,30
p_205,1,0,e_3,362,884,890,12.5,3,2,4.5,5,1,2,522,6,528
p_51,1,0,e_3,591,884,890,8.0,9,7,9.5,4,1,8,293,6,299
p_4,1,0,e_3,864,884,890,4.0,2,0,5.0,4,1,1,20,6,26
p_3,1,0,e_3,876,884,890,1.0,2,0,2.5,4,1,1,8,6,14
p_17,15,0,e_2,772,834,898,19.0,2,2,0.0,3,0,0,62,64,126
p_15,15,0,e_2,782,834,898,17.0,1,1,2.5,5,0,1,52,64,116
p_14,15,0,e_2,790,834,898,15.0,0,0,4.5,5,0,1,44,64,108
p_2,3,0,e_2,878,884,898,29.0,2,2,4.0,4,1,0,6,14,20
p_1,2,0,e_1,889,900,910,2.0,0,0,0.0,3,0,0,11,10,21
p_110,1,0,e_0,501,851,967,15.0,5,4,15.0,5,1,4,350,116,466
p_8,1,0,e_0,847,851,967,8.0,1,0,0.5,5,0,1,4,116,120
p_27,2,0,e_0,693,857,967,19.5,2,1,2.5,4,1,0,164,110,274
p_9,2,0,e_0,845,857,967,8.0,1,0,0.0,3,0,0,12,110,122
p_7,12,0,e_0,851,899,967,26.5,1,1,1.0,2,0,1,48,68,116
p_6,14,0,e_0,858,909,967,23.0,1,1,2.0,5,1,1,51,58,109
p_296,1,0,e_3,20,27,33,1.0,0,0,0.0,3,0,0,7,6,13
p_299,3,0,e_1,7,22,36,3.0,0,0,0.0,3,0,0,15,14,29
p_288,1,0,e_3,49,50,86,6.0,1,1,1.0,5,0,1,1,36,37
p_285,2,0,e_3,54,56,86,4.0,3,2,2.0,5,1,2,2,30,32
p_286,3,0,e_3,51,62,86,4.0,2,1,1.0,5,1,1,11,24,35
p_290,4,0,e_3,43,68,86,4.0,0,0,0.0,3,0,0,25,18,43
p_282,6,0,e_3,62,112,138,3.0,2,0,3.0,5,1,1,50,26,76
p_298,4,0,e_2,10,28,138,4.0,0,0,0.0,3,0,0,18,110,128
p_295,5,0,e_2,22,34,138,5.0,1,0,2.5,5,0,1,12,104,116
p_292,11,0,e_2,30,60,138,19.5,1,1,4.5,5,1,1,30,78,108
p_287,12,0,e_2,51,66,138,11.0,3,0,9.0,5,1,1,15,72,87
p_280,12,0,e_2,65,66,138,8.5,3,0,12.0,5,1,2,1,72,73
p_284,14,0,e_2,55,76,138,12.0,4,0,10.0,5,1,2,21,62,83
p_276,5,0,e_2,82,114,138,25.5,2,2,13.0,4,1,0,32,24,56
p_275,2,0,e_2,84,128,138,28.5,2,2,12.0,4,1,1,44,10,54
p_300,8,0,e_0,4,39,139,8.0,0,0,0.0,3,0,0,35,100,135
p_297,12,0,e_0,18,57,139,12.0,0,0,3.0,5,0,1,39,82,121
p_294,13,0,e_0,23,63,139,13.0,1,0,4.0,5,0,2,40,76,116
p_293,15,0,e_0,26,73,139,16.0,0,0,5.0,5,0,3,47,66,113
p_277,10,0,e_0,81,95,139,21.0,2,2,13.0,4,1,0,14,44,58
p_274,4,0,e_0,84,121,139,26.5,2,2,12.5,4,1,1,37,18,55
p_267,1,0,e_2,153,160,166,17.5,1,1,0.0,3,0,0,7,6,13
p_291,6,0,e_1,35,62,174,6.0,0,0,0.0,3,1,0,27,112,139
p_289,7,0,e_1,47,68,174,6.5,1,0,2.5,5,0,1,21,106,127
p_283,10,0,e_1,55,82,174,8.0,4,0,4.5,5,0,2,27,92,119
p_281,10,0,e_1,63,82,174,7.0,3,0,6.0,5,1,2,19,92,111
p_273,13,0,e_1,95,96,174,11.0,1,0,13.0,5,1,2,1,78,79
p_278,15,0,e_1,80,106,174,16.5,2,2,10.0,5,1,2,26,68,94
p_272,15,0,e_1,105,106,174,10.5,1,0,15.0,5,1,2,1,68,69
p_270,7,0,e_1,133,140,174,24.0,2,2,8.5,4,1,1,7,34,41
p_269,4,0,e_1,146,154,174,16.5,1,1,5.5,4,1,1,8,20,28
p_279,2,0,e_1,76,164,174,30.0,2,2,9.0,5,1,1,88,10,98
p_259,6,0,e_1,174,201,249,15.5,2,2,0.0,3,0,0,27,48,75
p_256,8,0,e_1,191,211,249,10.0,2,1,3.5,5,0,1,20,38,58
p_254,3,0,e_1,199,233,249,13.0,2,1,6.0,5,0,2,34,16,50
p_252,2,0,e_1,212,239,249,11.0,1,0,8.0,4,1,1,27,10,37
p_258,5,0,e_2,175,198,264,16.0,2,2,0.0,3,0,0,23,66,89
p_255,10,0,e_2,192,220,264,7.5,2,1,4.0,5,0,1,28,44,72
p_251,4,0,e_2,228,246,264,5.0,1,0,8.0,4,1,0,18,18,36
p_271,11,0,e_3,127,184,266,21.5,1,1,2.5,4,1,0,57,82,139
p_257,12,0,e_3,179,190,266,8.0,2,1,10.0,5,0,2,11,76,87
p_266,15,0,e_3,155,204,266,11.0,1,0,4.0,5,0,1,49,62,111
p_264,5,0,e_0,162,172,288,19.0,2,2,3.0,5,0,2,10,116,126
p_262,6,0,e_0,164,178,288,17.5,2,2,3.5,5,0,3,14,110,124
p_268,10,0,e_0,150,196,288,9.0,1,1,0.0,3,0,0,46,92,138
p_265,12,0,e_0,157,206,288,13.5,2,1,1.5,5,0,1,49,82,131
p_263,12,0,e_0,163,206,288,12.0,2,1,3.0,5,0,3,43,82,125
p_261,12,0,e_0,170,206,288,10.5,2,1,5.0,5,0,4,36,82,118
p_260,13,0,e_0,171,212,288,9.0,2,1,5.0,5,0,4,41,76,117
p_253,15,0,e_0,208,222,288,29.5,1,1,12.5,5,1,1,14,66,80
p_250,7,0,e_0,236,256,288,30.0,1,1,12.0,4,1,0,20,32,52
p_249,7,0,e_0,238,256,288,29.5,1,1,11.0,4,1,1,18,32,50
p_248,7,0,e_0,246,256,288,27.5,1,1,9.5,4,1,1,10,32,42
p_244,2,0,e_0,271,278,288,2.0,0,0,3.5,4,1,0,7,10,17
p_247,12,0,e_1,248,299,355,22.0,1,1,0.0,4,1,0,51,56,107
p_246,12,0,e_1,257,299,355,20.0,1,1,1.5,5,0,1,42,56,98
p_236,8,0,e_1,313,317,355,12.5,2,1,9.0,4,1,0,4,38,42
p_235,8,0,e_1,314,317,355,12.0,2,1,8.5,4,1,2,3,38,41
p_237,5,0,e_1,313,331,355,15.5,2,1,8.5,4,1,1,18,24,42
p_232,5,0,e_1,320,331,355,14.0,2,1,7.5,4,1,1,11,24,35
p_230,5,0,e_1,323,331,355,13.0,2,1,7.0,4,1,1,8,24,32
p_216,1,0,e_1,346,349,355,11.0,3,2,1.5,4,1,0,3,6,9
p_242,4,0,e_3,287,306,406,4.0,0,0,0.0,3,0,0,19,100,119
p_239,13,0,e_3,305,344,406,9.0,1,0,4.0,5,0,1,39,62,101
p_223,13,0,e_3,339,344,406,1.0,2,0,12.0,5,1,1,5,62,67
p_213,12,0,e_3,347,350,406,0.0,3,0,12.5,4,1,2,3,56,59
p_217,8,0,e_3,345,368,406,5.0,2,0,13.0,4,1,1,23,38,61
p_204,8,0,e_3,364,368,406,0.0,3,0,8.5,4,1,2,4,38,42
p_221,4,0,e_3,341,386,406,9.5,2,1,12.5,5,1,1,45,20,65
p_214,4,0,e_3,346,386,406,8.0,3,1,12.5,4,1,2,40,20,60
p_199,2,0,e_3,368,396,406,6.0,2,1,8.0,1,1,1,28,10,38
p_185,2,0,e_3,392,396,406,0.0,2,0,2.5,4,1,1,4,10,14
p_243,8,0,e_2,285,303,409,8.0,0,0,4.0,5,0,1,18,106,124
p_245,9,0,e_2,269,309,409,9.0,0,0,0.0,3,0,0,40,100,140
p_241,13,0,e_2,300,327,409,10.5,1,0,7.5,5,0,2,27,82,109
p_240,14,0,e_2,301,333,409,11.0,1,0,7.5,5,0,3,32,76,108
p_234,14,0,e_2,314,333,409,8.5,2,0,10.0,5,1,2,19,76,95
p_224,13,0,e_2,335,339,409,2.0,2,0,13.5,4,1,3,4,70,74
p_226,12,0,e_2,331,345,409,4.0,2,1,13.5,5,1,3,14,64,78
p_228,11,0,e_2,325,351,409,6.5,2,1,13.0,5,1,3,26,58,84
p_219,11,0,e_2,342,351,409,2.5,3,1,12.5,4,1,3,9,58,67
p_229,9,0,e_2,323,361,409,9.0,2,1,12.5,5,1,2,38,48,86
p_227,9,0,e_2,326,361,409,8.0,2,1,13.0,2,1,3,35,48,83
p_220,9,0,e_2,342,361,409,4.5,3,1,12.5,4,1,3,19,48,67
p_218,9,0,e_2,343,361,409,14.0,2,0,12.5,4,1,3,18,48,66
p_212,9,0,e_2,348,361,409,3.0,4,0,11.5,4,1,2,13,48,61
p_206,6,0,e_2,362,375,409,3.0,3,1,9.0,4,1,2,13,34,47
p_238,2,0,e_0,311,321,459,19.0,2,1,0.0,3,0,0,10,138,148
p_233,2,0,e_0,319,321,459,17.0,2,1,1.5,5,0,1,2,138,140
p_231,10,0,e_0,320,355,459,9.0,2,1,2.0,5,0,1,35,104,139
p_225,10,0,e_0,333,355,459,5.5,2,1,5.0,5,1,1,22,104,126
p_207,12,0,e_0,355,365,459,29.0,3,3,10.0,2,1,3,10,94,104
p_203,12,0,e_0,365,365,459,26.5,3,3,12.0,2,1,4,0,94,94
p_200,12,0,e_0,367,369,459,26.0,2,2,12.0,5,1,4,2,90,92
p_208,13,0,e_0,355,375,459,28.0,3,3,10.0,5,1,4,20,84,104
p_202,13,0,e_0,365,375,459,25.5,3,3,12.0,2,1,4,10,84,94
p_201,13,0,e_0,366,375,459,25.0,3,3,12.0,5,1,5,9,84,93
p_211,14,0,e_0,348,381,459,28.5,4,4,8.5,5,1,3,33,78,111
p_193,12,0,e_0,378,391,459,24.0,3,3,13.5,5,1,4,13,68,81
p_194,11,0,e_0,377,397,459,25.0,3,3,13.0,5,1,3,20,62,82
p_181,11,0,e_0,395,397,459,21.0,1,1,11.5,4,1,6,2,62,64
p_177,9,0,e_0,398,407,459,23.0,1,1,11.0,4,1,5,9,52,61
p_205,1,0,e_1,362,368,520,8.0,3,2,0.0,3,0,0,6,152,158
p_197,8,0,e_1,375,398,520,28.5,3,3,2.5,5,1,1,23,122,145
p_198,9,0,e_1,368,404,520,29.0,2,2,1.0,2,0,0,36,116,152
p_195,9,0,e_1,376,404,520,27.0,3,3,3.0,5,1,2,28,116,144
p_169,11,0,e_1,410,414,520,10.5,1,0,10.5,5,1,2,4,106,110
p_183,12,0,e_1,393,420,520,20.5,2,2,7.0,5,1,3,27,100,127
p_161,13,0,e_1,418,426,520,10.5,2,0,12.0,5,1,3,8,94,102
p_190,14,0,e_1,382,432,520,21.0,3,3,4.5,5,1,2,50,88,138
p_180,14,0,e_1,396,432,520,18.0,1,1,7.5,5,1,4,36,88,124
p_172,14,0,e_1,405,432,520,16.0,1,1,9.0,5,1,2,27,88,115
p_165,14,0,e_1,416,432,520,11.5,1,0,11.0,5,1,3,16,88,104
p_162,14,0,e_1,417,432,520,11.5,2,0,11.5,5,1,3,15,88,103
p_158,14,0,e_1,426,432,520,9.5,2,0,13.0,2,1,3,6,88,94
p_168,15,0,e_1,412,438,520,13.5,1,0,10.5,5,1,3,26,82,108
p_159,11,0,e_1,424,456,520,8.5,2,1,13.0,5,1,3,32,64,96
p_173,10,0,e_3,405,448,552,10.0,0,0,0.0,3,1,0,43,104,147
p_170,10,0,e_3,408,448,552,10.0,1,0,0.0,5,0,1,40,104,144
p_164,12,0,e_3,416,458,552,9.5,1,0,2.5,5,0,1,42,94,136
p_157,12,0,e_3,427,458,552,7.0,2,0,5.0,5,0,2,31,94,125
p_139,13,0,e_3,456,464,552,5.0,3,1,12.0,5,1,2,8,88,96
p_137,13,0,e_3,458,464,552,5.0,3,1,12.0,5,1,2,6,88,94
p_151,15,0,e_3,443,474,552,6.0,2,0,9.0,5,0,2,31,78,109
p_149,15,0,e_3,444,474,552,5.5,3,0,9.5,5,0,3,30,78,108
p_142,15,0,e_3,452,474,552,4.5,3,0,10.5,5,1,2,22,78,100
p_141,15,0,e_3,455,474,552,3.5,3,0,11.5,5,1,2,19,78,97
p_124,14,0,e_3,474,480,552,1.0,4,0,15.0,4,1,3,6,72,78
p_123,12,0,e_3,474,490,552,7.0,3,0,15.0,2,1,2,16,62,78
p_128,10,0,e_3,471,500,552,5.5,3,1,14.5,5,1,2,29,52,81
p_120,10,0,e_3,481,500,552,4.0,4,1,14.0,4,1,3,19,52,71
p_115,10,0,e_3,494,500,552,1.0,3,0,11.0,4,1,2,6,52,58
p_210,4,0,e_2,353,433,563,7.0,3,1,10.5,4,1,1,80,130,210
p_163,4,0,e_2,417,433,563,17.5,2,2,0.0,5,0,1,16,130,146
p_196,5,0,e_2,376,439,563,1.0,3,0,6.0,4,1,2,63,124,187
p_166,5,0,e_2,415,439,563,13.0,1,1,0.0,3,0,0,24,124,148
p_154,7,0,e_2,438,449,563,9.5,2,2,5.0,2,1,1,11,114,125
p_160,10,0,e_2,421,463,563,10.5,2,1,1.5,5,0,2,42,100,142
p_152,10,0,e_2,439,463,563,6.0,2,1,5.0,2,1,2,24,100,124
p_145,12,0,e_2,451,473,563,7.5,3,1,7.5,5,1,3,22,90,112
p_134,12,0,e_2,462,473,563,5.5,3,2,10.0,5,1,5,11,90,101
p_140,13,0,e_2,455,479,563,5.5,3,1,8.5,5,1,4,24,84,108
p_127,15,0,e_2,473,489,563,10.0,3,0,12.0,5,1,3,16,74,90
p_117,12,0,e_2,490,503,563,30.0,3,3,15.0,4,1,2,13,60,73
p_147,7,0,e_2,450,525,563,12.5,3,2,7.0,5,1,2,75,38,113
p_104,7,0,e_2,516,525,563,30.0,4,4,9.0,4,1,2,9,38,47
p_98,6,0,e_2,524,531,563,29.0,3,3,7.0,4,1,2,7,32,39
p_175,2,0,e_0,399,471,621,29.5,1,1,10.5,4,1,6,72,150,222
p_136,2,0,e_0,460,471,621,16.0,3,2,0.0,3,0,0,11,150,161
p_133,4,0,e_0,463,481,621,13.0,3,1,0.5,5,0,2,18,140,158
p_191,7,0,e_0,382,495,621,28.0,3,3,14.0,4,1,5,113,126,239
p_189,7,0,e_0,387,495,621,27.0,2,2,13.0,4,1,6,108,126,234
p_187,7,0,e_0,391,495,621,26.0,2,2,12.0,1,1,6,104,126,230
p_167,7,0,e_0,412,495,621,12.0,1,1,8.0,4,1,6,83,126,209
p_135,7,0,e_0,461,495,621,10.5,3,2,0.0,3,0,1,34,126,160
p_116,7,0,e_0,490,495,621,5.0,3,2,6.0,5,1,2,5,126,131
p_131,9,0,e_0,467,505,621,7.5,2,1,1.5,5,0,3,38,116,154
p_121,9,0,e_0,480,505,621,5.0,4,2,4.0,5,1,3,25,116,141
p_114,9,0,e_0,494,505,621,2.0,3,1,7.0,2,1,1,11,116,127
p_113,11,0,e_0,496,515,621,30.0,3,3,7.0,5,1,1,19,106,125
p_103,13,0,e_0,517,525,621,23.5,4,4,11.5,5,1,2,8,96,104
p_109,14,0,e_0,506,531,621,25.0,1,1,9.0,5,1,2,25,90,115
p_209,2,0,e_2,354,578,664,9.0,3,2,10.5,4,1,2,224,86,310
p_81,2,0,e_2,547,578,664,29.0,1,1,3.0,1,1,0,31,86,117
p_71,2,0,e_2,569,578,664,16.5,4,4,0.0,5,0,1,9,86,95
p_95,6,0,e_2,527,596,664,28.5,3,3,6.5,4,1,2,69,68,137
p_94,6,0,e_2,528,596,664,28.0,3,3,6.5,4,1,3,68,68,136
p_73,6,0,e_2,568,596,664,13.0,4,2,0.0,3,0,0,28,68,96
p_67,8,0,e_2,574,606,664,10.0,5,1,1.0,5,0,3,32,58,90
p_63,8,0,e_2,581,606,664,10.5,6,2,2.5,5,1,3,25,58,83
p_60,9,0,e_2,584,612,664,9.0,5,2,3.5,5,1,3,28,52,80
p_69,10,0,e_2,573,618,664,8.0,5,1,1.0,5,0,2,45,46,91
p_58,10,0,e_2,586,618,664,7.5,5,2,4.0,5,1,4,32,46,78
p_50,10,0,e_2,592,618,664,6.5,4,2,5.0,5,1,4,26,46,72
p_41,10,0,e_2,600,618,664,10.5,5,3,6.5,5,1,4,18,46,64
p_96,5,0,e_2,527,640,664,29.5,3,3,6.5,4,1,2,113,24,137
p_45,5,0,e_2,597,640,664,10.5,4,2,6.0,5,1,3,43,24,67
p_110,1,0,e_1,501,528,670,9.0,2,1,3.0,1,1,1,27,142,169
p_99,1,0,e_1,522,528,670,4.0,4,1,0.0,3,0,1,6,142,148
p_143,2,0,e_1,451,534,670,17.5,3,2,12.0,4,1,4,83,136,219
p_102,2,0,e_1,521,534,670,3.0,4,1,0.0,3,0,0,13,136,149
p_138,7,0,e_1,456,556,670,11.0,4,2,11.0,4,1,5,100,114,214
p_132,7,0,e_1,463,556,670,10.0,2,1,10.0,4,1,5,93,114,207
p_89,7,0,e_1,537,556,670,25.5,3,3,2.5,5,1,1,19,114,133
p_146,10,0,e_1,451,570,670,9.5,3,2,12.0,4,1,3,119,100,219
p_100,10,0,e_1,522,570,670,25.0,4,4,0.0,5,0,2,48,100,148
p_66,12,0,e_1,577,580,670,7.5,5,0,11.5,5,1,2,3,90,93
p_79,14,0,e_1,549,590,670,16.5,1,1,5.5,5,1,3,41,80,121
p_75,14,0,e_1,563,590,670,12.5,3,0,8.5,5,1,3,27,80,107
p_68,14,0,e_1,574,590,670,10.0,5,0,11.0,5,1,2,16,80,96
p_87,15,0,e_1,539,596,670,17.0,3,3,3.0,5,1,2,57,74,131
p_72,15,0,e_1,569,596,670,12.0,4,0,10.0,2,1,2,27,74,101
p_106,4,0,e_3,512,573,697,4.0,2,1,8.0,4,1,1,61,124,185
p_105,4,0,e_3,515,573,697,3.0,4,1,7.0,4,1,3,58,124,182
p_78,4,0,e_3,555,573,697,4.0,0,0,0.0,3,0,0,18,124,142
p_77,6,0,e_3,557,583,697,6.0,1,0,0.0,5,0,1,26,114,140
p_76,7,0,e_3,559,589,697,6.0,2,0,1.0,5,0,2,30,108,138
p_74,11,0,e_3,567,607,697,8.5,3,0,2.5,5,0,3,40,90,130
p_65,12,0,e_3,578,613,697,7.0,5,0,5.0,5,1,4,35,84,119
p_44,15,0,e_3,598,627,697,6.0,4,0,9.0,5,1,3,29,70,99
p_39,15,0,e_3,609,627,697,3.5,4,0,11.5,5,1,3,18,70,88
p_36,11,0,e_3,635,645,697,2.0,2,0,13.0,4,1,1,10,52,62
p_33,8,0,e_3,647,659,697,3.0,2,0,11.0,4,1,1,12,38,50
p_108,5,0,e_3,509,673,697,3.0,1,0,8.5,4,1,0,164,24,188
p_32,5,0,e_3,657,673,697,3.0,3,0,8.0,4,1,2,16,24,40
p_31,5,0,e_3,662,673,697,2.0,3,0,7.5,4,1,2,11,24,35
p_70,3,0,e_3,572,683,697,1.0,3,3,4.0,3,0,3,111,14,125
p_129,5,0,e_1,470,699,723,11.0,3,1,8.0,4,1,5,229,24,253
p_122,5,0,e_1,477,699,723,9.0,5,3,7.0,1,1,5,222,24,246
p_119,5,0,e_1,483,699,723,8.0,4,3,6.0,1,1,4,216,24,240
p_49,5,0,e_1,592,699,723,11.5,4,2,14.5,5,1,4,107,24,131
p_30,5,0,e_1,676,699,723,29.5,2,2,0.0,3,0,0,23,24,47
p_27,2,0,e_1,693,713,723,29.0,1,1,3.5,5,0,1,20,10,30
p_28,6,0,e_2,679,706,742,28.0,2,2,0.0,3,0,0,27,36,63
p_25,7,0,e_2,703,712,742,6.0,1,0,5.5,5,0,1,9,30,39
p_26,3,0,e_3,698,712,744,3.0,0,0,0.0,3,0,0,14,32,46
p_24,5,0,e_3,707,722,744,3.0,1,0,2.0,5,0,1,15,22,37
p_23,5,0,e_3,709,722,744,2.5,2,0,2.5,5,0,2,13,22,35
p_55,4,0,e_0,590,646,756,13.0,4,2,5.0,1,1,3,56,110,166
p_38,4,0,e_0,627,646,756,11.0,2,0,0.0,3,0,0,19,110,129
p_35,4,0,e_0,640,646,756,8.0,3,1,3.0,5,0,1,6,110,116
p_112,15,0,e_0,497,692,756,25.5,3,3,7.5,5,1,2,195,64,259
p_111,15,0,e_0,501,692,756,25.0,2,2,8.5,5,1,3,191,64,255
p_34,15,0,e_0,643,692,756,26.0,3,3,3.5,5,0,1,49,64,113
p_29,15,0,e_0,678,692,756,19.0,2,2,12.0,5,1,1,14,64,78
p_97,10,0,e_0,526,714,756,24.5,3,3,13.0,5,1,3,188,42,230
p_22,10,0,e_0,712,714,756,7.0,2,0,10.5,4,1,0,2,42,44
p_56,2,0,e_0,588,778,788,15.0,4,2,5.5,4,1,3,190,10,200
p_48,2,0,e_0,593,778,788,14.5,4,2,4.5,4,1,4,185,10,195
p_18,2,0,e_0,768,778,788,2.0,0,0,0.0,3,0,0,10,10,20
p_107,1,0,e_3,512,853,859,6.0,3,2,7.5,4,1,2,341,6,347
p_8,1,0,e_3,847,853,859,1.0,0,0,0.0,3,0,0,6,6,12
p_9,2,0,e_2,845,856,866,2.0,0,0,0.0,3,0,0,11,10,21
p_53,9,0,e_1,590,771,869,8.0,4,2,14.0,2,1,2,181,98,279
p_20,9,0,e_1,737,771,869,22.5,1,1,0.5,5,0,1,34,98,132
p_21,10,0,e_1,732,777,869,22.5,1,1,0.0,3,0,0,45,92,137
p_19,12,0,e_1,740,787,869,18.5,1,1,1.5,5,0,2,47,82,129
p_46,13,0,e_1,596,793,869,4.5,4,0,15.0,4,1,4,197,76,273
p_16,13,0,e_1,774,793,869,13.0,0,0,9.5,5,1,3,19,76,95
p_17,15,0,e_1,772,803,869,15.0,0,0,9.0,5,1,2,31,66,97
p_15,15,0,e_1,782,803,869,15.0,0,0,11.0,5,1,3,21,66,87
p_14,15,0,e_1,790,803,869,15.0,0,0,12.5,5,1,2,13,66,79
p_12,13,0,e_1,796,813,869,13.0,0,0,13.5,5,1,2,17,56,73
p_52,11,0,e_1,591,823,869,6.0,4,1,14.0,5,1,3,232,46,278
p_13,11,0,e_1,794,823,869,11.0,0,0,13.0,5,1,1,29,46,75
p_11,11,0,e_1,810,823,869,11.0,0,0,13.5,4,1,2,13,46,59
p_3,1,0,e_1,876,883,889,6.0,2,1,0.0,3,0,0,7,6,13
p_148,3,0,e_2,447,892,906,17.0,2,2,7.0,5,1,2,445,14,459
p_85,3,0,e_2,542,892,906,28.5,2,2,4.0,4,1,1,350,14,364
p_2,3,0,e_2,878,892,906,3.5,2,1,0.0,3,0,0,14,14,28
p_4,1,0,e_3,864,867,907,8.5,1,1,0.5,5,0,1,3,40,43
p_5,5,0,e_3,860,885,907,5.0,0,0,0.0,3,0,0,25,22,47
p_1,2,0,e_1,889,899,909,2.0,1,0,0.0,3,1,0,10,10,20
p_101,12,0,e_0,521,860,928,23.5,4,4,12.5,5,1,3,339,68,407
p_7,12,0,e_0,851,860,928,11.0,1,0,10.0,5,0,1,9,68,77
p_88,14,0,e_0,538,870,928,18.5,3,3,15.0,4,1,4,332,58,390
p_10,14,0,e_0,810,870,928,14.0,0,0,0.0,3,0,0,60,58,118
p_6,14,0,e_0,858,870,928,16.0,1,1,11.5,5,0,2,12,58,70
p_296,1,0,e_3,20,26,32,1.0,0,0,0.0,3,0,0,6,6,12
p_299,3,0,e_1,7,21,35,3.0,0,0,0.0,3,0,0,14,14,28
p_286,3,0,e_3,51,57,85,3.5,2,1,1.5,5,0,2,6,28,34
p_290,4,0,e_3,43,63,85,4.0,0,0,0.0,3,0,0,20,22,42
p_285,2,0,e_3,54,73,85,3.5,3,2,2.5,5,0,3,19,12,31
p_288,1,0,e_3,49,79,85,5.5,1,1,1.5,5,0,1,30,6,36
p_300,8,0,e_0,4,39,137,8.0,0,0,0.0,3,0,0,35,98,133
p_297,12,0,e_0,18,57,137,12.0,0,0,3.0,5,0,1,39,80,119
p_294,13,0,e_0,23,63,137,12.5,1,0,4.0,5,0,2,40,74,114
p_293,15,0,e_0,26,73,137,16.0,0,0,5.0,5,0,3,47,64,111
p_277,10,0,e_0,81,95,137,20.5,2,2,13.0,4,1,0,14,42,56
p_298,4,0,e_2,10,29,137,4.0,0,0,0.0,3,0,0,19,108,127
p_295,5,0,e_2,22,35,137,5.0,1,0,2.5,5,0,1,13,102,115
p_292,11,0,e_2,30,61,137,19.5,1,1,4.0,5,1,1,31,76,107
p_287,12,0,e_2,51,67,137,10.0,3,0,9.0,5,1,1,16,70,86
p_280,12,0,e_2,65,67,137,22.0,4,4,12.0,5,1,2,2,70,72
p_284,14,0,e_2,55,77,137,11.5,4,0,9.5,5,1,2,22,60,82
p_276,5,0,e_2,82,115,137,25.5,2,2,13.0,4,1,0,33,22,55
p_267,1,0,e_0,153,160,166,14.0,3,0,0.0,3,0,0,7,6,13
p_291,6,0,e_1,35,62,174,6.0,0,0,0.0,3,0,0,27,112,139
p_289,7,0,e_1,47,68,174,6.5,1,0,2.5,5,0,1,21,106,127
p_283,10,0,e_1,55,82,174,7.5,4,0,4.5,5,0,2,27,92,119
p_281,10,0,e_1,63,82,174,6.0,4,4,6.0,5,1,2,19,92,111
p_278,15,0,e_1,80,104,174,16.0,2,2,9.5,5,1,2,24,70,94
p_273,13,0,e_1,95,114,174,11.0,3,0,13.0,5,1,2,19,60,79
p_270,7,0,e_1,133,140,174,13.0,3,2,8.5,4,1,1,7,34,41
p_269,4,0,e_1,146,154,174,13.0,2,1,6.0,4,1,1,8,20,28
p_279,2,0,e_1,76,164,174,29.5,3,3,8.5,5,1,1,88,10,98
p_275,2,0,e_3,84,95,229,2.0,2,2,0.0,3,1,2,11,134,145
p_274,4,0,e_3,84,105,229,4.0,1,1,0.0,3,1,1,21,124,145
p_282,6,0,e_3,62,115,229,2.0,3,3,4.0,3,1,2,53,114,167
p_271,11,0,e_3,127,137,229,10.0,2,1,9.0,5,1,1,10,92,102
p_272,15,0,e_3,105,155,229,11.0,2,0,4.0,5,1,1,50,74,124
p_265,12,0,e_3,157,169,229,3.0,2,0,15.0,4,1,1,12,60,72
p_263,12,0,e_3,163,169,229,1.0,4,0,13.0,4,1,3,6,60,66
p_268,10,0,e_3,150,179,229,6.0,2,1,14.0,5,1,1,29,50,79
p_262,6,0,e_3,164,197,229,7.0,4,2,13.0,4,1,3,33,32,65
p_264,5,0,e_3,162,203,229,8.0,3,2,13.5,4,1,2,41,26,67
p_254,3,0,e_3,199,213,229,3.0,2,1,6.0,4,1,1,14,16,30
p_252,2,0,e_3,212,219,229,1.0,2,0,3.0,4,1,1,7,10,17
p_251,4,0,e_3,228,247,265,4.0,0,0,0.0,3,1,0,19,18,37
p_258,5,0,e_1,175,197,283,6.0,4,2,0.0,5,0,1,22,86,108
p_259,6,0,e_1,174,203,283,5.0,4,1,0.0,3,0,0,29,80,109
p_256,8,0,e_1,191,213,283,29.5,3,3,4.0,5,0,3,22,70,92
p_257,12,0,e_1,179,231,283,28.0,3,3,1.0,5,0,2,52,52,104
p_249,7,0,e_1,238,253,283,5.0,1,0,10.5,4,1,0,15,30,45
p_261,12,0,e_0,170,220,284,30.0,4,4,0.0,3,0,0,50,64,114
p_260,13,0,e_0,171,226,284,29.0,4,4,0.0,5,0,1,55,58,113
p_250,7,0,e_0,236,252,284,5.5,1,0,11.0,4,1,0,16,32,48
p_244,2,0,e_0,271,274,284,21.0,2,2,2.5,4,1,0,3,10,13
p_255,10,0,e_2,192,198,284,27.0,3,3,9.0,5,0,1,6,86,92
p_266,15,0,e_2,155,220,284,30.0,2,2,0.0,3,0,0,65,64,129
p_253,15,0,e_2,208,220,284,19.0,2,2,12.5,5,1,1,12,64,76
p_248,7,0,e_2,246,254,284,3.0,0,0,8.5,4,1,0,8,30,38
p_243,8,0,e_0,285,319,359,11.0,2,2,0.0,3,0,0,34,40,74
p_236,8,0,e_0,313,319,359,9.0,4,3,6.5,5,0,1,6,40,46
p_235,8,0,e_0,314,319,359,8.5,4,3,7.0,5,0,2,5,40,45
p_237,5,0,e_0,313,333,359,12.0,4,3,7.0,5,0,1,20,26,46
p_232,5,0,e_0,320,333,359,10.5,3,2,8.0,4,1,1,13,26,39
p_230,5,0,e_0,323,333,359,10.0,3,1,7.5,4,1,1,10,26,36
p_222,3,0,e_0,339,343,359,9.0,3,2,4.0,4,1,0,4,16,20
p_216,1,0,e_0,346,353,359,10.0,3,2,2.5,4,1,0,7,6,13
p_245,9,0,e_3,269,303,401,14.0,1,1,1.0,5,0,1,34,98,132
p_247,12,0,e_3,248,317,401,22.0,1,1,4.0,4,1,0,69,84,153
p_246,12,0,e_3,257,317,401,19.5,2,2,1.5,4,1,1,60,84,144
p_241,13,0,e_3,300,323,401,4.5,2,0,8.5,5,0,2,23,78,101
p_240,14,0,e_3,301,329,401,5.0,3,0,9.0,5,0,3,28,72,100
p_234,14,0,e_3,314,329,401,2.5,4,0,11.5,5,1,3,15,72,87
p_226,12,0,e_3,331,339,401,2.0,3,0,14.0,4,1,2,8,62,70
p_228,11,0,e_3,325,345,401,4.0,3,1,13.0,5,1,2,20,56,76
p_219,11,0,e_3,342,345,401,0.0,4,0,11.5,4,1,3,3,56,59
p_229,9,0,e_3,323,355,401,6.0,2,1,13.0,2,1,1,32,46,78
p_227,9,0,e_3,326,355,401,5.5,4,1,13.5,5,1,3,29,46,75
p_220,9,0,e_3,342,355,401,2.0,4,0,11.5,4,1,3,13,46,59
p_218,9,0,e_3,343,355,401,2.0,4,0,11.5,4,1,3,12,46,58
p_212,9,0,e_3,348,355,401,1.0,4,0,10.5,4,1,3,7,46,53
p_215,6,0,e_3,346,369,401,5.0,3,1,11.0,4,1,2,23,32,55
p_242,4,0,e_1,287,306,408,14.5,2,2,0.0,3,0,0,19,102,121
p_239,13,0,e_1,305,344,408,5.5,4,1,4.0,3,0,0,39,64,103
p_224,13,0,e_1,335,344,408,30.0,4,4,11.0,5,1,1,9,64,73
p_223,13,0,e_1,339,344,408,29.0,3,3,12.0,5,1,1,5,64,69
p_213,12,0,e_1,347,350,408,28.5,4,4,12.5,4,1,2,3,58,61
p_217,8,0,e_1,345,368,408,3.0,3,1,13.0,4,1,0,23,40,63
p_204,8,0,e_1,364,368,408,29.0,4,4,9.0,4,1,2,4,40,44
p_196,5,0,e_1,376,382,408,29.5,3,3,6.5,4,1,1,6,26,32
p_192,5,0,e_1,380,382,408,29.0,2,2,5.5,4,1,2,2,26,28
p_214,4,0,e_1,346,388,408,7.0,4,2,12.5,4,1,1,42,20,62
p_185,2,0,e_1,392,398,408,29.5,2,2,3.0,4,1,0,6,10,16
p_238,2,0,e_2,311,322,460,15.5,4,3,0.0,3,0,0,11,138,149
p_233,2,0,e_2,319,322,460,14.0,3,2,1.5,5,0,1,3,138,141
p_231,10,0,e_2,320,356,460,5.5,3,2,1.5,5,0,1,36,104,140
p_225,10,0,e_2,333,356,460,3.0,4,2,4.5,5,1,1,23,104,127
p_207,12,0,e_2,355,366,460,27.0,4,4,10.0,5,1,2,11,94,105
p_203,12,0,e_2,365,366,460,24.5,4,4,12.0,2,1,2,1,94,95
p_200,12,0,e_2,367,368,460,24.0,4,4,12.0,2,1,2,1,92,93
p_208,13,0,e_2,355,376,460,26.0,4,4,10.0,2,1,2,21,84,105
p_202,13,0,e_2,365,376,460,23.5,4,4,12.0,2,1,2,11,84,95
p_201,13,0,e_2,366,376,460,23.5,4,4,12.0,2,1,3,10,84,94
p_211,14,0,e_2,348,382,460,26.5,4,4,8.5,5,1,1,34,78,112
p_190,14,0,e_2,382,382,460,19.5,2,2,14.0,2,1,3,0,78,78
p_193,12,0,e_2,378,394,460,22.0,2,2,13.0,5,1,3,16,66,82
p_194,11,0,e_2,377,400,460,23.0,3,3,13.0,5,1,2,23,60,83
p_181,11,0,e_2,395,400,460,20.0,1,1,12.0,4,1,4,5,60,65
p_205,1,0,e_0,362,369,517,6.0,4,3,0.0,3,0,0,7,148,155
p_189,7,0,e_0,387,395,517,25.5,2,2,5.5,5,1,2,8,122,130
p_187,7,0,e_0,391,395,517,24.5,2,2,6.5,5,1,3,4,122,126
p_197,8,0,e_0,375,401,517,26.5,3,3,2.5,5,1,1,26,116,142
p_188,8,0,e_0,390,401,517,24.0,1,1,6.0,5,1,3,11,116,127
p_198,9,0,e_0,368,407,517,27.0,4,4,1.0,5,0,1,39,110,149
p_183,12,0,e_0,393,421,517,19.0,2,2,6.5,5,1,3,28,96,124
p_161,13,0,e_0,418,427,517,10.0,4,0,11.5,5,1,3,9,90,99
p_180,14,0,e_0,396,433,517,17.0,1,1,7.0,5,1,3,37,84,121
p_172,14,0,e_0,405,433,517,14.0,2,0,9.0,5,1,3,28,84,112
p_165,14,0,e_0,416,433,517,11.0,3,0,11.0,5,1,3,17,84,101
p_162,14,0,e_0,417,433,517,11.0,3,0,11.5,5,1,3,16,84,100
p_158,14,0,e_0,426,433,517,9.0,4,0,13.0,5,1,3,7,84,91
p_168,15,0,e_0,412,439,517,13.0,3,0,10.0,5,1,2,27,78,105
p_157,12,0,e_0,427,453,517,6.5,4,0,13.0,2,1,2,26,64,90
p_174,3,0,e_3,402,417,547,3.0,0,0,0.0,3,0,0,15,130,145
p_173,10,0,e_3,405,447,547,10.0,1,0,0.0,5,0,1,42,100,142
p_170,10,0,e_3,408,447,547,9.0,2,0,1.0,5,0,2,39,100,139
p_169,11,0,e_3,410,453,547,9.5,2,0,1.5,5,0,2,43,94,137
p_164,12,0,e_3,416,459,547,9.0,2,0,3.0,2,0,2,43,88,131
p_151,15,0,e_3,443,473,547,5.5,4,0,9.5,5,1,3,30,74,104
p_149,15,0,e_3,444,473,547,5.5,5,0,9.5,5,1,4,29,74,103
p_142,15,0,e_3,452,473,547,4.0,3,0,11.0,2,1,2,21,74,95
p_141,15,0,e_3,455,473,547,4.0,3,0,11.0,5,1,2,18,74,92
p_124,14,0,e_3,474,479,547,1.0,3,0,15.0,4,1,2,5,68,73
p_123,12,0,e_3,474,489,547,3.0,2,0,15.0,4,1,1,15,58,73
p_128,10,0,e_3,471,499,547,5.5,2,1,14.5,5,1,1,28,48,76
p_120,10,0,e_3,481,499,547,3.0,3,1,13.5,4,1,2,18,48,66
p_115,10,0,e_3,494,499,547,1.0,2,0,11.0,4,1,1,5,48,53
p_108,5,0,e_3,509,521,547,2.0,1,0,7.5,4,1,0,12,26,38
p_171,3,0,e_1,408,423,563,16.0,2,1,0.0,3,0,0,15,140,155
p_163,4,0,e_1,417,429,563,17.0,3,3,2.0,5,0,2,12,134,146
p_166,5,0,e_1,415,435,563,14.0,3,2,1.5,5,0,1,20,128,148
p_160,10,0,e_1,421,457,563,10.5,4,2,3.0,5,0,3,36,106,142
p_159,11,0,e_1,424,463,563,8.5,4,1,3.0,5,1,3,39,100,139
p_134,12,0,e_1,462,469,563,5.5,2,1,11.0,5,1,4,7,94,101
p_140,13,0,e_1,455,475,563,6.0,3,1,9.5,5,1,4,20,88,108
p_139,13,0,e_1,456,475,563,5.5,3,1,10.0,5,1,5,19,88,107
p_137,13,0,e_1,458,475,563,5.0,2,1,10.0,5,1,4,17,88,105
p_127,15,0,e_1,473,485,563,30.0,2,2,12.5,5,1,4,12,78,90
p_117,12,0,e_1,490,499,563,30.0,2,2,14.0,4,1,3,9,64,73
p_113,11,0,e_1,496,505,563,29.5,2,2,12.5,4,1,4,9,58,67
p_130,9,0,e_1,469,515,563,6.5,2,1,12.0,5,1,3,46,48,94
p_104,7,0,e_1,516,525,563,29.0,4,4,9.0,4,1,2,9,38,47
p_98,6,0,e_1,524,531,563,28.5,3,3,7.0,1,1,2,7,32,39
p_175,2,0,e_2,399,471,617,28.5,1,1,11.0,1,1,4,72,146,218
p_136,2,0,e_2,460,471,617,16.0,2,1,0.0,3,0,0,11,146,157
p_133,4,0,e_2,463,481,617,13.5,2,1,0.0,5,0,1,18,136,154
p_191,7,0,e_2,382,495,617,26.5,2,2,14.0,2,1,4,113,122,235
p_167,7,0,e_2,412,495,617,13.0,3,2,9.0,4,1,4,83,122,205
p_116,7,0,e_2,490,495,617,5.0,2,1,6.0,5,1,1,5,122,127
p_195,9,0,e_2,376,505,617,25.5,3,3,13.0,2,1,1,129,112,241
p_177,9,0,e_2,398,505,617,21.5,1,1,11.0,4,1,5,107,112,219
p_131,9,0,e_2,467,505,617,7.0,2,1,1.5,5,0,2,38,112,150
p_121,9,0,e_2,480,505,617,5.0,3,2,4.0,3,1,1,25,112,137
p_114,9,0,e_2,494,505,617,2.0,2,1,7.0,5,1,2,11,112,123
p_103,13,0,e_2,517,523,617,23.0,4,4,12.0,5,1,2,6,94,100
p_109,14,0,e_2,506,529,617,24.5,1,1,9.0,5,1,1,23,88,111
p_112,15,0,e_2,497,535,617,25.5,2,2,7.5,5,1,1,38,82,120
p_111,15,0,e_2,501,535,617,25.0,1,1,8.5,5,1,2,34,82,116
p_102,2,0,e_0,521,532,662,3.0,3,1,0.0,3,0,0,11,130,141
p_152,10,0,e_0,439,566,662,6.0,4,2,15.0,2,1,3,127,96,223
p_146,10,0,e_0,451,566,662,9.5,4,3,12.5,4,1,4,115,96,211
p_100,10,0,e_0,522,566,662,25.0,3,3,0.0,5,0,1,44,96,140
p_97,10,0,e_0,526,566,662,24.0,2,2,1.0,5,0,2,40,96,136
p_79,14,0,e_0,549,584,662,13.5,3,0,6.0,5,1,2,35,78,113
p_75,14,0,e_0,563,584,662,10.5,4,0,9.5,5,1,3,21,78,99
p_68,14,0,e_0,574,584,662,9.0,5,0,12.0,5,1,2,10,78,88
p_87,15,0,e_0,539,590,662,16.5,2,2,3.5,5,1,1,51,72,123
p_72,15,0,e_0,569,590,662,10.5,4,0,10.5,5,1,2,21,72,93
p_46,13,0,e_0,596,600,662,4.0,5,0,13.5,4,1,2,4,62,66
p_145,12,0,e_0,451,606,662,7.5,4,1,12.5,4,1,4,155,56,211
p_66,12,0,e_0,577,606,662,6.5,5,0,12.5,5,1,2,29,56,85
p_65,12,0,e_0,578,606,662,6.0,5,0,13.0,5,1,3,28,56,84
p_41,10,0,e_0,600,616,662,10.0,5,1,13.0,1,1,2,16,46,62
p_95,6,0,e_1,527,593,665,28.0,2,2,7.0,4,1,4,66,72,138
p_94,6,0,e_1,528,593,665,28.0,2,2,6.5,4,1,4,65,72,137
p_57,6,0,e_1,587,593,665,6.5,5,3,5.0,5,0,1,6,72,78
p_74,11,0,e_1,567,615,665,7.0,3,3,0.0,3,0,0,48,50,98
p_52,11,0,e_1,591,615,665,3.0,5,0,6.0,5,0,2,24,50,74
p_42,4,0,e_1,600,645,665,16.0,5,1,7.5,5,1,2,45,20,65
p_40,4,0,e_1,601,645,665,16.0,5,1,7.5,5,1,3,44,20,64
p_150,3,0,e_1,444,651,665,17.5,5,4,7.0,5,1,2,207,14,221
p_148,3,0,e_1,447,651,665,17.0,4,3,8.0,5,1,3,204,14,218
p_85,3,0,e_1,542,651,665,28.0,1,1,4.0,4,1,2,109,14,123
p_43,3,0,e_1,599,651,665,17.0,6,1,7.5,5,1,1,52,14,66
p_82,3,0,e_3,547,561,695,7.0,1,1,0.0,5,0,1,14,134,148
p_221,4,0,e_3,341,567,695,7.0,3,1,11.5,4,1,2,226,128,354
p_210,4,0,e_3,353,567,695,5.0,4,1,9.5,4,1,3,214,128,342
p_106,4,0,e_3,512,567,695,3.0,3,1,7.0,4,1,2,55,128,183
p_105,4,0,e_3,515,567,695,2.0,4,1,6.5,4,1,3,52,128,180
p_78,4,0,e_3,555,567,695,6.5,3,2,1.5,5,0,3,12,128,140
p_83,5,0,e_3,546,573,695,5.0,0,0,0.0,3,1,0,27,122,149
p_206,6,0,e_3,362,579,695,1.0,4,0,7.5,4,1,3,217,116,333
p_80,6,0,e_3,548,579,695,6.0,2,0,0.0,5,0,2,31,116,147
p_77,6,0,e_3,557,579,695,3.5,4,0,2.5,5,0,4,22,116,138
p_73,6,0,e_3,568,579,695,2.0,3,0,4.0,5,1,2,11,116,127
p_67,8,0,e_3,574,589,695,7.0,4,1,5.0,5,1,3,15,106,121
p_63,8,0,e_3,581,589,695,6.0,4,1,6.0,5,1,3,8,106,114
p_60,9,0,e_3,584,595,695,4.0,4,1,7.0,5,1,3,11,100,111
p_53,9,0,e_3,590,595,695,3.0,5,1,8.0,5,1,4,5,100,105
p_129,5,0,e_0,470,698,722,10.5,2,1,8.5,4,1,3,228,24,252
p_122,5,0,e_0,477,698,722,9.0,4,2,7.5,4,1,4,221,24,245
p_119,5,0,e_0,483,698,722,8.0,3,2,6.5,4,1,3,215,24,239
p_30,5,0,e_0,676,698,722,29.0,2,2,0.0,3,0,0,22,24,46
p_27,2,0,e_0,693,712,722,28.0,1,1,4.0,5,0,1,19,10,29
p_28,6,0,e_1,679,705,743,27.5,2,2,0.0,3,0,0,26,38,64
p_25,7,0,e_1,703,711,743,6.0,1,0,5.5,5,0,1,8,32,40
p_96,5,0,e_1,527,721,743,29.0,2,2,7.0,4,1,3,194,22,216
p_23,5,0,e_1,709,721,743,2.5,2,0,7.0,5,1,1,12,22,34
p_26,3,0,e_3,698,712,744,3.0,0,0,0.0,3,0,0,14,32,46
p_49,5,0,e_3,592,722,744,6.5,5,2,8.5,5,1,4,130,22,152
p_45,5,0,e_3,597,722,744,6.0,5,1,9.0,5,1,4,125,22,147
p_32,5,0,e_3,657,722,744,3.0,4,1,8.0,4,1,3,65,22,87
p_31,5,0,e_3,662,722,744,1.0,4,0,6.5,4,1,3,60,22,82
p_24,5,0,e_3,707,722,744,3.0,1,0,2.0,5,0,1,15,22,37
p_55,4,0,e_2,590,645,757,8.0,5,2,4.5,4,1,3,55,112,167
p_38,4,0,e_2,627,645,757,10.0,4,2,0.0,3,0,0,18,112,130
p_93,7,0,e_2,529,659,757,27.0,2,2,14.0,2,1,2,130,98,228
p_89,7,0,e_2,537,659,757,24.5,2,2,14.5,4,1,3,122,98,220
p_76,7,0,e_2,559,659,757,4.0,4,0,11.0,4,1,3,100,98,198
p_37,7,0,e_2,633,659,757,5.0,4,0,1.5,5,0,1,26,98,124
p_34,15,0,e_2,643,693,757,25.5,4,4,3.5,5,0,2,50,64,114
p_29,15,0,e_2,678,693,757,18.5,2,2,11.5,5,1,1,15,64,79
p_22,10,0,e_2,712,715,757,7.0,2,0,10.5,4,1,0,3,42,45
p_143,2,0,e_1,451,779,789,17.5,4,3,8.5,5,1,3,328,10,338
p_90,2,0,e_1,536,779,789,30.0,2,2,5.0,4,1,3,243,10,253
p_81,2,0,e_1,547,779,789,2.0,1,1,3.0,1,1,1,232,10,242
p_18,2,0,e_1,768,779,789,2.0,0,0,0.0,3,0,0,11,10,21
p_186,1,0,e_3,391,853,859,1.0,1,0,2.0,4,1,0,462,6,468
p_107,1,0,e_3,512,853,859,6.0,2,1,7.0,4,1,1,341,6,347
p_99,1,0,e_3,522,853,859,4.0,3,1,5.0,4,1,2,331,6,337
p_8,1,0,e_3,847,853,859,1.0,0,0,0.0,3,0,0,6,6,12
p_56,2,0,e_2,588,855,865,10.0,4,2,5.0,4,1,2,267,10,277
p_48,2,0,e_2,593,855,865,9.0,6,1,4.0,4,1,3,262,10,272
p_9,2,0,e_2,845,855,865,2.0,0,0,0.0,3,0,0,10,10,20
p_20,9,0,e_0,737,770,868,22.5,1,1,1.0,5,0,1,33,98,131
p_21,10,0,e_0,732,776,868,22.5,1,1,0.0,3,0,0,44,92,136
p_19,12,0,e_0,740,786,868,18.5,1,1,2.0,5,0,2,46,82,128
p_16,13,0,e_0,774,792,868,13.0,0,0,9.5,5,1,3,18,76,94
p_17,15,0,e_0,772,802,868,15.0,0,0,9.0,5,1,2,30,66,96
p_15,15,0,e_0,782,802,868,15.0,0,0,11.5,5,1,3,20,66,86
p_14,15,0,e_0,790,802,868,15.0,0,0,13.0,5,1,2,12,66,78
p_12,13,0,e_0,796,812,868,13.0,0,0,14.0,5,1,2,16,56,72
p_13,11,0,e_0,794,822,868,11.0,0,0,13.0,5,1,1,28,46,74
p_11,11,0,e_0,810,822,868,11.0,0,0,13.0,4,1,2,12,46,58
p_156,1,0,e_2,428,871,877,17.5,4,3,6.0,4,1,2,443,6,449
p_64,1,0,e_2,579,871,877,13.0,4,2,6.0,4,1,2,292,6,298
p_51,1,0,e_2,591,871,877,11.0,5,2,4.0,4,1,4,280,6,286
p_4,1,0,e_2,864,871,877,8.5,1,1,0.0,3,1,0,7,6,13
p_110,1,0,e_0,501,883,889,9.0,1,0,3.5,4,1,0,382,6,388
p_3,1,0,e_0,876,883,889,5.5,1,1,0.0,3,0,0,7,6,13
p_5,5,0,e_3,860,883,905,5.0,0,0,0.0,3,0,0,23,22,45
p_155,3,0,e_2,434,892,906,14.0,4,3,5.0,4,1,2,458,14,472
p_84,3,0,e_2,546,892,906,27.0,1,1,13.0,1,1,3,346,14,360
p_70,3,0,e_2,572,892,906,4.0,4,1,7.5,4,1,3,320,14,334
p_2,3,0,e_2,878,892,906,3.0,1,1,0.0,3,0,0,14,14,28
p_1,2,0,e_0,889,900,910,2.0,1,0,0.0,3,0,0,11,10,21
p_7,12,0,e_1,851,861,929,11.5,1,0,10.0,5,0,1,10,68,78
p_10,14,0,e_1,810,871,929,14.0,0,0,0.0,3,0,0,61,58,119
p_6,14,0,e_1,858,871,929,16.0,1,1,11.5,5,0,2,13,58,71
p_300,0,4,e_0,8,9,29,0.0,0,0,0.0,3,0,0,1,20,21
p_299,0,5,e_1,9,9,33,0.0,0,0,0.0,3,0,0,0,24,24
p_297,0,6,e_3,15,16,44,0.0,0,0,0.0,3,0,0,1,28,29
p_298,0,9,e_2,11,12,52,0.0,0,0,0.0,3,0,0,1,40,41
p_286,0,3,e_0,46,47,63,6.0,0,0,0.0,3,0,0,1,16,17
p_296,0,4,e_0,28,47,69,9.5,1,1,4.0,5,1,0,19,22,41
p_289,0,4,e_0,43,47,69,6.0,0,0,1.0,4,0,1,4,22,26
p_295,0,5,e_0,29,47,75,9.5,1,1,4.0,4,0,1,18,28,46
p_287,0,5,e_0,45,47,75,6.0,0,0,0.0,4,0,1,2,28,30
p_292,0,6,e_0,38,47,81,7.0,1,1,2.0,4,0,1,9,34,43
p_290,0,6,e_0,40,47,81,6.5,1,1,1.5,4,0,1,7,34,41
p_281,0,1,e_1,73,76,84,6.0,0,0,0.5,4,0,1,3,8,11
p_288,0,8,e_0,44,47,91,6.0,0,0,0.5,4,0,1,3,44,47
p_285,0,4,e_1,53,76,98,6.0,0,0,5.0,3,0,0,23,22,45
p_284,0,4,e_1,54,76,98,6.0,0,0,5.0,4,0,1,22,22,44
p_279,0,5,e_1,76,76,104,6.0,0,0,0.0,3,0,0,0,28,28
p_291,0,11,e_0,39,47,105,7.0,1,1,2.0,4,0,1,8,58,66
p_294,0,12,e_0,31,47,111,9.0,1,1,3.5,4,0,1,16,64,80
p_293,0,12,e_0,33,47,111,8.5,1,1,3.0,4,0,1,14,64,78
p_278,0,2,e_3,77,103,113,6.0,0,0,6.0,3,0,0,26,10,36
p_282,0,7,e_1,66,76,114,6.0,0,0,2.0,4,0,1,10,38,48
p_283,0,9,e_1,57,76,124,6.0,0,0,4.5,4,0,1,19,48,67
p_277,0,6,e_3,82,103,131,5.0,1,0,5.0,4,0,1,21,28,49
p_274,0,8,e_3,88,103,141,3.5,1,0,3.5,4,0,1,15,38,53
p_280,0,14,e_1,75,76,146,6.0,0,0,0.0,4,0,1,1,70,71
p_276,0,11,e_3,84,103,155,4.5,1,0,4.5,4,0,1,19,52,71
p_271,0,1,e_2,121,148,156,24.0,4,4,6.5,4,0,1,27,8,35
p_267,0,1,e_2,148,148,156,18.5,2,2,0.0,3,0,0,0,8,8
p_268,0,2,e_2,144,148,162,19.5,2,2,1.0,4,0,1,4,14,18
p_275,0,14,e_3,86,103,169,4.0,1,0,4.0,4,0,1,17,66,83
p_273,0,4,e_2,110,148,172,26.5,5,5,9.0,3,0,0,38,24,62
p_270,0,9,e_2,122,148,194,24.0,4,4,6.0,4,0,1,26,46,72
p_269,0,9,e_2,127,148,194,22.5,4,4,5.0,4,0,1,21,46,67
p_272,0,10,e_2,113,148,200,26.0,4,4,8.5,4,0,1,35,52,87
p_255,0,3,e_0,184,201,215,14.0,0,0,4.0,4,0,1,17,14,31
p_265,0,4,e_0,152,201,221,17.5,2,2,12.0,4,0,1,49,20,69
p_254,0,4,e_0,187,201,221,14.0,0,0,3.0,4,0,1,14,20,34
p_262,0,5,e_0,157,201,227,16.5,1,1,10.5,4,0,1,44,26,70
p_261,0,5,e_0,164,201,227,15.0,1,1,9.0,4,0,1,37,26,63
p_253,0,5,e_0,190,201,227,14.0,0,0,2.5,4,0,1,11,26,37
p_266,0,6,e_0,151,201,233,18.0,2,2,12.0,3,0,0,50,32,82
p_263,0,7,e_0,154,201,239,17.0,2,2,11.5,4,0,1,47,38,85
p_260,0,7,e_0,165,201,239,14.5,1,1,9.0,4,0,1,36,38,74
p_258,0,7,e_0,168,201,239,14.0,0,0,8.0,4,0,1,33,38,71
p_256,0,10,e_0,182,201,253,14.0,0,0,4.5,4,0,1,19,52,71
p_250,0,2,e_2,217,248,258,14.0,0,0,7.5,4,0,1,31,10,41
p_264,0,11,e_0,153,201,259,17.5,2,2,12.0,4,0,1,48,58,106
p_252,0,5,e_2,205,248,272,14.0,0,0,10.0,3,0,0,43,24,67
p_248,0,5,e_2,246,248,272,14.0,0,0,0.0,4,0,1,2,24,26
p_257,0,14,e_0,169,201,273,14.0,0,0,8.0,4,0,1,32,72,104
p_249,0,6,e_2,239,248,278,14.0,0,0,2.0,4,0,1,9,30,39
p_259,0,15,e_0,167,201,279,14.5,1,1,8.0,4,0,1,34,78,112
p_251,0,15,e_2,209,248,316,14.0,0,0,9.5,4,0,1,39,68,107
p_241,0,1,e_1,283,309,317,14.0,0,0,6.5,4,0,1,26,8,34
p_236,0,1,e_1,305,309,317,14.0,0,0,0.5,4,0,1,4,8,12
p_247,0,5,e_1,250,309,335,14.0,0,0,14.0,3,0,0,59,26,85
p_245,0,7,e_1,269,309,345,14.0,0,0,9.5,4,0,1,40,36,76
p_237,0,7,e_1,304,309,345,14.0,0,0,1.0,4,0,1,5,36,41
p_242,0,8,e_1,277,309,351,14.0,0,0,8.0,4,0,1,32,42,74
p_235,0,8,e_1,308,309,351,14.0,0,0,0.0,3,0,0,1,42,43
p_240,0,9,e_1,301,309,357,14.0,0,0,2.0,4,0,1,8,48,56
p_246,0,10,e_1,262,309,363,14.0,0,0,11.5,4,0,1,47,54,101
p_239,0,11,e_1,302,309,369,14.0,0,0,1.5,4,0,1,7,60,67
p_244,0,12,e_1,271,309,375,14.0,0,0,9.0,4,0,1,38,66,104
p_226,0,2,e_3,329,369,379,9.5,1,0,9.5,4,0,1,40,10,50
p_223,0,2,e_3,336,369,379,8.0,1,0,8.0,4,0,1,33,10,43
p_233,0,1,e_0,311,373,381,14.0,1,1,15.0,3,0,0,62,8,70
p_238,0,13,e_1,303,309,381,14.0,0,0,1.0,4,0,1,6,72,78
p_230,0,3,e_3,319,369,385,12.5,1,0,12.5,4,0,1,50,16,66
p_243,0,15,e_1,272,309,391,14.0,0,0,9.0,4,0,1,37,82,119
p_228,0,4,e_3,325,369,391,10.5,1,0,10.5,4,0,1,44,22,66
p_196,0,4,e_0,371,373,395,25.5,9,9,0.0,4,0,1,2,22,24
p_232,0,5,e_3,314,369,397,13.5,1,0,13.5,4,0,1,55,28,83
p_225,0,5,e_3,330,369,397,9.5,1,0,9.5,4,0,1,39,28,67
p_224,0,5,e_3,331,369,397,9.5,1,0,9.5,4,0,1,38,28,66
p_222,0,5,e_3,337,369,397,7.5,1,0,7.5,4,0,1,32,28,60
p_219,0,5,e_3,342,369,397,6.5,1,0,6.5,4,0,1,27,28,55
p_221,0,6,e_3,339,369,403,7.5,1,0,7.5,4,0,1,30,34,64
p_220,0,6,e_3,341,369,403,7.0,1,0,7.0,4,0,1,28,34,62
p_231,0,7,e_3,317,369,409,12.5,1,0,12.5,4,0,1,52,40,92
p_234,0,8,e_3,310,369,415,14.0,0,0,14.0,3,0,0,59,46,105
p_198,0,9,e_0,369,373,417,26.0,9,9,0.5,4,0,1,4,44,48
p_197,0,10,e_0,370,373,423,26.0,9,9,0.5,4,0,1,3,50,53
p_227,0,12,e_3,327,369,433,10.5,1,0,10.5,4,0,1,42,64,106
p_229,0,13,e_3,320,369,439,12.0,1,0,12.0,4,0,1,49,70,119
p_190,0,1,e_2,379,436,442,24.0,8,8,14.0,4,0,1,57,6,63
p_183,0,1,e_2,396,436,442,21.0,6,6,10.0,4,0,1,40,6,46
p_195,0,15,e_0,372,373,445,25.5,9,9,0.0,3,0,0,1,72,73
p_182,0,2,e_2,397,436,448,21.0,5,5,9.5,4,0,1,39,12,51
p_180,0,2,e_2,399,436,448,20.5,5,5,9.0,4,0,1,37,12,49
p_186,0,4,e_2,390,436,458,22.0,7,7,11.5,4,0,1,46,22,68
p_194,0,6,e_2,373,436,468,25.0,9,9,15.0,3,0,0,63,32,95
p_192,0,8,e_2,375,436,478,25.0,9,9,15.0,4,0,1,61,42,103
p_189,0,8,e_2,382,436,478,23.5,8,8,13.0,4,0,1,54,42,96
p_191,0,10,e_2,376,436,488,24.5,9,9,15.0,4,0,1,60,52,112
p_185,0,10,e_2,391,436,488,4.0,6,6,11.0,4,0,1,45,52,97
p_193,0,11,e_2,374,436,494,25.0,9,9,15.0,3,0,1,62,58,120
p_187,0,12,e_2,389,436,500,22.5,7,7,11.5,4,0,1,47,64,111
p_184,0,12,e_2,392,436,500,22.0,6,6,11.0,4,0,1,44,64,108
p_216,0,1,e_3,347,493,501,5.5,1,0,5.5,4,0,1,146,8,154
p_188,0,13,e_2,384,436,506,23.0,8,8,12.5,4,0,1,52,70,122
p_209,0,2,e_3,357,493,507,2.5,1,0,2.5,4,0,1,136,14,150
p_205,0,2,e_3,362,493,507,1.5,1,0,1.5,4,0,1,131,14,145
p_214,0,3,e_3,349,493,513,5.0,1,0,5.0,4,0,1,144,20,164
p_181,0,15,e_2,398,436,516,21.0,5,5,9.0,4,0,1,38,80,118
p_108,0,6,e_1,496,499,525,30.0,9,9,0.5,4,0,1,3,26,29
p_210,0,6,e_3,354,493,527,3.5,1,0,3.5,4,0,1,139,34,173
p_208,0,6,e_3,358,493,527,2.5,1,0,2.5,4,0,1,135,34,169
p_154,0,7,e_1,436,499,531,13.5,1,1,15.0,3,0,0,63,32,95
p_217,0,7,e_3,346,493,533,5.5,1,0,5.5,4,0,1,147,40,187
p_212,0,7,e_3,351,493,533,4.5,1,0,4.5,4,0,1,142,40,182
p_218,0,11,e_3,343,493,551,6.5,1,0,6.5,4,0,1,150,58,208
p_207,0,11,e_3,359,493,551,2.5,1,0,2.5,4,0,1,134,58,192
p_206,0,12,e_3,361,493,557,1.5,1,0,1.5,4,0,1,132,64,196
p_204,0,14,e_3,363,493,567,1.5,1,0,1.5,4,0,1,130,74,204
p_96,0,1,e_0,517,561,569,26.5,6,6,10.5,4,0,1,44,8,52
p_215,0,15,e_3,348,493,573,5.0,1,0,5.0,4,0,1,145,80,225
p_213,0,15,e_3,350,493,573,4.5,1,0,4.5,4,0,1,143,80,223
p_211,0,15,e_3,353,493,573,3.5,1,0,3.5,4,0,1,140,80,220
p_106,0,3,e_0,500,561,579,29.0,8,8,15.0,4,0,1,61,18,79
p_92,0,4,e_1,525,561,581,24.5,6,6,6.0,2,2,0,36,20,56
p_99,0,6,e_0,514,561,593,27.0,6,6,11.5,4,0,1,47,32,79
p_94,0,6,e_0,519,561,593,25.5,6,6,10.5,4,0,1,42,32,74
p_74,0,7,e_1,560,561,595,17.5,2,2,0.0,3,0,0,1,34,35
p_102,0,7,e_0,509,561,599,28.0,7,7,12.5,4,0,1,52,38,90
p_98,0,7,e_0,515,561,599,26.5,6,6,11.0,4,0,1,46,38,84
p_97,0,7,e_0,516,561,599,26.5,6,6,11.0,4,0,1,45,38,83
p_101,0,8,e_0,511,561,605,27.5,7,7,12.5,4,0,1,50,44,94
p_100,0,9,e_0,513,561,611,27.0,6,6,12.0,4,0,1,48,50,98
p_107,0,11,e_0,499,561,621,29.5,9,9,15.0,3,0,0,62,60,122
p_103,0,11,e_0,508,561,621,28.0,7,7,13.0,4,0,1,53,60,113
p_81,0,14,e_1,551,561,625,19.0,3,3,2.0,4,0,1,10,64,74
p_105,0,12,e_0,502,561,627,29.0,8,8,14.5,4,0,1,59,66,125
p_167,0,1,e_2,413,624,630,18.0,3,3,5.5,4,0,1,211,6,217
p_93,0,13,e_0,520,561,633,25.5,6,6,10.0,4,0,1,41,72,113
p_104,0,14,e_0,503,561,639,28.5,8,8,14.0,4,0,1,58,78,136
p_95,0,14,e_0,518,561,639,26.0,6,6,10.5,4,0,1,43,78,121
p_178,0,3,e_2,401,624,640,20.0,5,5,8.5,4,0,1,223,16,239
p_176,0,4,e_2,403,624,646,20.0,4,4,8.0,4,0,1,221,22,243
p_165,0,4,e_2,417,624,646,18.0,2,2,4.5,4,0,1,207,22,229
p_179,0,8,e_2,400,624,664,20.5,5,5,8.5,4,0,1,224,40,264
p_177,0,9,e_2,402,624,670,20.0,5,5,8.5,4,0,1,222,46,268
p_169,0,9,e_2,411,624,670,19.0,3,3,6.0,4,0,1,213,46,259
p_173,0,11,e_2,407,624,680,19.0,4,4,7.0,4,0,1,217,56,273
p_166,0,12,e_2,416,624,686,18.0,2,2,4.5,4,0,1,208,62,270
p_171,0,13,e_2,409,624,692,19.0,3,3,6.5,4,0,1,215,68,283
p_168,0,13,e_2,412,624,692,18.5,3,3,6.0,4,0,1,212,68,280
p_175,0,14,e_2,405,624,698,19.5,4,4,7.5,4,0,1,219,74,293
p_174,0,14,e_2,406,624,698,19.5,4,4,7.5,4,0,1,218,74,292
p_170,0,14,e_2,410,624,698,19.0,3,3,6.5,4,0,1,214,74,288
p_30,0,3,e_1,668,687,701,15.0,0,0,4.5,4,0,1,19,14,33
p_172,0,15,e_2,408,624,704,19.0,4,4,7.0,4,0,1,216,80,296
p_29,0,5,e_1,670,687,711,15.0,0,0,4.0,4,0,1,17,24,41
p_32,0,6,e_1,650,687,717,15.0,0,0,9.0,4,0,1,37,30,67
p_31,0,6,e_1,666,687,717,15.0,0,0,5.0,4,0,1,21,30,51
p_26,0,8,e_1,684,687,727,15.0,0,0,0.5,4,0,1,3,40,43
p_25,0,8,e_1,686,687,727,15.0,0,0,0.0,4,0,1,1,40,41
p_35,0,9,e_1,630,687,733,15.0,0,0,14.0,4,0,1,57,46,103
p_27,0,10,e_1,677,687,739,15.0,0,0,2.5,4,0,1,10,52,62
p_28,0,11,e_1,676,687,745,15.0,0,0,2.5,4,0,1,11,58,69
p_34,0,12,e_1,646,687,751,15.0,0,0,10.0,4,0,1,41,64,105
p_36,0,13,e_1,628,687,757,15.0,0,0,14.0,3,0,0,59,70,129
p_86,0,2,e_0,544,754,764,20.5,4,4,4.0,4,0,1,210,10,220
p_33,0,15,e_1,649,687,767,15.0,0,0,9.0,4,0,1,38,80,118
p_77,0,3,e_0,557,754,770,18.0,2,2,0.5,4,0,1,197,16,213
p_88,0,5,e_0,538,754,780,22.0,4,4,5.5,4,0,1,216,26,242
p_76,0,6,e_0,558,754,786,18.0,2,2,0.5,4,0,1,196,32,228
p_80,0,7,e_0,552,754,792,19.0,3,3,2.0,4,0,1,202,38,240
p_87,0,8,e_0,539,754,798,21.5,4,4,5.0,4,0,1,215,44,259
p_83,0,8,e_0,549,754,798,19.0,4,4,2.5,4,0,1,205,44,249
p_89,0,9,e_0,535,754,804,22.5,4,4,6.0,4,0,1,219,50,269
p_91,0,12,e_0,526,754,818,24.0,6,6,8.5,4,0,1,228,64,292
p_84,0,12,e_0,546,754,818,20.0,4,4,3.5,4,0,1,208,64,272
p_78,0,12,e_0,556,754,818,18.0,3,3,1.0,4,0,1,198,64,262
p_161,0,1,e_2,421,816,822,17.0,2,2,3.5,4,0,1,395,6,401
p_158,0,1,e_2,430,816,822,14.5,2,2,1.0,4,0,1,386,6,392
p_90,0,13,e_0,527,754,824,24.0,5,5,8.5,4,0,1,227,70,297
p_82,0,14,e_0,550,754,830,19.0,3,3,2.5,4,0,1,204,76,280
p_79,0,14,e_0,553,754,830,18.5,3,3,1.5,4,0,1,201,76,277
p_72,0,3,e_2,562,816,832,17.0,2,2,15.0,3,0,0,254,16,270
p_71,0,3,e_2,564,816,832,16.5,2,2,15.0,4,0,1,252,16,268
p_70,0,3,e_2,565,816,832,16.5,2,2,14.5,4,0,1,251,16,267
p_85,0,15,e_0,545,754,836,20.0,4,4,3.5,4,0,1,209,82,291
p_159,0,6,e_2,429,816,846,14.5,2,2,1.5,4,0,1,387,30,417
p_163,0,10,e_2,419,816,864,17.5,2,2,4.0,4,0,1,397,48,445
p_164,0,11,e_2,418,816,870,17.5,2,2,4.5,4,0,1,398,54,452
p_162,0,11,e_2,420,816,870,17.0,2,2,4.0,4,0,1,396,54,450
p_68,0,13,e_2,567,816,880,16.0,1,1,14.0,4,0,1,249,64,313
p_157,0,14,e_2,431,816,886,14.5,2,2,1.0,4,0,1,385,70,455
p_155,0,14,e_2,435,816,886,14.0,1,1,0.0,4,0,1,381,70,451
p_69,0,14,e_2,566,816,886,16.0,1,1,14.0,4,0,1,250,70,320
p_160,0,15,e_2,426,816,892,15.5,2,2,2.5,4,0,1,390,76,466
p_156,0,15,e_2,434,816,892,14.0,1,1,0.0,4,0,1,382,76,458
p_4,0,1,e_0,886,898,904,15.0,0,0,2.5,4,0,1,12,6,18
p_24,0,2,e_0,695,898,910,15.0,0,0,14.0,3,0,0,203,12,215
p_9,0,2,e_0,846,898,910,15.0,0,0,12.5,4,0,1,52,12,64
p_22,0,3,e_0,719,898,916,15.0,0,0,8.5,4,0,1,179,18,197
p_6,0,3,e_0,877,898,916,15.0,0,0,5.0,4,0,1,21,18,39
p_21,0,4,e_0,731,898,922,15.0,0,0,5.5,4,0,1,167,24,191
p_75,0,5,e_0,559,898,928,17.5,2,2,0.5,4,0,1,339,30,369
p_7,0,5,e_0,875,898,928,15.0,0,0,5.5,4,0,1,23,30,53
p_10,0,8,e_0,835,898,942,15.0,0,0,15.0,2,1,0,63,44,107
p_5,0,8,e_0,883,898,942,15.0,0,0,3.5,4,0,1,15,44,59
p_3,0,8,e_0,888,898,942,15.0,0,0,2.5,4,0,1,10,44,54
p_73,0,11,e_0,561,898,956,17.5,2,2,0.0,3,0,0,337,58,395
p_8,0,11,e_0,874,898,956,15.0,0,0,5.5,4,0,1,24,58,82
p_23,0,12,e_0,711,898,962,15.0,0,0,10.5,4,0,1,187,64,251
p_20,0,14,e_0,734,898,972,15.0,0,0,5.0,4,0,1,164,74,238
p_300,0,4,e_0,8,9,29,0.0,0,0,0.0,3,0,0,1,20,21
p_299,0,5,e_1,9,10,34,0.0,0,0,0.0,3,0,0,1,24,25
p_297,0,6,e_3,15,16,44,0.0,0,0,0.0,3,0,0,1,28,29
p_298,0,9,e_2,11,11,51,0.0,0,0,0.0,3,0,0,0,40,40
p_286,0,3,e_0,46,47,63,6.0,0,0,0.0,3,0,0,1,16,17
p_296,0,4,e_0,28,47,69,10.0,1,1,4.0,3,1,0,19,22,41
p_289,0,4,e_0,43,47,69,6.0,0,0,0.5,4,0,1,4,22,26
p_295,0,5,e_0,29,47,75,9.5,1,1,4.0,4,0,1,18,28,46
p_287,0,5,e_0,45,47,75,6.0,0,0,0.5,4,0,1,2,28,30
p_292,0,6,e_0,38,47,81,7.5,1,1,2.0,4,0,1,9,34,43
p_290,0,6,e_0,40,47,81,6.5,1,1,1.5,4,0,1,7,34,41
p_281,0,1,e_1,73,75,83,6.0,0,0,0.5,4,0,1,2,8,10
p_288,0,8,e_0,44,47,91,6.0,0,0,0.5,4,0,1,3,44,47
p_285,0,4,e_1,53,75,97,6.0,0,0,5.0,3,0,0,22,22,44
p_284,0,4,e_1,54,75,97,6.0,0,0,5.0,4,0,1,21,22,43
p_291,0,11,e_0,39,47,105,7.0,1,1,1.5,4,0,1,8,58,66
p_282,0,7,e_1,66,75,111,6.0,0,0,2.0,4,0,1,9,36,45
p_294,0,12,e_0,31,47,111,9.0,1,1,3.5,4,0,1,16,64,80
p_293,0,12,e_0,33,47,111,8.5,1,1,3.5,4,0,1,14,64,78
p_278,0,2,e_3,77,102,112,6.0,1,0,6.0,4,0,1,25,10,35
p_283,0,9,e_1,57,75,121,6.0,0,0,4.0,4,0,1,18,46,64
p_279,0,5,e_3,76,102,126,6.0,0,0,6.0,3,0,0,26,24,50
p_277,0,6,e_3,82,102,132,5.0,1,0,5.0,4,0,1,20,30,50
p_274,0,8,e_3,88,102,142,3.0,1,0,3.0,4,0,1,14,40,54
p_280,0,14,e_1,75,75,143,6.0,0,0,0.0,3,0,0,0,68,68
p_271,0,1,e_2,121,148,154,24.0,5,5,6.5,4,0,1,27,6,33
p_276,0,11,e_3,84,102,156,4.5,1,0,4.5,4,0,1,18,54,72
p_268,0,2,e_2,144,148,160,20.0,2,2,0.5,4,0,1,4,12,16
p_273,0,4,e_2,110,148,170,26.0,6,6,9.0,3,0,0,38,22,60
p_275,0,14,e_3,86,102,170,3.5,1,0,3.5,4,0,1,16,68,84
p_270,0,9,e_2,122,148,192,24.0,5,5,6.5,4,0,1,26,44,70
p_269,0,9,e_2,127,148,192,23.0,4,4,5.0,4,0,1,21,44,65
p_272,0,10,e_2,113,148,198,26.0,5,5,8.5,4,0,1,35,50,85
p_267,0,1,e_0,148,199,205,18.5,2,2,12.0,3,0,0,51,6,57
p_255,0,3,e_0,184,199,215,14.0,0,0,3.5,4,0,1,15,16,31
p_265,0,4,e_0,152,199,221,17.5,2,2,11.5,4,0,1,47,22,69
p_254,0,4,e_0,187,199,221,14.0,0,0,3.0,4,0,1,12,22,34
p_262,0,5,e_0,157,199,227,17.0,1,1,10.5,4,0,1,42,28,70
p_261,0,5,e_0,164,199,227,15.5,1,1,8.5,4,0,1,35,28,63
p_253,0,5,e_0,190,199,227,14.0,0,0,2.0,4,0,1,9,28,37
p_266,0,6,e_0,151,199,233,18.0,2,2,11.5,4,0,1,48,34,82
p_263,0,7,e_0,154,199,239,17.5,2,2,11.0,4,0,1,45,40,85
p_260,0,7,e_0,165,199,239,15.0,1,1,8.5,4,0,1,34,40,74
p_258,0,7,e_0,168,199,239,14.0,1,1,7.5,4,0,1,31,40,71
p_256,0,10,e_0,182,199,253,14.0,0,0,4.0,4,0,1,17,54,71
p_264,0,11,e_0,153,199,259,17.5,2,2,11.0,4,0,1,46,60,106
p_250,0,2,e_2,217,247,259,14.0,0,0,7.5,4,0,1,30,12,42
p_252,0,5,e_2,205,247,273,14.0,0,0,10.0,3,0,0,42,26,68
p_248,0,5,e_2,246,247,273,14.0,0,0,0.0,3,0,0,1,26,27
p_257,0,14,e_0,169,199,273,14.0,1,1,7.5,4,0,1,30,74,104
p_259,0,15,e_0,167,199,279,14.5,1,1,8.0,4,0,1,32,80,112
p_249,0,6,e_2,239,247,279,14.0,0,0,2.0,4,0,1,8,32,40
p_241,0,1,e_1,283,309,315,14.0,0,0,6.0,4,0,1,26,6,32
p_236,0,1,e_1,305,309,315,14.0,0,0,0.5,4,0,1,4,6,10
p_251,0,15,e_2,209,247,317,14.0,0,0,9.0,4,0,1,38,70,108
p_247,0,5,e_1,250,309,333,14.0,0,0,14.0,3,0,0,59,24,83
p_245,0,7,e_1,269,309,343,14.0,0,0,10.0,4,0,1,40,34,74
p_237,0,7,e_1,304,309,343,14.0,0,0,1.0,4,0,1,5,34,39
p_242,0,8,e_1,277,309,349,14.0,0,0,8.0,4,0,1,32,40,72
p_235,0,8,e_1,308,309,349,14.0,0,0,0.0,4,0,1,1,40,41
p_240,0,9,e_1,301,309,355,14.0,0,0,1.5,4,0,1,8,46,54
p_246,0,10,e_1,262,309,361,14.0,0,0,11.5,4,0,1,47,52,99
p_239,0,11,e_1,302,309,367,14.0,0,0,1.5,4,0,1,7,58,65
p_244,0,12,e_1,271,309,373,14.0,0,0,9.0,4,0,1,38,64,102
p_233,0,1,e_3,311,368,376,14.0,1,0,14.0,4,0,1,57,8,65
p_238,0,13,e_1,303,309,379,14.0,0,0,1.0,4,0,1,6,70,76
p_226,0,2,e_3,329,368,382,9.5,1,0,9.5,4,0,1,39,14,53
p_223,0,2,e_3,336,368,382,7.5,1,0,7.5,4,0,1,32,14,46
p_230,0,3,e_3,319,368,388,12.0,1,0,12.0,4,0,1,49,20,69
p_243,0,15,e_1,272,309,389,14.0,0,0,9.0,4,0,1,37,80,117
p_228,0,4,e_3,325,368,394,10.5,1,0,10.5,4,0,1,43,26,69
p_232,0,5,e_3,314,368,400,13.0,1,0,13.0,4,0,1,54,32,86
p_225,0,5,e_3,330,368,400,9.0,1,0,9.0,4,0,1,38,32,70
p_224,0,5,e_3,331,368,400,9.0,1,0,9.0,4,0,1,37,32,69
p_222,0,5,e_3,337,368,400,7.5,1,0,7.5,4,0,1,31,32,63
p_221,0,6,e_3,339,368,406,7.0,1,0,7.0,4,0,1,29,38,67
p_220,0,6,e_3,341,368,406,6.5,1,0,6.5,4,0,1,27,38,65
p_231,0,7,e_3,317,368,412,12.5,1,0,12.5,4,0,1,51,44,95
p_234,0,8,e_3,310,368,418,14.0,0,0,14.0,3,0,0,58,50,108
p_227,0,12,e_3,327,368,436,10.0,1,0,10.0,4,0,1,41,68,109
p_183,0,1,e_0,396,431,439,21.5,6,6,8.5,4,0,1,35,8,43
p_190,0,1,e_2,379,431,439,24.5,9,9,12.5,4,0,1,52,8,60
p_161,0,1,e_2,421,431,439,17.5,2,2,2.0,4,0,1,10,8,18
p_229,0,13,e_3,320,368,442,11.5,1,0,11.5,4,0,1,48,74,122
p_182,0,2,e_0,397,431,445,21.5,6,6,8.0,4,0,1,34,14,48
p_178,0,3,e_2,401,431,449,21.0,5,5,7.0,4,0,1,30,18,48
p_196,0,4,e_0,371,431,455,26.0,10,10,14.5,4,0,1,60,24,84
p_186,0,4,e_0,390,431,455,23.0,7,7,10.0,4,0,1,41,24,65
p_194,0,6,e_0,373,431,465,25.5,10,10,14.0,4,0,1,58,34,92
p_198,0,9,e_2,369,431,475,26.0,10,10,15.0,3,0,0,62,44,106
p_169,0,9,e_2,411,431,475,19.0,4,4,4.5,4,0,1,20,44,64
p_192,0,8,e_0,375,431,475,25.0,9,9,13.5,4,0,1,56,44,100
p_189,0,8,e_0,382,431,475,24.0,8,8,12.0,4,0,1,49,44,93
p_197,0,10,e_0,370,431,485,26.0,10,10,15.0,4,0,1,61,54,115
p_191,0,10,e_0,376,431,485,25.0,9,9,13.5,4,0,1,55,54,109
p_185,0,10,e_0,391,431,485,22.5,7,7,9.5,4,0,1,40,54,94
p_187,0,12,e_2,389,431,489,23.0,7,7,10.0,4,0,1,42,58,100
p_193,0,11,e_0,374,431,491,25.5,10,10,14.0,4,0,1,57,60,117
p_171,0,13,e_2,409,431,495,19.5,4,4,5.0,4,0,1,22,64,86
p_184,0,12,e_0,392,431,497,22.0,7,7,9.5,4,0,1,39,66,105
p_157,0,14,e_2,431,431,501,15.0,2,2,0.0,3,0,0,0,70,70
p_216,0,1,e_3,347,496,502,5.0,1,0,5.0,4,0,1,149,6,155
p_188,0,13,e_0,384,431,503,23.5,8,8,11.5,4,0,1,47,72,119
p_146,0,1,e_1,453,497,505,10.5,1,0,10.5,4,0,1,44,8,52
p_209,0,2,e_3,357,496,508,2.5,1,0,2.5,4,0,1,139,12,151
p_205,0,2,e_3,362,496,508,1.5,1,0,1.5,4,0,1,134,12,146
p_199,0,15,e_0,368,431,513,26.0,11,11,15.0,3,0,0,63,82,145
p_195,0,15,e_0,372,431,513,26.0,10,10,14.5,4,0,1,59,82,141
p_214,0,3,e_3,349,496,514,4.5,1,0,4.5,4,0,1,147,18,165
p_143,0,3,e_1,456,497,515,10.0,1,0,10.0,4,0,1,41,18,59
p_137,0,4,e_1,464,497,521,8.0,1,0,8.0,4,0,1,33,24,57
p_219,0,5,e_3,342,496,524,6.5,1,0,6.5,4,0,1,154,28,182
p_210,0,6,e_3,354,496,530,3.5,1,0,3.5,4,0,1,142,34,176
p_208,0,6,e_3,358,496,530,2.0,1,0,2.0,4,0,1,138,34,172
p_150,0,6,e_1,443,497,531,13.0,1,0,13.0,4,0,1,54,34,88
p_141,0,6,e_1,458,497,531,9.5,1,0,9.5,4,0,1,39,34,73
p_217,0,7,e_3,346,496,536,5.0,1,0,5.0,4,0,1,150,40,190
p_212,0,7,e_3,351,496,536,4.0,1,0,4.0,4,0,1,145,40,185
p_154,0,7,e_1,436,497,537,14.0,2,2,15.0,4,0,1,61,40,101
p_140,0,8,e_1,459,497,543,9.0,1,0,9.0,4,0,1,38,46,84
p_153,0,9,e_1,437,497,549,14.0,2,2,14.5,4,0,1,60,52,112
p_147,0,9,e_1,452,497,549,11.0,1,0,11.0,4,0,1,45,52,97
p_144,0,9,e_1,455,497,549,10.0,1,0,10.0,4,0,1,42,52,94
p_142,0,9,e_1,457,497,549,9.5,1,0,9.5,4,0,1,40,52,92
p_218,0,11,e_3,343,496,554,6.0,1,0,6.0,4,0,1,153,58,211
p_207,0,11,e_3,359,496,554,2.0,1,0,2.0,4,0,1,137,58,195
p_139,0,10,e_1,461,497,555,8.5,1,0,8.5,4,0,1,36,58,94
p_206,0,12,e_3,361,496,560,1.5,1,0,1.5,4,0,1,135,64,199
p_96,0,1,e_2,517,559,567,26.5,6,6,10.0,4,0,1,42,8,50
p_215,0,15,e_3,348,496,574,5.0,1,0,5.0,4,0,1,148,78,226
p_213,0,15,e_3,350,496,574,4.5,1,0,4.5,4,0,1,146,78,224
p_211,0,15,e_3,353,496,574,3.5,1,0,3.5,4,0,1,143,78,221
p_106,0,3,e_2,500,559,577,29.5,9,9,14.0,5,1,1,59,18,77
p_156,0,15,e_1,434,497,577,14.5,2,2,15.0,3,0,0,63,80,143
p_152,0,15,e_1,441,497,577,13.0,2,2,14.0,4,0,1,56,80,136
p_151,0,15,e_1,442,497,577,13.0,1,1,13.5,4,0,1,55,80,135
p_99,0,6,e_2,514,559,591,27.0,6,6,11.0,4,0,1,45,32,77
p_94,0,6,e_2,519,559,591,26.0,6,6,9.5,4,0,1,40,32,72
p_102,0,7,e_2,509,559,597,28.0,7,7,12.5,4,0,1,50,38,88
p_98,0,7,e_2,515,559,597,27.0,6,6,10.5,4,0,1,44,38,82
p_97,0,7,e_2,516,559,597,27.0,6,6,10.5,4,0,1,43,38,81
p_101,0,8,e_2,511,559,603,27.5,7,7,11.5,4,0,1,48,44,92
p_100,0,9,e_2,513,559,609,27.0,6,6,11.0,4,0,1,46,50,96
p_107,0,11,e_2,499,559,619,29.5,9,9,13.5,5,1,0,60,60,120
p_103,0,11,e_2,508,559,619,28.0,7,7,12.5,4,0,1,51,60,111
p_105,0,12,e_2,502,559,625,29.0,8,8,14.0,4,0,1,57,66,123
p_167,0,1,e_0,413,622,628,19.0,3,3,4.0,4,0,1,209,6,215
p_93,0,13,e_2,520,559,631,26.0,6,6,9.5,4,0,1,39,72,111
p_180,0,2,e_0,399,622,634,21.0,6,6,7.5,4,0,1,223,12,235
p_104,0,14,e_2,503,559,637,29.0,8,8,14.0,4,0,1,56,78,134
p_95,0,14,e_2,518,559,637,26.5,6,6,10.0,4,0,1,41,78,119
p_176,0,4,e_0,403,622,644,20.5,5,5,6.5,4,0,1,219,22,241
p_165,0,4,e_0,417,622,644,18.0,3,3,3.0,4,0,1,205,22,227
p_179,0,8,e_0,400,622,662,21.0,5,5,7.5,4,0,1,222,40,262
p_177,0,9,e_0,402,622,668,20.5,5,5,7.0,4,0,1,220,46,266
p_173,0,11,e_0,407,622,678,20.0,4,4,5.5,4,0,1,215,56,271
p_164,0,11,e_0,418,622,678,18.0,2,2,3.0,4,0,1,204,56,260
p_166,0,12,e_0,416,622,684,18.5,3,3,3.5,4,0,1,206,62,268
p_168,0,13,e_0,412,622,690,19.0,3,3,4.5,4,0,1,210,68,278
p_175,0,14,e_0,405,622,696,20.0,4,4,6.5,4,0,1,217,74,291
p_174,0,14,e_0,406,622,696,20.0,4,4,6.0,4,0,1,216,74,290
p_170,0,14,e_0,410,622,696,19.5,4,4,5.0,4,0,1,212,74,286
p_130,0,1,e_1,472,691,697,6.0,1,0,6.0,4,0,1,219,6,225
p_119,0,1,e_1,483,691,697,3.0,1,0,3.0,4,0,1,208,6,214
p_113,0,1,e_1,489,691,697,1.5,1,0,1.5,4,0,1,202,6,208
p_181,0,15,e_0,398,622,702,21.5,6,6,8.0,4,0,1,224,80,304
p_172,0,15,e_0,408,622,702,20.0,4,4,5.5,4,0,1,214,80,294
p_136,0,3,e_3,465,693,707,7.5,1,0,7.5,4,0,1,228,14,242
p_129,0,3,e_3,473,693,707,5.5,1,0,5.5,4,0,1,220,14,234
p_114,0,3,e_1,488,691,707,2.0,1,0,2.0,4,0,1,203,16,219
p_200,0,4,e_3,367,693,713,0.0,0,0,0.0,3,0,0,326,20,346
p_201,0,5,e_3,366,693,719,0.5,1,0,0.5,4,0,1,327,26,353
p_108,0,6,e_1,496,691,721,30.0,9,9,0.0,3,0,0,195,30,225
p_148,0,8,e_3,449,693,733,11.5,1,0,11.5,4,0,1,244,40,284
p_135,0,10,e_1,466,691,739,7.5,1,0,7.5,4,0,1,225,48,273
p_117,0,10,e_1,485,691,739,2.5,1,0,2.5,4,0,1,206,48,254
p_127,0,10,e_3,475,693,743,5.0,1,0,5.0,4,0,1,218,50,268
p_132,0,11,e_1,470,691,745,6.5,1,0,6.5,4,0,1,221,54,275
p_120,0,11,e_1,482,691,745,3.5,1,0,3.5,4,0,1,209,54,263
p_112,0,11,e_1,490,691,745,1.5,1,0,1.5,4,0,1,201,54,255
p_110,0,11,e_1,492,691,745,1.0,1,0,1.0,4,0,1,199,54,253
p_145,0,11,e_3,454,693,749,10.0,1,0,10.0,4,0,1,239,56,295
p_138,0,11,e_3,463,693,749,8.0,1,0,8.0,4,0,1,230,56,286
p_128,0,11,e_3,474,693,749,5.0,1,0,5.0,4,0,1,219,56,275
p_133,0,12,e_1,469,691,751,6.5,1,0,6.5,4,0,1,222,60,282
p_203,0,12,e_3,364,693,755,0.5,1,0,0.5,4,0,1,329,62,391
p_36,0,13,e_1,628,691,757,15.0,0,0,15.0,3,0,0,63,66,129
p_86,0,2,e_2,544,754,764,21.0,3,3,3.5,4,0,1,210,10,220
p_204,0,14,e_3,363,693,765,1.0,1,0,1.0,4,0,1,330,72,402
p_155,0,14,e_3,435,693,765,14.0,1,1,12.0,2,2,0,258,72,330
p_131,0,14,e_3,471,693,765,6.0,1,0,6.0,4,0,1,222,72,294
p_134,0,15,e_1,467,691,767,7.0,1,0,7.0,4,0,1,224,76,300
p_122,0,15,e_1,480,691,767,4.0,1,0,4.0,4,0,1,211,76,287
p_202,0,15,e_3,365,693,771,0.5,1,0,0.5,4,0,1,328,78,406
p_149,0,15,e_3,444,693,771,12.5,1,0,12.5,4,0,1,249,78,327
p_92,0,4,e_2,525,754,774,25.0,5,5,8.5,4,0,1,229,20,249
p_88,0,5,e_2,538,754,780,22.5,3,3,5.0,4,0,1,216,26,242
p_80,0,7,e_2,552,754,790,19.5,3,3,1.5,4,0,1,202,36,238
p_87,0,8,e_2,539,754,796,22.5,3,3,4.5,4,0,1,215,42,257
p_83,0,8,e_2,549,754,796,20.0,3,3,2.0,4,0,1,205,42,247
p_89,0,9,e_2,535,754,802,23.0,3,3,6.0,4,0,1,219,48,267
p_91,0,12,e_2,526,754,816,24.5,5,5,8.0,4,0,1,228,62,290
p_84,0,12,e_2,546,754,816,21.0,3,3,3.0,4,0,1,208,62,270
p_78,0,12,e_2,556,754,816,19.0,2,2,0.5,4,0,1,198,62,260
p_90,0,13,e_2,527,754,822,24.5,5,5,8.0,4,0,1,227,68,295
p_158,0,1,e_0,430,817,823,15.5,2,2,0.0,3,0,0,387,6,393
p_82,0,14,e_2,550,754,828,19.5,3,3,2.0,4,0,1,204,74,278
p_81,0,14,e_2,551,754,828,19.5,3,3,2.0,4,0,1,203,74,277
p_79,0,14,e_2,553,754,828,19.0,3,3,1.5,4,0,1,201,74,275
p_72,0,3,e_0,562,817,833,17.5,1,1,14.5,4,0,1,255,16,271
p_71,0,3,e_0,564,817,833,17.0,1,1,14.0,4,0,1,253,16,269
p_70,0,3,e_0,565,817,833,17.0,1,1,14.0,4,0,1,252,16,268
p_67,0,3,e_0,568,817,833,16.0,1,1,13.5,4,0,1,249,16,265
p_66,0,3,e_0,569,817,833,16.0,1,1,13.0,4,0,1,248,16,264
p_85,0,15,e_2,545,754,834,21.0,3,3,3.5,4,0,1,209,80,289
p_75,0,5,e_0,559,817,843,18.0,1,1,15.0,3,0,0,258,26,284
p_159,0,6,e_0,429,817,849,15.5,2,2,0.5,4,0,1,388,32,420
p_74,0,7,e_0,560,817,855,18.0,1,1,15.0,3,0,1,257,38,295
p_163,0,10,e_0,419,817,869,18.0,2,2,2.5,4,0,1,398,52,450
p_162,0,11,e_0,420,817,875,18.0,2,2,2.5,4,0,1,397,58,455
p_73,0,11,e_0,561,817,875,18.0,1,1,15.0,4,0,1,256,58,314
p_68,0,13,e_0,567,817,885,16.5,1,1,13.5,4,0,1,250,68,318
p_69,0,14,e_0,566,817,891,17.0,1,1,13.5,4,0,1,251,74,325
p_160,0,15,e_0,426,817,897,16.5,2,2,1.0,4,0,1,391,80,471
p_9,0,2,e_1,846,898,908,15.0,0,0,13.0,4,0,1,52,10,62
p_30,0,3,e_1,668,898,914,6.0,1,0,5.5,4,0,1,230,16,246
p_6,0,3,e_1,877,898,914,15.0,0,0,5.0,4,0,1,21,16,37
p_29,0,5,e_1,670,898,924,5.5,1,0,5.0,4,0,1,228,26,254
p_7,0,5,e_1,875,898,924,15.0,0,0,5.5,4,0,1,23,26,49
p_32,0,6,e_1,650,898,930,10.5,1,0,10.0,4,0,1,248,32,280
p_31,0,6,e_1,666,898,930,6.5,1,0,6.0,4,0,1,232,32,264
p_26,0,8,e_1,684,898,940,2.0,1,0,1.5,4,0,1,214,42,256
p_25,0,8,e_1,686,898,940,1.5,1,0,1.0,4,0,1,212,42,254
p_10,0,8,e_1,835,898,940,15.0,0,0,15.0,3,0,0,63,42,105
p_27,0,10,e_1,677,898,950,3.5,1,0,3.0,4,0,1,221,52,273
p_28,0,11,e_1,676,898,956,4.0,1,0,3.5,4,0,1,222,58,280
p_8,0,11,e_1,874,898,956,15.0,0,0,5.5,4,0,1,24,58,82
p_34,0,12,e_1,646,898,962,11.5,1,0,11.0,4,0,1,252,64,316
p_33,0,15,e_1,649,898,976,10.5,1,0,10.0,4,0,1,249,78,327
p_300,0,4,e_0,8,9,29,0.0,0,0,0.0,3,0,0,1,20,21
p_299,0,5,e_1,9,9,33,0.0,0,0,0.0,3,0,0,0,24,24
p_297,0,6,e_3,15,16,44,0.0,0,0,0.0,3,0,0,1,28,29
p_298,0,9,e_2,11,12,52,0.0,0,0,0.0,3,0,0,1,40,41
p_286,0,3,e_0,46,47,63,6.0,0,0,0.0,3,0,0,1,16,17
p_296,0,4,e_0,28,47,69,9.5,1,1,4.0,3,1,0,19,22,41
p_289,0,4,e_0,43,47,69,6.0,1,1,1.0,4,0,1,4,22,26
p_295,0,5,e_0,29,47,75,9.5,1,1,4.0,4,0,1,18,28,46
p_287,0,5,e_0,45,47,75,6.0,0,0,0.5,4,0,1,2,28,30
p_281,0,1,e_1,73,75,81,6.0,0,0,0.0,4,0,1,2,6,8
p_292,0,6,e_0,38,47,81,7.5,1,1,2.0,4,0,1,9,34,43
p_290,0,6,e_0,40,47,81,6.5,1,1,1.5,4,0,1,7,34,41
p_288,0,8,e_0,44,47,91,6.0,0,0,0.5,4,0,1,3,44,47
p_285,0,4,e_1,53,75,95,6.0,0,0,5.0,3,0,0,22,20,42
p_284,0,4,e_1,54,75,95,6.0,0,0,5.0,4,0,1,21,20,41
p_291,0,11,e_0,39,47,105,7.0,1,1,1.5,4,0,1,8,58,66
p_282,0,7,e_1,66,75,109,6.0,0,0,2.0,4,0,1,9,34,43
p_294,0,12,e_0,31,47,111,9.0,1,1,3.5,4,0,1,16,64,80
p_293,0,12,e_0,33,47,111,8.5,1,1,3.5,4,0,1,14,64,78
p_278,0,2,e_3,77,102,112,6.0,1,0,6.0,4,0,1,25,10,35
p_283,0,9,e_1,57,75,119,6.0,0,0,4.0,4,0,1,18,44,62
p_279,0,5,e_3,76,102,126,6.0,1,0,6.0,4,0,1,26,24,50
p_277,0,6,e_3,82,102,132,4.5,1,0,4.5,4,0,1,20,30,50
p_274,0,8,e_3,88,102,142,3.0,1,0,3.0,4,0,1,14,40,54
p_271,0,1,e_2,121,149,155,24.0,5,5,6.5,4,0,1,28,6,34
p_267,0,1,e_2,148,149,155,19.0,2,2,0.0,4,0,1,1,6,7
p_276,0,11,e_3,84,102,156,4.0,1,0,4.0,4,0,1,18,54,72
p_268,0,2,e_2,144,149,161,19.5,2,2,1.0,4,0,1,5,12,17
p_280,0,14,e_3,75,102,170,6.0,0,0,6.0,3,0,0,27,68,95
p_275,0,14,e_3,86,102,170,3.5,1,0,3.5,4,0,1,16,68,84
p_273,0,4,e_2,110,149,171,26.0,6,6,9.0,3,0,0,39,22,61
p_270,0,9,e_2,122,149,193,23.5,5,5,6.5,4,0,1,27,44,71
p_269,0,9,e_2,127,149,193,23.0,4,4,5.5,4,0,1,22,44,66
p_272,0,10,e_2,113,149,199,26.0,5,5,8.5,4,0,1,36,50,86
p_255,0,3,e_1,184,189,203,14.0,0,0,1.0,4,0,1,5,14,19
p_265,0,4,e_1,152,189,209,18.0,2,2,9.0,4,0,1,37,20,57
p_254,0,4,e_1,187,189,209,14.0,0,0,0.5,4,0,1,2,20,22
p_262,0,5,e_1,157,189,215,17.0,1,1,8.0,4,0,1,32,26,58
p_261,0,5,e_1,164,189,215,15.5,1,1,6.0,4,0,1,25,26,51
p_266,0,6,e_1,151,189,221,18.0,2,2,9.0,3,0,0,38,32,70
p_263,0,7,e_1,154,189,227,17.5,2,2,8.5,4,0,1,35,38,73
p_260,0,7,e_1,165,189,227,15.0,1,1,5.5,4,0,1,24,38,62
p_258,0,7,e_1,168,189,227,14.0,1,1,5.0,4,0,1,21,38,59
p_256,0,10,e_1,182,189,241,14.0,0,0,1.5,4,0,1,7,52,59
p_264,0,11,e_1,153,189,247,17.5,2,2,9.0,4,0,1,36,58,94
p_250,0,2,e_0,217,240,252,14.0,0,0,5.5,4,0,1,23,12,35
p_257,0,14,e_1,169,189,261,14.0,0,0,4.5,4,0,1,20,72,92
p_253,0,5,e_0,190,240,266,14.0,0,0,12.0,3,0,0,50,26,76
p_252,0,5,e_0,205,240,266,14.0,0,0,8.5,4,0,1,35,26,61
p_259,0,15,e_1,167,189,267,14.5,1,1,5.0,4,0,1,22,78,100
p_249,0,6,e_0,239,240,272,14.0,0,0,0.0,3,0,0,1,32,33
p_241,0,1,e_2,283,288,294,14.0,0,0,1.0,4,0,1,5,6,11
p_251,0,15,e_0,209,240,310,14.0,0,0,7.5,4,0,1,31,70,101
p_248,0,5,e_2,246,288,312,14.0,0,0,10.0,3,0,0,42,24,66
p_247,0,5,e_2,250,288,312,14.0,0,0,9.5,4,0,1,38,24,62
p_245,0,7,e_2,269,288,322,14.0,0,0,4.5,4,0,1,19,34,53
p_242,0,8,e_2,277,288,328,14.0,0,0,2.5,4,0,1,11,40,51
p_246,0,10,e_2,262,288,338,14.0,0,0,6.5,4,0,1,26,50,76
p_244,0,12,e_2,271,288,348,14.0,0,0,4.0,4,0,1,17,60,77
p_243,0,15,e_2,272,288,362,14.0,0,0,4.0,4,0,1,16,74,90
p_236,0,1,e_3,305,360,366,13.5,1,0,13.5,4,0,1,55,6,61
p_233,0,1,e_3,311,360,366,12.0,1,0,12.0,4,0,1,49,6,55
p_226,0,2,e_3,329,360,372,7.5,1,0,7.5,4,0,1,31,12,43
p_205,0,2,e_1,362,364,374,26.0,10,10,0.0,4,0,1,2,10,12
p_230,0,3,e_3,319,360,378,10.0,1,0,10.0,4,0,1,41,18,59
p_228,0,4,e_3,325,360,384,8.5,1,0,8.5,4,0,1,35,24,59
p_232,0,5,e_3,314,360,390,11.0,1,0,11.0,4,0,1,46,30,76
p_225,0,5,e_3,330,360,390,7.0,1,0,7.0,4,0,1,30,30,60
p_237,0,7,e_3,304,360,400,13.5,1,0,13.5,4,0,1,56,40,96
p_231,0,7,e_3,317,360,400,10.5,1,0,10.5,4,0,1,43,40,83
p_235,0,8,e_3,308,360,406,13.0,1,0,13.0,4,0,1,52,46,98
p_234,0,8,e_3,310,360,406,12.5,1,0,12.5,4,0,1,50,46,96
p_240,0,9,e_3,301,360,412,14.0,0,0,14.0,3,0,0,59,52,111
p_239,0,11,e_1,302,364,412,14.0,1,1,15.0,3,0,0,62,48,110
p_206,0,12,e_1,361,364,418,26.0,10,10,0.5,4,0,1,3,54,57
p_227,0,12,e_3,327,360,426,8.0,1,0,8.0,4,0,1,33,66,99
p_204,0,14,e_1,363,364,428,25.5,10,10,0.0,4,0,1,1,64,65
p_238,0,13,e_3,303,360,432,14.0,1,0,14.0,4,0,1,57,72,129
p_229,0,13,e_3,320,360,432,9.5,1,0,9.5,4,0,1,40,72,112
p_190,0,1,e_0,379,426,434,23.0,7,7,11.5,4,0,1,47,8,55
p_200,0,4,e_0,367,426,448,25.0,9,9,14.5,4,0,1,59,22,81
p_196,0,4,e_0,371,426,448,24.0,8,8,13.5,4,0,1,55,22,77
p_201,0,5,e_0,366,426,454,25.0,9,9,15.0,4,0,1,60,28,88
p_194,0,6,e_0,373,426,460,24.0,8,8,13.0,4,0,1,53,34,87
p_192,0,8,e_0,375,426,470,23.5,8,8,12.5,4,0,1,51,44,95
p_189,0,8,e_0,382,426,470,22.5,7,7,11.0,4,0,1,44,44,88
p_198,0,9,e_0,369,426,476,24.5,9,9,14.0,4,0,1,57,50,107
p_197,0,10,e_0,370,426,482,24.5,9,9,14.0,4,0,1,56,56,112
p_191,0,10,e_0,376,426,482,23.5,8,8,12.5,4,0,1,50,56,106
p_193,0,11,e_0,374,426,488,23.5,8,8,12.5,4,0,1,52,62,114
p_202,0,15,e_2,365,427,489,25.0,10,10,15.0,3,0,0,62,62,124
p_130,0,1,e_1,472,487,493,3.5,1,0,3.5,4,0,1,15,6,21
p_216,0,1,e_3,347,486,494,3.0,1,0,3.0,4,0,1,139,8,147
p_203,0,12,e_0,364,426,494,25.5,10,10,15.0,3,0,0,62,68,130
p_188,0,13,e_0,384,426,500,4.0,6,6,10.5,4,0,1,42,74,116
p_223,0,2,e_3,336,486,500,6.0,1,0,6.0,4,0,1,150,14,164
p_143,0,3,e_1,456,487,503,7.5,1,0,7.5,4,0,1,31,16,47
p_214,0,3,e_3,349,486,506,2.5,1,0,2.5,4,0,1,137,20,157
p_137,0,4,e_1,464,487,509,5.5,1,0,5.5,4,0,1,23,22,45
p_199,0,15,e_0,368,426,510,25.0,9,9,14.5,4,0,1,58,84,142
p_195,0,15,e_0,372,426,510,24.0,8,8,13.5,4,0,1,54,84,138
p_224,0,5,e_3,331,486,516,7.0,1,0,7.0,4,0,1,155,30,185
p_222,0,5,e_3,337,486,516,5.5,1,0,5.5,4,0,1,149,30,179
p_219,0,5,e_3,342,486,516,4.0,1,0,4.0,4,0,1,144,30,174
p_159,0,6,e_1,429,487,519,13.5,1,1,14.0,3,0,0,58,32,90
p_150,0,6,e_1,443,487,519,10.5,1,0,10.5,4,0,1,44,32,76
p_221,0,6,e_3,339,486,522,5.0,1,0,5.0,4,0,1,147,36,183
p_220,0,6,e_3,341,486,522,4.5,1,0,4.5,4,0,1,145,36,181
p_210,0,6,e_3,354,486,522,1.5,1,0,1.5,4,0,1,132,36,168
p_217,0,7,e_3,346,486,528,3.0,1,0,3.0,4,0,1,140,42,182
p_212,0,7,e_3,351,486,528,2.0,1,0,2.0,4,0,1,135,42,177
p_142,0,9,e_1,457,487,533,7.0,1,0,7.0,4,0,1,30,46,76
p_135,0,10,e_1,466,487,539,5.0,1,0,5.0,4,0,1,21,52,73
p_145,0,11,e_1,454,487,545,8.0,1,0,8.0,4,0,1,33,58,91
p_138,0,11,e_1,463,487,545,5.5,1,0,5.5,4,0,1,24,58,82
p_128,0,11,e_1,474,487,545,3.0,1,0,3.0,4,0,1,13,58,71
p_218,0,11,e_3,343,486,546,4.0,1,0,4.0,4,0,1,143,60,203
p_133,0,12,e_1,469,487,551,4.0,1,0,4.0,4,0,1,18,64,82
p_113,0,1,e_2,489,551,559,30.0,8,8,15.0,4,0,1,62,8,70
p_157,0,14,e_1,431,487,561,13.0,1,1,13.5,4,0,1,56,74,130
p_155,0,14,e_1,435,487,561,12.5,1,0,12.5,4,0,1,52,74,126
p_131,0,14,e_1,471,487,561,3.5,1,0,3.5,4,0,1,16,74,90
p_215,0,15,e_3,348,486,564,3.0,1,0,3.0,4,0,1,138,78,216
p_213,0,15,e_3,350,486,564,2.0,1,0,2.0,4,0,1,136,78,214
p_211,0,15,e_3,353,486,564,1.5,1,0,1.5,4,0,1,133,78,211
p_151,0,15,e_1,442,487,567,11.0,1,0,11.0,4,0,1,45,80,125
p_114,0,3,e_2,488,551,569,30.0,8,8,15.0,2,1,1,63,18,81
p_106,0,3,e_2,500,551,569,28.0,6,6,12.5,4,0,1,51,18,69
p_108,0,6,e_2,496,551,583,28.5,7,7,13.5,4,0,1,55,32,87
p_102,0,7,e_2,509,551,589,26.5,5,5,10.5,4,0,1,42,38,80
p_111,0,8,e_2,491,551,595,29.5,8,8,15.0,4,0,1,60,44,104
p_101,0,8,e_2,511,551,595,26.0,5,5,9.5,4,0,1,40,44,84
p_115,0,9,e_2,487,551,601,30.0,9,9,15.0,5,1,0,64,50,114
p_112,0,11,e_2,490,551,611,30.0,8,8,15.0,4,0,1,61,60,121
p_110,0,11,e_2,492,551,611,29.5,8,8,14.5,4,0,1,59,60,119
p_107,0,11,e_2,499,551,611,28.0,6,6,12.5,4,0,1,52,60,112
p_103,0,11,e_2,508,551,611,26.5,5,5,10.5,4,0,1,43,60,103
p_105,0,12,e_2,502,551,617,28.0,6,6,12.0,4,0,1,49,66,115
p_183,0,1,e_0,396,615,623,20.0,5,5,7.5,4,0,1,219,8,227
p_104,0,14,e_2,503,551,627,27.5,6,6,12.0,4,0,1,48,76,124
p_182,0,2,e_0,397,615,629,19.5,5,5,7.0,4,0,1,218,14,232
p_180,0,2,e_0,399,615,629,19.0,4,4,6.5,4,0,1,216,14,230
p_109,0,15,e_2,493,551,633,29.0,8,8,14.5,4,0,1,58,82,140
p_178,0,3,e_0,401,615,635,19.0,4,4,6.0,4,0,1,214,20,234
p_186,0,4,e_0,390,615,641,21.0,5,5,9.0,4,0,1,225,26,251
p_176,0,4,e_0,403,615,641,18.5,4,4,5.5,4,0,1,212,26,238
p_179,0,8,e_0,400,615,659,19.0,4,4,6.0,4,0,1,215,44,259
p_177,0,9,e_0,402,615,665,19.0,4,4,6.0,4,0,1,213,50,263
p_185,0,10,e_0,391,615,671,21.0,5,5,8.5,4,0,1,224,56,280
p_173,0,11,e_0,407,615,677,18.0,3,3,4.5,4,0,1,208,62,270
p_187,0,12,e_0,389,615,683,21.0,6,6,9.0,4,0,1,226,68,294
p_184,0,12,e_0,392,615,683,21.0,5,5,8.0,4,0,1,223,68,291
p_175,0,14,e_0,405,615,693,18.0,4,4,5.0,4,0,1,210,78,288
p_174,0,14,e_0,406,615,693,18.0,3,3,5.0,4,0,1,209,78,287
p_158,0,1,e_3,430,692,698,13.0,1,1,13.0,5,1,0,262,6,268
p_146,0,1,e_3,453,692,698,8.0,1,0,8.0,4,0,1,239,6,245
p_181,0,15,e_0,398,615,699,19.0,5,5,6.5,4,0,1,217,84,301
p_30,0,3,e_1,668,690,704,6.0,1,0,5.0,4,0,1,22,14,36
p_209,0,2,e_3,357,692,704,0.5,1,0,0.5,4,0,1,335,12,347
p_29,0,5,e_1,670,690,714,5.5,1,0,5.0,4,0,1,20,24,44
p_32,0,6,e_1,650,690,720,10.0,1,0,9.5,4,0,1,40,30,70
p_31,0,6,e_1,666,690,720,6.5,1,0,5.5,4,0,1,24,30,54
p_208,0,6,e_3,358,692,722,0.5,1,0,0.5,4,0,1,334,30,364
p_141,0,6,e_3,458,692,722,6.5,1,0,6.5,4,0,1,234,30,264
p_124,0,7,e_1,478,690,726,2.0,1,0,2.0,4,0,1,212,36,248
p_118,0,7,e_1,484,690,726,0.5,1,0,0.5,4,0,1,206,36,242
p_154,0,7,e_3,436,692,728,12.0,1,0,12.0,4,0,1,256,36,292
p_148,0,8,e_3,449,692,734,9.0,1,0,9.0,4,0,1,243,42,285
p_140,0,8,e_3,459,692,734,6.5,1,0,6.5,4,0,1,233,42,275
p_127,0,10,e_1,475,690,740,2.5,1,0,2.5,4,0,1,215,50,265
p_116,0,10,e_1,486,690,740,0.0,1,1,0.0,4,0,1,204,50,254
p_153,0,9,e_3,437,692,740,12.0,1,0,12.0,4,0,1,255,48,303
p_147,0,9,e_3,452,692,740,8.0,1,0,8.0,4,0,1,240,48,288
p_144,0,9,e_3,455,692,740,7.5,1,0,7.5,4,0,1,237,48,285
p_123,0,11,e_1,479,690,746,1.5,1,0,1.5,4,0,1,211,56,267
p_121,0,11,e_1,481,690,746,1.0,1,0,1.0,4,0,1,209,56,265
p_120,0,11,e_1,482,690,746,1.0,1,0,1.0,4,0,1,208,56,264
p_207,0,11,e_3,359,692,750,0.0,1,0,0.0,4,0,1,333,58,391
p_34,0,12,e_1,646,690,752,11.5,1,0,10.5,4,0,1,44,62,106
p_36,0,13,e_1,628,690,758,15.0,0,0,15.0,3,0,0,62,68,130
p_96,0,1,e_2,517,757,763,25.0,4,4,8.0,4,0,1,240,6,246
p_156,0,15,e_3,434,692,768,12.5,1,0,12.5,4,0,1,258,76,334
p_152,0,15,e_3,441,692,768,11.0,1,0,11.0,4,0,1,251,76,327
p_149,0,15,e_3,444,692,768,10.0,1,0,10.0,4,0,1,248,76,324
p_122,0,15,e_1,480,690,768,1.5,1,0,1.5,4,0,1,210,78,288
p_33,0,15,e_1,649,690,768,10.5,1,0,10.0,4,0,1,41,78,119
p_86,0,2,e_2,544,757,769,19.0,2,2,1.5,4,0,1,213,12,225
p_92,0,4,e_2,525,757,779,23.5,3,3,6.0,4,0,1,232,22,254
p_88,0,5,e_2,538,757,785,21.0,2,2,3.0,4,0,1,219,28,247
p_99,0,6,e_2,514,757,791,25.5,5,5,9.0,4,0,1,243,34,277
p_94,0,6,e_2,519,757,791,24.5,4,4,7.5,4,0,1,238,34,272
p_98,0,7,e_2,515,757,797,25.0,5,5,8.5,4,0,1,242,40,282
p_97,0,7,e_2,516,757,797,25.0,4,4,8.5,4,0,1,241,40,281
p_87,0,8,e_2,539,757,803,20.5,2,2,3.0,4,0,1,218,46,264
p_100,0,9,e_2,513,757,809,25.5,5,5,9.0,4,0,1,244,52,296
p_89,0,9,e_2,535,757,809,21.5,2,2,3.5,4,0,1,222,52,274
p_91,0,12,e_2,526,757,823,23.0,3,3,6.0,4,0,1,231,66,297
p_93,0,13,e_2,520,757,829,24.5,4,4,7.5,4,0,1,237,72,309
p_90,0,13,e_2,527,757,829,23.0,3,3,6.0,4,0,1,230,72,302
p_167,0,1,e_0,413,828,834,17.0,2,2,3.0,4,0,1,415,6,421
p_161,0,1,e_0,421,828,834,15.0,2,2,1.0,4,0,1,407,6,413
p_95,0,14,e_2,518,757,835,24.5,4,4,8.0,4,0,1,239,78,317
p_165,0,4,e_0,417,828,848,16.0,2,2,2.0,4,0,1,411,20,431
p_80,0,7,e_0,552,828,862,17.5,1,1,15.0,3,0,0,276,34,310
p_169,0,9,e_0,411,828,872,17.0,2,2,3.5,4,0,1,417,44,461
p_163,0,10,e_0,419,828,878,15.5,2,2,1.5,4,0,1,409,50,459
p_164,0,11,e_0,418,828,884,16.0,2,2,2.0,4,0,1,410,56,466
p_162,0,11,e_0,420,828,884,15.0,2,2,1.5,4,0,1,408,56,464
p_166,0,12,e_0,416,828,890,16.0,2,2,2.0,4,0,1,412,62,474
p_171,0,13,e_0,409,828,896,17.5,3,3,4.0,4,0,1,419,68,487
p_168,0,13,e_0,412,828,896,17.0,2,2,3.0,4,0,1,416,68,484
p_170,0,14,e_0,410,828,902,17.0,3,3,3.5,4,0,1,418,74,492
p_79,0,14,e_0,553,828,902,17.5,1,1,15.0,3,0,1,275,74,349
p_24,0,2,e_2,695,894,904,29.5,8,8,15.0,3,0,0,199,10,209
p_9,0,2,e_2,846,894,904,15.0,0,0,11.5,4,0,1,48,10,58
p_172,0,15,e_0,408,828,908,17.5,3,3,4.0,4,0,1,420,80,500
p_160,0,15,e_0,426,828,908,14.0,1,1,0.0,3,0,0,402,80,482
p_22,0,3,e_2,719,894,910,24.5,6,6,9.0,4,0,1,175,16,191
p_21,0,4,e_2,731,894,916,22.5,4,4,6.5,4,0,1,163,22,185
p_7,0,5,e_2,875,894,922,15.0,0,0,4.5,4,0,1,19,28,47
p_83,0,8,e_2,549,894,936,18.5,1,1,0.0,4,0,1,345,42,387
p_10,0,8,e_2,835,894,936,15.0,0,0,14.0,3,0,0,59,42,101
p_19,0,11,e_2,754,894,950,18.0,1,1,0.5,4,0,1,140,56,196
p_8,0,11,e_2,874,894,950,15.0,0,0,5.0,4,0,1,20,56,76
p_84,0,12,e_2,546,894,956,19.0,1,1,1.0,4,0,1,348,62,410
p_23,0,12,e_2,711,894,956,26.5,6,6,11.5,4,0,1,183,62,245
p_82,0,14,e_2,550,894,966,18.5,1,1,0.0,4,0,1,344,72,416
p_81,0,14,e_2,551,894,966,18.0,1,1,0.0,3,0,0,343,72,415
p_20,0,14,e_2,734,894,966,22.0,3,3,5.5,4,0,1,160,72,232
p_85,0,15,e_2,545,894,972,19.0,1,1,1.0,4,0,1,349,78,427
p_1,0,5,e_1,894,957,979,15.0,0,0,15.0,3,0,0,63,22,85
p_26,0,8,e_1,684,957,993,2.0,1,0,1.5,4,0,1,273,36,309
p_25,0,8,e_1,686,957,993,1.5,1,0,1.0,4,0,1,271,36,307
p_27,0,10,e_1,677,957,1003,3.5,1,0,3.0,4,0,1,280,46,326
p_28,0,11,e_1,676,957,1009,3.5,1,0,3.0,4,0,1,281,52,333
