p_300,0,4,e_0,8,9,25,0.0,0,0,0.0,3,0,0,1,16,17
p_297,0,6,e_3,15,16,38,0.0,0,0,0.0,3,0,0,1,22,23
p_296,0,4,e_0,28,43,57,10.5,1,1,2.0,3,0,0,15,14,29
p_292,0,6,e_0,38,43,65,3.0,0,0,0.5,4,0,1,5,22,27
p_290,0,6,e_0,40,43,65,3.0,0,0,0.5,4,0,1,3,22,25
p_289,0,4,e_3,43,64,78,3.0,0,0,3.0,3,0,0,21,14,35
p_285,0,4,e_3,53,64,78,1.5,1,0,1.5,4,0,1,11,14,25
p_284,0,4,e_3,54,64,78,1.5,1,0,1.5,4,0,1,10,14,24
p_294,0,12,e_0,31,43,85,10.0,1,1,2.0,4,0,1,12,42,54
p_293,0,12,e_0,33,43,85,10.0,1,1,1.5,4,0,1,10,42,52
p_288,0,8,e_3,44,64,92,3.0,1,1,3.0,3,0,1,20,28,48
p_278,0,2,e_1,77,105,113,16.0,5,5,4.5,4,1,1,28,8,36
p_277,0,6,e_1,82,105,127,15.5,4,4,4.0,4,1,1,23,22,45
p_274,0,8,e_1,88,105,135,14.5,4,4,3.0,4,1,1,17,30,47
p_273,0,4,e_0,110,123,137,11.0,3,3,2.0,4,2,0,13,14,27
p_280,0,14,e_1,75,105,155,16.5,5,5,5.0,4,1,1,30,50,80
p_275,0,14,e_1,86,105,155,15.0,4,4,3.0,4,1,1,19,50,69
p_272,0,10,e_0,113,123,157,11.0,3,3,1.5,4,2,1,10,34,44
p_268,0,2,e_3,144,162,170,3.0,4,0,3.0,4,3,1,18,8,26
p_265,0,4,e_3,152,162,178,1.5,4,0,1.5,4,3,1,10,16,26
p_266,0,6,e_3,151,162,186,2.0,4,0,2.0,4,3,1,11,24,35
p_254,0,4,e_1,187,199,213,19.0,6,6,2.0,4,4,1,12,14,26
p_250,0,2,e_0,217,221,229,7.5,6,0,0.5,4,4,1,4,8,12
p_256,0,10,e_1,182,199,233,19.5,7,7,2.5,4,4,1,17,34,51
p_257,0,14,e_1,169,199,247,21.0,9,9,5.0,4,4,1,30,48,78
p_249,0,6,e_3,239,262,284,3.5,6,0,3.5,4,6,0,23,22,45
p_246,0,10,e_3,262,262,298,0.0,6,6,0.0,3,6,0,0,36,36
p_242,0,8,e_1,277,299,325,20.0,8,8,3.5,4,6,1,22,26,48
p_244,0,12,e_1,271,299,339,21.0,8,8,4.5,4,6,1,28,40,68
p_235,0,8,e_0,308,317,345,15.5,6,6,1.5,4,5,1,9,28,37
p_234,0,8,e_0,310,317,345,15.0,6,6,1.0,4,5,1,7,28,35
p_226,0,2,e_3,329,362,370,5.5,7,0,5.5,4,6,1,33,8,41
p_228,0,4,e_3,325,362,378,6.0,7,0,6.0,4,6,1,37,16,53
p_205,0,2,e_2,362,390,400,0.0,6,6,4.5,4,1,1,28,10,38
p_227,0,12,e_3,327,362,404,6.0,7,0,6.0,4,6,1,35,42,77
p_200,0,4,e_2,367,390,408,25.5,10,10,3.5,4,1,1,23,18,41
p_196,0,4,e_2,371,390,408,25.0,9,9,3.0,4,1,1,19,18,37
p_194,0,6,e_2,373,390,416,24.5,9,9,2.5,4,1,1,17,26,43
p_182,0,2,e_0,397,415,423,21.0,8,8,3.0,4,7,0,18,8,26
p_185,0,10,e_1,391,397,429,22.0,8,8,1.0,4,6,0,6,32,38
p_197,0,10,e_2,370,390,430,25.0,9,9,3.0,4,1,1,20,40,60
p_203,0,12,e_2,364,390,438,26.0,10,10,4.0,4,1,1,26,48,74
p_204,0,14,e_2,363,390,446,26.0,10,10,4.5,4,1,1,27,56,83
p_223,0,2,e_3,336,462,470,4.0,7,0,4.0,4,6,1,126,8,134
p_186,0,4,e_2,390,498,512,22.5,8,8,0.0,3,1,0,108,14,122
p_192,0,8,e_2,375,498,526,24.5,9,9,2.5,4,1,1,123,28,151
p_189,0,8,e_2,382,498,526,23.5,8,8,1.5,4,1,1,116,28,144
p_184,0,12,e_1,392,493,531,22.0,8,8,0.5,4,6,1,101,38,139
p_191,0,10,e_2,376,498,534,24.5,9,9,2.0,4,1,1,122,36,158
p_187,0,12,e_2,389,498,542,22.5,8,8,0.0,4,1,1,109,44,153
p_137,0,4,e_2,464,600,614,26.0,8,8,5.5,4,4,1,136,14,150
p_139,0,10,e_2,461,600,634,0.0,7,7,6.0,4,4,0,139,34,173
p_135,0,10,e_2,466,600,634,25.5,8,8,5.0,4,4,1,134,34,168
p_133,0,12,e_2,469,698,736,25.0,8,8,5.0,4,4,1,229,38,267
p_131,0,14,e_2,471,698,744,25.0,7,7,4.5,4,4,1,227,46,273
p_298,4,0,e_2,10,25,39,4.0,0,0,0.0,3,0,0,15,14,29
p_285,2,0,e_1,54,96,104,17.0,4,2,7.5,3,0,3,42,8,50
p_300,8,0,e_0,4,31,107,8.0,0,0,0.0,3,0,0,27,76,103
p_297,12,0,e_0,18,45,107,12.0,0,0,2.0,5,0,1,27,62,89
p_282,6,0,e_0,62,85,107,16.0,4,2,6.5,4,1,1,23,22,45
p_279,2,0,e_0,76,99,107,4.0,3,0,4.5,4,1,2,23,8,31
p_275,2,0,e_0,84,99,107,2.0,4,0,3.0,1,1,2,15,8,23
p_291,6,0,e_3,35,41,115,14.0,2,1,2.0,5,0,2,6,74,80
p_287,12,0,e_3,51,61,115,7.5,3,0,4.5,5,1,2,10,54,64
p_284,14,0,e_3,55,69,115,9.0,4,0,5.0,5,1,3,14,46,60
p_274,4,0,e_3,84,101,115,1.0,3,0,5.0,4,1,2,17,14,31
p_290,4,0,e_2,43,58,146,15.0,3,1,0.0,3,0,0,15,88,103
p_283,10,0,e_2,55,78,146,9.0,4,2,1.5,5,0,4,23,68,91
p_281,10,0,e_2,63,78,146,12.0,4,2,2.5,5,1,4,15,68,83
p_280,12,0,e_2,65,86,146,9.5,4,1,3.0,5,1,4,21,60,81
p_277,10,0,e_2,81,114,146,25.5,3,3,5.0,5,1,5,33,32,65
p_268,10,0,e_1,150,168,200,6.5,4,1,7.5,3,0,3,18,32,50
p_265,12,0,e_3,157,173,215,11.0,5,1,7.0,5,0,5,16,42,58
p_262,6,0,e_3,164,193,215,1.0,6,0,7.5,4,0,6,29,22,51
p_269,4,0,e_3,146,201,215,13.0,3,2,5.0,5,0,3,55,14,69
p_263,12,0,e_2,163,184,250,24.5,6,6,2.5,5,0,6,21,66,87
p_261,12,0,e_2,170,184,250,23.5,7,7,4.0,5,0,7,14,66,80
p_257,12,0,e_2,179,184,250,23.0,8,8,5.5,5,0,8,5,66,71
p_255,10,0,e_2,192,212,250,23.0,7,7,7.0,5,1,8,20,38,58
p_256,8,0,e_2,191,220,250,25.5,8,8,7.0,5,1,7,29,30,59
p_259,6,0,e_2,174,228,250,30.0,7,7,4.5,5,0,7,54,22,76
p_252,2,0,e_2,212,242,250,28.5,6,6,5.0,1,1,8,30,8,38
p_251,4,0,e_1,228,282,296,24.0,5,4,4.5,5,0,3,54,14,68
p_244,2,0,e_0,271,289,297,4.0,7,1,4.0,4,0,4,18,8,26
p_247,12,0,e_3,248,253,315,12.5,5,1,5.5,5,0,5,5,62,67
p_246,12,0,e_3,257,275,315,11.5,6,1,6.5,5,1,5,18,40,58
p_242,4,0,e_3,287,301,315,0.0,6,0,4.5,4,1,5,14,14,28
p_243,8,0,e_2,285,320,348,26.5,6,6,5.5,5,0,7,35,28,63
p_238,2,0,e_2,311,340,348,28.5,6,6,5.5,4,0,8,29,8,37
p_233,2,0,e_2,319,340,348,27.5,6,5,4.0,1,0,8,21,8,29
p_236,8,0,e_1,313,322,398,22.5,6,6,2.5,5,0,5,9,76,85
p_231,10,0,e_1,320,330,398,19.5,6,2,4.0,5,0,6,10,68,78
p_226,12,0,e_1,331,338,398,15.5,6,1,5.0,5,1,6,7,60,67
p_213,12,0,e_1,347,360,398,13.5,6,1,7.5,5,1,7,13,38,51
p_240,14,0,e_0,301,341,403,18.0,6,6,0.5,5,0,4,40,62,102
p_234,14,0,e_0,314,341,403,14.0,5,5,2.5,5,0,5,27,62,89
p_225,10,0,e_0,333,363,403,17.0,6,2,5.5,5,0,6,30,40,70
p_217,8,0,e_0,345,371,403,17.5,6,2,7.5,3,1,7,26,32,58
p_215,6,0,e_0,346,379,403,19.5,6,3,7.5,3,1,8,33,24,57
p_221,4,0,e_0,341,387,403,22.0,6,4,7.0,5,1,6,46,16,62
p_214,4,0,e_0,346,387,403,21.5,6,4,7.5,4,1,9,41,16,57
p_210,4,0,e_0,353,387,403,20.0,7,4,6.5,4,1,9,34,16,50
p_209,2,0,e_0,354,395,403,22.0,7,4,6.5,4,1,9,41,8,49
p_199,2,0,e_0,368,395,403,5.0,10,2,4.5,4,1,9,27,8,35
p_235,8,0,e_3,314,341,421,8.0,5,5,0.0,3,1,5,27,80,107
p_211,14,0,e_3,348,361,421,11.0,6,1,5.0,5,1,5,13,60,73
p_207,12,0,e_3,355,377,421,12.0,8,3,6.0,5,1,7,22,44,66
p_204,8,0,e_3,364,391,421,15.0,9,4,7.0,5,1,8,27,30,57
p_206,6,0,e_3,362,399,421,17.0,8,4,7.0,5,1,7,37,22,59
p_185,2,0,e_3,392,413,421,2.0,8,0,4.0,4,1,7,21,8,29
p_175,2,0,e_3,399,413,421,1.0,8,0,3.0,1,1,7,14,8,22
p_203,12,0,e_2,365,386,456,5.0,10,10,2.5,5,0,7,21,70,91
p_200,12,0,e_2,367,386,456,25.5,10,10,3.0,5,0,8,19,70,89
p_193,12,0,e_2,378,386,456,24.0,9,9,5.0,5,0,10,8,70,78
p_190,14,0,e_2,382,394,456,21.5,9,9,5.5,5,0,10,12,62,74
p_180,14,0,e_2,396,404,456,19.5,9,9,7.0,5,1,10,8,52,60
p_183,12,0,e_2,393,412,456,22.0,9,9,7.0,2,1,9,19,44,63
p_197,8,0,e_2,375,426,456,28.5,10,10,4.0,5,0,8,51,30,81
p_188,8,0,e_2,390,426,456,26.0,8,8,6.5,5,1,10,36,30,66
p_179,6,0,e_2,397,434,456,27.5,9,9,7.5,5,1,11,37,22,59
p_176,6,0,e_2,398,434,456,27.0,8,8,7.5,3,1,12,36,22,58
p_163,4,0,e_2,417,442,456,26.5,7,7,5.5,4,1,10,25,14,39
p_172,14,0,e_1,405,442,502,18.0,8,8,1.0,5,0,8,37,60,97
p_165,14,0,e_1,416,442,502,16.5,7,7,3.0,5,0,9,26,60,86
p_162,14,0,e_1,417,442,502,16.5,7,7,3.0,5,0,9,25,60,85
p_158,14,0,e_1,426,442,502,15.5,7,1,4.5,5,0,9,16,60,76
p_152,10,0,e_1,439,464,502,17.0,7,3,6.5,5,0,10,25,38,63
p_153,8,0,e_1,438,472,502,19.5,7,4,6.5,5,0,9,34,30,64
p_144,4,0,e_1,451,486,502,21.0,7,5,7.0,4,1,11,35,16,51
p_133,4,0,e_1,463,486,502,19.5,8,5,5.0,4,1,12,23,16,39
p_143,2,0,e_1,451,494,502,23.5,7,6,7.0,4,1,10,43,8,51
p_136,2,0,e_1,460,494,502,22.0,7,4,5.5,4,1,12,34,8,42
p_173,10,0,e_0,405,435,505,22.0,8,8,0.0,5,0,6,30,70,100
p_170,10,0,e_0,408,435,505,22.0,8,8,0.5,5,0,7,27,70,97
p_164,12,0,e_0,416,443,505,19.0,7,7,2.0,5,0,9,27,62,89
p_157,12,0,e_0,427,443,505,17.0,7,2,3.5,5,0,10,16,62,78
p_145,12,0,e_0,451,465,505,13.5,7,2,7.0,5,1,8,14,40,54
p_125,4,0,e_0,474,491,505,3.0,10,2,4.5,4,1,8,17,14,31
p_160,10,0,e_3,421,453,523,10.0,6,6,0.0,3,1,6,32,70,102
p_146,10,0,e_3,451,453,523,15.5,7,3,4.5,5,0,7,2,70,72
p_134,12,0,e_3,462,481,523,12.0,7,2,6.0,5,1,6,19,42,61
p_126,6,0,e_3,473,501,523,1.0,9,0,7.0,4,1,8,28,22,50
p_118,4,0,e_3,488,509,523,1.0,9,0,5.0,4,1,8,21,14,35
p_128,10,0,e_2,471,488,564,27.5,9,9,2.0,5,0,8,17,76,93
p_120,10,0,e_2,481,488,564,26.0,9,9,4.0,5,0,11,7,76,83
p_123,12,0,e_2,474,496,564,25.0,10,10,3.0,5,0,10,22,68,90
p_117,12,0,e_2,490,496,564,23.0,10,10,5.0,5,1,10,6,68,74
p_124,14,0,e_2,474,504,564,23.0,10,10,3.0,5,0,9,30,60,90
p_109,14,0,e_2,506,514,564,18.5,9,9,7.0,5,1,9,8,50,58
p_115,10,0,e_2,494,528,564,24.0,10,10,6.0,5,1,10,34,36,70
p_106,4,0,e_2,512,548,564,27.5,8,8,7.0,4,1,10,36,16,52
p_105,4,0,e_2,515,548,564,27.5,8,8,7.0,4,1,10,33,16,49
p_102,2,0,e_2,521,556,564,28.5,8,8,6.0,4,1,10,35,8,43
p_90,2,0,e_2,536,556,564,26.0,8,7,4.0,4,1,10,20,8,28
p_101,12,0,e_1,521,540,606,18.5,8,8,3.0,5,0,8,19,66,85
p_88,14,0,e_1,538,548,606,14.0,8,1,5.5,5,0,10,10,58,68
p_95,6,0,e_1,527,582,606,23.5,8,6,4.0,5,0,9,55,24,79
p_94,6,0,e_1,528,582,606,23.5,8,6,4.0,5,0,10,54,24,78
p_80,6,0,e_1,548,582,606,20.0,8,6,7.0,5,1,10,34,24,58
p_77,6,0,e_1,557,582,606,19.0,8,5,7.0,4,1,11,25,24,49
p_78,4,0,e_1,555,590,606,21.0,7,5,7.5,4,1,10,35,16,51
p_81,2,0,e_1,547,598,606,24.5,8,7,7.0,5,1,10,51,8,59
p_56,2,0,e_1,588,598,606,3.0,11,0,2.5,4,1,10,10,8,18
p_98,6,0,e_0,524,525,609,24.0,8,6,3.0,5,0,8,1,84,85
p_97,10,0,e_0,526,539,609,19.5,8,3,3.0,5,1,8,13,70,83
p_79,14,0,e_0,549,553,609,12.0,8,1,6.5,5,1,9,4,56,60
p_86,6,0,e_0,541,587,609,21.0,8,6,5.0,5,1,8,46,22,68
p_71,2,0,e_0,569,601,609,21.0,9,4,6.0,4,1,9,32,8,40
p_48,2,0,e_0,593,601,609,3.0,11,1,2.5,4,1,9,8,8,16
p_100,10,0,e_3,522,555,629,10.0,7,7,0.0,3,1,7,33,74,107
p_75,14,0,e_3,563,569,629,10.0,8,1,6.0,5,1,7,6,60,66
p_69,10,0,e_3,573,591,629,3.0,9,9,7.5,3,1,8,18,38,56
p_67,8,0,e_3,574,599,629,1.0,10,10,7.5,3,1,9,25,30,55
p_73,6,0,e_3,568,607,629,17.0,8,4,7.0,2,1,7,39,22,61
p_55,4,0,e_3,590,615,629,1.0,10,0,5.0,1,1,9,25,14,39
p_63,8,0,e_2,581,590,672,28.5,11,11,2.5,5,0,10,9,82,91
p_58,10,0,e_2,586,598,672,26.0,11,11,3.5,5,0,12,12,74,86
p_50,10,0,e_2,592,598,672,25.0,11,11,4.0,5,1,12,6,74,80
p_66,12,0,e_2,577,606,672,25.0,11,11,2.0,5,0,9,29,66,95
p_65,12,0,e_2,578,606,672,25.0,11,11,2.0,5,0,10,28,66,94
p_68,14,0,e_2,574,614,672,7.0,10,10,1.5,5,0,8,40,58,98
p_41,10,0,e_2,600,636,672,24.0,11,11,5.0,5,1,11,36,36,72
p_59,6,0,e_2,584,650,672,30.0,11,11,3.0,5,0,11,66,22,88
p_57,6,0,e_2,587,650,672,29.5,11,11,3.5,5,0,13,63,22,85
p_54,6,0,e_2,590,650,672,29.0,11,11,4.0,2,0,12,60,22,82
p_47,6,0,e_2,594,650,672,29.0,11,11,4.5,5,1,12,56,22,78
p_42,4,0,e_2,600,658,672,30.0,11,11,5.0,5,1,12,58,14,72
p_40,4,0,e_2,601,658,672,30.0,11,11,5.0,5,1,13,57,14,71
p_38,4,0,e_2,627,658,672,26.5,9,9,6.5,4,1,11,31,14,45
p_35,4,0,e_2,640,658,672,24.5,8,6,4.5,4,1,10,18,14,32
p_33,8,0,e_1,647,676,702,19.5,8,4,6.5,5,0,8,29,26,55
p_28,6,0,e_3,679,705,727,1.0,8,0,7.5,4,0,8,26,22,48
p_27,2,0,e_3,693,719,727,3.0,9,1,5.0,4,0,9,26,8,34
p_22,10,0,e_2,712,736,768,22.0,10,10,6.5,5,0,8,24,32,56
p_21,10,0,e_1,732,734,798,19.5,8,3,5.0,5,0,8,2,64,66
p_19,12,0,e_0,740,741,801,16.0,8,2,6.0,5,0,8,1,60,61
p_18,2,0,e_0,768,793,801,21.5,8,5,5.0,4,1,8,25,8,33
p_10,14,0,e_2,810,812,866,17.0,8,8,7.0,5,0,8,2,54,56
p_9,2,0,e_2,845,858,866,24.0,8,6,3.0,4,1,8,13,8,21
p_7,12,0,e_3,851,859,921,13.5,8,2,4.5,5,0,8,8,62,70
p_6,14,0,e_3,858,867,921,10.0,8,1,6.0,2,0,8,9,54,63
p_1,2,0,e_3,889,913,921,3.0,9,1,5.0,4,1,8,24,8,32
p_3,4,0,e_2,25,40,54,4.0,0,0,0.0,3,0,0,15,14,29
p_7,2,0,e_2,55,63,71,13.0,2,2,0.0,3,0,0,8,8,16
p_11,4,0,e_1,84,101,115,3.0,3,1,4.5,4,0,2,17,14,31
p_9,10,0,e_3,67,99,133,5.0,2,0,5.0,5,0,2,32,34,66
p_16,4,0,e_3,101,119,133,1.0,3,0,5.0,4,1,2,18,14,32
p_12,0,8,e_1,86,115,141,7.0,3,0,4.5,4,0,3,29,26,55
p_13,8,0,e_2,87,103,175,24.0,3,3,1.5,5,0,2,16,72,88
p_17,10,0,e_2,112,143,175,23.0,4,4,5.5,5,1,3,31,32,63
p_21,0,10,e_2,142,175,207,16.5,3,3,5.0,1,1,4,33,32,65
p_24,14,0,e_1,157,161,217,10.5,4,0,6.5,5,0,2,4,56,60
p_26,6,0,e_1,169,195,217,6.5,4,2,7.0,4,1,2,26,22,48
p_30,2,0,e_1,200,209,217,2.0,4,0,2.5,4,1,3,9,8,17
p_22,6,0,e_3,146,153,229,10.0,3,2,2.0,5,1,2,7,76,83
p_35,0,6,e_3,222,229,249,1.0,5,0,1.0,4,2,3,7,20,27
p_32,0,10,e_1,209,217,249,3.0,4,0,1.0,4,1,3,8,32,40
p_29,14,0,e_2,192,221,265,22.0,4,4,2.5,5,1,4,29,44,73
p_38,12,0,e_3,240,269,309,10.5,5,0,1.5,5,2,3,29,40,69
p_44,4,0,e_3,275,295,309,1.0,5,0,5.5,4,2,3,20,14,34
p_42,4,0,e_1,269,301,315,2.0,5,1,7.5,4,0,3,32,14,46
p_43,4,0,e_1,270,301,315,2.0,5,1,7.0,4,0,4,31,14,45
p_51,0,4,e_1,309,315,329,18.0,4,4,1.0,4,1,4,6,14,20
p_46,8,0,e_2,291,335,363,24.5,6,6,4.0,5,0,6,44,28,72
p_60,2,0,e_2,338,355,363,21.5,6,4,3.5,4,1,7,17,8,25
p_58,0,6,e_2,330,363,383,24.5,6,6,4.5,4,0,8,33,20,53
p_55,14,0,e_0,314,339,393,13.5,6,0,3.0,5,0,4,25,54,79
p_61,12,0,e_0,341,355,393,11.5,6,1,7.0,5,1,4,14,38,52
p_53,8,0,e_3,313,335,399,19.5,5,2,0.5,5,1,4,22,64,86
p_56,8,0,e_3,324,335,399,18.0,6,2,2.0,5,1,5,11,64,75
p_52,14,0,e_3,312,355,399,14.0,4,0,0.0,5,1,3,43,44,87
p_68,2,0,e_1,389,405,413,29.5,5,5,3.5,4,0,4,16,8,24
p_69,2,0,e_1,391,405,413,29.0,5,5,3.0,4,0,5,14,8,22
p_67,12,0,e_2,377,403,463,21.5,5,5,2.0,5,1,7,26,60,86
p_72,6,0,e_2,417,443,463,21.5,5,3,7.5,4,1,7,26,20,46
p_77,4,0,e_0,455,475,489,2.0,7,1,5.0,4,0,5,20,14,34
p_74,10,0,e_3,424,431,497,16.0,5,1,4.0,5,2,3,7,66,73
p_76,10,0,e_3,440,465,497,13.5,6,1,6.5,5,3,3,25,32,57
p_78,12,0,e_1,455,471,509,24.5,7,7,7.0,5,0,4,16,38,54
p_82,0,12,e_3,494,497,535,0.5,6,0,0.5,4,3,3,3,38,41
p_83,0,12,e_1,501,509,547,29.5,6,6,1.0,4,1,6,8,38,46
p_84,12,0,e_2,504,521,559,17.0,6,1,6.5,5,0,7,17,38,55
p_85,14,0,e_0,517,533,589,13.0,6,1,4.5,5,0,5,16,56,72
p_86,14,0,e_0,518,533,589,12.5,6,1,4.5,5,0,6,15,56,71
p_88,10,0,e_0,531,555,589,14.5,6,2,7.0,5,0,6,24,34,58
p_93,4,0,e_0,543,575,589,19.0,6,3,7.0,4,1,6,32,14,46
p_91,14,0,e_3,539,543,599,9.5,5,1,6.5,5,2,3,4,56,60
p_92,10,0,e_3,540,565,599,13.5,6,2,6.5,5,2,4,25,34,59
p_95,10,0,e_3,547,565,599,12.5,7,1,7.5,5,3,4,18,34,52
p_98,6,0,e_3,555,579,599,0.0,7,0,6.5,4,3,4,24,20,44
p_100,10,0,e_1,557,575,607,26.0,8,8,7.5,5,0,7,18,32,50
p_105,12,0,e_2,582,597,651,20.5,6,6,3.5,5,0,8,15,54,69
p_110,12,0,e_2,590,597,651,19.5,6,6,5.0,5,0,9,7,54,61
p_102,14,0,e_2,568,605,651,21.0,7,7,1.0,5,0,7,37,46,83
p_103,14,0,e_2,577,605,651,19.5,7,7,2.5,5,0,8,28,46,74
p_104,14,0,e_2,581,605,651,19.0,6,6,3.5,5,0,8,24,46,70
p_111,2,0,e_2,607,643,651,27.0,5,4,7.0,4,1,7,36,8,44
p_117,0,2,e_2,636,651,659,24.0,6,6,2.0,4,1,8,15,8,23
p_109,10,0,e_0,590,621,687,21.5,6,6,0.0,5,0,5,31,66,97
p_125,2,0,e_0,668,679,687,2.0,7,0,2.5,4,1,6,11,8,19
p_123,0,2,e_3,661,693,701,5.0,6,0,5.0,4,2,4,32,8,40
p_118,8,0,e_1,649,677,703,28.0,6,6,7.0,5,0,7,28,26,54
p_119,8,0,e_1,650,677,703,28.0,6,6,7.0,5,0,8,27,26,53
p_133,6,0,e_0,734,763,785,17.5,7,5,7.5,3,0,7,29,22,51
p_132,4,0,e_0,730,771,785,20.5,6,4,7.0,5,0,6,41,14,55
p_134,14,0,e_3,734,739,791,9.5,6,1,6.5,5,2,4,5,52,57
p_136,14,0,e_1,749,755,799,23.0,7,7,7.5,5,0,7,6,44,50
p_138,12,0,e_2,756,785,843,23.5,7,7,1.0,5,1,7,29,58,87
p_141,12,0,e_2,770,785,843,21.5,7,7,3.5,5,1,8,15,58,73
p_144,6,0,e_0,815,861,881,20.5,6,4,4.5,5,1,5,46,20,66
p_152,2,0,e_3,868,879,887,1.0,7,0,3.0,4,2,5,11,8,19
p_147,6,0,e_1,849,875,895,29.0,6,6,7.0,4,0,7,26,20,46
p_149,6,0,e_2,859,863,949,27.5,6,6,2.5,5,1,8,4,86,90
p_146,10,0,e_2,846,877,949,25.5,6,6,0.5,5,1,7,31,72,103
p_151,12,0,e_2,863,885,949,20.5,7,7,3.0,5,2,8,22,64,86
p_156,12,0,e_2,884,885,949,18.5,8,8,6.0,2,2,8,1,64,65
p_159,8,0,e_2,893,921,949,21.0,7,3,7.0,5,2,8,28,28,56
p_153,6,0,e_2,872,929,949,25.0,8,8,4.0,5,2,9,57,20,77
p_154,4,0,e_0,874,895,977,26.5,8,8,1.0,4,2,5,21,82,103
p_300,0,4,e_0,8,9,25,0.0,0,0,0.0,3,0,0,1,16,17
p_297,0,6,e_3,15,16,38,0.0,0,0,0.0,3,0,0,1,22,23
p_296,0,4,e_0,28,43,57,10.5,1,1,2.0,3,0,0,15,14,29
p_292,0,6,e_0,38,43,65,3.0,0,0,0.5,4,0,1,5,22,27
p_290,0,6,e_0,40,43,65,3.0,0,0,0.5,4,0,1,3,22,25
p_289,0,4,e_3,43,64,78,3.0,0,0,3.0,3,0,0,21,14,35
p_285,0,4,e_3,53,64,78,1.5,1,0,1.5,4,0,1,11,14,25
p_284,0,4,e_3,54,64,78,1.5,1,0,1.5,4,0,1,10,14,24
p_294,0,12,e_0,31,43,85,10.0,1,1,2.0,4,0,1,12,42,54
p_293,0,12,e_0,33,43,85,10.0,1,1,1.5,4,0,1,10,42,52
p_288,0,8,e_3,44,64,92,3.0,1,1,3.0,3,0,1,20,28,48
p_278,0,2,e_1,77,105,113,2.0,4,4,4.5,4,1,1,28,8,36
p_277,0,6,e_1,82,105,127,15.5,4,4,4.0,4,1,1,23,22,45
p_274,0,8,e_1,88,105,135,14.5,4,4,2.5,4,1,1,17,30,47
p_273,0,4,e_0,110,123,139,11.5,3,3,2.0,4,2,0,13,16,29
p_280,0,14,e_1,75,105,155,16.5,5,5,5.0,4,1,1,30,50,80
p_275,0,14,e_1,86,105,155,15.0,4,4,3.0,4,1,1,19,50,69
p_272,0,10,e_0,113,123,159,10.5,3,3,1.5,4,2,1,10,36,46
p_268,0,2,e_3,144,162,170,3.0,4,0,3.0,4,3,1,18,8,26
p_265,0,4,e_3,152,162,178,1.5,4,0,1.5,4,3,1,10,16,26
p_266,0,6,e_3,151,162,186,1.5,4,0,1.5,4,3,1,11,24,35
p_254,0,4,e_1,187,199,213,19.0,6,6,2.0,4,4,1,12,14,26
p_250,0,2,e_0,217,223,231,7.5,6,0,1.0,4,4,1,6,8,14
p_256,0,10,e_1,182,199,233,19.5,7,7,3.0,4,4,1,17,34,51
p_257,0,14,e_1,169,199,247,21.0,8,8,5.0,4,4,1,30,48,78
p_249,0,6,e_3,239,262,282,3.5,6,0,3.5,4,6,0,23,20,43
p_246,0,10,e_1,262,299,331,0.0,6,6,6.0,4,6,0,37,32,69
p_244,0,12,e_1,271,299,339,21.0,7,7,4.5,4,6,1,28,40,68
p_235,0,8,e_0,308,319,347,15.0,6,6,1.5,4,5,1,11,28,39
p_234,0,8,e_0,310,319,347,7.0,6,6,1.5,4,5,1,9,28,37
p_226,0,2,e_3,329,358,366,4.5,7,0,4.5,4,6,1,29,8,37
p_228,0,4,e_3,325,358,374,5.5,7,0,5.5,4,6,1,33,16,49
p_227,0,12,e_3,327,358,400,5.0,7,0,5.0,4,6,1,31,42,73
p_242,0,8,e_1,277,397,423,20.0,7,7,3.5,4,6,1,120,26,146
p_187,0,12,e_2,389,389,429,21.5,8,8,0.0,3,1,0,0,40,40
p_223,0,2,e_3,336,458,466,3.5,7,0,3.5,4,6,1,122,8,130
p_135,0,10,e_2,466,467,501,25.0,7,7,0.0,3,1,0,1,34,35
p_208,0,6,e_1,358,493,513,26.0,10,10,6.5,4,6,0,135,20,155
p_221,0,6,e_3,339,554,574,3.0,7,0,3.0,4,6,1,215,20,235
p_220,0,6,e_3,341,650,670,2.5,7,0,2.5,4,6,1,309,20,329
p_32,0,6,e_2,650,661,681,26.0,8,8,2.0,4,3,0,11,20,31
p_300,0,4,e_0,8,8,24,0.0,0,0,0.0,3,0,0,0,16,16
p_297,0,6,e_3,15,16,38,0.0,0,0,0.0,3,0,0,1,22,23
p_296,0,4,e_0,28,43,57,10.5,1,1,2.0,3,0,0,15,14,29
p_292,0,6,e_0,38,43,65,3.0,0,0,0.5,4,0,1,5,22,27
p_290,0,6,e_0,40,43,65,3.0,0,0,0.5,4,0,1,3,22,25
p_289,0,4,e_3,43,63,77,3.0,0,0,3.0,3,0,0,20,14,34
p_285,0,4,e_3,53,63,77,1.5,1,0,1.5,4,0,1,10,14,24
p_284,0,4,e_3,54,63,77,1.5,1,0,1.5,4,0,1,9,14,23
p_294,0,12,e_0,31,43,85,10.0,1,1,2.0,4,0,1,12,42,54
p_293,0,12,e_0,33,43,85,10.0,1,1,1.5,4,0,1,10,42,52
p_288,0,8,e_3,44,63,91,3.0,1,0,3.0,4,0,1,19,28,47
p_278,0,2,e_1,77,106,114,2.0,4,4,5.0,4,1,1,29,8,37
p_277,0,6,e_1,82,106,128,15.5,4,4,4.0,4,1,1,24,22,46
p_274,0,8,e_1,88,106,136,14.5,4,4,3.0,4,1,1,18,30,48
p_273,0,4,e_0,110,123,139,11.0,3,3,2.0,4,2,0,13,16,29
p_280,0,14,e_1,75,106,156,16.5,5,5,5.0,4,1,1,31,50,81
p_275,0,14,e_1,86,106,156,15.0,4,4,3.5,4,1,1,20,50,70
p_272,0,10,e_0,113,123,159,10.5,3,3,1.5,4,2,1,10,36,46
p_268,0,2,e_3,144,161,169,2.5,4,0,2.5,4,3,1,17,8,25
p_265,0,4,e_3,152,161,177,1.5,4,0,1.5,4,3,1,9,16,25
p_266,0,6,e_3,151,161,185,1.5,4,0,1.5,4,3,1,10,24,34
p_254,0,4,e_1,187,200,214,19.0,6,6,2.0,4,4,1,13,14,27
p_250,0,2,e_0,217,223,231,7.5,6,0,1.0,4,4,1,6,8,14
p_256,0,10,e_1,182,200,234,19.5,7,7,3.0,4,4,1,18,34,52
p_257,0,14,e_1,169,200,248,21.0,8,8,5.0,4,4,1,31,48,79
p_249,0,6,e_3,239,261,281,3.5,6,0,3.5,4,6,0,22,20,42
p_246,0,10,e_1,262,300,332,22.0,7,7,6.5,4,6,0,38,32,70
p_244,0,12,e_1,271,300,340,20.5,7,7,4.5,4,6,1,29,40,69
p_235,0,8,e_0,308,319,347,15.0,6,6,1.5,4,5,1,11,28,39
p_234,0,8,e_0,310,319,347,7.0,6,6,1.5,4,5,1,9,28,37
p_226,0,2,e_3,329,357,367,4.5,7,0,4.5,4,6,1,28,10,38
p_228,0,4,e_3,325,357,375,5.5,7,0,5.5,4,6,1,32,18,50
p_227,0,12,e_3,327,357,401,5.0,7,0,5.0,4,6,1,30,44,74
p_242,0,8,e_1,277,398,424,19.5,7,7,3.5,4,6,1,121,26,147
p_187,0,12,e_2,389,389,429,22.0,8,8,0.0,3,1,0,0,40,40
p_223,0,2,e_3,336,459,467,3.5,7,0,3.5,4,6,1,123,8,131
p_135,0,10,e_2,466,467,501,25.0,7,7,0.0,3,1,0,1,34,35
p_208,0,6,e_1,358,494,514,26.0,11,11,6.5,4,6,0,136,20,156
p_221,0,6,e_3,339,555,575,3.0,7,0,3.0,4,6,1,216,20,236
p_220,0,6,e_3,341,651,671,2.5,7,0,2.5,4,6,1,310,20,330
p_32,0,6,e_2,650,661,681,0.0,8,0,2.0,4,3,1,11,20,31
p_34,0,12,e_2,646,661,701,1.0,8,0,2.5,4,3,1,15,40,55
p_21,0,4,e_2,731,759,773,2.5,8,0,4.5,4,4,1,28,14,42
p_20,0,14,e_2,734,759,805,2.0,8,0,4.0,4,4,1,25,46,71
p_9,0,2,e_2,846,857,865,25.5,7,7,2.0,4,5,0,11,8,19
p_300,0,4,e_0,8,8,24,0.0,0,0,0.0,3,0,0,0,16,16
p_297,0,6,e_3,15,16,38,0.0,0,0,0.0,3,0,0,1,22,23
p_296,0,4,e_0,28,42,56,10.5,1,1,2.0,3,0,0,14,14,28
p_292,0,6,e_0,38,42,64,3.0,0,0,0.5,4,0,1,4,22,26
p_290,0,6,e_0,40,42,64,3.0,0,0,0.0,4,0,1,2,22,24
p_289,0,4,e_3,43,64,78,3.0,0,0,3.0,3,0,0,21,14,35
p_285,0,4,e_3,53,64,78,1.5,1,0,1.5,4,0,1,11,14,25
p_284,0,4,e_3,54,64,78,1.5,1,0,1.5,4,0,1,10,14,24
p_294,0,12,e_0,31,42,84,10.0,1,1,1.5,4,0,1,11,42,53
p_293,0,12,e_0,33,42,84,9.5,1,1,1.5,4,0,1,9,42,51
p_288,0,8,e_3,44,64,92,3.0,1,0,3.0,4,0,1,20,28,48
p_278,0,2,e_1,77,106,114,16.0,5,5,5.0,4,1,1,29,8,37
p_277,0,6,e_1,82,106,128,15.5,4,4,4.0,4,1,1,24,22,46
p_274,0,8,e_1,88,106,136,14.5,4,4,3.0,4,1,1,18,30,48
p_273,0,4,e_0,110,122,136,11.5,3,3,2.0,4,2,0,12,14,26
p_272,0,10,e_0,113,122,156,10.5,3,3,1.5,4,2,1,9,34,43
p_280,0,14,e_1,75,106,156,16.5,5,5,5.0,4,1,1,31,50,81
p_275,0,14,e_1,86,106,156,15.0,4,4,3.5,4,1,1,20,50,70
p_268,0,2,e_3,144,162,170,3.0,4,0,3.0,4,3,1,18,8,26
p_265,0,4,e_3,152,162,178,1.5,4,0,1.5,4,3,1,10,16,26
p_266,0,6,e_3,151,162,186,1.5,4,0,1.5,4,3,1,11,24,35
p_254,0,4,e_1,187,200,214,19.0,6,6,2.0,4,4,1,13,14,27
p_250,0,2,e_0,217,220,228,7.5,6,0,0.5,4,3,1,3,8,11
p_256,0,10,e_1,182,200,234,19.5,7,7,3.0,4,4,1,18,34,52
p_257,0,14,e_1,169,200,248,21.0,9,9,5.0,4,4,1,31,48,79
p_249,0,6,e_3,239,262,284,3.5,6,0,3.5,4,6,0,23,22,45
p_246,0,10,e_3,262,262,298,0.0,6,6,0.0,3,6,0,0,36,36
p_242,0,8,e_1,277,300,326,20.0,8,8,3.5,4,6,1,23,26,49
p_235,0,8,e_0,308,316,342,15.5,6,6,1.0,4,4,1,8,26,34
p_234,0,8,e_0,310,316,342,15.0,6,6,1.0,4,4,1,6,26,32
p_244,0,12,e_0,271,316,356,21.0,8,8,7.5,4,4,0,45,40,85
p_228,0,4,e_3,325,362,376,6.0,7,0,6.0,4,6,1,37,14,51
p_209,0,2,e_2,357,390,398,0.5,7,0,5.5,4,1,1,33,8,41
p_205,0,2,e_2,362,390,398,0.0,6,6,4.5,4,1,1,28,8,36
p_186,0,4,e_1,390,396,412,22.0,7,7,1.0,4,6,0,6,16,22
p_210,0,6,e_2,354,390,412,1.0,7,0,6.0,4,1,1,36,22,58
p_208,0,6,e_2,358,390,412,0.5,7,0,5.0,4,1,1,32,22,54
p_182,0,2,e_0,397,414,424,21.0,7,7,3.0,4,7,0,17,10,27
p_180,0,2,e_0,399,414,424,20.5,7,7,2.5,4,7,1,15,10,25
p_206,0,12,e_2,361,390,432,0.0,6,6,4.5,4,1,1,29,42,71
p_227,0,12,e_3,327,458,496,6.0,7,0,6.0,4,6,1,131,38,169
p_200,0,4,e_2,367,490,504,25.5,8,8,3.5,4,1,1,123,14,137
p_185,0,10,e_1,391,494,528,21.5,7,7,0.5,4,6,1,103,34,137
p_203,0,12,e_2,364,490,530,26.0,8,8,4.0,4,1,1,126,40,166
p_204,0,14,e_2,363,490,538,26.0,8,8,4.5,4,1,1,127,48,175
p_179,0,8,e_0,400,512,540,20.5,7,7,2.5,4,7,1,112,28,140
p_226,0,2,e_3,329,554,562,5.5,7,0,5.5,4,6,1,225,8,233
p_197,0,10,e_2,370,590,622,25.0,8,8,3.0,4,1,1,220,32,252
p_184,0,12,e_1,392,592,632,21.5,7,7,0.5,4,6,1,200,40,240
p_196,0,4,e_2,371,686,700,25.0,8,8,3.0,4,1,1,315,14,329
p_300,0,4,e_0,8,9,25,0.0,0,0,0.0,3,0,0,1,16,17
p_297,0,6,e_3,15,16,38,0.0,0,0,0.0,3,0,0,1,22,23
p_296,0,4,e_0,28,43,57,10.5,1,1,2.0,3,0,0,15,14,29
p_292,0,6,e_0,38,43,65,3.0,0,0,0.5,4,0,1,5,22,27
p_290,0,6,e_0,40,43,65,3.0,0,0,0.5,4,0,1,3,22,25
p_289,0,4,e_3,43,63,77,3.0,0,0,3.0,3,0,0,20,14,34
p_285,0,4,e_3,53,63,77,1.5,1,0,1.5,4,0,1,10,14,24
p_284,0,4,e_3,54,63,77,1.5,1,0,1.5,4,0,1,9,14,23
p_294,0,12,e_0,31,43,85,10.0,1,1,2.0,4,0,1,12,42,54
p_293,0,12,e_0,33,43,85,10.0,1,1,1.5,4,0,1,10,42,52
p_288,0,8,e_3,44,63,91,3.0,1,0,3.0,4,0,1,19,28,47
p_278,0,2,e_1,77,106,114,2.0,4,4,5.0,4,1,1,29,8,37
p_277,0,6,e_1,82,106,128,15.5,4,4,4.0,4,1,1,24,22,46
p_274,0,8,e_1,88,106,136,14.5,4,4,3.0,4,1,1,18,30,48
p_273,0,4,e_0,110,123,137,11.0,3,3,2.0,4,2,0,13,14,27
p_280,0,14,e_1,75,106,156,16.0,5,5,5.0,4,1,1,31,50,81
p_275,0,14,e_1,86,106,156,14.5,4,4,3.0,4,1,1,20,50,70
p_272,0,10,e_0,113,123,157,7.0,3,3,1.5,4,2,1,10,34,44
p_268,0,2,e_3,144,161,169,2.5,4,0,2.5,4,3,1,17,8,25
p_265,0,4,e_3,152,161,177,1.5,4,0,1.5,4,3,1,9,16,25
p_266,0,6,e_3,151,161,185,1.5,4,0,1.5,4,3,1,10,24,34
p_254,0,4,e_1,187,200,214,19.0,6,6,2.0,4,4,1,13,14,27
p_250,0,2,e_0,217,221,229,7.5,6,0,0.5,4,4,1,4,8,12
p_256,0,10,e_1,182,200,234,19.5,7,7,3.0,4,4,1,18,34,52
p_257,0,14,e_1,169,200,248,21.0,8,8,5.0,4,4,1,31,48,79
p_249,0,6,e_3,239,261,281,3.5,6,0,3.5,4,6,0,22,20,42
p_242,0,8,e_2,277,296,322,19.5,7,7,3.0,4,1,1,19,26,45
p_246,0,10,e_2,262,296,330,22.0,7,7,5.5,4,1,0,34,34,68
p_244,0,12,e_2,271,296,338,20.5,7,7,4.0,4,1,1,25,42,67
p_235,0,8,e_0,308,317,343,14.5,6,6,1.5,4,5,1,9,26,35
p_234,0,8,e_0,310,317,343,7.0,6,6,1.0,4,5,1,7,26,33
p_228,0,4,e_3,325,357,373,5.0,7,0,5.0,4,6,1,32,16,48
p_227,0,12,e_3,327,357,399,5.0,7,0,5.0,4,6,1,30,42,72
p_205,0,2,e_2,362,396,404,25.5,9,9,5.5,4,4,1,34,8,42
p_200,0,4,e_2,367,396,412,25.0,9,9,4.5,4,4,1,29,16,45
p_208,0,6,e_2,358,396,420,26.0,10,10,6.0,4,4,0,38,24,62
p_182,0,2,e_0,397,413,423,20.5,8,8,2.5,4,7,1,16,10,26
p_206,0,12,e_2,361,396,440,26.0,9,9,5.5,4,4,1,35,44,79
p_203,0,12,e_2,364,396,440,25.5,9,9,5.0,4,4,1,32,44,76
p_204,0,14,e_2,363,396,448,25.5,9,9,5.5,4,4,1,33,52,85
p_226,0,2,e_3,329,457,467,4.5,7,0,4.5,4,6,1,128,10,138
p_141,0,6,e_1,458,488,510,26.0,9,9,5.0,4,6,1,30,22,52
p_196,0,4,e_2,371,500,516,24.0,9,9,4.0,4,4,1,129,16,145
p_140,0,8,e_1,459,488,518,26.0,8,8,5.0,4,6,1,29,30,59
p_194,0,6,e_2,373,500,524,24.0,8,8,3.5,4,4,1,127,24,151
p_139,0,10,e_1,461,488,526,26.0,8,8,4.5,4,6,1,27,38,65
p_192,0,8,e_2,375,500,532,24.0,8,8,3.5,4,4,1,125,32,157
p_197,0,10,e_2,370,500,540,24.5,9,9,4.5,4,4,1,130,40,170
p_137,0,4,e_1,464,590,606,25.5,8,8,4.0,4,6,1,126,16,142
p_189,0,8,e_2,382,604,630,22.5,8,8,2.0,4,4,1,222,26,248
p_191,0,10,e_2,376,604,638,23.5,8,8,3.5,4,4,1,228,34,262
p_186,0,4,e_2,390,702,716,21.5,8,8,1.0,4,4,1,312,14,326
p_135,0,10,e_1,466,688,720,25.0,7,7,3.5,4,6,1,222,32,254
p_187,0,12,e_2,389,702,742,21.5,8,8,1.0,4,4,1,313,40,353
p_185,0,10,e_2,391,800,832,21.5,8,8,1.0,4,4,1,409,32,441
p_184,0,12,e_2,392,800,840,21.0,8,8,0.5,4,4,1,408,40,448
p_300,0,4,e_0,8,8,24,0.0,0,0,0.0,3,0,0,0,16,16
p_297,0,6,e_3,15,16,38,0.0,0,0,0.0,3,0,0,1,22,23
p_296,0,4,e_0,28,43,59,10.5,1,1,2.0,3,0,0,15,16,31
p_289,0,4,e_0,43,43,59,2.5,1,0,0.0,3,0,0,0,16,16
p_290,0,6,e_0,40,43,67,3.0,1,0,0.5,4,0,1,3,24,27
p_285,0,4,e_3,53,58,74,1.0,1,0,1.0,4,0,1,5,16,21
p_284,0,4,e_3,54,58,74,0.5,1,0,0.5,4,0,1,4,16,20
p_292,0,6,e_3,38,58,82,3.0,0,0,3.0,2,1,0,20,24,44
p_294,0,12,e_0,31,43,87,10.0,1,1,2.0,4,0,1,12,44,56
p_293,0,12,e_0,33,43,87,10.0,1,1,1.5,4,0,1,10,44,54
p_288,0,8,e_3,44,58,90,2.5,1,0,2.5,4,0,1,14,32,46
p_278,0,2,e_1,77,106,114,15.5,5,5,4.5,4,1,1,29,8,37
p_277,0,6,e_1,82,106,128,15.0,4,4,4.0,4,1,1,24,22,46
p_274,0,8,e_1,88,106,136,14.0,4,4,3.0,4,1,1,18,30,48
p_273,0,4,e_0,110,125,139,11.0,3,3,2.5,4,2,0,15,14,29
p_280,0,14,e_1,75,106,156,16.0,5,5,5.0,4,1,1,31,50,81
p_275,0,14,e_1,86,106,156,14.5,4,4,3.5,4,1,1,20,50,70
p_272,0,10,e_0,113,125,159,7.0,3,3,2.0,4,2,1,12,34,46
p_268,0,2,e_3,144,160,168,2.5,4,0,2.5,4,3,1,16,8,24
p_265,0,4,e_3,152,160,176,1.5,4,0,1.5,4,3,1,8,16,24
p_266,0,6,e_3,151,160,184,1.5,4,0,1.5,4,3,1,9,24,33
p_254,0,4,e_2,187,202,216,19.0,6,6,2.5,4,1,1,15,14,29
p_250,0,2,e_0,217,223,231,7.0,6,0,1.0,4,4,1,6,8,14
p_256,0,10,e_2,182,202,236,19.0,7,7,3.0,4,1,1,20,34,54
p_257,0,14,e_2,169,202,250,21.0,8,8,5.5,4,1,1,33,48,81
p_249,0,6,e_3,239,260,280,3.5,6,0,3.5,4,6,0,21,20,41
p_242,0,8,e_1,277,294,320,19.5,7,7,2.5,4,4,1,17,26,43
p_246,0,10,e_1,262,294,328,22.0,7,7,5.0,4,4,1,32,34,66
p_244,0,12,e_1,271,294,336,20.5,7,7,4.0,4,4,1,23,42,65
p_235,0,8,e_0,308,319,345,7.0,6,6,2.0,4,5,1,11,26,37
p_234,0,8,e_0,310,319,345,7.5,6,0,1.5,4,5,1,9,26,35
p_226,0,2,e_3,329,356,364,4.5,7,0,4.5,4,6,1,27,8,35
p_228,0,4,e_3,325,356,372,5.0,7,0,5.0,4,6,1,31,16,47
p_227,0,12,e_3,327,356,398,4.5,7,0,4.5,4,6,1,29,42,71
p_209,0,2,e_1,357,394,402,26.0,10,10,6.0,4,5,0,37,8,45
p_205,0,2,e_1,362,394,402,25.0,10,10,5.0,4,5,1,32,8,40
p_208,0,6,e_2,358,396,416,26.0,10,10,6.0,4,5,0,38,20,58
p_206,0,12,e_1,361,394,434,25.5,10,10,5.5,4,5,1,33,40,73
p_203,0,12,e_1,364,394,434,25.0,9,9,5.0,4,5,1,30,40,70
p_204,0,14,e_1,363,394,442,25.0,10,10,5.0,4,5,1,31,48,79
p_223,0,2,e_3,336,456,464,3.5,7,0,3.5,4,6,1,120,8,128
p_137,0,4,e_2,464,492,506,25.0,7,7,4.5,4,5,1,28,14,42
p_200,0,4,e_1,367,494,508,24.5,9,9,4.5,4,5,1,127,14,141
p_141,0,6,e_2,458,492,514,26.0,8,8,5.5,4,5,1,34,22,56
p_148,0,8,e_2,449,492,522,1.0,8,0,7.0,4,5,0,43,30,73
p_140,0,8,e_2,459,492,522,26.0,8,8,5.5,4,5,1,33,30,63
p_139,0,10,e_2,461,492,530,25.5,8,8,5.0,4,5,1,31,38,69
p_221,0,6,e_3,339,552,572,3.0,7,0,3.0,4,6,1,213,20,233
p_197,0,10,e_1,370,590,622,24.5,9,9,4.0,4,5,1,220,32,252
p_133,0,12,e_2,469,594,632,24.5,7,7,3.5,4,5,1,125,38,163
p_126,0,12,e_2,476,594,632,23.5,7,7,2.5,4,5,1,118,38,156
p_220,0,6,e_3,341,648,668,2.5,7,0,2.5,4,6,1,307,20,327
p_196,0,4,e_1,371,686,700,2.0,8,8,3.5,4,5,1,315,14,329
p_125,0,14,e_2,477,690,734,23.0,7,7,2.5,4,5,1,213,44,257
p_300,0,4,e_0,8,9,25,0.0,0,0,0.0,3,0,0,1,16,17
p_297,0,6,e_3,15,16,38,0.0,0,0,0.0,3,0,0,1,22,23
p_296,0,4,e_0,28,43,59,10.5,1,1,2.0,3,0,0,15,16,31
p_289,0,4,e_0,43,43,59,3.0,0,0,0.0,3,0,0,0,16,16
p_292,0,6,e_0,38,43,67,3.0,0,0,1.0,4,0,1,5,24,29
p_290,0,6,e_0,40,43,67,3.0,0,0,0.5,4,0,1,3,24,27
p_285,0,4,e_3,53,65,79,2.0,1,0,2.0,4,0,1,12,14,26
p_284,0,4,e_3,54,65,79,2.0,1,0,2.0,4,0,1,11,14,25
p_294,0,12,e_0,31,43,87,10.0,1,1,2.0,4,0,1,12,44,56
p_293,0,12,e_0,33,43,87,10.0,1,1,1.5,4,0,1,10,44,54
p_288,0,8,e_3,44,65,93,3.0,0,0,3.0,3,0,0,21,28,49
p_278,0,2,e_1,77,105,113,16.5,5,5,4.5,4,1,1,28,8,36
p_277,0,6,e_1,82,105,127,15.5,4,4,4.0,4,1,1,23,22,45
p_274,0,8,e_1,88,105,135,14.5,4,4,3.0,4,1,1,17,30,47
p_273,0,4,e_0,110,125,139,11.5,3,3,2.5,4,2,0,15,14,29
p_280,0,14,e_1,75,105,155,16.5,5,5,5.0,4,1,1,30,50,80
p_275,0,14,e_1,86,105,155,15.0,4,4,3.0,4,1,1,19,50,69
p_272,0,10,e_0,113,125,159,11.0,3,3,2.0,4,2,1,12,34,46
p_268,0,2,e_3,144,163,171,3.0,4,0,3.0,4,3,1,19,8,27
p_265,0,4,e_3,152,163,179,1.5,4,0,1.5,4,3,1,11,16,27
p_266,0,6,e_3,151,163,187,2.0,4,0,2.0,4,3,1,12,24,36
p_254,0,4,e_1,187,199,213,19.0,6,6,2.0,4,4,1,12,14,26
p_250,0,2,e_0,217,223,231,7.5,6,0,1.0,4,4,1,6,8,14
p_256,0,10,e_1,182,199,233,20.0,7,7,2.5,4,4,1,17,34,51
p_257,0,14,e_1,169,199,247,21.0,9,9,5.0,4,4,1,30,48,78
p_249,0,6,e_3,239,263,283,4.0,6,0,4.0,4,6,0,24,20,44
p_246,0,10,e_3,262,263,297,0.0,7,0,0.0,4,6,1,1,34,35
p_242,0,8,e_1,277,299,325,20.0,8,8,3.5,4,6,1,22,26,48
p_244,0,12,e_1,271,299,339,21.0,8,8,4.5,4,6,1,28,40,68
p_235,0,8,e_0,308,319,347,15.5,6,6,1.5,4,5,1,11,28,39
p_234,0,8,e_0,310,319,347,15.0,6,6,1.5,4,5,1,9,28,37
p_226,0,2,e_3,329,361,371,5.5,7,0,5.5,4,6,1,32,10,42
p_228,0,4,e_3,325,361,379,6.0,7,0,6.0,4,6,1,36,18,54
p_227,0,12,e_3,327,361,405,5.5,7,0,5.5,4,6,1,34,44,78
p_205,0,2,e_1,362,397,405,26.0,11,11,5.5,4,6,0,35,8,43
p_223,0,2,e_3,336,463,471,4.0,7,0,4.0,4,6,1,127,8,135
p_204,0,14,e_1,363,493,537,26.0,10,10,5.5,4,6,1,130,44,174
p_221,0,6,e_3,339,559,579,3.5,7,0,3.5,4,6,1,220,20,240
p_203,0,12,e_1,364,589,627,26.0,10,10,5.5,4,6,1,225,38,263
p_220,0,6,e_3,341,655,675,3.5,7,0,3.5,4,6,1,314,20,334
p_300,0,4,e_0,8,9,25,0.0,0,0,0.0,3,0,0,1,16,17
p_297,0,6,e_3,15,15,37,0.0,0,0,0.0,3,0,0,0,22,22
p_296,0,4,e_0,28,43,59,10.5,1,1,2.0,3,0,0,15,16,31
p_289,0,4,e_0,43,43,59,3.0,0,0,0.0,3,0,0,0,16,16
p_292,0,6,e_0,38,43,67,3.0,0,0,0.5,4,0,1,5,24,29
p_290,0,6,e_0,40,43,67,3.0,0,0,0.5,4,0,1,3,24,27
p_285,0,4,e_3,53,64,78,2.0,1,0,2.0,4,0,1,11,14,25
p_284,0,4,e_3,54,64,78,1.5,1,0,1.5,4,0,1,10,14,24
p_294,0,12,e_0,31,43,87,10.0,1,1,2.0,4,0,1,12,44,56
p_293,0,12,e_0,33,43,87,9.5,1,1,1.5,4,0,1,10,44,54
p_288,0,8,e_3,44,64,92,3.0,0,0,3.0,3,0,0,20,28,48
p_278,0,2,e_1,77,106,114,16.0,5,5,4.5,4,1,1,29,8,37
p_277,0,6,e_1,82,106,128,15.5,4,4,4.0,4,1,1,24,22,46
p_274,0,8,e_1,88,106,136,14.5,4,4,3.0,4,1,1,18,30,48
p_273,0,4,e_0,110,125,139,11.0,3,3,2.5,4,2,0,15,14,29
p_280,0,14,e_1,75,106,156,16.5,5,5,5.0,4,1,1,31,50,81
p_275,0,14,e_1,86,106,156,15.0,4,4,3.0,4,1,1,20,50,70
p_272,0,10,e_0,113,125,159,10.5,3,3,2.0,4,2,1,12,34,46
p_268,0,2,e_3,144,162,170,3.0,4,0,3.0,4,3,1,18,8,26
p_265,0,4,e_3,152,162,178,1.5,4,0,1.5,4,3,1,10,16,26
p_266,0,6,e_3,151,162,186,1.5,4,0,1.5,4,3,1,11,24,35
p_254,0,4,e_1,187,200,214,19.0,6,6,2.0,4,4,1,13,14,27
p_250,0,2,e_0,217,223,231,7.5,6,0,1.0,4,4,1,6,8,14
p_256,0,10,e_1,182,200,234,19.5,7,7,3.0,4,4,1,18,34,52
p_257,0,14,e_1,169,200,248,21.0,9,9,5.0,4,4,1,31,48,79
p_249,0,6,e_3,239,262,284,3.5,6,0,3.5,4,6,0,23,22,45
p_246,0,10,e_3,262,262,298,0.0,6,6,0.0,3,6,0,0,36,36
p_242,0,8,e_1,277,300,326,20.0,8,8,3.5,4,6,1,23,26,49
p_244,0,12,e_1,271,300,340,21.0,8,8,5.0,4,6,1,29,40,69
p_235,0,8,e_0,308,319,347,15.5,6,6,1.5,4,5,1,11,28,39
p_234,0,8,e_0,310,319,347,15.5,6,6,1.5,4,5,1,9,28,37
p_226,0,2,e_3,329,362,372,5.5,7,0,5.5,4,6,1,33,10,43
p_228,0,4,e_3,325,362,380,6.0,7,0,6.0,4,6,1,37,18,55
p_186,0,4,e_2,390,390,406,22.5,8,8,0.0,3,1,1,0,16,16
p_227,0,12,e_3,327,362,406,5.5,7,0,5.5,4,6,1,35,44,79
p_187,0,12,e_2,389,390,432,23.0,8,8,0.0,3,1,0,1,42,43
p_204,0,14,e_1,363,398,442,26.0,11,11,6.0,4,6,0,35,44,79
p_223,0,2,e_3,336,464,472,4.5,7,0,4.5,4,6,1,128,8,136
p_150,0,6,e_2,443,470,490,3.5,8,0,4.5,4,1,1,27,20,47
p_148,0,8,e_2,449,470,498,2.5,8,0,3.5,4,1,1,21,28,49
p_175,0,14,e_2,405,470,518,20.0,7,7,2.0,3,3,0,65,48,113
p_155,0,14,e_2,435,470,518,4.5,8,0,6.0,4,1,1,35,48,83
p_203,0,12,e_1,364,494,532,26.0,10,10,5.5,4,6,1,130,38,168
p_221,0,6,e_3,339,560,582,4.0,7,0,4.0,4,6,1,221,22,243
p_141,0,6,e_2,458,570,590,1.0,8,0,2.0,4,1,1,112,20,132
p_140,0,8,e_2,459,570,598,0.5,8,0,2.0,4,1,1,111,28,139
p_220,0,6,e_3,341,658,678,3.5,7,0,3.5,4,6,1,317,20,337
p_139,0,10,e_2,461,668,700,0.5,8,0,1.5,4,1,1,207,32,239
p_137,0,4,e_2,464,764,778,0.0,7,7,1.0,4,1,1,300,14,314
p_300,0,4,e_0,8,8,24,0.0,0,0,0.0,3,0,0,0,16,16
p_297,0,6,e_3,15,16,38,0.0,0,0,0.0,3,0,0,1,22,23
p_296,0,4,e_0,28,43,59,10.5,1,1,2.0,3,0,0,15,16,31
p_289,0,4,e_0,43,43,59,2.5,1,0,0.0,3,0,0,0,16,16
p_290,0,6,e_0,40,43,67,3.0,1,0,0.5,4,0,1,3,24,27
p_285,0,4,e_3,53,58,74,0.5,1,0,0.5,4,0,1,5,16,21
p_284,0,4,e_3,54,58,74,0.5,1,0,0.5,4,0,1,4,16,20
p_292,0,6,e_3,38,58,82,3.0,0,0,3.0,2,1,0,20,24,44
p_294,0,12,e_0,31,43,87,10.0,1,1,2.0,4,0,1,12,44,56
p_293,0,12,e_0,33,43,87,10.0,1,1,1.5,4,0,1,10,44,54
p_288,0,8,e_3,44,58,90,2.5,1,0,2.5,4,0,1,14,32,46
p_278,0,2,e_1,77,106,114,15.5,5,5,4.5,4,1,1,29,8,37
p_277,0,6,e_1,82,106,128,15.0,4,4,4.0,4,1,1,24,22,46
p_274,0,8,e_1,88,106,136,14.5,4,4,3.0,4,1,1,18,30,48
p_273,0,4,e_0,110,125,139,11.0,3,3,2.5,4,2,0,15,14,29
p_280,0,14,e_1,75,106,156,16.0,5,5,5.0,4,1,1,31,50,81
p_275,0,14,e_1,86,106,156,14.5,4,4,3.5,4,1,1,20,50,70
p_272,0,10,e_0,113,125,159,7.0,3,3,2.0,4,2,1,12,34,46
p_268,0,2,e_3,144,160,168,2.5,4,0,2.5,4,3,1,16,8,24
p_265,0,4,e_3,152,160,176,1.0,4,0,1.0,4,3,1,8,16,24
p_266,0,6,e_3,151,160,184,1.5,4,0,1.5,4,3,1,9,24,33
p_254,0,4,e_2,187,202,216,18.5,6,6,2.5,4,1,1,15,14,29
p_250,0,2,e_0,217,223,231,7.0,6,0,1.0,4,4,1,6,8,14
p_256,0,10,e_2,182,202,236,19.5,7,7,3.5,4,1,1,20,34,54
p_257,0,14,e_2,169,202,250,21.0,8,8,5.5,4,1,1,33,48,81
p_249,0,6,e_3,239,260,280,3.5,6,0,3.5,4,6,0,21,20,41
p_242,0,8,e_1,277,294,320,19.5,7,7,3.0,4,4,1,17,26,43
p_246,0,10,e_1,262,294,328,22.0,7,7,5.0,4,4,1,32,34,66
p_244,0,12,e_1,271,294,336,20.5,7,7,3.5,4,4,1,23,42,65
p_235,0,8,e_0,308,319,345,7.0,6,6,2.0,4,5,1,11,26,37
p_234,0,8,e_0,310,319,345,7.5,6,0,1.5,4,5,1,9,26,35
p_226,0,2,e_3,329,356,364,4.5,7,0,4.5,4,6,1,27,8,35
p_228,0,4,e_3,325,356,372,5.0,7,0,5.0,4,6,1,31,16,47
p_227,0,12,e_3,327,356,398,5.0,7,0,5.0,4,6,1,29,42,71
p_209,0,2,e_1,357,394,402,26.0,10,10,6.0,4,5,1,37,8,45
p_205,0,2,e_1,362,394,402,25.5,10,10,5.5,4,5,1,32,8,40
p_208,0,6,e_1,358,394,416,26.0,10,10,6.0,4,5,1,36,22,58
p_206,0,12,e_1,361,394,436,25.5,10,10,5.5,4,5,1,33,42,75
p_223,0,2,e_3,336,456,464,3.5,7,0,3.5,4,6,1,120,8,128
p_203,0,12,e_1,364,494,532,25.0,9,9,5.0,4,5,1,130,38,168
p_204,0,14,e_1,363,494,540,25.0,9,9,5.0,4,5,1,131,46,177
p_221,0,6,e_3,339,552,572,3.0,7,0,3.0,4,6,1,213,20,233
p_200,0,4,e_1,367,592,606,24.5,9,9,4.5,4,5,1,225,14,239
p_220,0,6,e_3,341,648,668,2.5,7,0,2.5,4,6,1,307,20,327
p_300,0,4,e_0,8,8,24,0.0,0,0,0.0,3,0,0,0,16,16
p_297,0,6,e_3,15,15,37,0.0,0,0,0.0,3,0,0,0,22,22
p_296,0,4,e_0,28,42,56,10.5,1,1,2.0,3,0,0,14,14,28
p_292,0,6,e_0,38,42,64,3.0,0,0,0.5,4,0,1,4,22,26
p_290,0,6,e_0,40,42,64,3.0,0,0,0.5,4,0,1,2,22,24
p_289,0,4,e_3,43,63,77,3.0,0,0,3.0,3,0,0,20,14,34
p_285,0,4,e_3,53,63,77,1.5,1,0,1.5,4,0,1,10,14,24
p_284,0,4,e_3,54,63,77,1.5,1,0,1.5,4,0,1,9,14,23
p_294,0,12,e_0,31,42,84,10.0,1,1,2.0,4,0,1,11,42,53
p_293,0,12,e_0,33,42,84,9.5,1,1,1.5,4,0,1,9,42,51
p_288,0,8,e_3,44,63,91,3.0,1,0,3.0,4,0,1,19,28,47
p_278,0,2,e_1,77,106,114,2.0,4,4,5.0,4,1,1,29,8,37
p_277,0,6,e_1,82,106,128,15.5,4,4,4.0,4,1,1,24,22,46
p_273,0,4,e_0,110,122,136,11.0,3,3,2.0,4,2,0,12,14,26
p_274,0,8,e_1,88,106,136,14.5,4,4,3.0,4,1,1,18,30,48
p_272,0,10,e_0,113,122,156,7.0,3,3,1.5,4,2,1,9,34,43
p_280,0,14,e_1,75,106,156,16.0,5,5,5.0,4,1,1,31,50,81
p_275,0,14,e_1,86,106,156,15.0,4,4,3.5,4,1,1,20,50,70
p_268,0,2,e_3,144,161,169,3.0,4,0,3.0,4,3,1,17,8,25
p_265,0,4,e_3,152,161,177,1.5,4,0,1.5,4,3,1,9,16,25
p_266,0,6,e_3,151,161,185,1.5,4,0,1.5,4,3,1,10,24,34
p_254,0,4,e_1,187,200,214,19.0,6,6,2.0,4,4,1,13,14,27
p_250,0,2,e_0,217,220,228,7.0,6,0,0.5,4,2,1,3,8,11
p_256,0,10,e_1,182,200,234,19.5,7,7,3.0,4,4,1,18,34,52
p_257,0,14,e_1,169,200,248,21.0,8,8,5.0,4,4,1,31,48,79
p_249,0,6,e_3,239,261,281,3.5,6,0,3.5,4,6,0,22,20,42
p_242,0,8,e_1,277,300,326,19.5,7,7,4.0,4,6,1,23,26,49
p_246,0,10,e_1,262,300,334,22.0,7,7,6.0,4,6,0,38,34,72
p_235,0,8,e_0,308,316,342,15.0,6,6,1.5,4,3,1,8,26,34
p_234,0,8,e_0,310,316,342,7.5,6,0,1.0,4,3,1,6,26,32
p_244,0,12,e_0,271,316,356,20.5,7,7,7.5,4,3,0,45,40,85
p_186,0,4,e_2,390,390,406,20.5,7,7,0.0,3,1,0,0,16,16
p_209,0,2,e_1,357,398,406,0.0,6,6,7.0,4,6,0,41,8,49
p_182,0,2,e_0,397,414,422,19.5,7,7,2.5,4,7,0,17,8,25
p_180,0,2,e_0,399,414,422,19.5,7,7,2.5,4,7,1,15,8,23
p_179,0,8,e_0,400,414,442,19.0,7,7,2.5,4,7,1,14,28,42
p_137,0,4,e_2,464,488,504,24.0,7,7,4.0,4,1,1,24,16,40
p_141,0,6,e_2,458,488,512,25.0,7,7,5.0,4,1,1,30,24,54
p_208,0,6,e_1,358,494,514,26.0,7,7,6.5,4,6,1,136,20,156
p_140,0,8,e_2,459,488,520,25.0,7,7,5.0,4,1,1,29,32,61
p_176,0,4,e_0,403,512,526,7.0,7,7,1.5,4,7,1,109,14,123
p_139,0,10,e_2,461,488,528,24.5,7,7,4.5,4,1,1,27,40,67
p_135,0,10,e_2,466,488,528,23.5,7,7,3.5,4,1,1,22,40,62
p_174,0,14,e_2,406,488,542,7.5,7,0,2.0,3,2,0,82,54,136
p_133,0,12,e_2,469,586,624,23.0,7,7,3.0,4,1,1,117,38,155
p_131,0,14,e_2,471,586,632,23.0,7,7,2.5,4,1,1,115,46,161
p_175,0,14,e_0,405,608,652,7.5,7,0,1.5,4,7,1,203,44,247
p_127,0,10,e_2,475,684,716,22.5,7,7,2.0,4,1,1,209,32,241
p_126,0,12,e_2,476,780,818,22.0,7,7,2.0,4,1,1,304,38,342
p_125,0,14,e_2,477,876,920,22.0,7,7,1.5,4,1,1,399,44,443
p_300,0,4,e_0,8,9,25,0.0,0,0,0.0,3,0,0,1,16,17
p_297,0,6,e_3,15,16,38,0.0,0,0,0.0,3,0,0,1,22,23
p_296,0,4,e_0,28,43,59,10.5,1,1,2.0,3,0,0,15,16,31
p_289,0,4,e_0,43,43,59,3.0,0,0,0.0,3,0,0,0,16,16
p_292,0,6,e_0,38,43,67,3.0,0,0,1.0,4,0,1,5,24,29
p_290,0,6,e_0,40,43,67,3.0,0,0,0.5,4,0,1,3,24,27
p_285,0,4,e_3,53,64,78,2.0,1,0,2.0,4,0,1,11,14,25
p_284,0,4,e_3,54,64,78,1.5,1,0,1.5,4,0,1,10,14,24
p_294,0,12,e_0,31,43,87,10.0,1,1,2.0,4,0,1,12,44,56
p_293,0,12,e_0,33,43,87,9.5,1,1,1.5,4,0,1,10,44,54
p_288,0,8,e_3,44,64,92,3.0,0,0,3.0,3,0,0,20,28,48
p_278,0,2,e_1,77,105,113,2.0,4,4,4.5,4,1,1,28,8,36
p_277,0,6,e_1,82,105,127,15.5,4,4,4.0,4,1,1,23,22,45
p_274,0,8,e_1,88,105,135,14.5,4,4,2.5,4,1,1,17,30,47
p_273,0,4,e_0,110,125,139,11.5,3,3,2.5,4,2,0,15,14,29
p_280,0,14,e_1,75,105,155,16.5,5,5,5.0,4,1,1,30,50,80
p_275,0,14,e_1,86,105,155,15.0,4,4,3.0,4,1,1,19,50,69
p_272,0,10,e_0,113,125,159,11.0,3,3,2.0,4,2,1,12,34,46
p_268,0,2,e_3,144,162,170,3.0,4,0,3.0,4,3,1,18,8,26
p_265,0,4,e_3,152,162,178,1.5,4,0,1.5,4,3,1,10,16,26
p_266,0,6,e_3,151,162,186,2.0,4,0,2.0,4,3,1,11,24,35
p_254,0,4,e_1,187,199,213,19.0,6,6,2.0,4,4,1,12,14,26
p_250,0,2,e_0,217,223,231,7.5,6,0,1.0,4,4,1,6,8,14
p_256,0,10,e_1,182,199,233,19.5,7,7,2.5,4,4,1,17,34,51
p_257,0,14,e_1,169,199,247,21.0,8,8,5.0,4,4,1,30,48,78
p_249,0,6,e_3,239,262,282,3.5,6,0,3.5,4,6,0,23,20,43
p_246,0,10,e_1,262,299,331,22.0,7,7,6.0,4,6,0,37,32,69
p_244,0,12,e_1,271,299,339,20.5,7,7,4.5,4,6,1,28,40,68
p_235,0,8,e_0,308,319,347,15.0,6,6,1.5,4,5,1,11,28,39
p_234,0,8,e_0,310,319,347,14.5,6,6,1.5,4,5,1,9,28,37
p_226,0,2,e_3,329,358,366,5.0,7,0,5.0,4,6,1,29,8,37
p_228,0,4,e_3,325,358,374,5.5,7,0,5.5,4,6,1,33,16,49
p_227,0,12,e_3,327,358,400,5.0,7,0,5.0,4,6,1,31,42,73
p_209,0,2,e_2,357,390,400,0.0,6,6,5.5,4,1,1,33,10,43
p_205,0,2,e_2,362,390,400,25.5,10,10,4.5,4,1,1,28,10,38
p_200,0,4,e_2,367,390,408,25.0,9,9,3.5,4,1,1,23,18,41
p_208,0,6,e_2,358,390,416,26.0,10,10,5.0,4,1,1,32,26,58
p_242,0,8,e_1,277,397,425,19.5,7,7,3.5,4,6,1,120,28,148
p_197,0,10,e_2,370,390,430,24.5,9,9,3.0,4,1,1,20,40,60
p_206,0,12,e_2,361,390,438,25.5,10,10,4.5,4,1,1,29,48,77
p_203,0,12,e_2,364,390,438,25.5,10,10,4.5,4,1,1,26,48,74
p_204,0,14,e_2,363,390,446,25.5,10,10,4.5,4,1,1,27,56,83
p_223,0,2,e_3,336,458,466,3.5,7,0,3.5,4,6,1,122,8,130
p_196,0,4,e_2,371,498,512,24.5,9,9,3.0,4,1,1,127,14,141
p_194,0,6,e_2,373,498,520,24.0,9,9,3.0,4,1,1,125,22,147
p_185,0,10,e_1,391,495,527,21.5,8,8,1.0,4,6,0,104,32,136
p_192,0,8,e_2,375,498,528,24.0,8,8,2.5,4,1,1,123,30,153
p_189,0,8,e_2,382,498,528,23.0,8,8,1.5,4,1,1,116,30,146
p_191,0,10,e_2,376,498,536,24.0,8,8,2.0,4,1,1,122,38,160
p_221,0,6,e_3,339,554,576,3.0,7,0,3.0,4,6,1,215,22,237
p_186,0,4,e_2,390,600,614,21.5,8,8,0.0,3,1,0,210,14,224
p_141,0,6,e_2,458,600,622,26.0,8,8,6.5,4,4,0,142,22,164
p_184,0,12,e_1,392,591,629,21.0,8,8,0.5,4,6,1,199,38,237
p_140,0,8,e_2,459,600,630,26.0,8,8,6.5,4,4,1,141,30,171
p_187,0,12,e_2,389,600,644,22.0,8,8,0.0,4,1,1,211,44,255
p_220,0,6,e_3,341,652,672,2.5,7,0,2.5,4,6,1,311,20,331
p_137,0,4,e_2,464,702,716,25.5,8,8,5.5,4,4,1,238,14,252
p_139,0,10,e_2,461,702,736,25.5,8,8,6.0,4,4,1,241,34,275
p_135,0,10,e_2,466,800,832,25.0,7,7,5.5,4,4,1,334,32,366
p_133,0,12,e_2,469,896,934,25.0,7,7,4.5,4,4,1,427,38,465
p_300,0,4,e_0,8,9,25,0.0,0,0,0.0,3,0,0,1,16,17
p_297,0,6,e_3,15,16,38,0.0,0,0,0.0,3,0,0,1,22,23
p_296,0,4,e_0,28,43,59,10.5,1,1,2.0,3,0,0,15,16,31
p_289,0,4,e_0,43,43,59,3.0,0,0,0.0,3,0,0,0,16,16
p_292,0,6,e_0,38,43,67,3.0,0,0,0.5,4,0,1,5,24,29
p_290,0,6,e_0,40,43,67,3.0,0,0,0.5,4,0,1,3,24,27
p_285,0,4,e_3,53,65,79,2.0,1,0,2.0,4,0,1,12,14,26
p_284,0,4,e_3,54,65,79,2.0,1,0,2.0,4,0,1,11,14,25
p_294,0,12,e_0,31,43,87,10.0,1,1,2.0,4,0,1,12,44,56
p_293,0,12,e_0,33,43,87,10.0,1,1,1.5,4,0,1,10,44,54
p_288,0,8,e_3,44,65,93,3.0,0,0,3.0,3,0,0,21,28,49
p_278,0,2,e_1,77,105,113,16.5,5,5,4.5,4,1,1,28,8,36
p_277,0,6,e_1,82,105,127,15.5,4,4,3.5,4,1,1,23,22,45
p_274,0,8,e_1,88,105,135,14.5,4,4,2.5,4,1,1,17,30,47
p_273,0,4,e_0,110,125,139,11.5,3,3,2.5,4,2,0,15,14,29
p_280,0,14,e_1,75,105,155,16.5,5,5,5.0,4,1,1,30,50,80
p_275,0,14,e_1,86,105,155,15.0,4,4,3.0,4,1,1,19,50,69
p_272,0,10,e_0,113,125,159,11.0,3,3,2.0,4,2,1,12,34,46
p_268,0,2,e_3,144,163,171,3.0,4,0,3.0,4,3,1,19,8,27
p_265,0,4,e_3,152,163,179,2.0,4,0,2.0,4,3,1,11,16,27
p_266,0,6,e_3,151,163,187,2.0,4,0,2.0,4,3,1,12,24,36
p_254,0,4,e_1,187,199,213,19.0,6,6,2.0,4,4,1,12,14,26
p_250,0,2,e_0,217,223,231,7.5,6,0,1.0,4,4,1,6,8,14
p_256,0,10,e_1,182,199,233,20.0,7,7,2.5,4,4,1,17,34,51
p_257,0,14,e_1,169,199,247,21.5,9,9,5.0,4,4,1,30,48,78
p_249,0,6,e_3,239,263,283,4.0,6,0,4.0,4,6,0,24,20,44
p_246,0,10,e_3,262,263,297,0.0,7,0,0.0,4,6,1,1,34,35
p_242,0,8,e_1,277,299,325,20.0,8,8,3.5,4,6,1,22,26,48
p_244,0,12,e_1,271,299,339,21.0,8,8,4.5,4,6,1,28,40,68
p_235,0,8,e_0,308,319,347,15.5,6,6,1.5,4,5,1,11,28,39
p_234,0,8,e_0,310,319,347,15.0,6,6,1.5,4,5,1,9,28,37
p_226,0,2,e_3,329,361,369,5.5,7,0,5.5,4,6,1,32,8,40
p_228,0,4,e_3,325,361,377,6.0,7,0,6.0,4,6,1,36,16,52
p_227,0,12,e_3,327,361,403,5.5,7,0,5.5,4,6,1,34,42,76
p_187,0,12,e_2,389,389,429,22.5,8,8,0.0,3,1,0,0,40,40
p_206,0,12,e_1,361,397,435,26.0,10,10,6.0,4,6,0,36,38,74
p_223,0,2,e_3,336,461,469,4.0,7,0,4.0,4,6,1,125,8,133
p_205,0,2,e_1,362,493,501,26.0,10,10,6.0,4,6,1,131,8,139
p_135,0,10,e_2,466,467,501,25.5,8,8,0.0,3,1,0,1,34,35
p_221,0,6,e_3,339,557,577,3.5,7,0,3.5,4,6,1,218,20,238
p_204,0,14,e_1,363,589,633,26.0,10,10,5.5,4,6,1,226,44,270
p_220,0,6,e_3,341,653,673,3.0,7,0,3.0,4,6,1,312,20,332
p_203,0,12,e_1,364,685,723,25.5,10,10,5.5,4,6,1,321,38,359
p_21,0,4,e_2,731,755,771,3.0,7,0,4.0,4,3,1,24,16,40
p_23,0,12,e_2,711,755,797,6.0,7,0,7.0,4,3,0,44,42,86
p_20,0,14,e_2,734,755,805,2.5,7,0,3.5,4,3,1,21,50,71
p_9,0,2,e_2,846,857,865,25.5,7,7,1.5,4,4,0,11,8,19
p_300,0,4,e_0,8,9,25,0.0,0,0,0.0,3,0,0,1,16,17
p_297,0,6,e_3,15,16,38,0.0,0,0,0.0,3,0,0,1,22,23
p_296,0,4,e_0,28,42,56,10.5,1,1,2.0,3,0,0,14,14,28
p_292,0,6,e_0,38,42,64,3.0,0,0,0.5,4,0,1,4,22,26
p_290,0,6,e_0,40,42,64,3.0,0,0,0.5,4,0,1,2,22,24
p_289,0,4,e_3,43,64,78,3.0,0,0,3.0,3,0,0,21,14,35
p_285,0,4,e_3,53,64,78,2.0,1,0,2.0,4,0,1,11,14,25
p_284,0,4,e_3,54,64,78,1.5,1,0,1.5,4,0,1,10,14,24
p_294,0,12,e_0,31,42,84,10.0,1,1,2.0,4,0,1,11,42,53
p_293,0,12,e_0,33,42,84,9.5,1,1,1.5,4,0,1,9,42,51
p_288,0,8,e_3,44,64,92,3.0,1,1,3.0,3,0,1,20,28,48
p_278,0,2,e_1,77,105,113,16.0,5,5,4.5,4,1,1,28,8,36
p_277,0,6,e_1,82,105,127,15.5,4,4,3.5,4,1,1,23,22,45
p_274,0,8,e_1,88,105,135,14.5,4,4,3.0,4,1,1,17,30,47
p_273,0,4,e_0,110,122,138,11.0,3,3,2.0,4,2,0,12,16,28
p_280,0,14,e_1,75,105,155,16.5,5,5,5.0,4,1,1,30,50,80
p_275,0,14,e_1,86,105,155,15.0,4,4,3.0,4,1,1,19,50,69
p_272,0,10,e_0,113,122,158,10.5,3,3,1.5,4,2,1,9,36,45
p_268,0,2,e_3,144,162,170,3.0,4,0,3.0,4,3,1,18,8,26
p_265,0,4,e_3,152,162,178,1.5,4,0,1.5,4,3,1,10,16,26
p_266,0,6,e_3,151,162,186,1.5,4,0,1.5,4,3,1,11,24,35
p_254,0,4,e_1,187,199,213,19.0,6,6,2.0,4,4,1,12,14,26
p_250,0,2,e_0,217,222,230,7.5,6,0,1.0,4,4,1,5,8,13
p_256,0,10,e_1,182,199,233,19.5,7,7,2.5,4,4,1,17,34,51
p_257,0,14,e_1,169,199,247,21.0,9,9,5.0,4,4,1,30,48,78
p_249,0,6,e_3,239,262,284,3.5,6,0,3.5,4,6,0,23,22,45
p_246,0,10,e_3,262,262,298,0.0,6,6,0.0,3,6,0,0,36,36
p_242,0,8,e_1,277,299,325,20.0,8,8,3.5,4,6,1,22,26,48
p_244,0,12,e_1,271,299,339,21.0,8,8,4.5,4,6,1,28,40,68
p_235,0,8,e_0,308,318,344,15.5,6,6,1.5,4,5,1,10,26,36
p_234,0,8,e_0,310,318,344,15.0,6,6,1.0,4,5,1,8,26,34
p_226,0,2,e_3,329,362,372,5.5,7,0,5.5,4,6,1,33,10,43
p_228,0,4,e_3,325,362,380,6.0,7,0,6.0,4,6,1,37,18,55
p_186,0,4,e_2,390,390,406,22.5,8,8,0.0,3,1,1,0,16,16
p_227,0,12,e_3,327,362,406,6.0,7,0,6.0,4,6,1,35,44,79
p_182,0,2,e_0,397,414,422,21.5,8,8,2.5,4,7,0,17,8,25
p_187,0,12,e_2,389,390,432,23.0,8,8,0.0,3,1,0,1,42,43
p_204,0,14,e_1,363,397,441,26.0,11,11,5.5,4,6,0,34,44,78
p_223,0,2,e_3,336,464,472,4.0,7,0,4.0,4,6,1,128,8,136
p_203,0,12,e_1,364,493,531,26.0,10,10,5.5,4,6,1,129,38,167
p_86,0,2,e_2,544,566,576,2.5,8,0,3.5,4,2,1,22,10,32
p_94,0,6,e_2,519,566,590,7.0,8,0,7.5,4,2,1,47,24,71
p_101,0,8,e_2,511,566,598,18.5,7,7,6.5,5,2,0,55,32,87
p_87,0,8,e_2,539,566,598,3.5,8,0,4.5,4,2,1,27,32,59
p_83,0,8,e_2,549,566,598,2.0,8,0,2.5,4,2,1,17,32,49
p_91,0,12,e_2,526,566,612,5.5,8,0,6.5,4,2,1,40,46,86
p_84,0,12,e_2,546,566,612,2.0,8,0,3.0,4,2,1,20,46,66
p_82,0,14,e_2,550,566,620,1.5,8,0,2.5,4,2,1,16,54,70
p_76,0,6,e_2,558,672,692,0.5,8,0,1.5,4,2,1,114,20,134
p_78,0,12,e_2,556,672,712,0.5,8,0,1.5,4,2,1,116,40,156
p_81,0,14,e_2,551,672,720,1.5,8,0,2.5,4,2,1,121,48,169
p_79,0,14,e_2,553,672,720,1.0,8,0,2.0,4,2,1,119,48,167
p_300,0,4,e_0,8,9,25,0.0,0,0,0.0,3,0,0,1,16,17
p_297,0,6,e_3,15,15,37,0.0,0,0,0.0,3,0,0,0,22,22
p_296,0,4,e_0,28,43,59,10.5,1,1,2.0,3,0,0,15,16,31
p_289,0,4,e_0,43,43,59,3.0,0,0,0.0,3,0,0,0,16,16
p_292,0,6,e_0,38,43,67,3.0,0,0,0.5,4,0,1,5,24,29
p_290,0,6,e_0,40,43,67,3.0,0,0,0.5,4,0,1,3,24,27
p_285,0,4,e_3,53,65,79,2.0,1,0,2.0,4,0,1,12,14,26
p_284,0,4,e_3,54,65,79,1.5,1,0,1.5,4,0,1,11,14,25
p_294,0,12,e_0,31,43,87,10.0,1,1,2.0,4,0,1,12,44,56
p_293,0,12,e_0,33,43,87,9.5,1,1,1.5,4,0,1,10,44,54
p_288,0,8,e_3,44,65,93,3.0,0,0,3.0,3,0,0,21,28,49
p_278,0,2,e_1,77,105,113,16.0,5,5,4.5,4,1,1,28,8,36
p_277,0,6,e_1,82,105,127,15.5,4,4,3.5,4,1,1,23,22,45
p_274,0,8,e_1,88,105,135,15.0,4,4,2.5,4,1,1,17,30,47
p_273,0,4,e_0,110,125,139,11.5,3,3,2.5,4,2,0,15,14,29
p_280,0,14,e_1,75,105,155,16.5,5,5,5.0,4,1,1,30,50,80
p_275,0,14,e_1,86,105,155,15.0,4,4,3.0,4,1,1,19,50,69
p_272,0,10,e_0,113,125,159,11.0,3,3,2.0,4,2,1,12,34,46
p_268,0,2,e_3,144,163,171,3.0,4,0,3.0,4,3,1,19,8,27
p_265,0,4,e_3,152,163,179,1.5,4,0,1.5,4,3,1,11,16,27
p_266,0,6,e_3,151,163,187,2.0,4,0,2.0,4,3,1,12,24,36
p_254,0,4,e_1,187,199,213,19.0,6,6,2.0,4,4,1,12,14,26
p_250,0,2,e_0,217,223,231,7.5,6,0,1.0,4,4,1,6,8,14
p_256,0,10,e_1,182,199,233,20.0,7,7,3.0,4,4,1,17,34,51
p_257,0,14,e_1,169,199,247,21.5,9,9,5.0,4,4,1,30,48,78
p_249,0,6,e_3,239,263,283,4.0,6,0,4.0,4,6,0,24,20,44
p_246,0,10,e_3,262,263,297,0.0,7,0,0.0,4,6,1,1,34,35
p_242,0,8,e_1,277,299,325,20.0,8,8,3.5,4,6,1,22,26,48
p_244,0,12,e_1,271,299,339,21.0,8,8,4.5,4,6,1,28,40,68
p_235,0,8,e_0,308,319,347,15.5,6,6,1.5,4,5,1,11,28,39
p_234,0,8,e_0,310,319,347,15.0,6,6,1.5,4,5,1,9,28,37
p_226,0,2,e_3,329,361,369,5.5,7,0,5.5,4,6,1,32,8,40
p_228,0,4,e_3,325,361,377,6.0,7,0,6.0,4,6,1,36,16,52
p_209,0,2,e_2,357,389,399,0.5,7,0,5.5,4,1,1,32,10,42
p_227,0,12,e_3,327,361,403,5.5,7,0,5.5,4,6,1,34,42,76
p_186,0,4,e_1,390,397,411,22.0,8,8,1.0,4,6,0,7,14,21
p_220,0,6,e_2,341,389,413,3.5,7,0,7.5,3,1,0,48,24,72
p_210,0,6,e_2,354,389,413,1.0,7,0,6.0,4,1,1,35,24,59
p_208,0,6,e_2,358,389,413,0.5,7,0,5.0,4,1,1,31,24,55
p_223,0,2,e_3,336,461,469,4.0,7,0,4.0,4,6,1,125,8,133
p_205,0,2,e_2,362,489,497,26.0,10,10,4.5,4,1,1,127,8,135
p_185,0,10,e_1,391,493,525,22.0,8,8,1.0,4,6,1,102,32,134
p_206,0,12,e_2,361,489,529,0.0,6,6,4.5,4,1,1,128,40,168
p_203,0,12,e_2,364,489,529,26.0,10,10,4.0,4,1,1,125,40,165
p_204,0,14,e_2,363,489,537,26.0,10,10,4.0,4,1,1,126,48,174
p_221,0,6,e_3,339,557,577,3.5,7,0,3.5,4,6,1,218,20,238
p_200,0,4,e_2,367,589,603,25.5,10,10,3.5,4,1,1,222,14,236
p_184,0,12,e_1,392,589,629,21.5,8,8,0.5,4,6,1,197,40,237
p_165,0,4,e_3,417,653,667,7.0,7,0,7.0,4,7,0,236,14,250
p_300,0,4,e_0,8,8,24,0.0,0,0,0.0,3,0,0,0,16,16
p_297,0,6,e_3,15,15,37,0.0,0,0,0.0,3,0,0,0,22,22
p_296,0,4,e_0,28,43,59,10.5,1,1,2.0,3,0,0,15,16,31
p_289,0,4,e_0,43,43,59,3.0,0,0,0.0,3,0,0,0,16,16
p_292,0,6,e_0,38,43,67,3.0,0,0,1.0,4,0,1,5,24,29
p_290,0,6,e_0,40,43,67,3.0,0,0,0.5,4,0,1,3,24,27
p_285,0,4,e_3,53,65,79,2.0,1,0,2.0,4,0,1,12,14,26
p_284,0,4,e_3,54,65,79,2.0,1,0,2.0,4,0,1,11,14,25
p_294,0,12,e_0,31,43,87,10.0,1,1,2.0,4,0,1,12,44,56
p_293,0,12,e_0,33,43,87,9.5,1,1,1.5,4,0,1,10,44,54
p_288,0,8,e_3,44,65,93,3.0,0,0,3.0,3,0,0,21,28,49
p_278,0,2,e_1,77,106,114,16.5,5,5,5.0,4,1,1,29,8,37
p_277,0,6,e_1,82,106,128,16.0,4,4,4.0,4,1,1,24,22,46
p_274,0,8,e_1,88,106,136,15.0,4,4,3.0,4,1,1,18,30,48
p_273,0,4,e_0,110,125,139,11.5,3,3,2.5,4,2,0,15,14,29
p_280,0,14,e_1,75,106,156,16.5,5,5,5.0,4,1,1,31,50,81
p_275,0,14,e_1,86,106,156,15.0,4,4,3.0,4,1,1,20,50,70
p_272,0,10,e_0,113,125,159,11.0,3,3,2.0,4,2,1,12,34,46
p_268,0,2,e_3,144,163,171,3.0,4,0,3.0,4,3,1,19,8,27
p_265,0,4,e_3,152,163,179,2.0,4,0,2.0,4,3,1,11,16,27
p_266,0,6,e_3,151,163,187,2.0,4,0,2.0,4,3,1,12,24,36
p_254,0,4,e_1,187,200,214,19.0,6,6,2.0,4,4,1,13,14,27
p_250,0,2,e_0,217,223,231,7.5,6,0,1.0,4,4,1,6,8,14
p_256,0,10,e_1,182,200,234,19.5,7,7,3.0,4,4,1,18,34,52
p_257,0,14,e_1,169,200,248,21.0,9,9,5.0,4,4,1,31,48,79
p_249,0,6,e_3,239,263,283,4.0,6,0,4.0,4,6,0,24,20,44
p_246,0,10,e_1,262,300,332,0.0,6,6,6.0,4,6,0,38,32,70
p_244,0,12,e_1,271,300,340,21.0,7,7,4.5,4,6,1,29,40,69
p_235,0,8,e_0,308,319,345,15.0,6,6,2.0,4,5,1,11,26,37
p_234,0,8,e_0,310,319,345,15.0,6,6,1.5,4,5,1,9,26,35
p_226,0,2,e_3,329,359,367,5.0,7,0,5.0,4,6,1,30,8,38
p_228,0,4,e_3,325,359,375,5.5,7,0,5.5,4,6,1,34,16,50
p_209,0,2,e_2,357,390,400,0.0,7,0,5.5,4,1,1,33,10,43
p_227,0,12,e_3,327,359,401,5.5,7,0,5.5,4,6,1,32,42,74
p_210,0,6,e_2,354,390,414,1.0,7,0,6.0,4,1,1,36,24,60
p_208,0,6,e_2,358,390,414,0.0,6,6,5.5,4,1,1,32,24,56
p_182,0,2,e_0,397,415,423,20.5,8,8,3.0,4,7,0,18,8,26
p_242,0,8,e_1,277,398,424,20.0,7,7,3.5,4,6,1,121,26,147
p_206,0,12,e_2,361,390,434,26.0,10,10,5.0,4,1,1,29,44,73
p_223,0,2,e_3,336,459,467,4.0,7,0,4.0,4,6,1,123,8,131
p_205,0,2,e_2,362,492,500,25.5,10,10,4.5,4,1,1,130,8,138
p_185,0,10,e_1,391,494,526,21.5,8,8,1.0,4,6,0,103,32,135
p_203,0,12,e_2,364,492,532,25.5,10,10,4.0,4,1,1,128,40,168
p_204,0,14,e_2,363,492,540,25.5,10,10,4.5,4,1,1,129,48,177
p_200,0,4,e_2,367,592,606,25.0,9,9,4.0,4,1,1,225,14,239
p_184,0,12,e_1,392,590,628,21.5,8,8,1.0,4,6,1,198,38,236
p_300,0,4,e_0,8,8,24,0.0,0,0,0.0,3,0,0,0,16,16
p_297,0,6,e_3,15,16,38,0.0,0,0,0.0,3,0,0,1,22,23
p_296,0,4,e_0,28,43,57,10.5,1,1,2.0,3,0,0,15,14,29
p_290,0,6,e_0,40,43,65,3.0,1,0,0.5,4,0,1,3,22,25
p_289,0,4,e_3,43,59,73,2.5,1,0,2.5,4,0,1,16,14,30
p_285,0,4,e_3,53,59,73,1.0,1,0,1.0,4,0,1,6,14,20
p_284,0,4,e_3,54,59,73,1.0,1,0,1.0,4,0,1,5,14,19
p_292,0,6,e_3,38,59,81,3.0,0,0,3.0,3,0,0,21,22,43
p_294,0,12,e_0,31,43,85,10.0,1,1,2.0,4,0,1,12,42,54
p_293,0,12,e_0,33,43,85,10.0,1,1,1.5,4,0,1,10,42,52
p_288,0,8,e_3,44,59,89,2.5,1,0,2.5,4,0,1,15,30,45
p_278,0,2,e_1,77,105,113,15.5,5,5,4.5,4,1,1,28,8,36
p_277,0,6,e_1,82,105,127,15.0,4,4,4.0,4,1,1,23,22,45
p_274,0,8,e_1,88,105,135,14.0,4,4,2.5,4,1,1,17,30,47
p_273,0,4,e_0,110,123,137,11.0,3,3,2.0,4,2,0,13,14,27
p_280,0,14,e_1,75,105,155,16.0,5,5,5.0,4,1,1,30,50,80
p_275,0,14,e_1,86,105,155,14.5,4,4,3.0,4,1,1,19,50,69
p_272,0,10,e_0,113,123,157,7.5,3,0,1.5,4,2,1,10,34,44
p_268,0,2,e_3,144,159,167,2.5,4,0,2.5,4,3,1,15,8,23
p_265,0,4,e_3,152,159,175,1.0,4,0,1.0,4,3,1,7,16,23
p_266,0,6,e_3,151,159,183,1.5,4,0,1.5,4,3,1,8,24,32
p_254,0,4,e_2,187,202,216,18.5,6,6,2.5,4,1,1,15,14,29
p_250,0,2,e_0,217,221,229,7.0,6,0,0.5,4,3,1,4,8,12
p_256,0,10,e_2,182,202,236,19.0,7,7,3.5,4,1,1,20,34,54
p_257,0,14,e_2,169,202,250,21.0,8,8,5.5,4,1,1,33,48,81
p_249,0,6,e_3,239,259,279,3.5,6,0,3.5,4,6,0,20,20,40
p_242,0,8,e_1,277,293,319,19.5,7,7,2.5,4,4,1,16,26,42
p_246,0,10,e_1,262,293,327,22.0,7,7,5.0,4,4,1,31,34,65
p_235,0,8,e_0,308,317,343,7.5,6,0,1.5,4,4,1,9,26,35
p_234,0,8,e_0,310,317,343,7.5,6,0,1.0,4,4,1,7,26,33
p_244,0,12,e_0,271,317,357,20.0,7,7,7.5,4,4,0,46,40,86
p_226,0,2,e_3,329,355,363,4.5,7,0,4.5,4,6,1,26,8,34
p_228,0,4,e_3,325,355,371,5.0,7,0,5.0,4,6,1,30,16,46
p_227,0,12,e_3,327,355,397,4.5,7,0,4.5,4,6,1,28,42,70
p_186,0,4,e_2,390,396,410,21.0,8,8,1.0,4,5,1,6,14,20
p_182,0,2,e_0,397,415,423,20.0,7,7,3.0,4,7,1,18,8,26
p_185,0,10,e_2,391,396,430,21.0,8,8,0.5,4,5,1,5,34,39
p_184,0,12,e_2,392,396,438,21.0,8,8,0.5,4,5,1,4,42,46
p_223,0,2,e_3,336,455,463,3.0,7,0,3.0,4,6,1,119,8,127
p_180,0,2,e_0,399,511,519,20.0,7,7,2.5,4,7,1,112,8,120
p_148,0,8,e_2,449,496,522,1.0,8,0,7.5,4,5,0,47,26,73
p_117,0,10,e_2,485,496,530,21.5,7,7,1.5,4,5,1,11,34,45
p_116,0,10,e_2,486,496,530,21.5,7,7,1.5,4,5,1,10,34,44
p_221,0,6,e_3,339,551,571,2.5,7,0,2.5,4,6,1,212,20,232
p_111,0,8,e_2,491,594,620,20.5,7,7,0.5,4,5,1,103,26,129
p_179,0,8,e_0,400,607,633,20.0,7,7,2.5,4,7,1,207,26,233
p_220,0,6,e_3,341,647,667,2.0,7,0,2.0,4,6,1,306,20,326
p_300,0,4,e_0,8,8,24,0.0,0,0,0.0,3,0,0,0,16,16
p_297,0,6,e_3,15,16,38,0.0,0,0,0.0,3,0,0,1,22,23
p_296,0,4,e_0,28,43,57,10.5,1,1,2.0,3,0,0,15,14,29
p_292,0,6,e_0,38,43,65,3.0,0,0,0.5,4,0,1,5,22,27
p_290,0,6,e_0,40,43,65,3.0,0,0,0.5,4,0,1,3,22,25
p_289,0,4,e_3,43,64,78,3.0,0,0,3.0,3,0,0,21,14,35
p_285,0,4,e_3,53,64,78,1.5,1,0,1.5,4,0,1,11,14,25
p_284,0,4,e_3,54,64,78,1.5,1,0,1.5,4,0,1,10,14,24
p_294,0,12,e_0,31,43,85,10.0,1,1,2.0,4,0,1,12,42,54
p_293,0,12,e_0,33,43,85,9.5,1,1,1.5,4,0,1,10,42,52
p_288,0,8,e_3,44,64,92,3.0,1,1,3.0,3,0,1,20,28,48
p_278,0,2,e_1,77,106,114,16.0,5,5,4.5,4,1,1,29,8,37
p_277,0,6,e_1,82,106,128,15.5,4,4,4.0,4,1,1,24,22,46
p_274,0,8,e_1,88,106,136,14.5,4,4,3.0,4,1,1,18,30,48
p_273,0,4,e_0,110,123,139,11.0,3,3,2.0,4,2,0,13,16,29
p_280,0,14,e_1,75,106,156,16.5,5,5,5.0,4,1,1,31,50,81
p_275,0,14,e_1,86,106,156,15.0,4,4,3.5,4,1,1,20,50,70
p_272,0,10,e_0,113,123,159,10.5,3,3,1.5,4,2,1,10,36,46
p_268,0,2,e_3,144,162,170,3.0,4,0,3.0,4,3,1,18,8,26
p_265,0,4,e_3,152,162,178,1.5,4,0,1.5,4,3,1,10,16,26
p_266,0,6,e_3,151,162,186,2.0,4,0,2.0,4,3,1,11,24,35
p_254,0,4,e_1,187,200,214,19.0,6,6,2.0,4,4,1,13,14,27
p_250,0,2,e_0,217,223,231,7.5,6,0,1.0,4,4,1,6,8,14
p_256,0,10,e_1,182,200,234,19.5,7,7,3.0,4,4,1,18,34,52
p_257,0,14,e_1,169,200,248,21.0,9,9,5.0,4,4,1,31,48,79
p_249,0,6,e_3,239,262,282,4.0,6,0,4.0,4,6,0,23,20,43
p_246,0,10,e_1,262,300,332,22.0,7,7,6.5,4,6,0,38,32,70
p_244,0,12,e_1,271,300,340,21.0,7,7,5.0,4,6,1,29,40,69
p_235,0,8,e_0,308,319,347,15.0,6,6,2.0,4,5,1,11,28,39
p_234,0,8,e_0,310,319,347,14.5,6,6,1.5,4,5,1,9,28,37
p_226,0,2,e_3,329,358,366,5.0,7,0,5.0,4,6,1,29,8,37
p_228,0,4,e_3,325,358,374,5.5,7,0,5.5,4,6,1,33,16,49
p_227,0,12,e_3,327,358,400,5.0,7,0,5.0,4,6,1,31,42,73
p_205,0,2,e_2,362,390,400,25.5,10,10,4.5,4,1,1,28,10,38
p_200,0,4,e_2,367,390,408,25.0,9,9,4.0,4,1,1,23,18,41
p_208,0,6,e_2,358,390,416,0.0,6,6,5.0,4,1,1,32,26,58
p_242,0,8,e_1,277,398,426,19.5,7,7,4.0,4,6,1,121,28,149
p_206,0,12,e_2,361,390,436,25.5,10,10,5.0,4,1,1,29,46,75
p_203,0,12,e_2,364,390,436,25.5,10,10,4.5,4,1,1,26,46,72
p_204,0,14,e_2,363,390,444,25.5,10,10,4.5,4,1,1,27,54,81
p_223,0,2,e_3,336,458,466,3.5,7,0,3.5,4,6,1,122,8,130
p_196,0,4,e_2,371,496,510,24.5,9,9,3.0,4,1,1,125,14,139
p_194,0,6,e_2,373,496,518,2.0,8,8,2.5,4,1,1,123,22,145
p_192,0,8,e_2,375,496,526,24.0,8,8,2.5,4,1,1,121,30,151
p_185,0,10,e_1,391,496,530,21.5,8,8,1.0,4,6,0,105,34,139
p_197,0,10,e_2,370,496,534,24.5,9,9,3.0,4,1,1,126,38,164
p_221,0,6,e_3,339,554,576,3.0,7,0,3.0,4,6,1,215,22,237
p_189,0,8,e_2,382,598,624,23.0,8,8,1.0,4,1,1,216,26,242
p_184,0,12,e_1,392,594,632,21.5,8,8,1.0,4,6,1,202,38,240
p_191,0,10,e_2,376,598,632,24.0,8,8,2.0,4,1,1,222,34,256
p_220,0,6,e_3,341,652,672,2.5,7,0,2.5,4,6,1,311,20,331
p_186,0,4,e_2,390,696,710,21.5,8,8,0.0,3,1,0,306,14,320
p_187,0,12,e_2,389,696,736,21.5,8,8,0.0,4,1,1,307,40,347
p_140,0,8,e_2,459,794,820,26.0,8,8,6.0,4,6,0,335,26,361
p_46,0,4,e_2,594,890,904,20.5,7,7,0.5,4,6,1,296,14,310
p_45,0,2,e_2,595,986,994,20.0,7,7,0.5,4,6,1,391,8,399
p_44,0,8,e_2,596,1082,1108,20.0,7,7,0.0,4,6,1,486,26,512
p_300,0,4,e_0,8,8,24,0.0,0,0,0.0,3,0,0,0,16,16
p_297,0,6,e_3,15,16,38,0.0,0,0,0.0,3,0,0,1,22,23
p_296,0,4,e_0,28,42,56,10.5,1,1,2.0,3,0,0,14,14,28
p_292,0,6,e_0,38,42,64,3.0,0,0,0.5,4,0,1,4,22,26
p_290,0,6,e_0,40,42,64,3.0,0,0,0.0,4,0,1,2,22,24
p_289,0,4,e_3,43,64,78,3.0,0,0,3.0,3,0,0,21,14,35
p_285,0,4,e_3,53,64,78,2.0,1,0,2.0,4,0,1,11,14,25
p_284,0,4,e_3,54,64,78,1.5,1,0,1.5,4,0,1,10,14,24
p_294,0,12,e_0,31,42,84,10.0,1,1,2.0,4,0,1,11,42,53
p_293,0,12,e_0,33,42,84,9.5,1,1,1.5,4,0,1,9,42,51
p_288,0,8,e_3,44,64,92,3.0,1,1,3.0,3,0,1,20,28,48
p_278,0,2,e_1,77,106,114,2.0,4,4,4.5,4,1,1,29,8,37
p_277,0,6,e_1,82,106,128,15.5,4,4,4.0,4,1,1,24,22,46
p_274,0,8,e_1,88,106,136,14.5,4,4,3.0,4,1,1,18,30,48
p_273,0,4,e_0,110,122,138,11.5,3,3,2.0,4,2,0,12,16,28
p_280,0,14,e_1,75,106,156,16.5,5,5,5.0,4,1,1,31,50,81
p_275,0,14,e_1,86,106,156,15.0,4,4,3.5,4,1,1,20,50,70
p_272,0,10,e_0,113,122,158,11.0,3,3,1.5,4,2,1,9,36,45
p_268,0,2,e_3,144,162,170,3.0,4,0,3.0,4,3,1,18,8,26
p_265,0,4,e_3,152,162,178,1.5,4,0,1.5,4,3,1,10,16,26
p_266,0,6,e_3,151,162,186,2.0,4,0,2.0,4,3,1,11,24,35
p_254,0,4,e_1,187,200,214,19.0,6,6,2.0,4,4,1,13,14,27
p_250,0,2,e_0,217,222,230,7.5,6,0,1.0,4,3,1,5,8,13
p_256,0,10,e_1,182,200,234,19.5,7,7,3.0,4,4,1,18,34,52
p_257,0,14,e_1,169,200,248,21.0,9,9,5.0,4,4,1,31,48,79
p_249,0,6,e_3,239,262,284,3.5,6,0,3.5,4,6,0,23,22,45
p_246,0,10,e_3,262,262,298,0.0,6,6,0.0,3,6,0,0,36,36
p_242,0,8,e_1,277,300,326,20.0,8,8,4.0,4,6,1,23,26,49
p_244,0,12,e_1,271,300,340,21.0,8,8,4.5,4,6,1,29,40,69
p_235,0,8,e_0,308,318,346,15.5,6,6,1.5,4,4,1,10,28,38
p_234,0,8,e_0,310,318,346,15.5,6,6,1.5,4,4,1,8,28,36
p_228,0,4,e_3,325,362,378,6.0,7,0,6.0,4,6,1,37,16,53
p_227,0,12,e_3,327,362,404,6.0,7,0,6.0,4,6,1,35,42,77
p_187,0,12,e_2,389,390,430,22.5,8,8,0.0,3,1,0,1,40,41
p_203,0,12,e_1,364,398,438,26.0,9,9,5.5,4,6,1,34,40,74
p_204,0,14,e_1,363,398,446,26.0,10,10,6.0,4,6,0,35,48,83
p_226,0,2,e_3,329,462,470,5.5,7,0,5.5,4,6,1,133,8,141
p_150,0,6,e_2,443,468,490,3.0,8,0,4.0,4,1,1,25,22,47
p_148,0,8,e_2,449,468,498,2.0,8,0,3.0,4,1,1,19,30,49
p_157,0,14,e_2,431,468,518,5.0,8,0,6.0,4,1,1,37,50,87
p_155,0,14,e_2,435,468,518,4.5,8,0,5.5,4,1,1,33,50,83
p_141,0,6,e_2,458,570,592,0.5,8,0,1.5,4,1,1,112,22,134
p_140,0,8,e_2,459,668,694,0.5,8,0,1.5,4,1,1,209,26,235
p_139,0,10,e_2,461,764,796,0.0,8,0,1.0,4,1,1,303,32,335
p_300,0,4,e_0,8,8,24,0.0,0,0,0.0,3,0,0,0,16,16
p_297,0,6,e_3,15,15,37,0.0,0,0,0.0,3,0,0,0,22,22
p_296,0,4,e_0,28,42,56,10.5,1,1,2.0,3,0,0,14,14,28
p_292,0,6,e_0,38,42,64,3.0,0,0,0.5,4,0,1,4,22,26
p_290,0,6,e_0,40,42,64,3.0,0,0,0.0,4,0,1,2,22,24
p_289,0,4,e_3,43,64,78,3.0,0,0,3.0,3,0,0,21,14,35
p_285,0,4,e_3,53,64,78,2.0,1,0,2.0,4,0,1,11,14,25
p_284,0,4,e_3,54,64,78,1.5,1,0,1.5,4,0,1,10,14,24
p_294,0,12,e_0,31,42,84,10.0,1,1,1.5,4,0,1,11,42,53
p_293,0,12,e_0,33,42,84,9.5,1,1,1.5,4,0,1,9,42,51
p_288,0,8,e_3,44,64,92,3.0,1,1,3.0,3,0,1,20,28,48
p_278,0,2,e_1,77,105,113,16.0,5,5,4.5,4,1,1,28,8,36
p_277,0,6,e_1,82,105,127,15.5,4,4,3.5,4,1,1,23,22,45
p_274,0,8,e_1,88,105,135,14.5,4,4,2.5,4,1,1,17,30,47
p_273,0,4,e_0,110,122,138,11.0,3,3,2.0,4,2,0,12,16,28
p_280,0,14,e_1,75,105,155,16.5,5,5,5.0,4,1,1,30,50,80
p_275,0,14,e_1,86,105,155,15.0,4,4,3.0,4,1,1,19,50,69
p_272,0,10,e_0,113,122,158,11.0,3,3,1.5,4,2,1,9,36,45
p_268,0,2,e_3,144,162,170,3.0,4,0,3.0,4,3,1,18,8,26
p_265,0,4,e_3,152,162,178,1.5,4,0,1.5,4,3,1,10,16,26
p_266,0,6,e_3,151,162,186,2.0,4,0,2.0,4,3,1,11,24,35
p_254,0,4,e_1,187,199,213,19.0,6,6,2.0,4,4,1,12,14,26
p_250,0,2,e_0,217,222,230,7.5,6,0,1.0,4,4,1,5,8,13
p_256,0,10,e_1,182,199,233,19.5,7,7,2.5,4,4,1,17,34,51
p_257,0,14,e_1,169,199,247,21.0,8,8,5.0,4,4,1,30,48,78
p_249,0,6,e_3,239,262,282,4.0,6,0,4.0,4,6,0,23,20,43
p_242,0,8,e_2,277,295,321,19.5,7,7,3.0,4,1,1,18,26,44
p_246,0,10,e_2,262,295,329,0.0,6,6,5.5,4,1,0,33,34,67
p_244,0,12,e_2,271,295,337,21.0,7,7,4.0,4,1,1,24,42,66
p_235,0,8,e_0,308,318,344,15.0,6,6,1.5,4,5,1,10,26,36
p_234,0,8,e_0,310,318,344,7.0,6,6,1.0,4,5,1,8,26,34
p_226,0,2,e_3,329,358,366,4.5,7,0,4.5,4,6,1,29,8,37
p_228,0,4,e_3,325,358,374,5.5,7,0,5.5,4,6,1,33,16,49
p_227,0,12,e_3,327,358,400,5.0,7,0,5.0,4,6,1,31,42,73
p_205,0,2,e_2,362,395,403,25.5,10,10,5.5,4,4,1,33,8,41
p_200,0,4,e_2,367,395,411,25.0,9,9,4.5,4,4,1,28,16,44
p_208,0,6,e_2,358,395,419,26.0,10,10,6.0,4,4,0,37,24,61
p_206,0,12,e_2,361,395,439,25.5,10,10,5.5,4,4,1,34,44,78
p_203,0,12,e_2,364,395,439,25.5,10,10,5.0,4,4,1,31,44,75
p_204,0,14,e_2,363,395,447,25.5,10,10,5.5,4,4,1,32,52,84
p_223,0,2,e_3,336,458,466,3.5,7,0,3.5,4,6,1,122,8,130
p_141,0,6,e_1,458,487,507,26.0,8,8,4.5,4,6,1,29,20,49
p_196,0,4,e_2,371,499,513,24.5,9,9,4.0,4,4,1,128,14,142
p_140,0,8,e_1,459,487,515,26.0,8,8,4.5,4,6,1,28,28,56
p_194,0,6,e_2,373,499,521,24.0,9,9,3.5,4,4,1,126,22,148
p_139,0,10,e_1,461,487,523,26.0,8,8,4.5,4,6,1,26,36,62
p_192,0,8,e_2,375,499,529,24.0,8,8,3.5,4,4,1,124,30,154
p_197,0,10,e_2,370,499,537,24.5,9,9,4.0,4,4,1,129,38,167
p_137,0,4,e_1,464,587,601,25.0,8,8,3.5,4,6,1,123,14,137
p_189,0,8,e_2,382,601,627,23.0,8,8,2.0,4,4,1,219,26,245
p_191,0,10,e_2,376,601,635,24.0,8,8,3.0,4,4,1,225,34,259
p_186,0,4,e_2,390,699,713,21.5,8,8,1.0,4,4,1,309,14,323
p_135,0,10,e_1,466,683,715,25.0,7,7,3.5,4,6,1,217,32,249
p_187,0,12,e_2,389,699,739,22.0,8,8,1.0,4,4,1,310,40,350
p_185,0,10,e_2,391,797,829,21.5,8,8,0.5,4,4,1,406,32,438
p_184,0,12,e_2,392,797,837,21.5,8,8,0.5,4,4,1,405,40,445
p_300,0,4,e_0,8,9,25,0.0,0,0,0.0,3,0,0,1,16,17
p_297,0,6,e_3,15,16,38,0.0,0,0,0.0,3,0,0,1,22,23
p_296,0,4,e_0,28,43,59,10.5,1,1,2.0,3,0,0,15,16,31
p_289,0,4,e_0,43,43,59,3.0,0,0,0.0,3,0,0,0,16,16
p_292,0,6,e_0,38,43,67,3.0,0,0,0.5,4,0,1,5,24,29
p_290,0,6,e_0,40,43,67,3.0,0,0,0.5,4,0,1,3,24,27
p_285,0,4,e_3,53,65,79,2.0,1,0,2.0,4,0,1,12,14,26
p_284,0,4,e_3,54,65,79,1.5,1,0,1.5,4,0,1,11,14,25
p_294,0,12,e_0,31,43,87,10.0,1,1,2.0,4,0,1,12,44,56
p_293,0,12,e_0,33,43,87,9.5,1,1,1.5,4,0,1,10,44,54
p_288,0,8,e_3,44,65,93,3.0,0,0,3.0,3,0,0,21,28,49
p_278,0,2,e_1,77,106,114,16.0,5,5,4.5,4,1,1,29,8,37
p_277,0,6,e_1,82,106,128,15.5,4,4,4.0,4,1,1,24,22,46
p_274,0,8,e_1,88,106,136,15.0,4,4,3.0,4,1,1,18,30,48
p_273,0,4,e_0,110,125,139,11.5,3,3,2.5,4,2,0,15,14,29
p_280,0,14,e_1,75,106,156,16.5,5,5,5.0,4,1,1,31,50,81
p_275,0,14,e_1,86,106,156,15.0,4,4,3.5,4,1,1,20,50,70
p_272,0,10,e_0,113,125,159,11.0,3,3,2.0,4,2,1,12,34,46
p_268,0,2,e_3,144,163,171,3.0,4,0,3.0,4,3,1,19,8,27
p_265,0,4,e_3,152,163,179,2.0,4,0,2.0,4,3,1,11,16,27
p_266,0,6,e_3,151,163,187,2.0,4,0,2.0,4,3,1,12,24,36
p_254,0,4,e_1,187,200,214,19.0,6,6,2.0,4,4,1,13,14,27
p_250,0,2,e_0,217,223,231,7.5,6,0,1.0,4,4,1,6,8,14
p_256,0,10,e_1,182,200,234,19.5,7,7,3.0,4,4,1,18,34,52
p_257,0,14,e_1,169,200,248,21.0,9,9,5.0,4,4,1,31,48,79
p_249,0,6,e_3,239,263,285,4.0,6,0,4.0,4,6,0,24,22,46
p_246,0,10,e_3,262,263,299,0.0,6,6,0.0,3,6,0,1,36,37
p_242,0,8,e_1,277,300,326,20.5,8,8,4.0,4,6,1,23,26,49
p_244,0,12,e_1,271,300,340,21.0,8,8,5.0,4,6,1,29,40,69
p_235,0,8,e_0,308,319,347,15.5,6,6,1.5,4,5,1,11,28,39
p_234,0,8,e_0,310,319,347,15.5,6,6,1.5,4,5,1,9,28,37
p_226,0,2,e_3,329,363,371,5.5,7,0,5.5,4,6,1,34,8,42
p_228,0,4,e_3,325,363,379,6.0,7,0,6.0,4,6,1,38,16,54
p_205,0,2,e_2,362,390,398,0.0,6,6,4.5,4,1,1,28,8,36
p_227,0,12,e_3,327,363,405,6.0,7,0,6.0,4,6,1,36,42,78
p_200,0,4,e_2,367,390,406,25.5,10,10,4.0,4,1,1,23,16,39
p_196,0,4,e_2,371,390,406,25.0,9,9,3.0,4,1,1,19,16,35
p_186,0,4,e_1,390,398,414,22.5,8,8,1.0,4,6,0,8,16,24
p_194,0,6,e_2,373,390,414,25.0,9,9,2.5,4,1,1,17,24,41
p_197,0,10,e_2,370,390,428,25.0,10,10,3.5,4,1,1,20,38,58
p_203,0,12,e_2,364,390,436,26.0,10,10,4.5,4,1,1,26,46,72
p_204,0,14,e_2,363,390,444,26.0,10,10,4.5,4,1,1,27,54,81
p_223,0,2,e_3,336,463,473,4.5,7,0,4.5,4,6,1,127,10,137
p_137,0,4,e_2,464,496,512,26.0,8,8,5.0,4,4,0,32,16,48
p_192,0,8,e_2,375,496,526,24.5,9,9,2.5,4,1,1,121,30,151
p_189,0,8,e_2,382,496,526,24.0,8,8,1.5,4,1,1,114,30,144
p_185,0,10,e_1,391,496,528,22.0,8,8,1.0,4,6,1,105,32,137
p_191,0,10,e_2,376,496,534,24.5,9,9,2.0,4,1,1,120,38,158
p_187,0,12,e_2,389,496,542,22.5,8,8,0.0,4,1,1,107,46,153
p_221,0,6,e_3,339,561,583,4.0,7,0,4.0,4,6,1,222,22,244
p_184,0,12,e_1,392,592,632,22.0,8,8,1.0,4,6,1,200,40,240
p_135,0,10,e_2,466,600,634,26.0,8,8,5.0,4,4,1,134,34,168
p_133,0,12,e_2,469,600,642,25.5,8,8,4.5,4,4,1,131,42,173
p_220,0,6,e_3,341,659,679,3.5,7,0,3.5,4,6,1,318,20,338
p_131,0,14,e_2,471,700,744,25.5,8,8,4.0,4,4,1,229,44,273
p_300,0,4,e_0,8,9,25,0.0,0,0,0.0,3,0,0,1,16,17
p_297,0,6,e_3,15,15,37,0.0,0,0,0.0,3,0,0,0,22,22
p_296,0,4,e_0,28,43,59,10.5,1,1,2.0,3,0,0,15,16,31
p_289,0,4,e_0,43,43,59,3.0,0,0,0.0,3,0,0,0,16,16
p_292,0,6,e_0,38,43,67,3.0,0,0,0.5,4,0,1,5,24,29
p_290,0,6,e_0,40,43,67,3.0,0,0,0.5,4,0,1,3,24,27
p_285,0,4,e_3,53,65,79,2.0,1,0,2.0,4,0,1,12,14,26
p_284,0,4,e_3,54,65,79,2.0,1,0,2.0,4,0,1,11,14,25
p_294,0,12,e_0,31,43,87,10.0,1,1,2.0,4,0,1,12,44,56
p_293,0,12,e_0,33,43,87,9.5,1,1,1.5,4,0,1,10,44,54
p_288,0,8,e_3,44,65,93,3.0,0,0,3.0,3,0,0,21,28,49
p_278,0,2,e_1,77,106,114,16.5,5,5,5.0,4,1,1,29,8,37
p_277,0,6,e_1,82,106,128,16.0,4,4,4.0,4,1,1,24,22,46
p_274,0,8,e_1,88,106,136,14.5,4,4,3.0,4,1,1,18,30,48
p_273,0,4,e_0,110,125,139,11.5,3,3,2.5,4,2,0,15,14,29
p_280,0,14,e_1,75,106,156,16.5,5,5,5.0,4,1,1,31,50,81
p_275,0,14,e_1,86,106,156,15.0,4,4,3.5,4,1,1,20,50,70
p_272,0,10,e_0,113,125,159,11.0,3,3,2.0,4,2,1,12,34,46
p_268,0,2,e_3,144,163,171,3.0,4,0,3.0,4,3,1,19,8,27
p_265,0,4,e_3,152,163,179,1.5,4,0,1.5,4,3,1,11,16,27
p_266,0,6,e_3,151,163,187,2.0,4,0,2.0,4,3,1,12,24,36
p_254,0,4,e_2,187,201,215,19.0,6,6,2.0,4,1,1,14,14,28
p_250,0,2,e_0,217,223,231,7.5,6,0,1.0,4,4,1,6,8,14
p_256,0,10,e_2,182,201,235,20.0,7,7,3.0,4,1,1,19,34,53
p_257,0,14,e_2,169,201,249,21.5,9,9,5.0,4,1,1,32,48,80
p_249,0,6,e_3,239,263,283,4.0,6,0,4.0,4,6,0,24,20,44
p_246,0,10,e_3,262,263,297,0.0,7,0,0.0,4,6,1,1,34,35
p_242,0,8,e_1,277,294,320,20.0,8,8,3.0,4,4,1,17,26,43
p_244,0,12,e_1,271,294,334,21.0,8,8,3.5,4,4,1,23,40,63
p_235,0,8,e_0,308,319,347,15.5,6,6,2.0,4,5,1,11,28,39
p_234,0,8,e_0,310,319,347,15.0,6,6,1.5,4,5,1,9,28,37
p_226,0,2,e_3,329,361,371,5.5,7,0,5.5,4,6,1,32,10,42
p_228,0,4,e_3,325,361,379,6.0,7,0,6.0,4,6,1,36,18,54
p_205,0,2,e_1,362,392,402,26.0,11,11,5.0,4,5,0,30,10,40
p_227,0,12,e_3,327,361,405,5.5,7,0,5.5,4,6,1,34,44,78
p_200,0,4,e_1,367,392,410,25.5,10,10,4.0,4,5,1,25,18,43
p_182,0,2,e_0,397,417,427,21.0,8,8,3.0,4,7,0,20,10,30
p_203,0,12,e_1,364,392,436,26.0,10,10,4.5,4,5,1,28,44,72
p_184,0,12,e_2,392,397,437,22.0,8,8,0.5,4,5,1,5,40,45
p_204,0,14,e_2,363,397,445,26.0,10,10,5.5,4,5,0,34,48,82
p_223,0,2,e_3,336,463,471,4.0,7,0,4.0,4,6,1,127,8,135
p_196,0,4,e_1,371,494,508,25.0,9,9,3.5,4,5,1,123,14,137
p_108,0,6,e_2,496,497,519,21.0,7,7,0.0,3,6,0,1,22,23
p_197,0,10,e_1,370,494,528,25.0,9,9,3.5,4,5,1,124,34,158
p_221,0,6,e_3,339,559,581,3.5,7,0,3.5,4,6,1,220,22,242
p_45,0,2,e_2,595,595,605,21.0,7,7,0.0,3,6,0,0,10,10
p_194,0,6,e_1,373,592,612,25.0,9,9,3.0,4,5,1,219,20,239
p_48,0,4,e_2,592,595,613,21.5,7,7,0.5,4,6,1,3,18,21
p_46,0,4,e_2,594,595,613,21.0,7,7,0.0,4,6,1,1,18,19
p_220,0,6,e_3,341,657,677,3.5,7,0,3.5,4,6,1,316,20,336
p_18,0,10,e_2,766,789,821,24.0,7,7,4.0,4,6,0,23,32,55
p_5,0,8,e_2,883,885,911,20.0,7,7,0.0,4,6,1,2,26,28
p_300,0,4,e_0,8,9,25,0.0,0,0,0.0,3,0,0,1,16,17
p_297,0,6,e_3,15,16,38,0.0,0,0,0.0,3,0,0,1,22,23
p_296,0,4,e_0,28,43,57,10.5,1,1,2.0,3,0,0,15,14,29
p_292,0,6,e_0,38,43,65,3.0,0,0,1.0,4,0,1,5,22,27
p_290,0,6,e_0,40,43,65,3.0,0,0,0.5,4,0,1,3,22,25
p_289,0,4,e_3,43,64,78,3.0,0,0,3.0,3,0,0,21,14,35
p_285,0,4,e_3,53,64,78,1.5,1,0,1.5,4,0,1,11,14,25
p_284,0,4,e_3,54,64,78,1.5,1,0,1.5,4,0,1,10,14,24
p_294,0,12,e_0,31,43,85,10.0,1,1,2.0,4,0,1,12,42,54
p_293,0,12,e_0,33,43,85,10.0,1,1,1.5,4,0,1,10,42,52
p_288,0,8,e_3,44,64,92,3.0,1,0,3.0,4,0,1,20,28,48
p_278,0,2,e_1,77,105,113,2.0,4,4,4.5,4,1,1,28,8,36
p_277,0,6,e_1,82,105,127,15.5,4,4,3.5,4,1,1,23,22,45
p_274,0,8,e_1,88,105,135,14.5,4,4,2.5,4,1,1,17,30,47
p_273,0,4,e_0,110,123,139,11.5,3,3,2.0,4,2,0,13,16,29
p_280,0,14,e_1,75,105,155,16.5,5,5,5.0,4,1,1,30,50,80
p_275,0,14,e_1,86,105,155,15.0,4,4,3.0,4,1,1,19,50,69
p_272,0,10,e_0,113,123,159,11.0,3,3,1.5,4,2,1,10,36,46
p_268,0,2,e_3,144,162,170,3.0,4,0,3.0,4,3,1,18,8,26
p_265,0,4,e_3,152,162,178,1.5,4,0,1.5,4,3,1,10,16,26
p_266,0,6,e_3,151,162,186,1.5,4,0,1.5,4,3,1,11,24,35
p_254,0,4,e_1,187,199,213,19.0,6,6,2.0,4,4,1,12,14,26
p_250,0,2,e_0,217,223,231,7.5,6,0,1.0,4,4,1,6,8,14
p_256,0,10,e_1,182,199,233,19.5,7,7,3.0,4,4,1,17,34,51
p_257,0,14,e_1,169,199,247,21.0,8,8,5.0,4,4,1,30,48,78
p_249,0,6,e_3,239,262,282,4.0,6,0,4.0,4,6,0,23,20,43
p_246,0,10,e_1,262,299,331,22.0,7,7,6.0,4,6,0,37,32,69
p_244,0,12,e_1,271,299,339,21.0,7,7,4.5,4,6,1,28,40,68
p_235,0,8,e_0,308,319,345,15.0,6,6,1.5,4,5,1,11,26,37
p_234,0,8,e_0,310,319,345,14.5,6,6,1.5,4,5,1,9,26,35
p_226,0,2,e_3,329,358,368,4.5,7,0,4.5,4,6,1,29,10,39
p_228,0,4,e_3,325,358,376,5.5,7,0,5.5,4,6,1,33,18,51
p_227,0,12,e_3,327,358,402,5.0,7,0,5.0,4,6,1,31,44,75
p_242,0,8,e_1,277,397,425,19.5,7,7,3.5,4,6,1,120,28,148
p_187,0,12,e_2,389,390,430,22.0,8,8,0.0,3,1,0,1,40,41
p_223,0,2,e_3,336,460,470,3.5,7,0,3.5,4,6,1,124,10,134
p_92,0,4,e_2,525,562,578,5.5,7,0,6.0,4,1,1,37,16,53
p_99,0,6,e_2,514,562,586,7.5,7,0,7.5,5,1,1,48,24,72
p_94,0,6,e_2,519,562,586,6.5,7,0,7.0,4,1,1,43,24,67
p_101,0,8,e_2,511,562,594,7.0,7,7,7.0,5,1,1,51,32,83
p_91,0,12,e_2,526,562,608,5.5,7,0,6.0,4,1,1,36,46,82
p_95,0,14,e_2,518,562,616,6.5,7,0,7.5,4,1,1,44,54,98
p_86,0,2,e_2,544,660,668,2.0,7,0,3.0,4,1,1,116,8,124
p_87,0,8,e_2,539,660,688,3.0,7,0,4.0,4,1,1,121,28,149
p_83,0,8,e_2,549,660,688,1.5,7,0,2.0,4,1,1,111,28,139
p_84,0,12,e_2,546,660,702,2.0,7,0,2.5,4,1,1,114,42,156
p_82,0,14,e_2,550,760,804,1.5,7,0,2.0,4,1,1,210,44,254
p_81,0,14,e_2,551,760,804,1.0,7,0,1.5,4,1,1,209,44,253
p_79,0,14,e_2,553,760,804,1.0,7,0,1.5,4,1,1,207,44,251
p_76,0,6,e_2,558,856,876,26.0,7,7,0.5,4,1,1,298,20,318
p_78,0,12,e_2,556,856,896,1.5,7,0,1.0,4,1,1,300,40,340
p_300,0,4,e_0,8,9,25,0.0,0,0,0.0,3,0,0,1,16,17
p_297,0,6,e_3,15,16,38,0.0,0,0,0.0,3,0,0,1,22,23
p_296,0,4,e_0,28,43,57,10.5,1,1,2.0,3,0,0,15,14,29
p_292,0,6,e_0,38,43,65,3.0,0,0,0.5,4,0,1,5,22,27
p_290,0,6,e_0,40,43,65,3.0,0,0,0.5,4,0,1,3,22,25
p_289,0,4,e_3,43,64,78,3.0,0,0,3.0,3,0,0,21,14,35
p_285,0,4,e_3,53,64,78,2.0,1,0,2.0,4,0,1,11,14,25
p_284,0,4,e_3,54,64,78,1.5,1,0,1.5,4,0,1,10,14,24
p_294,0,12,e_0,31,43,85,10.0,1,1,2.0,4,0,1,12,42,54
p_293,0,12,e_0,33,43,85,10.0,1,1,1.5,4,0,1,10,42,52
p_288,0,8,e_3,44,64,92,3.0,1,0,3.0,4,0,1,20,28,48
p_278,0,2,e_1,77,105,113,2.0,4,4,4.5,4,1,1,28,8,36
p_277,0,6,e_1,82,105,127,15.5,4,4,4.0,4,1,1,23,22,45
p_274,0,8,e_1,88,105,135,14.5,4,4,2.5,4,1,1,17,30,47
p_273,0,4,e_0,110,123,139,11.0,3,3,2.0,4,2,0,13,16,29
p_280,0,14,e_1,75,105,155,16.5,5,5,5.0,4,1,1,30,50,80
p_275,0,14,e_1,86,105,155,15.0,4,4,3.0,4,1,1,19,50,69
p_272,0,10,e_0,113,123,159,10.5,3,3,1.5,4,2,1,10,36,46
p_268,0,2,e_3,144,162,170,3.0,4,0,3.0,4,3,1,18,8,26
p_265,0,4,e_3,152,162,178,1.5,4,0,1.5,4,3,1,10,16,26
p_266,0,6,e_3,151,162,186,2.0,4,0,2.0,4,3,1,11,24,35
p_254,0,4,e_1,187,199,213,19.0,6,6,2.0,4,4,1,12,14,26
p_250,0,2,e_0,217,223,231,7.5,6,0,1.0,4,4,1,6,8,14
p_256,0,10,e_1,182,199,233,19.5,7,7,2.5,4,4,1,17,34,51
p_257,0,14,e_1,169,199,247,21.0,8,8,5.0,4,4,1,30,48,78
p_249,0,6,e_3,239,262,282,3.5,6,0,3.5,4,6,0,23,20,43
p_246,0,10,e_1,262,299,331,22.0,7,7,6.0,4,6,0,37,32,69
p_244,0,12,e_1,271,299,339,21.0,7,7,4.5,4,6,1,28,40,68
p_235,0,8,e_0,308,319,345,15.0,6,6,1.5,4,5,1,11,26,37
p_234,0,8,e_0,310,319,345,7.0,6,6,1.5,4,5,1,9,26,35
p_226,0,2,e_3,329,358,366,5.0,7,0,5.0,4,6,1,29,8,37
p_228,0,4,e_3,325,358,374,5.5,7,0,5.5,4,6,1,33,16,49
p_227,0,12,e_3,327,358,400,5.0,7,0,5.0,4,6,1,31,42,73
p_182,0,2,e_0,397,415,423,20.5,8,8,3.0,4,7,0,18,8,26
p_242,0,8,e_1,277,397,423,19.5,7,7,3.5,4,6,1,120,26,146
p_187,0,12,e_2,389,389,429,22.0,8,8,0.0,3,1,0,0,40,40
p_223,0,2,e_3,336,458,466,3.5,7,0,3.5,4,6,1,122,8,130
p_135,0,10,e_2,466,467,501,25.0,7,7,0.0,3,1,0,1,34,35
p_208,0,6,e_1,358,493,513,26.0,10,10,6.5,4,6,0,135,20,155
p_300,0,4,e_0,8,9,25,0.0,0,0,0.0,3,0,0,1,16,17
p_297,0,6,e_3,15,16,38,0.0,0,0,0.0,3,0,0,1,22,23
p_296,0,4,e_0,28,42,56,10.5,1,1,2.0,3,0,0,14,14,28
p_292,0,6,e_0,38,42,64,3.0,0,0,0.5,4,0,1,4,22,26
p_290,0,6,e_0,40,42,64,3.0,0,0,0.5,4,0,1,2,22,24
p_289,0,4,e_3,43,63,77,3.0,0,0,3.0,3,0,0,20,14,34
p_285,0,4,e_3,53,63,77,1.5,1,0,1.5,4,0,1,10,14,24
p_284,0,4,e_3,54,63,77,1.5,1,0,1.5,4,0,1,9,14,23
p_294,0,12,e_0,31,42,84,10.0,1,1,2.0,4,0,1,11,42,53
p_293,0,12,e_0,33,42,84,10.0,1,1,1.5,4,0,1,9,42,51
p_288,0,8,e_3,44,63,91,3.0,1,0,3.0,4,0,1,19,28,47
p_278,0,2,e_1,77,106,114,16.0,4,4,5.0,4,1,1,29,8,37
p_277,0,6,e_1,82,106,128,15.5,4,4,4.0,4,1,1,24,22,46
p_274,0,8,e_1,88,106,136,14.5,4,4,3.0,4,1,1,18,30,48
p_273,0,4,e_0,110,122,136,11.0,3,3,2.0,4,2,0,12,14,26
p_280,0,14,e_1,75,106,156,16.5,5,5,5.0,4,1,1,31,50,81
p_275,0,14,e_1,86,106,156,15.0,4,4,3.5,4,1,1,20,50,70
p_272,0,10,e_0,113,122,156,10.5,3,3,1.5,4,2,1,9,34,43
p_268,0,2,e_3,144,161,169,3.0,4,0,3.0,4,3,1,17,8,25
p_265,0,4,e_3,152,161,177,1.5,4,0,1.5,4,3,1,9,16,25
p_266,0,6,e_3,151,161,185,1.5,4,0,1.5,4,3,1,10,24,34
p_254,0,4,e_1,187,200,214,19.0,6,6,2.0,4,4,1,13,14,27
p_250,0,2,e_0,217,220,228,7.5,6,0,0.5,4,3,1,3,8,11
p_256,0,10,e_1,182,200,234,19.5,7,7,3.0,4,4,1,18,34,52
p_257,0,14,e_1,169,200,248,21.0,8,8,5.0,4,4,1,31,48,79
p_249,0,6,e_3,239,261,281,3.5,6,0,3.5,4,6,0,22,20,42
p_246,0,10,e_1,262,300,332,22.0,7,7,6.5,4,6,0,38,32,70
p_244,0,12,e_1,271,300,340,20.5,7,7,4.5,4,6,1,29,40,69
p_235,0,8,e_0,308,316,342,15.0,6,6,1.5,4,4,1,8,26,34
p_234,0,8,e_0,310,316,342,7.5,6,0,1.0,4,4,1,6,26,32
p_228,0,4,e_3,325,357,371,5.0,7,0,5.0,4,6,1,32,14,46
p_180,0,2,e_0,399,412,420,19.5,7,7,2.0,4,7,1,13,8,21
p_242,0,8,e_1,277,398,424,19.5,7,7,4.0,4,6,1,121,26,147
p_187,0,12,e_2,389,390,430,21.5,7,7,0.0,3,1,0,1,40,41
p_179,0,8,e_0,400,412,440,19.5,7,7,2.0,4,7,1,12,28,40
p_227,0,12,e_3,327,453,491,5.0,7,0,5.0,4,6,1,126,38,164
p_209,0,2,e_1,357,494,502,26.0,8,8,7.0,4,6,0,137,8,145
p_226,0,2,e_3,329,549,557,4.5,7,0,4.5,4,6,1,220,8,228
p_208,0,6,e_1,358,590,610,26.0,8,8,6.5,4,6,1,232,20,252
p_300,0,4,e_0,8,8,24,0.0,0,0,0.0,3,0,0,0,16,16
p_297,0,6,e_3,15,16,38,0.0,0,0,0.0,3,0,0,1,22,23
p_296,0,4,e_0,28,43,57,10.5,1,1,2.0,3,0,0,15,14,29
p_290,0,6,e_0,40,43,65,3.0,1,0,0.5,4,0,1,3,22,25
p_289,0,4,e_3,43,58,72,2.5,1,0,2.5,4,0,1,15,14,29
p_285,0,4,e_3,53,58,72,1.0,1,0,1.0,4,0,1,5,14,19
p_284,0,4,e_3,54,58,72,0.5,1,0,0.5,4,0,1,4,14,18
p_292,0,6,e_3,38,58,80,3.0,0,0,3.0,2,1,0,20,22,42
p_294,0,12,e_0,31,43,85,10.0,1,1,2.0,4,0,1,12,42,54
p_293,0,12,e_0,33,43,85,9.5,1,1,1.5,4,0,1,10,42,52
p_288,0,8,e_3,44,58,88,2.0,1,0,2.0,4,0,1,14,30,44
p_278,0,2,e_1,77,105,113,15.5,5,5,4.5,4,1,1,28,8,36
p_277,0,6,e_1,82,105,127,15.0,4,4,4.0,4,1,1,23,22,45
p_274,0,8,e_1,88,105,135,14.0,3,3,2.5,4,1,1,17,30,47
p_273,0,4,e_0,110,123,139,7.0,3,3,2.0,4,2,0,13,16,29
p_280,0,14,e_1,75,105,155,16.0,5,5,5.0,4,1,1,30,50,80
p_275,0,14,e_1,86,105,155,14.5,4,4,3.0,4,1,1,19,50,69
p_272,0,10,e_0,113,123,159,7.5,3,0,1.5,4,2,1,10,36,46
p_265,0,4,e_3,152,158,172,1.0,4,0,1.0,4,3,1,6,14,20
p_266,0,6,e_3,151,158,180,1.0,4,0,1.0,4,3,1,7,22,29
p_268,0,2,e_2,144,202,210,2.0,4,0,6.0,5,1,0,58,8,66
p_254,0,4,e_2,187,202,218,18.0,6,6,2.5,4,1,1,15,16,31
p_250,0,2,e_0,217,223,231,6.5,6,0,1.0,4,4,1,6,8,14
p_256,0,10,e_2,182,202,238,19.0,6,6,3.0,4,1,1,20,36,56
p_257,0,14,e_2,169,202,252,20.5,8,8,5.5,4,1,1,33,50,83
p_249,0,6,e_3,239,256,276,3.0,6,0,3.0,4,6,0,17,20,37
p_242,0,8,e_1,277,293,319,19.0,6,6,2.5,4,4,1,16,26,42
p_246,0,10,e_1,262,293,327,21.5,7,7,5.0,4,4,1,31,34,65
p_244,0,12,e_1,271,293,335,19.5,7,7,3.5,4,4,1,22,42,64
p_235,0,8,e_0,308,319,347,7.0,6,0,1.5,4,5,1,11,28,39
p_234,0,8,e_0,310,319,347,7.0,6,0,1.5,4,5,1,9,28,37
p_226,0,2,e_3,329,352,360,4.0,7,0,4.0,4,6,1,23,8,31
p_223,0,2,e_3,336,352,360,2.5,7,0,2.5,4,6,1,16,8,24
p_228,0,4,e_3,325,352,368,4.5,7,0,4.5,4,6,1,27,16,43
p_227,0,12,e_3,327,352,394,4.0,7,0,4.0,4,6,1,25,42,67
p_209,0,2,e_1,357,393,403,25.5,10,10,6.0,4,5,1,36,10,46
p_210,0,6,e_1,354,393,417,26.0,10,10,6.5,4,5,1,39,24,63
p_182,0,2,e_0,397,417,425,19.5,7,7,3.5,4,7,1,20,8,28
p_221,0,6,e_3,339,452,472,2.0,7,0,2.0,4,6,1,113,20,133
p_220,0,6,e_3,341,452,472,1.5,7,0,1.5,4,6,1,111,20,131
p_208,0,6,e_1,358,493,513,25.5,10,10,6.0,4,5,1,135,20,155
p_206,0,12,e_1,361,589,629,25.0,9,9,5.5,4,5,1,228,40,268
p_205,0,2,e_1,362,687,695,25.0,9,9,5.0,4,5,1,325,8,333
p_21,0,4,e_2,731,774,788,1.0,9,0,7.0,4,7,0,43,14,57
p_204,0,14,e_1,363,783,827,24.5,9,9,5.0,4,5,1,420,44,464
p_203,0,12,e_1,364,879,917,24.5,9,9,5.0,4,5,1,515,38,553
p_300,0,4,e_0,8,9,25,0.0,0,0,0.0,3,0,0,1,16,17
p_297,0,6,e_3,15,16,38,0.0,0,0,0.0,3,0,0,1,22,23
p_296,0,4,e_0,28,42,56,10.5,1,1,2.0,3,0,0,14,14,28
p_290,0,6,e_0,40,42,64,3.0,1,0,0.5,4,0,1,2,22,24
p_289,0,4,e_3,43,58,74,2.5,1,0,2.5,4,0,1,15,16,31
p_285,0,4,e_3,53,58,74,1.0,1,0,1.0,4,0,1,5,16,21
p_284,0,4,e_3,54,58,74,0.5,1,0,0.5,4,0,1,4,16,20
p_292,0,6,e_3,38,58,82,3.0,0,0,3.0,2,1,0,20,24,44
p_294,0,12,e_0,31,42,84,10.0,1,1,1.5,4,0,1,11,42,53
p_293,0,12,e_0,33,42,84,9.5,1,1,1.5,4,0,1,9,42,51
p_288,0,8,e_3,44,58,90,2.0,1,0,2.0,4,0,1,14,32,46
p_278,0,2,e_1,77,105,113,15.5,5,5,4.5,4,1,1,28,8,36
p_277,0,6,e_1,82,105,127,15.0,4,4,4.0,4,1,1,23,22,45
p_274,0,8,e_1,88,105,135,14.0,4,4,2.5,4,1,1,17,30,47
p_273,0,4,e_0,110,122,138,11.0,3,3,2.0,4,2,0,12,16,28
p_280,0,14,e_1,75,105,155,16.0,5,5,5.0,4,1,1,30,50,80
p_275,0,14,e_1,86,105,155,14.5,4,4,3.0,4,1,1,19,50,69
p_272,0,10,e_0,113,122,158,7.0,3,3,1.5,4,2,1,9,36,45
p_268,0,2,e_3,144,160,168,2.5,4,0,2.5,4,3,1,16,8,24
p_265,0,4,e_3,152,160,176,1.5,4,0,1.5,4,3,1,8,16,24
p_266,0,6,e_3,151,160,184,1.5,4,0,1.5,4,3,1,9,24,33
p_254,0,4,e_2,187,201,215,19.0,5,5,2.5,4,2,1,14,14,28
p_250,0,2,e_0,217,222,230,7.0,5,0,0.5,4,3,1,5,8,13
p_256,0,10,e_2,182,201,235,19.5,6,6,3.0,4,2,1,19,34,53
p_257,0,14,e_2,169,201,249,21.0,7,7,5.0,4,2,1,32,48,80
p_249,0,6,e_3,239,260,280,3.5,5,0,3.5,4,5,0,21,20,41
p_242,0,8,e_1,277,293,319,19.5,6,6,2.5,4,3,1,16,26,42
p_246,0,10,e_1,262,293,327,22.0,6,6,5.0,4,3,1,31,34,65
p_244,0,12,e_1,271,293,335,20.5,6,6,3.5,4,3,1,22,42,64
p_235,0,8,e_0,308,318,344,14.5,5,5,1.5,4,4,1,10,26,36
p_234,0,8,e_0,310,318,344,7.5,5,0,1.5,4,4,1,8,26,34
p_226,0,2,e_3,329,356,364,4.5,6,0,4.5,4,5,1,27,8,35
p_223,0,2,e_3,336,356,364,3.5,6,0,3.5,4,5,1,20,8,28
p_228,0,4,e_3,325,356,372,5.0,6,0,5.0,4,5,1,31,16,47
p_227,0,12,e_3,327,356,398,4.5,6,0,4.5,4,5,1,29,42,71
p_209,0,2,e_1,357,393,401,26.0,9,9,6.0,4,5,1,36,8,44
p_208,0,6,e_1,358,393,415,26.0,9,9,6.0,4,5,1,35,22,57
p_182,0,2,e_0,397,414,422,20.0,6,6,2.5,4,7,1,17,8,25
p_206,0,12,e_1,361,393,435,25.5,9,9,5.0,4,5,1,32,42,74
p_221,0,6,e_3,339,456,476,2.5,6,0,2.5,4,5,1,117,20,137
p_220,0,6,e_3,341,456,476,2.5,6,0,2.5,4,5,1,115,20,135
p_205,0,2,e_1,362,493,501,25.5,9,9,5.0,4,5,1,131,8,139
p_203,0,12,e_1,364,493,533,25.0,8,8,4.5,4,5,1,129,40,169
p_204,0,14,e_1,363,493,541,25.0,8,8,5.0,4,5,1,130,48,178
p_200,0,4,e_1,367,593,607,24.5,8,8,4.0,4,5,1,226,14,240
p_21,0,4,e_2,731,771,785,1.5,8,0,6.5,4,6,0,40,14,54
p_20,0,14,e_2,734,771,817,1.0,8,0,6.0,4,6,1,37,46,83
p_9,0,2,e_2,846,869,877,24.0,7,7,4.0,4,6,0,23,8,31
p_300,0,4,e_0,8,8,24,0.0,0,0,0.0,3,0,0,0,16,16
p_297,0,6,e_3,15,15,37,0.0,0,0,0.0,3,0,0,0,22,22
p_296,0,4,e_0,28,42,56,10.5,1,1,2.0,3,0,0,14,14,28
p_292,0,6,e_0,38,42,64,3.0,0,0,0.5,4,0,1,4,22,26
p_290,0,6,e_0,40,42,64,3.0,0,0,0.0,4,0,1,2,22,24
p_289,0,4,e_3,43,64,78,3.0,0,0,3.0,3,0,0,21,14,35
p_285,0,4,e_3,53,64,78,1.5,1,0,1.5,4,0,1,11,14,25
p_284,0,4,e_3,54,64,78,1.5,1,0,1.5,4,0,1,10,14,24
p_294,0,12,e_0,31,42,84,10.0,1,1,2.0,4,0,1,11,42,53
p_293,0,12,e_0,33,42,84,9.5,1,1,1.5,4,0,1,9,42,51
p_288,0,8,e_3,44,64,92,3.0,1,1,3.0,3,0,1,20,28,48
p_278,0,2,e_1,77,105,113,2.0,4,4,4.5,4,1,1,28,8,36
p_277,0,6,e_1,82,105,127,15.5,4,4,3.5,4,1,1,23,22,45
p_274,0,8,e_1,88,105,135,14.5,4,4,3.0,4,1,1,17,30,47
p_273,0,4,e_0,110,122,138,11.0,3,3,2.0,4,2,0,12,16,28
p_280,0,14,e_1,75,105,155,16.5,5,5,5.0,4,1,1,30,50,80
p_275,0,14,e_1,86,105,155,15.0,4,4,3.0,4,1,1,19,50,69
p_272,0,10,e_0,113,122,158,11.0,3,3,1.5,4,2,1,9,36,45
p_268,0,2,e_3,144,162,170,3.0,4,0,3.0,4,3,1,18,8,26
p_265,0,4,e_3,152,162,178,1.5,4,0,1.5,4,3,1,10,16,26
p_266,0,6,e_3,151,162,186,2.0,4,0,2.0,4,3,1,11,24,35
p_254,0,4,e_1,187,199,213,19.0,6,6,2.0,4,4,1,12,14,26
p_250,0,2,e_0,217,222,230,7.5,6,0,1.0,4,4,1,5,8,13
p_256,0,10,e_1,182,199,233,19.5,7,7,3.0,4,4,1,17,34,51
p_257,0,14,e_1,169,199,247,21.0,9,9,5.0,4,4,1,30,48,78
p_249,0,6,e_3,239,262,282,3.5,6,0,3.5,4,6,0,23,20,43
p_246,0,10,e_1,262,299,331,0.0,6,6,6.0,4,6,0,37,32,69
p_244,0,12,e_1,271,299,339,20.5,7,7,4.5,4,6,1,28,40,68
p_235,0,8,e_0,308,318,346,15.0,6,6,1.5,4,5,1,10,28,38
p_234,0,8,e_0,310,318,346,14.5,6,6,1.5,4,5,1,8,28,36
p_226,0,2,e_3,329,358,366,5.0,7,0,5.0,4,6,1,29,8,37
p_228,0,4,e_3,325,358,374,5.5,7,0,5.5,4,6,1,33,16,49
p_227,0,12,e_3,327,358,400,5.0,7,0,5.0,4,6,1,31,42,73
p_242,0,8,e_1,277,397,423,20.0,7,7,3.5,4,6,1,120,26,146
p_182,0,2,e_0,397,416,424,20.5,8,8,3.0,4,7,0,19,8,27
p_223,0,2,e_3,336,458,466,3.5,7,0,3.5,4,6,1,122,8,130
p_137,0,4,e_2,464,484,498,25.5,8,8,3.5,4,1,1,20,14,34
p_209,0,2,e_1,357,493,501,0.0,6,6,6.5,4,6,0,136,8,144
p_141,0,6,e_2,458,484,506,0.0,7,7,4.5,4,1,1,26,22,48
p_148,0,8,e_2,449,484,514,1.5,8,0,5.5,4,1,1,35,30,65
p_140,0,8,e_2,459,484,514,26.0,8,8,4.0,4,1,1,25,30,55
p_139,0,10,e_2,461,484,522,25.5,8,8,3.5,4,1,1,23,38,61
p_135,0,10,e_2,466,484,522,25.0,7,7,3.0,4,1,1,18,38,56
p_208,0,6,e_1,358,589,609,26.0,10,10,6.5,4,6,1,231,20,251
p_133,0,12,e_2,469,586,624,24.5,7,7,2.5,4,1,1,117,38,155
p_131,0,14,e_2,471,586,632,24.5,7,7,2.0,4,1,1,115,46,161
p_127,0,10,e_2,475,684,716,23.5,7,7,1.5,4,1,1,209,32,241
p_126,0,12,e_2,476,780,818,23.5,7,7,1.5,4,1,1,304,38,342
p_125,0,14,e_2,477,876,920,23.5,7,7,1.0,4,1,1,399,44,443
p_300,0,4,e_0,8,8,24,0.0,0,0,0.0,3,0,0,0,16,16
p_297,0,6,e_3,15,16,38,0.0,0,0,0.0,3,0,0,1,22,23
p_296,0,4,e_0,28,43,59,10.5,1,1,2.0,3,0,0,15,16,31
p_289,0,4,e_0,43,43,59,3.0,0,0,0.0,3,0,0,0,16,16
p_292,0,6,e_0,38,43,67,3.0,0,0,0.5,4,0,1,5,24,29
p_290,0,6,e_0,40,43,67,3.0,0,0,0.5,4,0,1,3,24,27
p_285,0,4,e_3,53,65,79,2.0,1,0,2.0,4,0,1,12,14,26
p_284,0,4,e_3,54,65,79,1.5,1,0,1.5,4,0,1,11,14,25
p_294,0,12,e_0,31,43,87,10.0,1,1,2.0,4,0,1,12,44,56
p_293,0,12,e_0,33,43,87,10.0,1,1,1.5,4,0,1,10,44,54
p_288,0,8,e_3,44,65,93,3.0,0,0,3.0,3,0,0,21,28,49
p_278,0,2,e_1,77,105,113,16.5,5,5,4.5,4,1,1,28,8,36
p_277,0,6,e_1,82,105,127,15.5,4,4,3.5,4,1,1,23,22,45
p_274,0,8,e_1,88,105,135,15.0,4,4,3.0,4,1,1,17,30,47
p_273,0,4,e_0,110,125,139,11.5,3,3,2.5,4,2,0,15,14,29
p_280,0,14,e_1,75,105,155,16.5,5,5,5.0,4,1,1,30,50,80
p_275,0,14,e_1,86,105,155,15.0,4,4,3.0,4,1,1,19,50,69
p_272,0,10,e_0,113,125,159,11.0,3,3,2.0,4,2,1,12,34,46
p_268,0,2,e_3,144,163,171,3.0,4,0,3.0,4,3,1,19,8,27
p_265,0,4,e_3,152,163,179,2.0,4,0,2.0,4,3,1,11,16,27
p_266,0,6,e_3,151,163,187,2.0,4,0,2.0,4,3,1,12,24,36
p_254,0,4,e_2,187,202,216,19.0,6,6,2.5,4,1,1,15,14,29
p_250,0,2,e_0,217,223,231,7.5,6,0,1.0,4,4,1,6,8,14
p_256,0,10,e_2,182,202,236,20.0,7,7,3.5,4,1,1,20,34,54
p_257,0,14,e_2,169,202,250,21.0,9,9,5.5,4,1,1,33,48,81
p_249,0,6,e_3,239,263,283,4.0,6,0,4.0,4,6,0,24,20,44
p_246,0,10,e_3,262,263,297,0.0,7,0,0.0,4,6,1,1,34,35
p_242,0,8,e_1,277,293,319,20.0,8,8,2.5,4,4,1,16,26,42
p_244,0,12,e_1,271,293,333,21.0,8,8,3.5,4,4,1,22,40,62
p_235,0,8,e_0,308,319,345,15.5,6,6,1.5,4,5,1,11,26,37
p_234,0,8,e_0,310,319,345,15.0,6,6,1.5,4,5,1,9,26,35
p_226,0,2,e_3,329,361,369,5.5,7,0,5.5,4,6,1,32,8,40
p_228,0,4,e_3,325,361,377,6.0,7,0,6.0,4,6,1,36,16,52
p_205,0,2,e_1,362,391,399,26.0,10,10,4.5,4,5,1,29,8,37
p_227,0,12,e_3,327,361,403,5.5,7,0,5.5,4,6,1,34,42,76
p_182,0,2,e_2,397,398,408,21.0,8,8,0.0,4,6,1,1,10,11
p_180,0,2,e_0,399,415,423,20.5,8,8,2.5,4,7,0,16,8,24
p_206,0,12,e_1,361,391,431,0.0,6,6,5.0,4,5,0,30,40,70
p_203,0,12,e_1,364,391,431,26.0,10,10,4.5,4,5,1,27,40,67
p_185,0,10,e_2,391,398,434,22.0,8,8,1.0,4,6,0,7,36,43
p_204,0,14,e_1,363,391,439,26.0,10,10,4.5,4,5,1,28,48,76
p_184,0,12,e_2,392,398,442,22.0,8,8,1.0,4,6,1,6,44,50
p_179,0,8,e_0,400,415,443,20.5,8,8,2.5,4,7,1,15,28,43
p_223,0,2,e_3,336,461,469,4.0,7,0,4.0,4,6,1,125,8,133
p_200,0,4,e_1,367,491,507,25.0,10,10,4.0,4,5,1,124,16,140
p_108,0,6,e_2,496,500,520,20.5,7,7,0.5,4,7,1,4,20,24
p_221,0,6,e_3,339,557,577,3.5,7,0,3.5,4,6,1,218,20,238
p_48,0,4,e_2,592,596,610,20.5,7,7,0.5,4,7,1,4,14,18
p_197,0,10,e_1,370,589,623,25.0,9,9,3.5,4,5,1,219,34,253
p_49,0,14,e_2,591,596,642,21.0,7,7,1.0,4,7,1,5,46,51
p_220,0,6,e_3,341,653,673,3.5,7,0,3.5,4,6,1,312,20,332
p_196,0,4,e_1,371,687,701,25.0,9,9,3.0,4,5,1,316,14,330
p_46,0,4,e_2,594,694,708,20.5,7,7,0.0,4,7,1,100,14,114
p_45,0,2,e_2,595,790,798,20.5,7,7,0.0,4,7,1,195,8,203
p_300,0,4,e_0,8,8,24,0.0,0,0,0.0,3,0,0,0,16,16
p_297,0,6,e_3,15,16,38,0.0,0,0,0.0,3,0,0,1,22,23
p_296,0,4,e_0,28,42,56,10.5,1,1,2.0,3,0,0,14,14,28
p_290,0,6,e_0,40,42,64,3.0,1,0,0.0,4,0,1,2,22,24
p_289,0,4,e_3,43,58,74,2.5,1,0,2.5,4,0,1,15,16,31
p_285,0,4,e_3,53,58,74,0.5,1,0,0.5,4,0,1,5,16,21
p_284,0,4,e_3,54,58,74,0.5,1,0,0.5,4,0,1,4,16,20
p_292,0,6,e_3,38,58,82,3.0,0,0,3.0,2,1,0,20,24,44
p_294,0,12,e_0,31,42,84,10.0,1,1,2.0,4,0,1,11,42,53
p_293,0,12,e_0,33,42,84,10.0,1,1,1.5,4,0,1,9,42,51
p_288,0,8,e_3,44,58,90,2.5,1,0,2.5,4,0,1,14,32,46
p_278,0,2,e_1,77,106,114,16.0,5,5,5.0,4,1,1,29,8,37
p_277,0,6,e_1,82,106,128,15.0,4,4,4.0,4,1,1,24,22,46
p_274,0,8,e_1,88,106,136,14.5,4,4,3.0,4,1,1,18,30,48
p_273,0,4,e_0,110,122,138,11.0,3,3,2.0,4,2,0,12,16,28
p_280,0,14,e_1,75,106,156,16.0,5,5,5.0,4,1,1,31,50,81
p_275,0,14,e_1,86,106,156,14.5,4,4,3.5,4,1,1,20,50,70
p_272,0,10,e_0,113,122,158,7.0,3,3,1.5,4,2,1,9,36,45
p_268,0,2,e_3,144,160,168,3.5,3,0,2.5,4,3,0,16,8,24
p_265,0,4,e_3,152,160,176,1.5,4,0,1.5,4,3,1,8,16,24
p_266,0,6,e_3,151,160,184,1.5,4,0,1.5,4,3,1,9,24,33
p_254,0,4,e_2,187,201,215,18.5,5,5,2.0,4,1,1,14,14,28
p_250,0,2,e_0,217,222,230,7.0,5,0,1.0,4,4,1,5,8,13
p_256,0,10,e_2,182,201,235,19.0,6,6,3.0,4,1,1,19,34,53
p_257,0,14,e_2,169,201,249,21.0,7,7,5.5,4,1,1,32,48,80
p_249,0,6,e_3,239,260,280,3.5,5,0,3.5,4,5,0,21,20,41
p_242,0,8,e_1,277,294,320,19.5,6,6,3.0,4,4,1,17,26,43
p_246,0,10,e_1,262,294,328,22.0,6,6,5.0,4,4,1,32,34,66
p_244,0,12,e_1,271,294,336,20.5,6,6,4.0,4,4,1,23,42,65
p_235,0,8,e_0,308,318,346,14.5,5,5,1.5,4,5,1,10,28,38
p_226,0,2,e_3,329,356,364,4.5,6,0,4.5,4,5,1,27,8,35
p_223,0,2,e_3,336,356,364,3.0,6,0,3.0,4,5,1,20,8,28
p_228,0,4,e_3,325,356,372,5.0,6,0,5.0,4,5,1,31,16,47
p_234,0,8,e_3,310,356,386,7.5,5,0,7.5,4,5,0,46,30,76
p_227,0,12,e_3,327,356,400,5.0,6,0,5.0,4,5,1,29,44,73
p_209,0,2,e_1,357,394,402,26.0,10,10,6.0,4,5,1,37,8,45
p_205,0,2,e_1,362,394,402,25.5,10,10,5.5,4,5,1,32,8,40
p_210,0,6,e_2,354,395,415,0.5,6,0,6.5,4,5,0,41,20,61
p_208,0,6,e_1,358,394,416,26.0,10,10,6.0,4,5,1,36,22,58
p_206,0,12,e_1,361,394,436,25.5,10,10,5.5,4,5,1,33,42,75
p_221,0,6,e_3,339,458,478,3.0,6,0,3.0,4,5,1,119,20,139
p_220,0,6,e_3,341,458,478,2.5,6,0,2.5,4,5,1,117,20,137
p_148,0,8,e_2,449,491,517,1.5,7,0,7.0,4,5,0,42,26,68
p_203,0,12,e_1,364,494,534,25.0,9,9,5.0,4,5,1,130,40,170
p_204,0,14,e_1,363,494,542,25.0,10,10,5.0,4,5,1,131,48,179
p_200,0,4,e_1,367,594,610,24.5,9,9,4.5,4,5,1,227,16,243
p_300,0,4,e_0,8,9,25,0.0,0,0,0.0,3,0,0,1,16,17
p_297,0,6,e_3,15,16,38,0.0,0,0,0.0,3,0,0,1,22,23
p_296,0,4,e_0,28,42,56,10.5,1,1,2.0,3,0,0,14,14,28
p_292,0,6,e_0,38,42,64,3.0,0,0,0.5,4,0,1,4,22,26
p_290,0,6,e_0,40,42,64,3.0,0,0,0.0,4,0,1,2,22,24
p_289,0,4,e_3,43,63,77,3.0,0,0,3.0,3,0,0,20,14,34
p_285,0,4,e_3,53,63,77,1.5,1,0,1.5,4,0,1,10,14,24
p_284,0,4,e_3,54,63,77,1.5,1,0,1.5,4,0,1,9,14,23
p_294,0,12,e_0,31,42,84,10.0,1,1,1.5,4,0,1,11,42,53
p_293,0,12,e_0,33,42,84,9.5,1,1,1.5,4,0,1,9,42,51
p_288,0,8,e_3,44,63,91,3.0,1,0,3.0,4,0,1,19,28,47
p_278,0,2,e_1,77,106,114,16.0,4,4,4.5,4,1,1,29,8,37
p_277,0,6,e_1,82,106,128,15.5,4,4,4.0,4,1,1,24,22,46
p_274,0,8,e_1,88,106,136,14.5,4,4,3.0,4,1,1,18,30,48
p_273,0,4,e_0,110,122,138,11.0,3,3,2.0,4,2,0,12,16,28
p_280,0,14,e_1,75,106,156,16.0,5,5,5.0,4,1,1,31,50,81
p_275,0,14,e_1,86,106,156,14.5,4,4,3.0,4,1,1,20,50,70
p_272,0,10,e_0,113,122,158,10.5,3,3,1.5,4,2,1,9,36,45
p_268,0,2,e_3,144,161,169,2.5,4,0,2.5,4,3,1,17,8,25
p_265,0,4,e_3,152,161,177,1.5,4,0,1.5,4,3,1,9,16,25
p_266,0,6,e_3,151,161,185,1.5,4,0,1.5,4,3,1,10,24,34
p_254,0,4,e_2,187,202,216,19.0,6,6,2.5,4,1,1,15,14,29
p_250,0,2,e_0,217,222,230,7.5,6,0,1.0,4,4,1,5,8,13
p_256,0,10,e_2,182,202,236,19.5,7,7,3.0,4,1,1,20,34,54
p_257,0,14,e_2,169,202,250,21.0,8,8,5.5,4,1,1,33,48,81
p_249,0,6,e_3,239,261,281,3.5,6,0,3.5,4,6,0,22,20,42
p_242,0,8,e_1,277,294,320,19.5,7,7,3.0,4,4,1,17,26,43
p_246,0,10,e_1,262,294,328,22.0,7,7,5.0,4,4,0,32,34,66
p_244,0,12,e_1,271,294,336,20.5,7,7,3.5,4,4,1,23,42,65
p_235,0,8,e_0,308,318,344,15.0,6,6,1.5,4,5,1,10,26,36
p_234,0,8,e_0,310,318,344,7.5,6,0,1.5,4,5,1,8,26,34
p_226,0,2,e_3,329,357,365,4.5,7,0,4.5,4,6,1,28,8,36
p_228,0,4,e_3,325,357,373,5.5,7,0,5.5,4,6,1,32,16,48
p_227,0,12,e_3,327,357,399,5.0,7,0,5.0,4,6,1,30,42,72
p_209,0,2,e_1,357,394,402,0.0,6,6,6.0,4,5,0,37,8,45
p_205,0,2,e_1,362,394,402,25.5,10,10,5.5,4,5,1,32,8,40
p_208,0,6,e_2,358,396,416,26.0,10,10,6.0,4,5,0,38,20,58
p_206,0,12,e_1,361,394,434,25.5,10,10,5.5,4,5,1,33,40,73
p_203,0,12,e_1,364,394,434,25.0,10,10,5.0,4,5,1,30,40,70
p_204,0,14,e_1,363,394,442,25.5,10,10,5.0,4,5,1,31,48,79
p_223,0,2,e_3,336,457,465,3.5,7,0,3.5,4,6,1,121,8,129
p_137,0,4,e_2,464,492,506,25.0,7,7,4.5,4,5,1,28,14,42
p_200,0,4,e_1,367,494,508,25.0,9,9,4.5,4,5,1,127,14,141
p_141,0,6,e_2,458,492,514,26.0,8,8,5.5,4,5,1,34,22,56
p_140,0,8,e_2,459,492,522,26.0,8,8,5.5,4,5,1,33,30,63
p_139,0,10,e_2,461,492,530,25.5,8,8,5.0,4,5,1,31,38,69
p_135,0,10,e_2,466,492,530,25.0,7,7,4.0,4,5,1,26,38,64
p_197,0,10,e_1,370,590,622,24.5,9,9,4.0,4,5,1,220,32,252
p_126,0,12,e_2,476,594,632,23.5,7,7,2.5,4,5,1,118,38,156
p_196,0,4,e_1,371,686,700,24.5,9,9,4.0,4,5,1,315,14,329
p_300,0,4,e_0,8,9,25,0.0,0,0,0.0,3,0,0,1,16,17
p_297,0,6,e_3,15,16,38,0.0,0,0,0.0,3,0,0,1,22,23
p_296,0,4,e_0,28,43,57,10.5,1,1,2.0,3,0,0,15,14,29
p_290,0,6,e_0,40,43,65,3.0,1,0,0.5,4,0,1,3,22,25
p_289,0,4,e_3,43,58,72,2.5,1,0,2.5,4,0,1,15,14,29
p_285,0,4,e_3,53,58,72,0.5,1,0,0.5,4,0,1,5,14,19
p_284,0,4,e_3,54,58,72,0.5,1,0,0.5,4,0,1,4,14,18
p_292,0,6,e_3,38,58,80,3.0,0,0,3.0,2,1,0,20,22,42
p_294,0,12,e_0,31,43,85,10.0,1,1,2.0,4,0,1,12,42,54
p_293,0,12,e_0,33,43,85,9.5,1,1,1.5,4,0,1,10,42,52
p_288,0,8,e_3,44,58,88,2.5,1,0,2.5,4,0,1,14,30,44
p_278,0,2,e_1,77,106,114,15.5,5,5,4.5,4,1,1,29,8,37
p_277,0,6,e_1,82,106,128,15.0,4,4,4.0,4,1,1,24,22,46
p_274,0,8,e_1,88,106,136,14.0,3,3,3.0,4,1,1,18,30,48
p_273,0,4,e_0,110,123,137,10.5,3,3,2.0,4,2,0,13,14,27
p_280,0,14,e_1,75,106,156,15.5,5,5,5.0,4,1,1,31,50,81
p_275,0,14,e_1,86,106,156,14.5,4,4,3.0,4,1,1,20,50,70
p_272,0,10,e_0,113,123,157,7.5,3,0,1.5,4,2,1,10,34,44
p_268,0,2,e_3,144,158,166,2.5,4,0,2.5,4,3,1,14,8,22
p_265,0,4,e_3,152,158,174,1.0,4,0,1.0,4,3,1,6,16,22
p_266,0,6,e_3,151,158,182,1.0,4,0,1.0,4,3,1,7,24,31
p_254,0,4,e_2,187,202,216,18.5,6,6,2.5,4,2,1,15,14,29
p_250,0,2,e_0,217,221,229,7.0,6,0,0.5,4,4,1,4,8,12
p_256,0,10,e_2,182,202,236,19.0,6,6,3.5,4,2,1,20,34,54
p_257,0,14,e_2,169,202,250,21.0,8,8,5.5,4,2,1,33,48,81
p_249,0,6,e_3,239,258,278,3.0,6,0,3.0,4,6,0,19,20,39
p_242,0,8,e_1,277,294,320,19.0,6,6,3.0,4,3,1,17,26,43
p_246,0,10,e_1,262,294,328,21.5,7,7,5.0,4,3,1,32,34,66
p_244,0,12,e_1,271,294,336,20.0,7,7,3.5,4,3,1,23,42,65
p_235,0,8,e_0,308,317,343,7.5,6,0,1.5,4,5,1,9,26,35
p_234,0,8,e_0,310,317,343,7.0,6,0,1.0,4,5,1,7,26,33
p_226,0,2,e_3,329,354,362,4.0,7,0,4.0,4,6,1,25,8,33
p_228,0,4,e_3,325,354,370,5.0,7,0,5.0,4,6,1,29,16,45
p_227,0,12,e_3,327,354,396,4.5,7,0,4.5,4,6,1,27,42,69
p_182,0,2,e_0,397,413,421,20.0,7,7,2.5,4,7,1,16,8,24
p_223,0,2,e_3,336,454,462,3.0,7,0,3.0,4,6,1,118,8,126
p_221,0,6,e_3,339,454,476,2.5,7,0,2.5,4,6,1,115,22,137
p_220,0,6,e_3,341,552,572,2.0,7,0,2.0,4,6,1,211,20,231
p_300,0,4,e_0,8,9,25,0.0,0,0,0.0,3,0,0,1,16,17
p_297,0,6,e_3,15,16,38,0.0,0,0,0.0,3,0,0,1,22,23
p_296,0,4,e_0,28,42,56,10.5,1,1,2.0,3,0,0,14,14,28
p_292,0,6,e_0,38,42,64,3.0,0,0,0.5,4,0,1,4,22,26
p_290,0,6,e_0,40,42,64,3.0,0,0,0.0,4,0,1,2,22,24
p_289,0,4,e_3,43,63,77,3.0,0,0,3.0,3,0,0,20,14,34
p_285,0,4,e_3,53,63,77,1.5,1,0,1.5,4,0,1,10,14,24
p_284,0,4,e_3,54,63,77,1.5,1,0,1.5,4,0,1,9,14,23
p_294,0,12,e_0,31,42,84,10.0,1,1,2.0,4,0,1,11,42,53
p_293,0,12,e_0,33,42,84,10.0,1,1,1.5,4,0,1,9,42,51
p_288,0,8,e_3,44,63,91,3.0,1,0,3.0,4,0,1,19,28,47
p_278,0,2,e_1,77,106,114,2.0,4,4,5.0,4,1,1,29,8,37
p_277,0,6,e_1,82,106,128,15.5,4,4,4.0,4,1,1,24,22,46
p_274,0,8,e_1,88,106,136,14.5,4,4,3.0,4,1,1,18,30,48
p_273,0,4,e_0,110,122,138,11.0,3,3,2.0,4,2,0,12,16,28
p_280,0,14,e_1,75,106,156,16.5,5,5,5.0,4,1,1,31,50,81
p_275,0,14,e_1,86,106,156,14.5,4,4,3.0,4,1,1,20,50,70
p_272,0,10,e_0,113,122,158,7.0,3,3,1.5,4,2,1,9,36,45
p_268,0,2,e_3,144,161,169,2.5,4,0,2.5,4,3,1,17,8,25
p_265,0,4,e_3,152,161,177,1.5,4,0,1.5,4,3,1,9,16,25
p_266,0,6,e_3,151,161,185,1.5,4,0,1.5,4,3,1,10,24,34
p_254,0,4,e_1,187,200,214,19.0,6,6,2.0,4,4,1,13,14,27
p_250,0,2,e_0,217,222,230,7.5,6,0,0.5,4,3,1,5,8,13
p_256,0,10,e_1,182,200,234,19.5,7,7,3.0,4,4,1,18,34,52
p_257,0,14,e_1,169,200,248,21.0,8,8,5.0,4,4,1,31,48,79
p_249,0,6,e_3,239,261,281,3.5,6,0,3.5,4,6,0,22,20,42
p_242,0,8,e_2,277,296,322,19.5,7,7,3.0,4,1,1,19,26,45
p_246,0,10,e_2,262,296,330,22.0,7,7,5.5,4,1,1,34,34,68
p_244,0,12,e_2,271,296,338,20.5,7,7,4.0,4,1,1,25,42,67
p_235,0,8,e_0,308,318,344,14.5,6,6,1.5,4,4,1,10,26,36
p_234,0,8,e_0,310,318,344,7.5,6,0,1.0,4,4,1,8,26,34
p_226,0,2,e_3,329,357,367,4.5,7,0,4.5,4,6,1,28,10,38
p_228,0,4,e_3,325,357,375,5.0,7,0,5.0,4,6,1,32,18,50
p_227,0,12,e_3,327,357,401,5.0,7,0,5.0,4,6,1,30,44,74
p_205,0,2,e_2,362,396,404,25.5,10,10,5.5,4,5,1,34,8,42
p_200,0,4,e_2,367,396,412,25.0,9,9,5.0,4,5,1,29,16,45
p_208,0,6,e_2,358,396,420,26.0,10,10,6.0,4,5,0,38,24,62
p_182,0,2,e_0,397,414,424,20.5,8,8,3.0,4,7,1,17,10,27
p_206,0,12,e_2,361,396,440,26.0,10,10,6.0,4,5,1,35,44,79
p_203,0,12,e_2,364,396,440,25.5,10,10,5.5,4,5,1,32,44,76
p_204,0,14,e_2,363,396,448,25.5,10,10,5.5,4,5,1,33,52,85
p_223,0,2,e_3,336,459,467,3.5,7,0,3.5,4,6,1,123,8,131
p_141,0,6,e_1,458,488,508,0.0,7,7,5.0,4,6,0,30,20,50
p_196,0,4,e_2,371,500,514,24.5,9,9,4.0,4,5,1,129,14,143
p_194,0,6,e_2,373,500,522,24.5,9,9,3.5,4,5,1,127,22,149
p_139,0,10,e_1,461,488,522,26.0,8,8,4.5,4,6,1,27,34,61
p_197,0,10,e_2,370,500,536,24.5,9,9,4.5,4,5,1,130,36,166
p_221,0,6,e_3,339,555,575,3.0,7,0,3.0,4,6,1,216,20,236
p_137,0,4,e_1,464,586,600,25.5,8,8,4.0,4,6,1,122,14,136
p_192,0,8,e_2,375,600,626,24.0,8,8,3.5,4,5,1,225,26,251
p_191,0,10,e_2,376,600,634,24.0,8,8,3.0,4,5,1,224,34,258
p_220,0,6,e_3,341,651,673,2.5,7,0,2.5,4,6,1,310,22,332
p_135,0,10,e_1,466,682,714,25.0,7,7,3.5,4,6,1,216,32,248
p_189,0,8,e_2,382,698,724,23.0,8,8,2.5,4,5,1,316,26,342
p_187,0,12,e_2,389,794,832,22.0,8,8,1.0,4,5,1,405,38,443
p_186,0,4,e_2,390,890,904,22.0,8,8,1.0,4,5,1,500,14,514
p_185,0,10,e_2,391,986,1018,21.5,8,8,0.5,4,5,1,595,32,627
p_184,0,12,e_2,392,1082,1120,21.5,8,8,0.5,4,5,1,690,38,728
p_140,0,8,e_2,459,1178,1204,0.0,7,7,6.5,4,5,0,719,26,745
p_300,0,4,e_0,8,9,25,0.0,0,0,0.0,3,0,0,1,16,17
p_297,0,6,e_3,15,15,37,0.0,0,0,0.0,3,0,0,0,22,22
p_296,0,4,e_0,28,43,57,10.5,1,1,2.0,3,0,0,15,14,29
p_290,0,6,e_0,40,43,65,3.0,1,0,0.5,4,0,1,3,22,25
p_289,0,4,e_3,43,59,73,2.5,1,0,2.5,4,0,1,16,14,30
p_285,0,4,e_3,53,59,73,1.0,1,0,1.0,4,0,1,6,14,20
p_284,0,4,e_3,54,59,73,0.5,1,0,0.5,4,0,1,5,14,19
p_292,0,6,e_3,38,59,81,3.0,0,0,3.0,3,0,0,21,22,43
p_294,0,12,e_0,31,43,85,10.0,1,1,2.0,4,0,1,12,42,54
p_293,0,12,e_0,33,43,85,9.5,1,1,1.5,4,0,1,10,42,52
p_288,0,8,e_3,44,59,89,2.5,1,0,2.5,4,0,1,15,30,45
p_278,0,2,e_1,77,106,114,15.5,5,5,5.0,4,1,1,29,8,37
p_277,0,6,e_1,82,106,128,15.0,4,4,4.0,4,1,1,24,22,46
p_274,0,8,e_1,88,106,136,14.0,3,3,3.0,4,1,1,18,30,48
p_273,0,4,e_0,110,123,139,10.5,3,3,2.0,4,2,0,13,16,29
p_280,0,14,e_1,75,106,156,16.0,5,5,5.0,4,1,1,31,50,81
p_275,0,14,e_1,86,106,156,14.5,4,4,3.5,4,1,1,20,50,70
p_272,0,10,e_0,113,123,159,7.5,3,0,1.5,4,2,1,10,36,46
p_268,0,2,e_3,144,159,167,2.5,4,0,2.5,4,3,1,15,8,23
p_265,0,4,e_3,152,159,175,1.0,4,0,1.0,4,3,1,7,16,23
p_266,0,6,e_3,151,159,183,1.0,4,0,1.0,4,3,1,8,24,32
p_254,0,4,e_2,187,201,215,14.5,5,5,2.0,4,1,1,14,14,28
p_250,0,2,e_0,217,223,231,7.0,5,0,1.0,4,4,1,6,8,14
p_256,0,10,e_2,182,201,235,15.0,5,5,3.0,4,1,1,19,34,53
p_257,0,14,e_2,169,201,249,17.0,7,7,5.0,4,1,1,32,48,80
p_249,0,6,e_3,239,259,279,3.0,5,0,3.0,4,5,0,20,20,40
p_242,0,8,e_1,277,294,320,15.5,6,6,2.5,4,4,1,17,26,43
p_246,0,10,e_1,262,294,328,17.5,6,6,5.0,4,4,1,32,34,66
p_244,0,12,e_1,271,294,336,16.0,6,6,3.5,4,4,1,23,42,65
p_235,0,8,e_0,308,319,347,7.0,5,5,2.0,4,5,1,11,28,39
p_234,0,8,e_0,310,319,347,7.5,5,0,1.5,4,5,1,9,28,37
p_226,0,2,e_3,329,355,365,4.5,6,0,4.5,4,5,1,26,10,36
p_223,0,2,e_3,336,355,365,3.0,6,0,3.0,4,5,1,19,10,29
p_228,0,4,e_3,325,355,373,5.0,6,0,5.0,4,5,1,30,18,48
p_227,0,12,e_3,327,355,399,4.5,6,0,4.5,4,5,1,28,44,72
p_209,0,2,e_1,357,394,402,26.0,9,9,6.0,4,5,0,37,8,45
p_205,0,2,e_1,362,394,402,25.5,9,9,5.5,4,5,1,32,8,40
p_208,0,6,e_1,358,394,416,26.0,9,9,6.0,4,5,1,36,22,58
p_206,0,12,e_1,361,394,436,25.5,9,9,5.5,4,5,1,33,42,75
p_204,0,14,e_1,363,394,444,25.5,9,9,5.0,4,5,1,31,50,81
p_221,0,6,e_3,339,457,477,2.5,6,0,2.5,4,5,1,118,20,138
p_220,0,6,e_3,341,457,477,2.5,6,0,2.5,4,5,1,116,20,136
p_200,0,4,e_1,367,496,512,25.0,8,8,4.5,4,5,1,129,16,145
p_203,0,12,e_1,364,496,538,25.0,8,8,5.0,4,5,1,132,42,174
p_79,0,14,e_2,553,583,627,26.0,7,7,5.0,4,6,0,30,44,74
p_197,0,10,e_1,370,596,628,24.5,8,8,4.0,4,5,1,226,32,258
p_32,0,6,e_2,650,679,699,26.0,7,7,5.0,4,6,1,29,20,49
p_31,0,6,e_2,666,679,699,23.0,7,7,2.0,4,6,1,13,20,33
p_196,0,4,e_1,371,692,706,24.0,8,8,4.0,4,5,1,321,14,335
p_34,0,12,e_2,646,679,719,0.0,8,0,5.5,4,6,0,33,40,73
p_27,0,10,e_2,677,777,809,21.0,7,7,0.5,4,6,1,100,32,132
p_10,0,8,e_2,835,873,899,0.0,7,7,6.5,4,6,0,38,26,64
p_300,0,4,e_0,8,8,24,0.0,0,0,0.0,3,0,0,0,16,16
p_297,0,6,e_3,15,15,37,0.0,0,0,0.0,3,0,0,0,22,22
p_296,0,4,e_0,28,42,56,10.5,1,1,2.0,3,0,0,14,14,28
p_292,0,6,e_0,38,42,64,3.0,0,0,0.5,4,0,1,4,22,26
p_290,0,6,e_0,40,42,64,3.0,0,0,0.0,4,0,1,2,22,24
p_289,0,4,e_3,43,64,78,3.0,0,0,3.0,3,0,0,21,14,35
p_285,0,4,e_3,53,64,78,1.5,1,0,1.5,4,0,1,11,14,25
p_284,0,4,e_3,54,64,78,1.5,1,0,1.5,4,0,1,10,14,24
p_294,0,12,e_0,31,42,84,10.0,1,1,1.5,4,0,1,11,42,53
p_293,0,12,e_0,33,42,84,9.5,1,1,1.5,4,0,1,9,42,51
p_288,0,8,e_3,44,64,92,3.0,1,0,3.0,4,0,1,20,28,48
p_278,0,2,e_1,77,106,114,2.0,4,4,4.5,4,1,1,29,8,37
p_277,0,6,e_1,82,106,128,15.5,4,4,4.0,4,1,1,24,22,46
p_274,0,8,e_1,88,106,136,14.5,4,4,3.0,4,1,1,18,30,48
p_273,0,4,e_0,110,122,136,11.0,3,3,2.0,4,2,0,12,14,26
p_280,0,14,e_1,75,106,156,16.5,5,5,5.0,4,1,1,31,50,81
p_275,0,14,e_1,86,106,156,15.0,4,4,3.0,4,1,1,20,50,70
p_272,0,10,e_0,113,122,156,11.0,3,3,1.5,4,2,1,9,34,43
p_268,0,2,e_3,144,162,170,3.0,4,0,3.0,4,3,1,18,8,26
p_265,0,4,e_3,152,162,178,1.5,4,0,1.5,4,3,1,10,16,26
p_266,0,6,e_3,151,162,186,1.5,4,0,1.5,4,3,1,11,24,35
p_254,0,4,e_2,187,201,215,19.0,6,6,2.0,4,1,1,14,14,28
p_250,0,2,e_0,217,220,228,7.5,6,0,0.5,4,3,1,3,8,11
p_256,0,10,e_2,182,201,235,19.5,7,7,3.0,4,1,1,19,34,53
p_257,0,14,e_2,169,201,249,21.0,9,9,5.5,4,1,1,32,48,80
p_249,0,6,e_3,239,262,282,3.5,6,0,3.5,4,6,0,23,20,43
p_242,0,8,e_1,277,294,320,20.0,7,7,3.0,4,4,1,17,26,43
p_246,0,10,e_1,262,294,328,22.0,7,7,5.0,4,4,1,32,34,66
p_244,0,12,e_1,271,294,336,21.0,7,7,4.0,4,4,1,23,42,65
p_235,0,8,e_0,308,316,342,15.0,6,6,1.5,4,4,1,8,26,34
p_234,0,8,e_0,310,316,342,14.5,6,6,1.0,4,4,1,6,26,32
p_228,0,4,e_3,325,358,372,5.5,7,0,5.5,4,6,1,33,14,47
p_227,0,12,e_3,327,358,398,5.0,7,0,5.0,4,6,1,31,40,71
p_205,0,2,e_1,362,394,402,25.5,9,9,5.5,4,5,1,32,8,40
p_208,0,6,e_1,358,394,416,26.0,9,9,6.0,4,5,0,36,22,58
p_182,0,2,e_0,397,412,420,20.0,7,7,2.5,4,7,1,15,8,23
p_206,0,12,e_1,361,394,436,25.5,9,9,5.5,4,5,1,33,42,75
p_203,0,12,e_1,364,394,436,25.0,9,9,5.0,4,5,1,30,42,72
p_204,0,14,e_1,363,394,444,25.5,9,9,5.0,4,5,1,31,50,81
p_226,0,2,e_3,329,456,464,5.0,7,0,5.0,4,6,1,127,8,135
p_200,0,4,e_1,367,496,510,24.5,9,9,4.5,4,5,1,129,14,143
p_180,0,2,e_0,399,508,516,20.0,7,7,2.0,4,7,1,109,8,117
p_197,0,10,e_1,370,496,530,24.5,9,9,4.0,4,5,1,126,34,160
p_76,0,6,e_2,558,583,603,25.0,7,7,4.0,4,6,1,25,20,45
p_196,0,4,e_1,371,594,608,2.0,8,8,3.5,4,5,1,223,14,237
p_78,0,12,e_2,556,583,623,25.5,7,7,4.5,4,6,1,27,40,67
p_179,0,8,e_0,400,604,630,20.0,7,7,2.0,4,7,1,204,26,230
p_194,0,6,e_1,373,690,710,24.0,8,8,3.5,4,5,1,317,20,337
p_300,0,4,e_0,8,9,25,0.0,0,0,0.0,3,0,0,1,16,17
p_297,0,6,e_3,15,15,37,0.0,0,0,0.0,3,0,0,0,22,22
p_296,0,4,e_0,28,42,56,10.5,1,1,2.0,3,0,0,14,14,28
p_292,0,6,e_0,38,42,64,3.0,0,0,0.5,4,0,1,4,22,26
p_290,0,6,e_0,40,42,64,3.0,0,0,0.0,4,0,1,2,22,24
p_289,0,4,e_3,43,64,78,3.0,0,0,3.0,3,0,0,21,14,35
p_285,0,4,e_3,53,64,78,1.5,1,0,1.5,4,0,1,11,14,25
p_284,0,4,e_3,54,64,78,1.5,1,0,1.5,4,0,1,10,14,24
p_294,0,12,e_0,31,42,84,10.0,1,1,1.5,4,0,1,11,42,53
p_293,0,12,e_0,33,42,84,9.5,1,1,1.5,4,0,1,9,42,51
p_288,0,8,e_3,44,64,92,3.0,1,1,3.0,3,0,1,20,28,48
p_278,0,2,e_1,77,106,114,16.0,5,5,4.5,4,1,1,29,8,37
p_277,0,6,e_1,82,106,128,15.5,4,4,4.0,4,1,1,24,22,46
p_273,0,4,e_0,110,122,136,11.5,3,3,2.0,4,2,0,12,14,26
p_274,0,8,e_1,88,106,136,14.5,4,4,3.0,4,1,1,18,30,48
p_272,0,10,e_0,113,122,156,11.0,3,3,1.5,4,2,1,9,34,43
p_280,0,14,e_1,75,106,156,16.5,5,5,5.0,4,1,1,31,50,81
p_275,0,14,e_1,86,106,156,15.0,4,4,3.0,4,1,1,20,50,70
p_268,0,2,e_3,144,162,170,3.0,4,0,3.0,4,3,1,18,8,26
p_265,0,4,e_3,152,162,178,1.5,4,0,1.5,4,3,1,10,16,26
p_266,0,6,e_3,151,162,186,1.5,4,0,1.5,4,3,1,11,24,35
p_254,0,4,e_1,187,200,214,19.0,6,6,2.0,4,4,1,13,14,27
p_250,0,2,e_0,217,220,228,7.5,6,0,0.5,4,3,1,3,8,11
p_256,0,10,e_1,182,200,234,19.5,7,7,3.0,4,4,1,18,34,52
p_257,0,14,e_1,169,200,248,21.0,8,8,5.0,4,4,1,31,48,79
p_249,0,6,e_3,239,262,282,4.0,6,0,4.0,4,6,0,23,20,43
p_242,0,8,e_1,277,300,326,19.5,7,7,3.5,4,6,1,23,26,49
p_246,0,10,e_1,262,300,334,22.0,7,7,6.0,4,6,0,38,34,72
p_235,0,8,e_0,308,316,342,15.0,6,6,1.5,4,4,1,8,26,34
p_234,0,8,e_0,310,316,342,14.5,6,6,1.0,4,4,1,6,26,32
p_244,0,12,e_0,271,316,356,20.5,7,7,7.5,4,4,0,45,40,85
p_228,0,4,e_3,325,358,372,5.5,7,0,5.5,4,6,1,33,14,47
p_205,0,2,e_2,362,389,397,25.5,8,8,4.5,4,1,1,27,8,35
p_220,0,6,e_2,341,389,411,3.0,7,0,7.5,3,1,0,48,22,70
p_208,0,6,e_2,358,389,411,26.0,8,8,5.0,4,1,1,31,22,53
p_180,0,2,e_0,399,414,422,20.0,7,7,2.5,4,7,1,15,8,23
p_206,0,12,e_2,361,389,431,25.5,8,8,4.5,4,1,1,28,42,70
p_203,0,12,e_2,364,389,431,25.0,8,8,4.0,4,1,1,25,42,67
p_187,0,12,e_1,389,398,438,21.5,7,7,1.5,4,6,0,9,40,49
p_204,0,14,e_2,363,389,439,25.5,8,8,4.5,4,1,1,26,50,76
p_179,0,8,e_0,400,414,442,19.5,7,7,2.0,4,7,1,14,28,42
p_227,0,12,e_3,327,454,494,5.0,7,0,5.0,4,6,1,127,40,167
p_200,0,4,e_2,367,491,505,24.5,8,8,3.5,4,1,1,124,14,138
p_196,0,4,e_2,371,491,505,2.0,7,7,3.0,4,1,1,120,14,134
p_186,0,4,e_1,390,496,510,21.5,7,7,1.5,4,6,1,106,14,120
p_197,0,10,e_2,370,491,525,24.0,8,8,3.0,4,1,1,121,34,155
p_226,0,2,e_3,329,552,562,4.5,7,0,4.5,4,6,1,223,10,233
p_194,0,6,e_2,373,589,609,24.0,7,7,2.5,4,1,1,216,20,236
p_185,0,10,e_1,391,592,626,21.0,7,7,1.0,4,6,1,201,34,235
p_192,0,8,e_2,375,685,711,23.5,7,7,2.0,4,1,1,310,26,336
p_184,0,12,e_1,392,690,728,21.0,7,7,1.0,4,6,1,298,38,336
p_191,0,10,e_2,376,781,813,23.5,7,7,2.0,4,1,1,405,32,437
p_300,0,4,e_0,8,8,24,0.0,0,0,0.0,3,0,0,0,16,16
p_297,0,6,e_3,15,16,38,0.0,0,0,0.0,3,0,0,1,22,23
p_296,0,4,e_0,28,42,56,10.5,1,1,2.0,3,0,0,14,14,28
p_292,0,6,e_0,38,42,64,3.0,0,0,0.5,4,0,1,4,22,26
p_290,0,6,e_0,40,42,64,3.0,0,0,0.5,4,0,1,2,22,24
p_289,0,4,e_3,43,63,77,3.0,0,0,3.0,3,0,0,20,14,34
p_285,0,4,e_3,53,63,77,1.5,1,0,1.5,4,0,1,10,14,24
p_284,0,4,e_3,54,63,77,1.5,1,0,1.5,4,0,1,9,14,23
p_294,0,12,e_0,31,42,84,10.0,1,1,1.5,4,0,1,11,42,53
p_293,0,12,e_0,33,42,84,9.5,1,1,1.5,4,0,1,9,42,51
p_288,0,8,e_3,44,63,91,3.0,1,0,3.0,4,0,1,19,28,47
p_278,0,2,e_1,77,106,114,2.0,4,4,5.0,4,1,1,29,8,37
p_277,0,6,e_1,82,106,128,15.5,4,4,4.0,4,1,1,24,22,46
p_273,0,4,e_0,110,122,136,11.0,3,3,2.0,4,2,0,12,14,26
p_274,0,8,e_1,88,106,136,14.5,4,4,3.0,4,1,1,18,30,48
p_272,0,10,e_0,113,122,156,10.5,3,3,1.5,4,2,1,9,34,43
p_280,0,14,e_1,75,106,156,16.0,5,5,5.0,4,1,1,31,50,81
p_275,0,14,e_1,86,106,156,14.5,4,4,3.5,4,1,1,20,50,70
p_268,0,2,e_3,144,161,169,3.0,4,0,3.0,4,3,1,17,8,25
p_265,0,4,e_3,152,161,177,1.5,4,0,1.5,4,3,1,9,16,25
p_266,0,6,e_3,151,161,185,1.5,4,0,1.5,4,3,1,10,24,34
p_254,0,4,e_1,187,200,214,19.0,6,6,2.0,4,4,1,13,14,27
p_250,0,2,e_0,217,220,228,7.0,6,0,0.5,4,3,1,3,8,11
p_256,0,10,e_1,182,200,234,19.5,7,7,3.0,4,4,1,18,34,52
p_257,0,14,e_1,169,200,248,21.0,8,8,5.0,4,4,1,31,48,79
p_249,0,6,e_3,239,261,281,3.5,6,0,3.5,4,6,0,22,20,42
p_242,0,8,e_1,277,300,326,19.5,7,7,4.0,4,6,1,23,26,49
p_246,0,10,e_1,262,300,334,22.0,7,7,6.5,4,6,0,38,34,72
p_235,0,8,e_0,308,316,342,14.5,6,6,1.0,4,4,1,8,26,34
p_234,0,8,e_0,310,316,342,7.0,6,6,1.0,4,4,1,6,26,32
p_244,0,12,e_1,271,300,342,20.5,7,7,5.0,4,6,1,29,42,71
p_228,0,4,e_3,325,357,371,5.0,7,0,5.0,4,6,1,32,14,46
p_209,0,2,e_2,357,389,399,0.0,6,6,5.0,4,1,1,32,10,42
p_205,0,2,e_2,362,389,399,25.5,8,8,4.5,4,1,1,27,10,37
p_200,0,4,e_2,367,389,407,24.5,8,8,3.5,4,1,1,22,18,40
p_186,0,4,e_1,390,400,414,21.0,7,7,1.5,4,6,0,10,14,24
p_220,0,6,e_2,341,389,415,2.5,7,0,7.5,3,1,0,48,26,74
p_210,0,6,e_2,354,389,415,0.5,7,0,5.5,4,1,1,35,26,61
p_208,0,6,e_2,358,389,415,26.0,8,8,5.0,4,1,1,31,26,57
p_185,0,10,e_1,391,400,434,21.0,7,7,1.5,4,6,1,9,34,43
p_206,0,12,e_2,361,389,435,25.5,8,8,4.5,4,1,1,28,46,74
p_203,0,12,e_2,364,389,435,25.0,8,8,4.0,4,1,1,25,46,71
p_179,0,8,e_0,400,412,438,19.5,7,7,2.0,4,7,0,12,26,38
p_204,0,14,e_2,363,389,443,25.0,8,8,4.5,4,1,1,26,54,80
p_227,0,12,e_3,327,453,491,5.0,7,0,5.0,4,6,1,126,38,164
p_196,0,4,e_2,371,495,509,24.0,7,7,3.0,4,1,1,124,14,138
p_194,0,6,e_2,373,495,517,24.0,7,7,2.5,4,1,1,122,22,144
p_192,0,8,e_2,375,495,525,23.5,7,7,2.5,4,1,1,120,30,150
p_197,0,10,e_2,370,495,533,24.0,8,8,3.0,4,1,1,125,38,163
p_191,0,10,e_2,376,495,533,23.5,7,7,2.0,4,1,1,119,38,157
p_184,0,12,e_1,392,498,536,21.0,7,7,1.5,4,6,1,106,38,144
p_226,0,2,e_3,329,549,557,4.5,7,0,4.5,4,6,1,220,8,228
p_182,0,2,e_1,397,594,602,20.0,7,7,0.5,4,6,1,197,8,205
p_189,0,8,e_2,382,597,623,22.5,7,7,1.0,4,1,1,215,26,241
p_187,0,12,e_2,389,597,637,21.5,7,7,0.0,3,1,0,208,40,248
p_300,0,4,e_0,8,9,25,0.0,0,0,0.0,3,0,0,1,16,17
p_297,0,6,e_3,15,16,38,0.0,0,0,0.0,3,0,0,1,22,23
p_296,0,4,e_0,28,42,56,10.5,1,1,2.0,3,0,0,14,14,28
p_292,0,6,e_0,38,42,64,3.0,0,0,0.5,4,0,1,4,22,26
p_290,0,6,e_0,40,42,64,3.0,0,0,0.0,4,0,1,2,22,24
p_289,0,4,e_3,43,64,78,3.0,0,0,3.0,3,0,0,21,14,35
p_285,0,4,e_3,53,64,78,2.0,1,0,2.0,4,0,1,11,14,25
p_284,0,4,e_3,54,64,78,1.5,1,0,1.5,4,0,1,10,14,24
p_294,0,12,e_0,31,42,84,10.0,1,1,2.0,4,0,1,11,42,53
p_293,0,12,e_0,33,42,84,10.0,1,1,1.5,4,0,1,9,42,51
p_288,0,8,e_3,44,64,92,3.0,1,0,3.0,4,0,1,20,28,48
p_278,0,2,e_1,77,106,114,16.0,5,5,5.0,4,1,1,29,8,37
p_277,0,6,e_1,82,106,128,15.5,4,4,4.0,4,1,1,24,22,46
p_274,0,8,e_1,88,106,136,14.5,4,4,3.0,4,1,1,18,30,48
p_273,0,4,e_0,110,122,138,11.0,3,3,2.0,4,2,0,12,16,28
p_280,0,14,e_1,75,106,156,16.5,5,5,5.0,4,1,1,31,50,81
p_275,0,14,e_1,86,106,156,15.0,4,4,3.0,4,1,1,20,50,70
p_272,0,10,e_0,113,122,158,11.0,3,3,1.5,4,2,1,9,36,45
p_268,0,2,e_3,144,162,170,3.0,4,0,3.0,4,3,1,18,8,26
p_265,0,4,e_3,152,162,178,1.5,4,0,1.5,4,3,1,10,16,26
p_266,0,6,e_3,151,162,186,2.0,4,0,2.0,4,3,1,11,24,35
p_254,0,4,e_1,187,200,214,19.0,6,6,2.0,4,4,1,13,14,27
p_250,0,2,e_0,217,222,230,7.5,6,0,1.0,4,4,1,5,8,13
p_256,0,10,e_1,182,200,234,19.5,7,7,3.0,4,4,1,18,34,52
p_257,0,14,e_1,169,200,248,21.0,8,8,5.0,4,4,1,31,48,79
p_249,0,6,e_3,239,262,282,3.5,6,0,3.5,4,6,0,23,20,43
p_246,0,10,e_1,262,300,332,22.0,7,7,6.5,4,6,0,38,32,70
p_244,0,12,e_1,271,300,340,20.5,7,7,4.5,4,6,1,29,40,69
p_235,0,8,e_0,308,318,344,15.0,6,6,1.5,4,5,1,10,26,36
p_234,0,8,e_0,310,318,344,14.5,6,6,1.0,4,5,1,8,26,34
p_226,0,2,e_3,329,358,368,5.0,7,0,5.0,4,6,1,29,10,39
p_228,0,4,e_3,325,358,376,5.5,7,0,5.5,4,6,1,33,18,51
p_227,0,12,e_3,327,358,402,5.0,7,0,5.0,4,6,1,31,44,75
p_242,0,8,e_1,277,398,426,20.0,7,7,4.0,4,6,1,121,28,149
p_223,0,2,e_3,336,460,468,3.5,7,0,3.5,4,6,1,124,8,132
p_137,0,4,e_2,464,484,500,25.5,8,8,3.5,4,1,1,20,16,36
p_140,0,8,e_2,459,484,514,0.0,7,7,4.0,4,1,1,25,30,55
p_139,0,10,e_2,461,484,522,26.0,8,8,4.0,4,1,1,23,38,61
p_135,0,10,e_2,466,484,522,25.5,8,8,3.0,4,1,1,18,38,56
p_133,0,12,e_2,469,484,530,25.0,7,7,2.5,4,1,1,15,46,61
p_131,0,14,e_2,471,484,538,25.0,7,7,2.0,4,1,1,13,54,67
p_127,0,10,e_2,475,590,622,24.0,7,7,1.5,4,1,1,115,32,147
p_126,0,12,e_2,476,590,630,24.0,7,7,1.0,4,1,1,114,40,154
p_125,0,14,e_2,477,590,638,24.0,7,7,1.0,4,1,1,113,48,161
p_300,0,4,e_0,8,8,24,0.0,0,0,0.0,3,0,0,0,16,16
p_297,0,6,e_3,15,16,38,0.0,0,0,0.0,3,0,0,1,22,23
p_296,0,4,e_0,28,43,57,10.5,1,1,2.0,3,0,0,15,14,29
p_292,0,6,e_0,38,43,65,3.0,0,0,0.5,4,0,1,5,22,27
p_290,0,6,e_0,40,43,65,3.0,0,0,0.5,4,0,1,3,22,25
p_289,0,4,e_3,43,64,78,3.0,0,0,3.0,3,0,0,21,14,35
p_285,0,4,e_3,53,64,78,2.0,1,0,2.0,4,0,1,11,14,25
p_284,0,4,e_3,54,64,78,1.5,1,0,1.5,4,0,1,10,14,24
p_294,0,12,e_0,31,43,85,10.0,1,1,2.0,4,0,1,12,42,54
p_293,0,12,e_0,33,43,85,9.5,1,1,1.5,4,0,1,10,42,52
p_288,0,8,e_3,44,64,92,3.0,1,1,3.0,3,0,1,20,28,48
p_278,0,2,e_1,77,105,113,16.0,5,5,4.5,4,1,1,28,8,36
p_277,0,6,e_1,82,105,127,15.5,4,4,3.5,4,1,1,23,22,45
p_274,0,8,e_1,88,105,135,14.5,4,4,2.5,4,1,1,17,30,47
p_273,0,4,e_0,110,123,139,11.0,3,3,2.0,4,2,0,13,16,29
p_280,0,14,e_1,75,105,155,16.5,5,5,5.0,4,1,1,30,50,80
p_275,0,14,e_1,86,105,155,15.0,4,4,3.0,4,1,1,19,50,69
p_272,0,10,e_0,113,123,159,11.0,3,3,1.5,4,2,1,10,36,46
p_268,0,2,e_3,144,162,170,3.0,4,0,3.0,4,3,1,18,8,26
p_265,0,4,e_3,152,162,178,1.5,4,0,1.5,4,3,1,10,16,26
p_266,0,6,e_3,151,162,186,1.5,4,0,1.5,4,3,1,11,24,35
p_254,0,4,e_2,187,202,216,19.0,6,6,2.5,4,1,1,15,14,29
p_250,0,2,e_0,217,223,231,7.5,6,0,1.0,4,4,1,6,8,14
p_256,0,10,e_2,182,202,236,19.5,7,7,3.5,4,1,1,20,34,54
p_257,0,14,e_2,169,202,250,21.0,9,9,5.5,4,1,1,33,48,81
p_249,0,6,e_3,239,262,282,3.5,6,0,3.5,4,6,0,23,20,43
p_242,0,8,e_1,277,293,319,19.5,7,7,2.5,4,4,1,16,26,42
p_246,0,10,e_1,262,293,327,0.0,6,6,5.0,4,4,1,31,34,65
p_244,0,12,e_1,271,293,335,20.5,7,7,3.5,4,4,1,22,42,64
p_235,0,8,e_0,308,319,345,15.0,6,6,2.0,4,5,1,11,26,37
p_234,0,8,e_0,310,319,345,7.0,6,6,1.5,4,5,1,9,26,35
p_226,0,2,e_3,329,358,366,5.0,7,0,5.0,4,6,1,29,8,37
p_228,0,4,e_3,325,358,374,5.5,7,0,5.5,4,6,1,33,16,49
p_227,0,12,e_3,327,358,400,5.0,7,0,5.0,4,6,1,31,42,73
p_209,0,2,e_1,357,393,401,0.0,6,6,6.0,4,5,0,36,8,44
p_205,0,2,e_1,362,393,401,25.5,10,10,5.0,4,5,1,31,8,39
p_208,0,6,e_2,358,396,416,26.0,10,10,6.0,4,5,0,38,20,58
p_206,0,12,e_1,361,393,433,25.5,10,10,5.0,4,5,1,32,40,72
p_203,0,12,e_1,364,393,433,25.5,10,10,5.0,4,5,1,29,40,69
p_184,0,12,e_2,392,396,436,21.0,8,8,0.5,4,5,1,4,40,44
p_204,0,14,e_1,363,393,441,25.5,10,10,5.0,4,5,1,30,48,78
p_223,0,2,e_3,336,458,466,3.5,7,0,3.5,4,6,1,122,8,130
p_200,0,4,e_1,367,493,507,25.0,9,9,4.5,4,5,1,126,14,140
p_221,0,6,e_3,339,554,574,3.0,7,0,3.0,4,6,1,215,20,235
p_86,0,2,e_2,544,588,596,1.5,8,0,7.5,4,5,0,44,8,52
p_76,0,6,e_2,558,588,610,25.5,8,8,5.0,4,5,1,30,22,52
p_197,0,10,e_1,370,589,621,24.5,9,9,3.5,4,5,1,219,32,251
p_78,0,12,e_2,556,588,630,26.0,8,8,5.0,4,5,1,32,42,74
p_220,0,6,e_3,341,650,670,3.0,7,0,3.0,4,6,1,309,20,329
p_196,0,4,e_1,371,685,699,24.5,9,9,3.5,4,5,1,314,14,328
p_300,0,4,e_0,8,9,25,0.0,0,0,0.0,3,0,0,1,16,17
p_297,0,6,e_3,15,15,37,0.0,0,0,0.0,3,0,0,0,22,22
p_296,0,4,e_0,28,42,56,10.5,1,1,2.0,3,0,0,14,14,28
p_292,0,6,e_0,38,42,64,3.0,0,0,0.5,4,0,1,4,22,26
p_290,0,6,e_0,40,42,64,3.0,0,0,0.0,4,0,1,2,22,24
p_289,0,4,e_3,43,63,77,3.0,0,0,3.0,3,0,0,20,14,34
p_285,0,4,e_3,53,63,77,1.5,1,0,1.5,4,0,1,10,14,24
p_284,0,4,e_3,54,63,77,1.5,1,0,1.5,4,0,1,9,14,23
p_294,0,12,e_0,31,42,84,10.0,1,1,2.0,4,0,1,11,42,53
p_293,0,12,e_0,33,42,84,9.5,1,1,1.5,4,0,1,9,42,51
p_288,0,8,e_3,44,63,91,3.0,1,0,3.0,4,0,1,19,28,47
p_278,0,2,e_1,77,106,114,2.0,4,4,4.5,4,1,1,29,8,37
p_277,0,6,e_1,82,106,128,15.5,4,4,4.0,4,1,1,24,22,46
p_274,0,8,e_1,88,106,136,14.5,4,4,3.0,4,1,1,18,30,48
p_273,0,4,e_0,110,122,138,11.0,3,3,2.0,4,2,0,12,16,28
p_280,0,14,e_1,75,106,156,16.0,5,5,5.0,4,1,1,31,50,81
p_275,0,14,e_1,86,106,156,14.5,4,4,3.0,4,1,1,20,50,70
p_272,0,10,e_0,113,122,158,10.5,3,3,1.5,4,2,1,9,36,45
p_268,0,2,e_3,144,161,169,2.5,4,0,2.5,4,3,1,17,8,25
p_265,0,4,e_3,152,161,177,1.5,4,0,1.5,4,3,1,9,16,25
p_266,0,6,e_3,151,161,185,1.5,4,0,1.5,4,3,1,10,24,34
p_254,0,4,e_1,187,200,214,19.0,6,6,2.0,4,4,1,13,14,27
p_250,0,2,e_0,217,222,230,7.0,6,0,1.0,4,4,1,5,8,13
p_256,0,10,e_1,182,200,234,19.5,7,7,3.0,4,4,1,18,34,52
p_257,0,14,e_1,169,200,248,21.0,8,8,5.0,4,4,1,31,48,79
p_249,0,6,e_3,239,261,281,3.5,6,0,3.5,4,6,0,22,20,42
p_246,0,10,e_1,262,300,332,22.0,7,7,6.0,4,6,0,38,32,70
p_244,0,12,e_1,271,300,340,20.5,7,7,4.5,4,6,1,29,40,69
p_235,0,8,e_0,308,318,344,14.5,6,6,1.5,4,5,1,10,26,36
p_234,0,8,e_0,310,318,344,7.5,6,0,1.0,4,5,1,8,26,34
p_228,0,4,e_3,325,357,371,5.5,7,0,5.5,4,6,1,32,14,46
p_227,0,12,e_3,327,357,397,5.0,7,0,5.0,4,6,1,30,40,70
p_180,0,2,e_0,399,414,422,20.0,7,7,2.5,4,7,1,15,8,23
p_242,0,8,e_1,277,398,424,19.5,7,7,4.0,4,6,1,121,26,147
p_226,0,2,e_3,329,455,463,4.5,7,0,4.5,4,6,1,126,8,134
p_209,0,2,e_1,357,494,502,0.0,6,6,7.0,4,6,0,137,8,145
p_179,0,8,e_0,400,510,536,20.0,7,7,2.5,4,7,1,110,26,136
p_208,0,6,e_1,358,590,610,26.0,9,9,6.5,4,6,1,232,20,252
p_300,0,4,e_0,8,8,24,0.0,0,0,0.0,3,0,0,0,16,16
p_297,0,6,e_3,15,15,37,0.0,0,0,0.0,3,0,0,0,22,22
p_296,0,4,e_0,28,43,57,10.5,1,1,2.0,3,0,0,15,14,29
p_292,0,6,e_0,38,43,65,3.0,0,0,0.5,4,0,1,5,22,27
p_290,0,6,e_0,40,43,65,3.0,0,0,0.5,4,0,1,3,22,25
p_289,0,4,e_3,43,64,78,3.0,0,0,3.0,3,0,0,21,14,35
p_285,0,4,e_3,53,64,78,2.0,1,0,2.0,4,0,1,11,14,25
p_284,0,4,e_3,54,64,78,1.5,1,0,1.5,4,0,1,10,14,24
p_294,0,12,e_0,31,43,85,10.0,1,1,2.0,4,0,1,12,42,54
p_293,0,12,e_0,33,43,85,9.5,1,1,1.5,4,0,1,10,42,52
p_288,0,8,e_3,44,64,92,3.0,1,0,3.0,4,0,1,20,28,48
p_278,0,2,e_1,77,106,114,2.0,4,4,4.5,4,1,1,29,8,37
p_277,0,6,e_1,82,106,128,15.5,4,4,4.0,4,1,1,24,22,46
p_274,0,8,e_1,88,106,136,14.5,4,4,3.0,4,1,1,18,30,48
p_273,0,4,e_0,110,123,139,11.5,3,3,2.0,4,2,0,13,16,29
p_280,0,14,e_1,75,106,156,16.5,5,5,5.0,4,1,1,31,50,81
p_275,0,14,e_1,86,106,156,15.0,4,4,3.5,4,1,1,20,50,70
p_272,0,10,e_0,113,123,159,10.5,3,3,1.5,4,2,1,10,36,46
p_268,0,2,e_3,144,162,170,3.0,4,0,3.0,4,3,1,18,8,26
p_265,0,4,e_3,152,162,178,1.5,4,0,1.5,4,3,1,10,16,26
p_266,0,6,e_3,151,162,186,2.0,4,0,2.0,4,3,1,11,24,35
p_254,0,4,e_1,187,200,214,19.0,6,6,2.0,4,4,1,13,14,27
p_250,0,2,e_0,217,223,231,7.5,6,0,1.0,4,4,1,6,8,14
p_256,0,10,e_1,182,200,234,19.5,7,7,3.0,4,4,1,18,34,52
p_257,0,14,e_1,169,200,248,21.0,8,8,5.0,4,4,1,31,48,79
p_249,0,6,e_3,239,262,282,3.5,6,0,3.5,4,6,0,23,20,43
p_246,0,10,e_1,262,300,332,22.0,7,7,6.0,4,6,0,38,32,70
p_244,0,12,e_1,271,300,340,21.0,7,7,5.0,4,6,1,29,40,69
p_235,0,8,e_0,308,319,345,15.0,6,6,2.0,4,5,1,11,26,37
p_234,0,8,e_0,310,319,345,14.5,6,6,1.5,4,5,1,9,26,35
p_226,0,2,e_3,329,358,368,5.0,7,0,5.0,4,6,1,29,10,39
p_228,0,4,e_3,325,358,376,5.5,7,0,5.5,4,6,1,33,18,51
p_227,0,12,e_3,327,358,402,5.0,7,0,5.0,4,6,1,31,44,75
p_186,0,4,e_2,390,390,406,22.0,8,8,0.0,3,1,1,0,16,16
p_182,0,2,e_0,397,415,423,20.5,8,8,3.0,4,7,0,18,8,26
p_242,0,8,e_1,277,398,424,19.5,7,7,4.0,4,6,1,121,26,147
p_187,0,12,e_2,389,390,432,22.0,8,8,0.0,3,1,0,1,42,43
p_223,0,2,e_3,336,460,468,3.5,7,0,3.5,4,6,1,124,8,132
p_209,0,2,e_1,357,494,502,0.0,6,6,6.5,4,6,0,137,8,145
p_300,0,4,e_0,8,8,24,0.0,0,0,0.0,3,0,0,0,16,16
p_297,0,6,e_3,15,15,37,0.0,0,0,0.0,3,0,0,0,22,22
p_296,0,4,e_0,28,43,57,10.5,1,1,2.0,3,0,0,15,14,29
p_292,0,6,e_0,38,43,65,3.0,0,0,1.0,4,0,1,5,22,27
p_290,0,6,e_0,40,43,65,3.0,0,0,0.5,4,0,1,3,22,25
p_289,0,4,e_3,43,63,77,3.0,0,0,3.0,3,0,0,20,14,34
p_285,0,4,e_3,53,63,77,1.5,1,0,1.5,4,0,1,10,14,24
p_284,0,4,e_3,54,63,77,1.5,1,0,1.5,4,0,1,9,14,23
p_294,0,12,e_0,31,43,85,10.0,1,1,2.0,4,0,1,12,42,54
p_293,0,12,e_0,33,43,85,9.5,1,1,1.5,4,0,1,10,42,52
p_288,0,8,e_3,44,63,91,3.0,1,0,3.0,4,0,1,19,28,47
p_278,0,2,e_1,77,105,113,16.0,4,4,4.5,4,1,1,28,8,36
p_277,0,6,e_1,82,105,127,15.5,4,4,3.5,4,1,1,23,22,45
p_274,0,8,e_1,88,105,135,14.5,4,4,3.0,4,1,1,17,30,47
p_273,0,4,e_0,110,123,137,11.0,3,3,2.0,4,2,0,13,14,27
p_280,0,14,e_1,75,105,155,16.0,5,5,5.0,4,1,1,30,50,80
p_275,0,14,e_1,86,105,155,14.5,4,4,3.0,4,1,1,19,50,69
p_272,0,10,e_0,113,123,157,10.5,3,3,1.5,4,2,1,10,34,44
p_268,0,2,e_3,144,161,169,2.5,4,0,2.5,4,3,1,17,8,25
p_265,0,4,e_3,152,161,177,1.5,4,0,1.5,4,3,1,9,16,25
p_266,0,6,e_3,151,161,185,1.5,4,0,1.5,4,3,1,10,24,34
p_254,0,4,e_1,187,199,213,19.0,6,6,2.0,4,4,1,12,14,26
p_250,0,2,e_0,217,221,229,7.5,6,0,0.5,4,4,1,4,8,12
p_256,0,10,e_1,182,199,233,19.5,7,7,3.0,4,4,1,17,34,51
p_257,0,14,e_1,169,199,247,21.0,8,8,5.0,4,4,1,30,48,78
p_249,0,6,e_3,239,261,281,3.5,6,0,3.5,4,6,0,22,20,42
p_246,0,10,e_1,262,299,331,22.0,7,7,6.0,4,6,0,37,32,69
p_244,0,12,e_1,271,299,339,20.5,7,7,4.5,4,6,1,28,40,68
p_235,0,8,e_0,308,317,345,15.0,6,6,1.5,4,5,1,9,28,37
p_234,0,8,e_0,310,317,345,7.0,6,6,1.0,4,5,1,7,28,35
p_226,0,2,e_3,329,357,367,4.5,7,0,4.5,4,6,1,28,10,38
p_228,0,4,e_3,325,357,375,5.0,7,0,5.0,4,6,1,32,18,50
p_227,0,12,e_3,327,357,401,5.0,7,0,5.0,4,6,1,30,44,74
p_182,0,2,e_0,397,415,423,20.5,8,8,3.0,4,7,0,18,8,26
p_242,0,8,e_1,277,397,423,19.5,7,7,3.5,4,6,1,120,26,146
p_223,0,2,e_3,336,459,467,3.5,7,0,3.5,4,6,1,123,8,131
p_208,0,6,e_1,358,493,513,26.0,10,10,6.5,4,6,0,135,20,155
p_76,0,6,e_2,558,579,601,26.0,7,7,3.5,4,3,1,21,22,43
p_78,0,12,e_2,556,579,621,26.0,7,7,3.5,4,3,0,23,42,65
p_69,0,14,e_2,566,579,629,24.5,7,7,2.0,4,3,1,13,50,63
p_64,0,4,e_2,574,673,687,23.0,7,7,0.5,4,3,1,99,14,113
p_291,6,0,e_3,35,41,61,6.0,1,0,2.0,5,0,1,6,20,26
p_298,4,0,e_2,10,24,104,4.0,0,0,0.0,3,0,0,14,80,94
p_284,14,0,e_2,55,56,104,17.0,2,2,7.0,5,1,1,1,48,49
p_283,10,0,e_2,55,70,104,21.0,2,2,7.0,2,1,1,15,34,49
p_279,2,0,e_2,76,96,104,20.0,2,1,4.0,4,1,1,20,8,28
p_275,2,0,e_2,84,96,104,18.5,2,1,3.0,4,1,2,12,8,20
p_287,12,0,e_1,51,66,110,19.5,2,2,7.0,5,0,5,15,44,59
p_282,6,0,e_1,62,86,110,6.0,1,0,6.5,4,0,7,24,24,48
p_290,4,0,e_1,43,94,110,29.0,2,2,5.5,5,0,3,51,16,67
p_285,2,0,e_1,54,102,110,29.0,2,2,7.5,3,0,6,48,8,56
p_280,12,0,e_3,65,99,157,11.5,1,0,0.5,5,0,1,34,58,92
p_268,10,0,e_1,150,174,208,21.0,4,4,6.5,5,0,4,24,34,58
p_262,6,0,e_1,164,188,208,23.0,3,2,6.5,4,0,5,24,20,44
p_259,6,0,e_3,174,177,261,21.5,3,2,2.5,5,0,3,3,84,87
p_255,10,0,e_3,192,223,261,14.5,5,2,5.5,5,1,4,31,38,69
p_256,8,0,e_3,191,231,261,17.0,4,2,5.0,5,1,3,40,30,70
p_251,4,0,e_3,228,245,261,0.0,6,0,4.5,4,1,5,17,16,33
p_252,2,0,e_3,212,253,261,4.0,6,0,6.5,4,1,5,41,8,49
p_244,2,0,e_2,271,286,294,26.5,3,2,3.5,4,0,4,15,8,23
p_247,12,0,e_1,248,266,304,20.0,5,5,6.5,5,0,4,18,38,56
p_240,14,0,e_3,301,305,359,9.5,3,1,6.5,5,0,3,4,54,58
p_238,2,0,e_3,311,351,359,5.0,4,0,7.5,4,1,3,40,8,48
p_233,2,0,e_3,319,351,359,4.0,6,1,6.0,4,1,5,32,8,40
p_234,14,0,e_2,314,338,388,23.0,6,6,3.0,5,0,4,24,50,74
p_225,10,0,e_2,333,352,388,24.0,6,6,6.0,5,0,5,19,36,55
p_221,4,0,e_2,341,372,388,28.5,6,6,7.0,4,1,6,31,16,47
p_214,4,0,e_2,346,372,388,27.5,6,6,6.0,4,1,7,26,16,42
p_210,4,0,e_2,353,372,388,27.0,5,5,5.0,4,1,6,19,16,35
p_209,2,0,e_2,354,380,388,28.5,5,5,5.0,4,1,6,26,8,34
p_199,2,0,e_2,368,380,388,27.0,5,4,2.5,4,1,7,12,8,20
p_236,8,0,e_1,313,330,402,29.5,5,5,1.0,5,0,4,17,72,89
p_235,8,0,e_1,314,330,402,29.0,6,6,1.5,5,0,5,16,72,88
p_231,10,0,e_1,320,338,402,26.0,6,6,2.5,5,0,5,18,64,82
p_226,12,0,e_1,331,346,402,22.5,6,6,4.0,5,1,6,15,56,71
p_211,14,0,e_1,348,354,402,17.5,6,6,6.0,5,1,8,6,48,54
p_213,12,0,e_1,347,362,402,19.5,6,6,6.0,5,1,7,15,40,55
p_217,8,0,e_1,345,376,402,24.0,6,6,6.0,2,1,6,31,26,57
p_206,6,0,e_3,362,379,463,24.0,4,2,0.0,5,0,4,17,84,101
p_190,14,0,e_3,382,405,463,13.0,7,1,3.0,5,1,6,23,58,81
p_180,14,0,e_3,396,405,463,10.5,8,1,5.5,5,1,7,9,58,67
p_172,14,0,e_3,405,405,463,9.0,8,1,7.0,2,1,7,0,58,58
p_173,10,0,e_3,405,429,463,13.0,7,3,7.0,2,1,6,24,34,58
p_170,10,0,e_3,408,429,463,13.0,8,3,7.0,5,1,7,21,34,55
p_163,4,0,e_3,417,449,463,3.0,10,1,7.0,4,1,9,32,14,46
p_185,2,0,e_2,392,396,492,23.0,8,5,0.5,5,0,5,4,96,100
p_183,12,0,e_2,393,428,492,13.0,8,3,0.5,5,0,6,35,64,99
p_153,8,0,e_2,438,462,492,26.0,10,10,7.5,3,1,7,24,30,54
p_144,4,0,e_2,451,476,492,28.0,9,9,6.0,4,1,8,25,16,41
p_143,2,0,e_2,451,484,492,30.0,9,9,5.5,4,1,9,33,8,41
p_136,2,0,e_2,460,484,492,28.5,9,9,4.0,4,1,10,24,8,32
p_164,12,0,e_1,416,440,506,25.0,10,10,2.0,5,0,8,24,66,90
p_157,12,0,e_1,427,440,506,23.0,11,11,4.0,5,0,9,13,66,79
p_165,14,0,e_1,416,448,506,23.0,10,10,2.0,5,0,7,32,58,90
p_162,14,0,e_1,417,448,506,23.0,11,11,2.5,5,0,9,31,58,89
p_158,14,0,e_1,426,448,506,21.5,11,11,3.5,5,0,9,22,58,80
p_145,12,0,e_1,451,464,506,20.0,9,9,7.5,5,1,9,13,42,55
p_152,10,0,e_1,439,472,506,23.5,10,10,6.0,2,0,8,33,34,67
p_146,10,0,e_1,451,472,506,22.0,9,9,7.5,5,1,9,21,34,55
p_133,4,0,e_1,463,492,506,26.0,8,6,6.0,1,1,9,29,14,43
p_125,4,0,e_1,474,492,506,24.5,9,7,5.0,4,1,9,18,14,32
p_123,12,0,e_3,474,501,565,16.5,8,2,1.5,5,0,8,27,64,91
p_117,12,0,e_3,490,501,565,14.0,10,2,4.0,5,0,10,11,64,75
p_109,14,0,e_3,506,509,565,9.5,10,1,6.5,5,1,9,3,56,59
p_118,4,0,e_3,488,549,565,22.0,9,7,4.0,5,0,9,61,16,77
p_105,4,0,e_3,515,549,565,3.0,10,1,7.5,4,1,9,34,16,50
p_102,2,0,e_3,521,557,565,4.0,10,3,6.5,4,1,9,36,8,44
p_90,2,0,e_3,536,557,565,2.0,11,1,4.0,4,1,10,21,8,29
p_100,10,0,e_2,522,524,600,26.5,11,11,4.5,5,0,8,2,76,78
p_101,12,0,e_2,521,532,600,24.5,10,10,4.5,5,0,7,11,68,79
p_88,14,0,e_2,538,540,600,20.0,11,11,7.0,5,1,8,2,60,62
p_97,10,0,e_2,526,562,600,25.5,11,11,5.0,5,1,8,36,38,74
p_80,6,0,e_2,548,576,600,26.0,10,10,7.0,4,1,9,28,24,52
p_78,4,0,e_2,555,584,600,27.0,10,10,6.0,4,1,10,29,16,45
p_81,2,0,e_2,547,592,600,30.0,11,11,7.5,4,1,8,45,8,53
p_71,2,0,e_2,569,592,600,27.5,9,8,4.0,4,1,10,23,8,31
p_79,14,0,e_1,549,550,606,18.0,10,10,7.0,5,0,9,1,56,57
p_95,6,0,e_1,527,584,606,29.5,11,11,3.0,5,0,8,57,22,79
p_77,6,0,e_1,557,584,606,25.0,9,9,7.5,4,1,9,27,22,49
p_56,2,0,e_1,588,598,606,25.0,11,8,2.5,4,1,8,10,8,18
p_73,6,0,e_3,568,585,667,24.0,8,5,0.0,5,0,8,17,82,99
p_67,8,0,e_3,574,593,667,21.0,9,4,1.0,5,0,9,19,74,93
p_63,8,0,e_3,581,593,667,19.5,10,4,2.5,5,0,10,12,74,86
p_58,10,0,e_3,586,601,667,17.0,10,3,3.0,5,1,9,15,66,81
p_50,10,0,e_3,592,601,667,16.0,10,3,4.0,2,1,9,9,66,75
p_40,4,0,e_3,601,653,667,21.0,9,5,5.0,2,1,8,52,14,66
p_38,4,0,e_3,627,653,667,2.0,10,1,6.5,4,1,9,26,14,40
p_42,4,0,e_2,600,614,702,21.0,9,5,0.0,3,1,8,14,88,102
p_41,10,0,e_2,600,634,702,15.0,9,3,0.0,3,1,7,34,68,102
p_33,8,0,e_2,647,674,702,25.0,10,10,7.0,5,1,8,27,28,55
p_35,4,0,e_2,640,688,702,30.0,10,10,6.0,5,1,7,48,14,62
p_22,10,0,e_3,712,731,763,12.5,8,3,7.5,5,0,8,19,32,51
p_21,10,0,e_2,732,734,798,25.0,9,9,5.0,5,0,7,2,64,66
p_19,12,0,e_1,740,758,798,21.5,9,9,6.5,5,0,8,18,40,58
p_18,2,0,e_1,768,790,798,27.5,8,7,4.5,4,1,8,22,8,30
p_9,2,0,e_1,845,886,894,29.0,8,8,7.5,4,0,8,41,8,49
p_10,14,0,e_2,810,842,894,22.5,8,8,2.0,5,0,7,32,52,84
p_6,14,0,e_3,858,901,955,16.0,8,1,0.0,5,0,8,43,54,97
p_1,2,0,e_3,889,947,955,23.0,9,6,5.0,5,0,9,58,8,66
p_298,4,0,e_2,10,24,38,4.0,0,0,0.0,3,0,0,14,14,28
p_291,6,0,e_3,35,41,61,6.0,1,0,2.0,5,0,1,6,20,26
p_287,12,0,e_1,51,66,106,19.5,2,2,7.0,5,0,3,15,40,55
p_285,2,0,e_1,54,98,106,29.0,2,2,7.5,3,0,4,44,8,52
p_300,8,0,e_0,4,30,106,8.0,0,0,0.0,3,0,0,26,76,102
p_297,12,0,e_0,18,44,106,12.0,0,0,2.0,5,0,1,26,62,88
p_282,6,0,e_0,62,84,106,6.0,1,0,6.5,4,1,2,22,22,44
p_279,2,0,e_0,76,98,106,19.5,3,2,4.0,4,1,3,22,8,30
p_275,2,0,e_0,84,98,106,18.5,4,3,3.0,4,1,3,14,8,22
p_290,4,0,e_2,43,57,143,29.0,2,2,0.0,3,0,0,14,86,100
p_283,10,0,e_2,55,77,143,21.0,2,2,2.0,5,0,4,22,66,88
p_284,14,0,e_2,55,91,143,17.0,2,2,1.5,5,0,3,36,52,88
p_281,10,0,e_3,63,93,161,10.0,1,0,0.0,5,0,1,30,68,98
p_277,10,0,e_3,81,93,161,11.0,3,1,3.0,5,0,3,12,68,80
p_280,12,0,e_3,65,101,161,11.5,2,0,0.5,5,0,2,36,60,96
p_274,4,0,e_3,84,147,161,16.5,4,3,3.5,5,0,4,63,14,77
p_268,10,0,e_1,150,170,204,22.0,5,5,7.0,5,0,5,20,34,54
p_269,4,0,e_1,146,190,204,28.0,6,6,6.5,5,0,4,44,14,58
p_265,12,0,e_2,157,181,247,18.5,5,5,2.0,5,0,3,24,66,90
p_263,12,0,e_2,163,181,247,18.0,4,2,3.0,5,0,4,18,66,84
p_261,12,0,e_2,170,181,247,17.0,4,2,4.5,5,0,5,11,66,77
p_257,12,0,e_2,179,181,247,15.5,4,2,5.5,5,0,6,2,66,68
p_255,10,0,e_2,192,209,247,15.0,4,2,7.5,3,1,6,17,38,55
p_256,8,0,e_2,191,217,247,17.5,4,2,7.5,5,1,5,26,30,56
p_262,6,0,e_2,164,225,247,24.0,4,2,3.0,5,0,4,61,22,83
p_259,6,0,e_2,174,225,247,22.0,4,2,5.0,5,0,6,51,22,73
p_252,2,0,e_2,212,239,247,5.0,4,1,5.0,4,1,6,27,8,35
p_251,4,0,e_3,228,243,257,0.0,4,0,4.5,4,0,4,15,14,29
p_244,2,0,e_0,271,288,296,26.0,5,4,4.0,4,0,4,17,8,25
p_247,12,0,e_1,248,262,300,19.5,5,5,7.0,5,0,4,14,38,52
p_243,8,0,e_2,285,317,347,17.5,5,3,6.0,5,0,5,32,30,62
p_242,4,0,e_2,287,331,347,21.5,5,4,6.5,5,0,6,44,16,60
p_238,2,0,e_2,311,339,347,5.0,5,1,5.0,4,0,7,28,8,36
p_233,2,0,e_2,319,339,347,4.0,5,1,4.0,4,1,7,20,8,28
p_246,12,0,e_3,257,295,355,12.0,4,4,0.0,3,1,4,38,60,98
p_240,14,0,e_3,301,303,355,9.5,5,1,6.5,5,1,4,2,52,54
p_225,10,0,e_0,333,360,396,23.5,5,5,6.0,5,0,5,27,36,63
p_215,6,0,e_0,346,374,396,25.5,5,5,7.0,4,0,9,28,22,50
p_221,4,0,e_0,341,382,396,28.0,5,5,7.5,5,0,7,41,14,55
p_214,4,0,e_0,346,382,396,27.5,5,5,7.0,4,0,10,36,14,50
p_210,4,0,e_0,353,382,396,26.5,5,5,6.0,4,0,10,29,14,43
p_236,8,0,e_1,313,326,400,29.0,5,5,2.0,5,0,4,13,74,87
p_235,8,0,e_1,314,326,400,28.5,5,5,2.0,5,0,6,12,74,86
p_231,10,0,e_1,320,334,400,26.0,5,5,3.0,5,0,6,14,66,80
p_226,12,0,e_1,331,342,400,22.0,5,5,4.5,5,1,6,11,58,69
p_234,14,0,e_1,314,350,400,22.5,5,5,2.0,5,0,5,36,50,86
p_211,14,0,e_1,348,350,400,17.0,5,5,6.5,5,1,9,2,50,52
p_213,12,0,e_1,347,358,400,19.0,5,5,6.5,5,1,8,11,42,53
p_217,8,0,e_1,345,372,400,23.5,5,5,6.5,5,1,7,27,28,55
p_199,2,0,e_1,368,392,400,26.5,7,5,4.5,4,1,8,24,8,32
p_207,12,0,e_2,355,385,455,18.0,5,2,1.0,5,0,5,30,70,100
p_203,12,0,e_2,365,385,455,17.0,7,2,3.0,5,0,6,20,70,90
p_200,12,0,e_2,367,385,455,16.5,7,2,3.0,5,0,6,18,70,88
p_193,12,0,e_2,378,385,455,15.0,6,2,5.0,5,0,8,7,70,77
p_190,14,0,e_2,382,393,455,12.5,6,1,5.5,5,0,8,11,62,73
p_180,14,0,e_2,396,403,455,10.5,8,1,7.0,5,1,8,7,52,59
p_183,12,0,e_2,393,411,455,13.0,8,2,7.0,2,1,7,18,44,62
p_197,8,0,e_2,375,425,455,19.5,7,2,4.5,5,0,6,50,30,80
p_176,6,0,e_2,398,433,455,18.0,9,4,7.5,3,1,9,35,22,57
p_163,4,0,e_2,417,441,455,2.0,10,1,5.0,4,1,9,24,14,38
p_209,2,0,e_3,354,363,465,2.0,4,4,0.0,3,1,4,9,102,111
p_206,6,0,e_3,362,377,465,23.0,4,2,1.0,2,0,4,15,88,103
p_204,8,0,e_3,364,385,465,21.0,6,2,1.0,5,1,5,21,80,101
p_172,14,0,e_3,405,413,465,9.0,9,1,7.0,5,1,8,8,52,60
p_173,10,0,e_3,405,427,465,13.0,10,3,7.0,5,1,9,22,38,60
p_188,8,0,e_3,390,435,465,17.5,6,2,4.5,5,1,5,45,30,75
p_179,6,0,e_3,397,443,465,18.5,8,4,5.5,5,1,7,46,22,68
p_185,2,0,e_3,392,457,465,23.0,7,4,5.0,5,1,6,65,8,73
p_125,4,0,e_3,474,479,493,24.5,8,6,1.5,5,0,8,5,14,19
p_175,2,0,e_1,399,408,496,22.0,9,4,0.0,3,1,7,9,88,97
p_170,10,0,e_1,408,434,496,27.5,11,11,1.0,2,0,7,26,62,88
p_164,12,0,e_1,416,442,496,25.0,10,10,2.0,5,1,9,26,54,80
p_157,12,0,e_1,427,442,496,23.0,9,9,4.0,5,1,10,15,54,69
p_165,14,0,e_1,416,450,496,23.0,10,10,2.0,5,1,8,34,46,80
p_162,14,0,e_1,417,450,496,22.5,10,10,2.5,5,1,10,33,46,79
p_158,14,0,e_1,426,450,496,21.0,9,9,3.5,5,1,10,24,46,70
p_144,4,0,e_1,451,482,496,28.0,8,8,7.0,4,1,7,31,14,45
p_133,4,0,e_1,463,482,496,26.0,8,8,5.0,4,1,8,19,14,33
p_160,10,0,e_0,421,428,498,26.0,10,10,4.0,5,0,7,7,70,77
p_152,10,0,e_0,439,462,498,23.5,9,9,6.5,5,1,8,23,36,59
p_153,8,0,e_0,438,470,498,26.0,9,9,6.5,5,1,7,32,28,60
p_143,2,0,e_0,451,490,498,30.0,8,8,6.5,4,1,9,39,8,47
p_136,2,0,e_0,460,490,498,28.5,8,8,5.5,4,1,10,30,8,38
p_126,6,0,e_2,473,475,565,23.0,8,5,3.0,5,0,9,2,90,92
p_120,10,0,e_2,481,489,565,22.0,10,10,4.0,5,1,10,8,76,84
p_145,12,0,e_2,451,497,565,20.0,8,8,0.5,4,1,8,46,68,114
p_134,12,0,e_2,462,497,565,18.5,8,8,1.0,5,0,9,35,68,103
p_117,12,0,e_2,490,497,565,18.5,10,10,5.0,5,1,11,7,68,75
p_124,14,0,e_2,474,505,565,14.5,8,1,3.0,5,0,10,31,60,91
p_109,14,0,e_2,506,507,565,14.0,9,1,7.0,5,1,10,1,58,59
p_115,10,0,e_2,494,529,565,20.0,9,3,5.5,5,1,11,35,36,71
p_118,4,0,e_2,488,549,565,27.0,10,10,5.0,5,1,11,61,16,77
p_106,4,0,e_2,512,549,565,23.0,9,7,7.5,4,1,10,37,16,53
p_105,4,0,e_2,515,549,565,22.5,9,7,7.5,4,1,10,34,16,50
p_102,2,0,e_2,521,557,565,23.5,9,7,6.5,4,1,10,36,8,44
p_90,2,0,e_2,536,557,565,21.5,8,4,4.0,4,1,10,21,8,29
p_100,10,0,e_1,522,528,594,15.5,9,3,4.0,5,0,8,6,66,72
p_97,10,0,e_1,526,528,594,15.0,9,3,4.5,5,0,10,2,66,68
p_101,12,0,e_1,521,536,594,13.5,9,2,4.0,5,0,7,15,58,73
p_88,14,0,e_1,538,544,594,9.5,8,1,6.0,5,1,8,6,50,56
p_98,6,0,e_1,524,570,594,19.0,9,6,4.5,5,0,9,46,24,70
p_95,6,0,e_1,527,570,594,19.0,9,5,5.0,5,0,10,43,24,67
p_94,6,0,e_1,528,570,594,19.0,9,5,5.0,2,0,9,42,24,66
p_80,6,0,e_1,548,570,594,1.0,9,0,6.5,4,1,9,22,24,46
p_78,4,0,e_1,555,578,594,2.0,9,1,5.5,4,1,9,23,16,39
p_81,2,0,e_1,547,586,594,5.0,9,3,6.5,4,1,8,39,8,47
p_77,6,0,e_0,557,574,594,29.5,9,9,5.5,4,0,7,17,20,37
p_146,10,0,e_3,451,525,595,22.0,8,8,2.0,4,1,7,74,70,144
p_128,10,0,e_3,471,525,595,19.0,8,2,1.0,5,0,8,54,70,124
p_123,12,0,e_3,474,533,595,16.5,9,2,1.5,5,0,9,59,62,121
p_86,6,0,e_3,541,573,595,17.0,8,3,7.0,5,1,7,32,22,54
p_71,2,0,e_3,569,587,595,1.0,9,0,3.5,4,1,8,18,8,26
p_48,2,0,e_1,593,602,624,28.0,8,8,0.0,3,1,7,9,22,31
p_42,4,0,e_1,600,610,624,25.5,7,5,1.0,5,0,9,10,14,24
p_40,4,0,e_1,601,610,624,25.5,7,5,1.0,2,0,9,9,14,23
p_73,6,0,e_2,568,585,679,27.5,9,9,0.5,5,0,9,17,94,111
p_59,6,0,e_2,584,585,679,25.5,9,9,3.0,2,0,12,1,94,95
p_57,6,0,e_2,587,587,679,25.0,8,8,3.0,2,1,12,0,92,92
p_54,6,0,e_2,590,591,679,24.5,8,8,3.0,5,1,13,1,88,89
p_67,8,0,e_2,574,599,679,25.0,9,9,1.5,5,0,11,25,80,105
p_63,8,0,e_2,581,599,679,24.0,9,9,2.5,5,0,13,18,80,98
p_69,10,0,e_2,573,607,679,23.0,9,9,1.0,5,0,10,34,72,106
p_58,10,0,e_2,586,607,679,21.0,9,9,3.0,2,1,12,21,72,93
p_50,10,0,e_2,592,607,679,20.5,8,8,3.0,5,1,13,15,72,87
p_66,12,0,e_2,577,615,679,20.5,9,9,2.0,5,0,12,38,64,102
p_65,12,0,e_2,578,615,679,20.5,9,9,2.0,5,0,13,37,64,101
p_79,14,0,e_2,549,623,679,23.0,9,9,2.0,4,1,9,74,56,130
p_75,14,0,e_2,563,623,679,20.5,9,9,0.0,4,1,9,60,56,116
p_68,14,0,e_2,574,623,679,19.0,9,9,1.0,5,0,11,49,56,105
p_38,4,0,e_2,627,663,679,21.0,7,4,7.5,5,1,9,36,16,52
p_55,4,0,e_0,590,608,692,27.0,8,8,0.5,4,1,7,18,84,102
p_47,6,0,e_0,594,616,692,24.0,8,8,0.0,3,1,8,22,76,98
p_33,8,0,e_1,647,650,726,28.0,8,8,3.5,5,0,8,3,76,79
p_41,10,0,e_1,600,658,726,19.5,7,2,0.5,5,0,8,58,68,126
p_28,6,0,e_1,679,704,726,24.5,8,8,7.0,4,1,7,25,22,47
p_27,2,0,e_1,693,718,726,27.5,8,7,4.5,4,1,8,25,8,33
p_22,10,0,e_2,712,743,775,16.5,8,3,5.0,5,0,8,31,32,63
p_21,10,0,e_3,732,753,785,13.0,8,3,7.0,5,0,8,21,32,53
p_18,2,0,e_0,768,780,788,1.0,9,0,3.0,4,0,7,12,8,20
p_19,12,0,e_1,740,764,822,24.0,9,9,2.0,5,0,7,24,58,82
p_10,14,0,e_2,810,819,873,12.0,8,1,5.5,5,0,8,9,54,63
p_56,2,0,e_2,588,865,873,29.0,8,8,3.0,2,1,12,277,8,285
p_9,2,0,e_2,845,865,873,3.0,8,1,4.5,4,1,8,20,8,28
p_7,12,0,e_1,851,860,922,21.5,8,8,4.5,5,0,8,9,62,71
p_6,14,0,e_1,858,868,922,18.5,8,8,5.5,5,0,9,10,54,64
p_1,2,0,e_1,889,914,922,26.5,8,7,5.0,4,1,8,25,8,33
p_291,6,0,e_3,35,40,60,6.5,1,0,2.5,5,0,1,5,20,25
p_290,4,0,e_1,43,90,106,29.0,2,2,5.5,5,0,3,47,16,63
p_285,2,0,e_1,54,98,106,29.0,2,2,7.5,3,0,5,44,8,52
p_298,4,0,e_2,10,24,114,4.0,0,0,0.0,3,0,0,14,90,104
p_287,12,0,e_2,51,70,114,19.5,2,2,6.5,5,1,1,19,44,63
p_283,10,0,e_2,55,78,114,21.0,2,2,7.0,5,1,2,23,36,59
p_282,6,0,e_2,62,92,114,6.0,1,0,7.0,4,1,3,30,22,52
p_279,2,0,e_2,76,106,114,15.5,2,1,5.5,4,1,3,30,8,38
p_275,2,0,e_2,84,106,114,14.5,2,1,4.0,4,1,3,22,8,30
p_281,10,0,e_3,63,92,124,9.5,1,0,0.5,5,0,1,29,32,61
p_277,10,0,e_3,81,92,124,7.0,2,0,3.0,5,0,2,11,32,43
p_265,12,0,e_3,157,162,202,7.0,3,0,5.0,5,0,3,5,40,45
p_269,4,0,e_3,146,188,202,14.5,2,1,3.5,5,0,2,42,14,56
p_268,10,0,e_1,150,170,202,8.0,3,1,7.0,5,0,4,20,32,52
p_262,6,0,e_2,164,190,210,30.0,4,4,7.0,4,0,3,26,20,46
p_244,2,0,e_3,271,290,298,2.0,4,0,4.0,4,0,4,19,8,27
p_247,12,0,e_1,248,260,302,10.5,3,1,7.5,5,0,7,12,42,54
p_251,4,0,e_1,228,286,302,22.0,3,2,4.0,5,0,6,58,16,74
p_252,2,0,e_1,212,294,302,26.5,3,2,1.5,5,0,5,82,8,90
p_246,12,0,e_2,257,268,306,23.5,3,3,7.5,3,0,3,11,38,49
p_243,8,0,e_3,285,324,400,23.0,5,5,2.0,4,0,5,39,76,115
p_215,6,0,e_3,346,376,400,1.0,8,8,7.5,3,1,7,30,24,54
p_214,4,0,e_3,346,384,400,3.0,7,7,7.5,3,1,6,38,16,54
p_210,4,0,e_3,353,384,400,2.0,9,1,6.5,4,1,8,31,16,47
p_209,2,0,e_3,354,392,400,4.0,9,2,6.5,4,1,8,38,8,46
p_236,8,0,e_1,313,328,408,20.0,6,4,1.5,5,0,6,15,80,95
p_235,8,0,e_1,314,328,408,19.5,6,4,1.5,5,0,7,14,80,94
p_231,10,0,e_1,320,336,408,16.5,6,3,3.0,5,0,7,16,72,88
p_226,12,0,e_1,331,344,408,13.0,7,2,4.0,5,1,7,13,64,77
p_213,12,0,e_1,347,366,408,25.5,9,9,6.5,5,1,9,19,42,61
p_217,8,0,e_1,345,380,408,15.0,7,4,6.0,5,1,8,35,28,63
p_221,4,0,e_1,341,394,408,19.5,7,4,5.5,5,1,7,53,14,67
p_225,10,0,e_2,333,338,410,14.5,7,3,4.0,5,0,5,5,72,77
p_240,14,0,e_2,301,352,410,16.0,6,1,1.0,4,1,3,51,58,109
p_234,14,0,e_2,314,352,410,13.5,6,1,1.0,5,0,4,38,58,96
p_211,14,0,e_2,348,352,410,23.5,9,9,6.5,5,1,6,4,58,62
p_207,12,0,e_2,355,368,410,24.5,10,10,7.5,5,1,5,13,42,55
p_206,6,0,e_2,362,388,410,29.0,10,10,7.0,4,1,6,26,22,48
p_199,2,0,e_2,368,402,410,2.0,10,0,6.0,4,1,7,34,8,42
p_185,2,0,e_2,392,402,410,29.0,8,8,2.5,4,1,8,10,8,18
p_170,10,0,e_1,408,440,506,19.0,10,5,0.0,3,1,8,32,66,98
p_160,10,0,e_1,421,440,506,17.0,10,5,2.0,5,0,10,19,66,85
p_164,12,0,e_1,416,448,506,16.0,11,3,1.0,5,0,9,32,58,90
p_157,12,0,e_1,427,448,506,14.5,10,3,3.0,5,0,10,21,58,79
p_180,14,0,e_1,396,456,506,16.5,9,9,2.0,4,1,7,60,50,110
p_162,14,0,e_1,417,456,506,14.0,11,1,1.0,5,0,10,39,50,89
p_158,14,0,e_1,426,456,506,12.5,10,1,3.0,5,0,10,30,50,80
p_153,8,0,e_1,438,476,506,16.5,10,6,5.0,5,0,10,38,30,68
p_144,4,0,e_1,451,490,506,19.0,10,5,6.5,5,1,9,39,16,55
p_136,2,0,e_1,460,498,506,5.0,10,1,6.5,4,1,9,38,8,46
p_175,2,0,e_3,399,408,508,2.0,9,9,0.0,3,1,9,9,100,109
p_176,6,0,e_3,398,422,508,24.5,9,9,0.5,4,1,8,24,86,110
p_183,12,0,e_3,393,442,508,19.0,8,8,1.0,4,1,7,49,66,115
p_172,14,0,e_3,405,450,508,15.5,10,1,0.5,5,0,10,45,58,103
p_146,10,0,e_3,451,472,508,13.0,8,3,7.0,5,1,7,21,36,57
p_133,4,0,e_3,463,492,508,2.0,10,1,6.5,4,1,9,29,16,45
p_143,2,0,e_3,451,500,508,21.0,9,5,7.0,5,1,8,49,8,57
p_188,8,0,e_2,390,436,514,23.5,9,9,3.0,4,1,7,46,78,124
p_173,10,0,e_2,405,444,514,19.5,10,4,0.5,4,1,7,39,70,109
p_152,10,0,e_2,439,444,514,14.5,10,5,4.0,5,1,8,5,70,75
p_165,14,0,e_2,416,458,514,14.0,11,1,0.5,5,0,8,42,56,98
p_145,12,0,e_2,451,474,514,11.0,10,2,6.0,5,1,8,23,40,63
p_134,12,0,e_2,462,474,514,24.5,10,10,7.5,5,1,9,12,40,52
p_125,4,0,e_2,474,500,514,1.0,10,0,6.0,1,1,8,26,14,40
p_105,4,0,e_3,515,522,536,25.0,7,6,1.0,5,0,7,7,14,21
p_98,6,0,e_1,524,526,608,26.0,9,9,3.0,5,0,9,2,82,84
p_109,14,0,e_1,506,552,608,16.5,8,8,0.0,3,1,8,46,56,102
p_77,6,0,e_1,557,586,608,21.0,9,6,7.5,4,1,9,29,22,51
p_81,2,0,e_1,547,600,608,27.0,9,7,6.5,5,1,9,53,8,61
p_71,2,0,e_1,569,600,608,23.0,9,6,5.5,4,1,10,31,8,39
p_56,2,0,e_1,588,600,608,21.0,10,6,3.0,4,1,9,12,8,20
p_100,10,0,e_2,522,546,618,22.0,9,9,1.0,5,0,8,24,72,96
p_97,10,0,e_2,526,546,618,21.5,9,9,2.0,5,0,9,20,72,92
p_88,14,0,e_2,538,560,618,16.0,9,1,4.0,5,0,9,22,58,80
p_79,14,0,e_2,549,560,618,14.5,9,1,5.0,5,1,9,11,58,69
p_75,14,0,e_2,563,570,618,12.0,9,1,7.0,5,1,8,7,48,55
p_73,6,0,e_2,568,596,618,19.0,9,6,7.0,4,1,9,28,22,50
p_48,2,0,e_2,593,610,618,5.0,11,11,3.5,4,1,9,17,8,25
p_90,2,0,e_3,536,544,648,2.0,8,8,0.0,3,1,8,8,104,112
p_101,12,0,e_3,521,576,648,16.0,8,2,2.0,5,0,8,55,72,127
p_66,12,0,e_3,577,578,648,12.0,11,3,6.0,5,1,10,1,70,71
p_65,12,0,e_3,578,580,648,12.0,11,3,6.0,5,1,10,2,68,70
p_68,14,0,e_3,574,588,648,10.0,10,1,6.0,5,1,9,14,60,74
p_69,10,0,e_3,573,610,648,14.5,9,4,5.5,5,1,8,37,38,75
p_58,10,0,e_3,586,610,648,13.5,11,4,6.5,5,1,10,24,38,62
p_50,10,0,e_3,592,610,648,3.0,11,11,7.5,3,1,10,18,38,56
p_67,8,0,e_3,574,618,648,16.0,11,7,6.0,5,1,10,44,30,74
p_63,8,0,e_3,581,618,648,16.0,11,6,6.0,5,1,10,37,30,67
p_47,6,0,e_3,594,626,648,1.0,11,0,7.5,4,1,10,32,22,54
p_55,4,0,e_3,590,634,648,19.0,10,6,7.0,5,1,9,44,14,58
p_42,4,0,e_3,600,634,648,2.0,13,1,6.5,4,1,12,34,14,48
p_40,4,0,e_3,601,634,648,2.0,13,1,6.5,4,1,12,33,14,47
p_41,10,0,e_1,600,640,706,26.5,13,13,1.0,4,1,8,40,66,106
p_35,4,0,e_1,640,692,706,27.0,9,9,5.0,5,1,8,52,14,66
p_38,4,0,e_2,627,632,716,29.0,10,10,1.0,5,0,8,5,84,89
p_27,2,0,e_2,693,708,716,21.0,9,4,3.5,4,1,8,15,8,23
p_28,6,0,e_3,679,724,744,19.0,8,5,5.0,5,0,8,45,20,65
p_22,10,0,e_1,712,738,806,24.0,9,9,1.0,5,0,8,26,68,94
p_19,12,0,e_1,740,746,806,18.5,9,9,5.0,5,1,8,6,60,66
p_18,2,0,e_1,768,798,806,24.0,8,6,6.0,4,1,8,30,8,38
p_21,10,0,e_2,732,748,812,22.0,9,9,2.5,5,0,8,16,64,80
p_10,14,0,e_1,810,850,906,19.5,8,8,0.5,5,0,8,40,56,96
p_7,12,0,e_1,851,866,906,16.0,8,2,7.0,5,1,8,15,40,55
p_1,2,0,e_1,889,898,906,5.0,8,2,2.5,4,1,8,9,8,17
p_6,14,0,e_2,858,864,910,13.0,8,1,7.5,5,0,9,6,46,52
p_9,2,0,e_2,845,902,910,27.0,8,7,5.5,5,0,8,57,8,65
p_291,6,0,e_3,35,40,60,6.0,1,0,2.0,5,0,1,5,20,25
p_287,12,0,e_1,51,65,107,19.5,2,2,7.0,5,0,5,14,42,56
p_290,4,0,e_1,43,91,107,28.5,2,2,5.5,5,0,3,48,16,64
p_285,2,0,e_1,54,99,107,29.0,2,2,7.5,3,0,6,45,8,53
p_298,4,0,e_2,10,24,112,4.0,0,0,0.0,3,0,0,14,88,102
p_284,14,0,e_2,55,64,112,17.0,2,2,7.0,5,1,2,9,48,57
p_282,6,0,e_2,62,90,112,6.0,1,0,7.0,4,1,3,28,22,50
p_275,2,0,e_2,84,104,112,14.5,4,2,4.0,4,1,3,20,8,28
p_277,10,0,e_3,81,92,128,9.5,2,0,3.5,5,0,2,11,36,47
p_274,4,0,e_3,84,112,128,12.5,3,1,3.5,5,0,3,28,16,44
p_279,2,0,e_3,76,120,128,2.5,1,0,2.5,5,0,1,44,8,52
p_268,10,0,e_1,150,171,203,6.5,3,0,7.0,5,0,4,21,32,53
p_265,12,0,e_3,157,166,206,7.5,3,0,4.5,5,0,3,9,40,49
p_263,12,0,e_3,163,166,206,6.5,4,0,5.5,5,0,4,3,40,43
p_269,4,0,e_3,146,192,206,7.5,2,1,2.5,5,0,2,46,14,60
p_262,6,0,e_2,164,188,208,12.5,4,2,7.0,4,0,4,24,20,44
p_247,12,0,e_1,248,261,301,5.5,4,0,7.5,5,0,4,13,40,53
p_244,2,0,e_1,271,293,301,3.0,4,1,4.5,4,1,4,22,8,30
p_252,2,0,e_3,212,214,304,11.0,2,1,1.0,5,0,2,2,90,92
p_251,4,0,e_3,228,290,304,7.0,3,1,3.0,5,1,2,62,14,76
p_240,14,0,e_1,301,345,397,16.5,4,4,0.0,3,1,4,44,52,96
p_234,14,0,e_1,314,345,397,13.0,4,0,2.0,5,0,5,31,52,83
p_217,8,0,e_1,345,365,397,12.5,7,2,7.0,2,0,5,20,32,52
p_215,6,0,e_1,346,373,397,14.0,7,3,7.0,4,1,8,27,24,51
p_214,4,0,e_1,346,381,397,16.0,7,3,7.0,4,1,7,35,16,51
p_209,2,0,e_1,354,389,397,17.5,6,2,5.5,4,1,9,35,8,43
p_199,2,0,e_1,368,389,397,4.0,8,1,4.0,4,1,9,21,8,29
p_211,14,0,e_2,348,354,400,8.0,7,0,7.5,5,0,4,6,46,52
p_210,4,0,e_2,353,386,400,15.5,6,2,7.0,4,0,6,33,14,47
p_238,2,0,e_3,311,312,416,23.0,3,2,1.0,5,0,3,1,104,105
p_235,8,0,e_3,314,332,416,17.0,4,1,1.0,5,1,3,18,84,102
p_231,10,0,e_3,320,340,416,14.0,6,1,2.0,5,1,5,20,76,96
p_225,10,0,e_3,333,340,416,12.0,7,2,4.0,5,1,6,7,76,83
p_226,12,0,e_3,331,348,416,10.0,6,1,4.0,2,1,5,17,68,85
p_213,12,0,e_3,347,348,416,8.0,6,1,6.0,2,1,5,1,68,69
p_207,12,0,e_3,355,372,416,7.5,6,1,6.5,5,1,5,17,44,61
p_206,6,0,e_3,362,392,416,1.0,7,0,7.5,4,1,6,30,24,54
p_221,4,0,e_3,341,400,416,17.0,6,3,5.0,5,1,5,59,16,75
p_233,2,0,e_3,319,408,416,22.0,5,3,2.0,5,1,4,89,8,97
p_185,2,0,e_3,392,408,416,1.0,7,0,3.0,4,1,6,16,8,24
p_163,4,0,e_3,417,430,444,22.0,5,4,0.0,5,0,5,13,14,27
p_179,6,0,e_1,397,417,495,26.5,7,7,0.0,5,0,6,20,78,98
p_176,6,0,e_1,398,417,495,26.5,7,7,0.0,5,0,7,19,78,97
p_173,10,0,e_1,405,431,495,21.5,6,6,1.0,5,0,8,26,64,90
p_170,10,0,e_1,408,431,495,21.0,5,5,1.5,5,0,9,23,64,87
p_172,14,0,e_1,405,445,495,17.5,6,6,1.0,5,0,7,40,50,90
p_165,14,0,e_1,416,445,495,14.0,5,0,3.0,2,0,8,29,50,79
p_162,14,0,e_1,417,445,495,14.0,6,0,3.0,5,1,8,28,50,78
p_158,14,0,e_1,426,445,495,12.5,7,0,4.5,5,1,8,19,50,69
p_152,10,0,e_1,439,459,495,21.0,7,7,6.0,5,1,8,20,36,56
p_153,8,0,e_1,438,467,495,23.0,7,7,6.0,5,1,7,29,28,57
p_144,4,0,e_1,451,481,495,21.0,7,5,6.5,4,1,8,30,14,44
p_133,4,0,e_1,463,481,495,23.0,8,6,4.5,4,1,8,18,14,32
p_143,2,0,e_2,451,488,496,23.0,7,6,7.0,4,0,7,37,8,45
p_136,2,0,e_2,460,488,496,25.5,8,7,5.5,4,0,8,28,8,36
p_160,10,0,e_3,421,476,554,15.5,6,2,0.5,5,0,6,55,78,133
p_146,10,0,e_3,451,476,554,15.0,7,2,1.0,5,0,7,25,78,103
p_128,10,0,e_3,471,476,554,16.0,9,3,4.0,5,0,9,5,78,83
p_164,12,0,e_3,416,484,554,12.0,4,4,0.0,3,1,4,68,70,138
p_157,12,0,e_3,427,484,554,12.5,7,1,1.5,5,0,7,57,70,127
p_145,12,0,e_3,451,484,554,13.0,7,1,1.0,5,0,7,33,70,103
p_134,12,0,e_3,462,484,554,15.0,8,2,3.0,5,0,8,22,70,92
p_123,12,0,e_3,474,484,554,13.0,10,2,5.0,5,0,10,10,70,80
p_124,14,0,e_3,474,492,554,11.0,10,1,5.0,5,0,10,18,62,80
p_117,12,0,e_3,490,508,554,11.5,10,3,6.5,5,1,9,18,46,64
p_115,10,0,e_3,494,516,554,13.0,10,3,7.0,5,1,9,22,38,60
p_126,6,0,e_3,473,530,554,19.5,9,6,4.5,5,0,9,57,24,81
p_106,4,0,e_3,512,538,554,1.0,10,0,5.5,4,1,9,26,16,42
p_105,4,0,e_3,515,538,554,1.0,11,0,5.0,4,1,10,23,16,39
p_102,2,0,e_3,521,546,554,2.0,10,1,4.5,4,1,9,25,8,33
p_100,10,0,e_1,522,527,597,24.0,11,11,4.5,5,0,8,5,70,75
p_109,14,0,e_1,506,541,597,22.0,11,11,1.5,5,0,7,35,56,91
p_80,6,0,e_1,548,575,597,25.0,8,8,7.5,4,1,8,27,22,49
p_81,2,0,e_1,547,589,597,29.0,8,8,7.5,4,1,7,42,8,50
p_71,2,0,e_1,569,589,597,26.0,10,9,4.0,4,1,9,20,8,28
p_97,10,0,e_2,526,528,600,23.5,11,11,4.5,5,0,8,2,72,74
p_101,12,0,e_2,521,536,600,22.5,10,10,4.0,5,0,7,15,64,79
p_88,14,0,e_2,538,544,600,18.0,9,9,6.0,5,1,7,6,56,62
p_77,6,0,e_2,557,578,600,23.5,7,4,6.5,4,1,8,21,22,43
p_78,4,0,e_2,555,586,600,26.0,7,5,7.0,4,1,7,31,14,45
p_42,4,0,e_1,600,611,625,19.5,13,7,0.5,5,0,7,11,14,25
p_73,6,0,e_3,568,574,664,22.0,9,6,2.0,5,0,9,6,90,96
p_67,8,0,e_3,574,582,664,19.0,10,6,3.0,2,0,10,8,82,90
p_69,10,0,e_3,573,590,664,17.0,10,4,3.0,5,0,10,17,74,91
p_58,10,0,e_3,586,590,664,15.5,11,4,4.5,5,1,10,4,74,78
p_75,14,0,e_3,563,604,664,15.0,7,1,1.0,5,0,7,41,60,101
p_50,10,0,e_3,592,626,664,15.0,12,4,5.0,5,1,11,34,38,72
p_41,10,0,e_3,600,626,664,13.5,13,4,6.5,5,1,12,26,38,64
p_54,6,0,e_3,590,640,664,19.0,11,6,5.0,5,1,10,50,24,74
p_47,6,0,e_3,594,640,664,18.5,13,7,5.5,5,1,12,46,24,70
p_38,4,0,e_3,627,648,664,1.0,11,0,5.0,4,1,10,21,16,37
p_90,2,0,e_3,536,656,664,0.0,10,0,2.5,4,1,9,120,8,128
p_56,2,0,e_3,588,656,664,23.0,11,7,5.0,5,1,10,68,8,76
p_33,8,0,e_2,647,670,696,24.0,10,10,7.5,3,0,8,23,26,49
p_28,6,0,e_1,679,701,723,22.0,8,5,6.5,4,0,7,22,22,44
p_27,2,0,e_1,693,715,723,23.5,8,6,4.5,4,0,8,22,8,30
p_19,12,0,e_2,740,754,796,20.0,8,8,7.0,5,0,9,14,42,56
p_21,10,0,e_2,732,762,796,23.0,8,8,6.0,5,0,8,30,34,64
p_18,2,0,e_2,768,788,796,26.5,8,7,4.0,4,1,8,20,8,28
p_10,14,0,e_2,810,840,894,22.0,8,8,2.0,5,0,8,30,54,84
p_9,2,0,e_2,845,886,894,28.0,8,8,7.5,4,1,8,41,8,49
p_7,12,0,e_1,851,855,917,12.0,8,8,5.5,5,0,7,4,62,66
p_6,14,0,e_1,858,863,917,15.5,8,1,6.5,5,1,7,5,54,59
p_1,2,0,e_1,889,909,917,22.0,8,5,4.0,4,1,7,20,8,28
p_287,12,0,e_1,51,65,105,13.0,2,1,7.0,5,0,3,14,40,54
p_279,2,0,e_1,76,97,105,5.0,4,4,4.5,4,1,3,21,8,29
p_300,8,0,e_0,4,31,107,8.0,0,0,0.0,3,0,0,27,76,103
p_282,6,0,e_0,62,83,107,17.5,3,2,6.5,4,1,3,21,24,45
p_290,4,0,e_0,43,91,107,22.5,2,2,5.5,5,1,1,48,16,64
p_285,2,0,e_0,54,99,107,22.5,2,2,7.5,4,1,2,45,8,53
p_275,2,0,e_0,84,99,107,5.0,5,5,3.0,4,1,3,15,8,23
p_298,4,0,e_2,10,25,111,4.0,0,0,0.0,3,0,0,15,86,101
p_283,10,0,e_2,55,77,111,14.0,3,3,7.0,5,1,4,22,34,56
p_291,6,0,e_2,35,91,111,21.5,2,2,3.5,5,1,1,56,20,76
p_268,10,0,e_0,150,171,203,12.5,6,2,7.0,5,0,2,21,32,53
p_265,12,0,e_2,157,169,211,10.5,6,1,7.5,5,0,5,12,42,54
p_262,6,0,e_2,164,189,211,1.0,6,6,7.0,4,0,6,25,22,47
p_269,4,0,e_2,146,197,211,18.5,6,3,5.5,5,0,3,51,14,65
p_261,12,0,e_0,170,241,301,10.5,6,1,5.0,1,0,3,71,60,131
p_244,2,0,e_0,271,293,301,20.5,8,4,4.5,4,1,5,22,8,30
p_252,2,0,e_2,212,219,315,20.5,8,4,0.0,5,0,4,7,96,103
p_247,12,0,e_2,248,251,315,5.0,8,8,5.5,5,1,5,3,64,67
p_246,12,0,e_2,257,273,315,5.0,8,8,7.0,5,1,5,16,42,58
p_243,8,0,e_2,285,287,315,1.0,8,8,4.0,4,1,5,2,28,30
p_251,4,0,e_2,228,301,315,18.5,8,4,2.0,5,1,4,73,14,87
p_242,4,0,e_2,287,301,315,3.0,8,8,4.0,1,1,5,14,14,28
p_235,8,0,e_1,314,319,395,1.0,8,8,3.0,5,0,7,5,76,81
p_215,6,0,e_1,346,371,395,1.0,9,9,7.0,4,1,7,25,24,49
p_214,4,0,e_1,346,379,395,3.0,9,9,7.0,4,1,8,33,16,49
p_199,2,0,e_1,368,387,395,20.5,11,7,3.5,4,1,9,19,8,27
p_236,8,0,e_0,313,327,403,1.0,8,8,1.5,5,0,6,14,76,90
p_240,14,0,e_0,301,347,403,7.0,8,8,0.0,5,0,5,46,56,102
p_234,14,0,e_0,314,347,403,8.5,8,1,2.0,5,0,7,33,56,89
p_221,4,0,e_0,341,387,403,3.0,9,9,6.0,5,1,7,46,16,62
p_210,4,0,e_0,353,387,403,18.5,10,6,7.5,4,1,8,34,16,50
p_209,2,0,e_0,354,395,403,20.5,10,6,7.5,4,1,8,41,8,49
p_238,2,0,e_2,311,323,423,20.5,8,4,0.5,4,1,4,12,100,112
p_233,2,0,e_2,319,323,423,20.5,8,4,0.5,5,0,5,4,100,104
p_231,10,0,e_2,320,349,423,12.5,8,2,0.5,5,0,5,29,74,103
p_213,12,0,e_2,347,357,423,10.5,9,2,5.0,5,1,8,10,66,76
p_207,12,0,e_2,355,357,423,10.5,10,3,5.5,5,1,8,2,66,68
p_203,12,0,e_2,365,379,423,10.5,10,3,7.0,5,1,9,14,44,58
p_217,8,0,e_2,345,393,423,14.5,9,4,4.5,5,1,7,48,30,78
p_204,8,0,e_2,364,393,423,14.5,10,5,7.0,5,1,9,29,30,59
p_206,6,0,e_2,362,401,423,16.5,10,6,6.5,5,1,8,39,22,61
p_185,2,0,e_2,392,415,423,20.5,12,8,4.0,4,1,9,23,8,31
p_175,2,0,e_2,399,415,423,5.0,12,12,3.0,4,1,9,16,8,24
p_179,6,0,e_1,397,415,505,1.0,12,12,0.0,5,0,10,18,90,108
p_188,8,0,e_1,390,423,505,14.5,12,7,0.5,4,1,8,33,82,115
p_170,10,0,e_1,408,431,505,12.5,12,5,2.0,5,0,11,23,74,97
p_160,10,0,e_1,421,431,505,12.5,12,5,3.5,5,1,11,10,74,84
p_180,14,0,e_1,396,445,505,7.0,12,12,0.0,5,0,9,49,60,109
p_165,14,0,e_1,416,445,505,7.0,12,12,3.0,5,1,11,29,60,89
p_162,14,0,e_1,417,445,505,7.0,12,12,3.0,5,1,11,28,60,88
p_152,10,0,e_1,439,467,505,12.5,12,5,6.0,5,1,10,28,38,66
p_153,8,0,e_1,438,475,505,1.0,12,12,6.0,5,1,9,37,30,67
p_144,4,0,e_1,451,489,505,3.0,12,12,7.5,4,1,11,38,16,54
p_143,2,0,e_1,451,497,505,20.5,12,8,7.5,4,1,10,46,8,54
p_176,6,0,e_0,398,423,511,16.5,12,8,0.5,4,1,8,25,88,113
p_173,10,0,e_0,405,437,511,3.0,12,12,0.0,5,0,10,32,74,106
p_164,12,0,e_0,416,445,511,5.0,12,12,2.0,5,0,11,29,66,95
p_172,14,0,e_0,405,453,511,8.5,12,1,0.0,5,0,9,48,58,106
p_146,10,0,e_0,451,475,511,12.5,12,5,7.0,5,1,9,24,36,60
p_133,4,0,e_0,463,495,511,3.0,12,12,7.0,4,1,10,32,16,48
p_125,4,0,e_0,474,495,511,18.5,12,8,5.0,4,1,11,21,16,37
p_136,2,0,e_0,460,503,511,20.5,12,8,7.5,4,1,9,43,8,51
p_163,4,0,e_2,417,437,533,3.0,12,12,1.0,4,1,7,20,96,116
p_157,12,0,e_2,427,463,533,10.5,12,3,0.5,5,0,9,36,70,106
p_145,12,0,e_2,451,463,533,10.5,12,3,4.0,5,1,9,12,70,82
p_134,12,0,e_2,462,463,533,5.0,12,12,6.0,5,1,9,1,70,71
p_158,14,0,e_2,426,471,533,7.0,12,12,0.0,5,0,8,45,62,107
p_124,14,0,e_2,474,481,533,8.5,12,1,7.0,5,1,10,7,52,59
p_123,12,0,e_2,474,489,533,5.0,12,12,7.0,5,1,9,15,44,59
p_128,10,0,e_2,471,497,533,12.5,12,5,7.0,2,1,7,26,36,62
p_126,6,0,e_2,473,511,533,16.5,12,8,7.0,5,1,8,38,22,60
p_118,4,0,e_2,488,519,533,3.0,12,12,6.0,4,1,10,31,14,45
p_115,10,0,e_1,494,537,607,3.0,13,13,1.5,4,1,9,43,70,113
p_100,10,0,e_1,522,537,607,3.0,13,13,2.5,5,0,10,15,70,85
p_97,10,0,e_1,526,537,607,3.0,13,13,3.0,5,0,11,11,70,81
p_109,14,0,e_1,506,551,607,7.0,13,13,0.0,5,0,9,45,56,101
p_98,6,0,e_1,524,585,607,16.5,13,8,3.0,5,0,10,61,22,83
p_77,6,0,e_1,557,585,607,16.5,13,8,7.5,4,1,10,28,22,50
p_90,2,0,e_1,536,599,607,20.5,13,8,5.0,2,0,10,63,8,71
p_71,2,0,e_1,569,599,607,20.5,13,8,5.5,4,1,10,30,8,38
p_56,2,0,e_1,588,599,607,20.5,13,8,2.5,4,1,9,11,8,19
p_106,4,0,e_0,512,525,617,18.5,13,8,0.0,5,0,8,13,92,105
p_105,4,0,e_0,515,525,617,18.5,13,8,0.5,5,0,9,10,92,102
p_95,6,0,e_0,527,533,617,16.5,13,8,2.0,5,1,10,6,84,90
p_101,12,0,e_0,521,553,617,5.0,13,13,1.5,5,0,10,32,64,96
p_73,6,0,e_0,568,593,617,16.5,13,8,7.0,4,1,10,25,24,49
p_78,4,0,e_0,555,601,617,18.5,13,8,6.0,5,1,9,46,16,62
p_102,2,0,e_0,521,609,617,5.0,13,13,1.5,5,0,9,88,8,96
p_81,2,0,e_0,547,609,617,20.5,13,8,5.0,5,1,10,62,8,70
p_48,2,0,e_0,593,609,617,20.5,13,8,3.0,4,1,10,16,8,24
p_94,6,0,e_2,528,553,641,16.5,13,8,0.5,4,1,8,25,88,113
p_86,6,0,e_2,541,553,641,1.0,13,13,1.0,5,0,10,12,88,100
p_80,6,0,e_2,548,553,641,1.0,13,13,2.5,5,0,10,5,88,93
p_88,14,0,e_2,538,579,641,7.0,13,13,0.5,5,0,9,41,62,103
p_79,14,0,e_2,549,579,641,8.5,13,1,2.5,5,0,10,30,62,92
p_75,14,0,e_2,563,579,641,8.5,13,1,4.5,5,1,9,16,62,78
p_68,14,0,e_2,574,579,641,7.0,13,13,6.0,5,1,11,5,62,67
p_66,12,0,e_2,577,595,641,5.0,13,13,7.0,5,1,11,18,46,64
p_65,12,0,e_2,578,595,641,5.0,13,13,7.0,5,1,12,17,46,63
p_69,10,0,e_2,573,603,641,12.5,13,5,6.0,5,1,9,30,38,68
p_67,8,0,e_2,574,611,641,1.0,13,13,6.0,5,1,10,37,30,67
p_63,8,0,e_2,581,611,641,14.5,13,7,7.0,5,1,11,30,30,60
p_59,6,0,e_2,584,619,641,16.5,13,8,7.5,4,1,11,35,22,57
p_57,6,0,e_2,587,619,641,1.0,13,13,7.5,4,1,12,32,22,54
p_54,6,0,e_2,590,619,641,1.0,13,13,6.5,4,1,13,29,22,51
p_47,6,0,e_1,594,627,705,1.0,13,13,2.0,4,1,9,33,78,111
p_35,4,0,e_1,640,691,705,18.5,13,8,5.0,5,1,8,51,14,65
p_38,4,0,e_0,627,631,715,18.5,13,8,1.5,5,0,8,4,84,88
p_27,2,0,e_0,693,707,715,5.0,13,13,3.0,4,1,8,14,8,22
p_33,8,0,e_2,647,667,739,1.0,13,13,1.0,5,0,8,20,72,92
p_28,6,0,e_2,679,719,739,1.0,13,13,6.0,5,1,8,40,20,60
p_22,10,0,e_1,712,737,803,12.5,13,5,1.0,5,0,8,25,66,91
p_18,2,0,e_1,768,795,803,5.0,13,13,5.5,4,1,8,27,8,35
p_21,10,0,e_0,732,747,811,12.5,13,5,2.5,5,0,8,15,64,79
p_19,12,0,e_2,740,777,835,10.5,13,3,0.0,5,0,8,37,58,95
p_10,14,0,e_1,810,847,899,7.0,13,13,1.0,5,0,8,37,52,89
p_9,2,0,e_0,845,899,907,5.0,13,13,5.5,5,0,8,54,8,62
p_1,2,0,e_0,889,899,907,5.0,13,13,2.5,4,0,9,10,8,18
p_7,12,0,e_2,851,873,933,5.0,13,13,2.5,5,0,8,22,60,82
p_6,14,0,e_2,858,881,933,7.0,13,13,3.5,5,0,9,23,52,75
p_298,4,0,e_2,10,24,38,4.0,0,0,0.0,3,0,0,14,14,28
p_291,6,0,e_3,35,41,61,6.0,1,0,2.0,5,0,1,6,20,26
p_300,8,0,e_0,4,30,106,8.0,0,0,0.0,3,0,0,26,76,102
p_297,12,0,e_0,18,44,106,12.0,0,0,2.0,5,0,1,26,62,88
p_282,6,0,e_0,62,84,106,6.0,1,0,6.5,4,1,2,22,22,44
p_275,2,0,e_0,84,98,106,14.5,5,3,3.0,4,1,2,14,8,22
p_284,14,0,e_1,55,60,108,17.0,2,2,7.5,3,0,5,5,48,53
p_287,12,0,e_1,51,68,108,19.5,2,2,7.0,5,0,3,17,40,57
p_285,2,0,e_1,54,100,108,29.0,2,2,7.5,3,0,4,46,8,54
p_277,10,0,e_3,81,93,129,9.0,2,0,3.0,5,0,2,12,36,48
p_274,4,0,e_3,84,113,129,12.5,4,2,3.5,5,0,4,29,16,45
p_279,2,0,e_3,76,121,129,2.0,1,0,2.0,5,0,1,45,8,53
p_290,4,0,e_2,43,58,144,29.0,2,2,0.0,3,0,0,15,86,101
p_283,10,0,e_2,55,78,144,21.0,2,2,1.5,5,0,3,23,66,89
p_281,10,0,e_2,63,78,144,10.0,1,0,2.5,5,1,3,15,66,81
p_280,12,0,e_2,65,86,144,11.5,1,0,3.0,5,1,3,21,58,79
p_268,10,0,e_1,150,172,204,6.5,4,0,6.5,5,0,3,22,32,54
p_265,12,0,e_3,157,167,233,13.5,5,1,4.5,5,0,5,10,66,76
p_263,12,0,e_3,163,167,233,12.5,6,1,5.5,5,0,6,4,66,70
p_261,12,0,e_3,170,189,233,11.5,7,1,6.5,5,1,6,19,44,63
p_262,6,0,e_3,164,209,233,18.5,6,3,5.5,5,0,6,45,24,69
p_259,6,0,e_3,174,209,233,17.0,9,3,7.0,5,1,8,35,24,59
p_269,4,0,e_3,146,217,233,7.5,3,2,2.5,5,0,3,71,16,87
p_252,2,0,e_3,212,225,233,1.0,8,0,3.0,4,1,7,13,8,21
p_257,12,0,e_2,179,182,244,25.5,9,9,5.5,5,0,4,3,62,65
p_255,10,0,e_2,192,210,244,26.0,8,8,7.5,3,1,5,18,34,52
p_256,8,0,e_2,191,218,244,28.0,8,8,7.0,5,1,4,27,26,53
p_244,2,0,e_0,271,288,296,22.0,7,4,4.0,4,0,4,17,8,25
p_247,12,0,e_1,248,262,302,15.5,6,2,7.0,5,0,5,14,40,54
p_251,4,0,e_1,228,288,302,26.5,7,7,3.5,5,0,3,60,14,74
p_246,12,0,e_3,257,271,333,14.5,6,2,3.5,5,0,6,14,62,76
p_242,4,0,e_3,287,317,333,3.0,8,1,7.0,4,1,7,30,16,46
p_238,2,0,e_3,311,325,333,1.0,9,0,3.0,4,1,8,14,8,22
p_243,8,0,e_2,285,314,342,29.5,8,8,6.5,5,0,4,29,28,57
p_233,2,0,e_2,319,334,342,30.0,9,9,3.5,4,1,4,15,8,23
p_226,12,0,e_0,331,334,398,18.0,8,8,5.5,5,0,6,3,64,67
p_215,6,0,e_0,346,374,398,22.0,8,5,7.5,4,1,6,28,24,52
p_214,4,0,e_0,346,382,398,24.0,8,6,7.5,4,1,7,36,16,52
p_210,4,0,e_0,353,382,398,23.0,8,6,6.5,4,1,8,29,16,45
p_209,2,0,e_0,354,390,398,25.0,8,6,6.5,4,1,8,36,8,44
p_236,8,0,e_1,313,328,400,24.5,10,10,1.5,5,0,6,15,72,87
p_235,8,0,e_1,314,328,400,24.5,10,10,1.5,5,0,7,14,72,86
p_231,10,0,e_1,320,336,400,22.0,9,9,3.0,5,0,7,16,64,80
p_240,14,0,e_1,301,350,400,20.5,9,9,0.0,3,1,4,49,50,99
p_234,14,0,e_1,314,350,400,18.5,10,10,1.5,5,0,7,36,50,86
p_211,14,0,e_1,348,350,400,14.0,8,1,7.0,5,1,9,2,50,52
p_213,12,0,e_1,347,358,400,16.0,8,2,6.5,5,1,8,11,42,53
p_217,8,0,e_1,345,372,400,20.0,8,4,6.0,5,1,7,27,28,55
p_199,2,0,e_1,368,392,400,22.5,11,7,4.5,4,1,8,24,8,32
p_225,10,0,e_3,333,365,439,10.0,7,7,0.0,3,1,7,32,74,106
p_203,12,0,e_3,365,373,439,13.0,9,2,5.0,2,0,9,8,66,74
p_200,12,0,e_3,367,373,439,13.0,11,2,5.0,5,1,10,6,66,72
p_193,12,0,e_3,378,395,439,11.5,11,2,6.5,5,1,10,17,44,61
p_204,8,0,e_3,364,409,439,17.0,8,3,5.0,2,0,8,45,30,75
p_197,8,0,e_3,375,409,439,16.0,10,3,6.0,5,1,9,34,30,64
p_206,6,0,e_3,362,417,439,19.5,8,5,4.5,5,0,8,55,22,77
p_185,2,0,e_3,392,431,439,4.0,12,2,6.5,4,1,11,39,8,47
p_221,4,0,e_2,341,356,450,25.0,8,6,0.0,3,1,4,15,94,109
p_207,12,0,e_2,355,382,450,14.5,8,2,2.0,3,0,6,27,68,95
p_190,14,0,e_2,382,390,450,9.0,12,1,6.0,5,1,6,8,60,68
p_183,12,0,e_2,393,406,450,24.5,13,13,7.5,5,1,7,13,44,57
p_188,8,0,e_2,390,420,450,29.0,12,12,7.0,2,1,6,30,30,60
p_179,6,0,e_2,397,428,450,30.0,12,12,7.5,4,1,8,31,22,53
p_176,6,0,e_2,398,428,450,30.0,12,12,7.5,4,1,9,30,22,52
p_163,4,0,e_2,417,436,450,29.0,10,10,4.5,4,1,8,19,14,33
p_180,14,0,e_0,396,442,498,22.0,12,12,0.0,4,1,6,46,56,102
p_144,4,0,e_0,451,482,498,24.5,9,7,7.0,4,1,9,31,16,47
p_133,4,0,e_0,463,482,498,22.5,10,8,5.0,4,1,10,19,16,35
p_143,2,0,e_0,451,490,498,26.5,8,7,7.0,4,1,8,39,8,47
p_175,2,0,e_1,399,408,500,3.0,12,1,0.0,3,1,7,9,92,101
p_173,10,0,e_1,405,434,500,24.5,12,12,0.5,5,0,8,29,66,95
p_170,10,0,e_1,408,434,500,24.0,11,11,1.0,5,1,9,26,66,92
p_160,10,0,e_1,421,434,500,22.5,10,10,3.0,5,1,10,13,66,79
p_164,12,0,e_1,416,442,500,21.0,10,10,2.0,5,1,9,26,58,84
p_157,12,0,e_1,427,442,500,19.5,10,10,4.0,5,1,10,15,58,73
p_172,14,0,e_1,405,450,500,20.5,12,12,0.5,5,0,9,45,50,95
p_165,14,0,e_1,416,450,500,19.0,11,11,2.0,5,1,9,34,50,84
p_162,14,0,e_1,417,450,500,19.0,10,10,2.5,5,1,10,33,50,83
p_158,14,0,e_1,426,450,500,18.0,10,10,3.5,5,1,10,24,50,74
p_152,10,0,e_1,439,464,500,20.0,8,3,5.5,5,1,10,25,36,61
p_153,8,0,e_1,438,472,500,22.0,9,9,5.5,5,1,9,34,28,62
p_136,2,0,e_1,460,492,500,25.0,10,8,5.5,4,1,9,32,8,40
p_146,10,0,e_3,451,471,549,18.5,8,3,1.5,5,0,8,20,78,98
p_128,10,0,e_3,471,471,549,15.0,9,4,5.0,2,0,9,0,78,78
p_145,12,0,e_3,451,481,549,16.5,9,2,1.5,5,0,9,30,68,98
p_134,12,0,e_3,462,481,549,14.5,10,2,3.5,5,0,10,19,68,87
p_124,14,0,e_3,474,489,549,11.0,11,1,5.0,5,1,10,15,60,75
p_117,12,0,e_3,490,505,549,11.0,12,2,7.0,5,1,11,15,44,59
p_120,10,0,e_3,481,513,549,14.0,11,4,6.0,5,1,10,32,36,68
p_126,6,0,e_3,473,527,549,19.0,10,6,5.0,2,1,9,54,22,76
p_118,4,0,e_3,488,535,549,19.0,11,5,7.0,2,1,10,47,14,61
p_123,12,0,e_2,474,488,552,13.0,12,3,4.0,5,0,7,14,64,78
p_115,10,0,e_2,494,516,552,27.5,13,13,7.0,5,1,8,22,36,58
p_125,4,0,e_2,474,536,552,21.0,11,7,3.5,5,0,6,62,16,78
p_106,4,0,e_2,512,536,552,1.0,11,0,5.5,4,1,10,24,16,40
p_105,4,0,e_2,515,536,552,1.0,11,0,5.0,4,1,10,21,16,37
p_102,2,0,e_2,521,544,552,2.0,11,1,4.5,4,1,9,23,8,31
p_100,10,0,e_1,522,532,596,23.5,11,11,3.5,5,0,9,10,64,74
p_97,10,0,e_1,526,532,596,23.0,10,10,4.0,5,0,11,6,64,70
p_101,12,0,e_1,521,540,596,22.0,11,11,3.0,5,0,8,19,56,75
p_109,14,0,e_1,506,548,596,22.0,12,12,0.5,5,0,7,42,48,90
p_88,14,0,e_1,538,548,596,17.5,9,9,5.5,5,1,11,10,48,58
p_98,6,0,e_1,524,574,596,27.5,11,11,4.0,5,0,10,50,22,72
p_95,6,0,e_1,527,574,596,27.0,10,10,4.5,5,0,11,47,22,69
p_94,6,0,e_1,528,574,596,27.0,10,10,4.5,5,0,11,46,22,68
p_86,6,0,e_1,541,574,596,25.5,9,9,6.0,5,1,10,33,22,55
p_90,2,0,e_1,536,588,596,30.0,9,9,5.5,5,1,10,52,8,60
p_71,2,0,e_1,569,588,596,25.0,10,7,3.5,4,1,9,19,8,27
p_80,6,0,e_0,548,574,598,6.0,8,8,7.5,4,0,9,26,24,50
p_78,4,0,e_0,555,582,598,25.0,9,7,6.0,4,0,10,27,16,43
p_81,2,0,e_0,547,590,598,28.5,9,9,7.5,4,0,8,43,8,51
p_77,6,0,e_3,557,569,659,23.0,9,6,1.0,5,0,9,12,90,102
p_69,10,0,e_3,573,583,659,16.5,10,4,3.5,5,1,9,10,76,86
p_66,12,0,e_3,577,591,659,14.0,11,3,4.0,5,1,10,14,68,82
p_79,14,0,e_3,549,599,659,14.0,8,8,0.0,3,1,8,50,60,110
p_75,14,0,e_3,563,599,659,14.0,10,1,2.0,5,0,10,36,60,96
p_68,14,0,e_3,574,599,659,12.5,11,1,3.5,5,1,10,25,60,85
p_58,10,0,e_3,586,621,659,14.5,12,5,5.5,5,1,11,35,38,73
p_41,10,0,e_3,600,621,659,13.0,13,3,7.0,5,1,12,21,38,59
p_59,6,0,e_3,584,635,659,19.0,11,7,5.0,5,1,10,51,24,75
p_54,6,0,e_3,590,635,659,18.0,14,7,6.0,2,1,13,45,24,69
p_47,6,0,e_3,594,635,659,17.5,14,7,6.5,5,1,13,41,24,65
p_55,4,0,e_3,590,643,659,20.0,14,8,6.0,5,1,13,53,16,69
p_42,4,0,e_3,600,643,659,19.0,13,5,7.0,5,1,12,43,16,59
p_40,4,0,e_3,601,643,659,19.0,13,5,7.0,5,1,12,42,16,58
p_56,2,0,e_3,588,651,659,22.5,13,9,5.5,5,1,12,63,8,71
p_73,6,0,e_2,568,572,662,21.0,10,6,2.5,5,0,8,4,90,94
p_67,8,0,e_2,574,580,662,18.5,11,6,3.0,5,1,8,6,82,88
p_65,12,0,e_2,578,594,662,14.0,12,3,3.5,5,1,9,16,68,84
p_50,10,0,e_2,592,622,662,14.0,14,4,6.0,5,1,11,30,40,70
p_63,8,0,e_2,581,630,662,17.5,12,7,4.0,5,1,9,49,32,81
p_57,6,0,e_2,587,638,662,18.5,13,8,5.0,5,1,10,51,24,75
p_38,4,0,e_2,627,646,662,30.0,12,12,4.5,4,1,11,19,16,35
p_48,2,0,e_2,593,654,662,22.0,14,7,6.0,5,1,12,61,8,69
p_35,4,0,e_1,640,678,692,28.5,11,11,7.0,5,0,8,38,14,52
p_33,8,0,e_3,647,685,757,23.5,10,10,1.5,4,1,9,38,72,110
p_28,6,0,e_3,679,737,757,21.0,9,6,3.0,5,0,9,58,20,78
p_27,2,0,e_2,693,750,758,23.0,10,6,5.0,5,0,8,57,8,65
p_21,10,0,e_1,732,756,788,23.5,10,10,6.5,5,0,8,24,32,56
p_22,10,0,e_0,712,724,792,27.0,10,10,3.0,5,0,8,12,68,80
p_19,12,0,e_0,740,752,792,20.5,9,9,7.5,3,1,8,12,40,52
p_18,2,0,e_0,768,784,792,26.5,8,7,3.5,4,1,8,16,8,24
p_10,14,0,e_1,810,832,886,21.5,8,8,3.5,5,0,8,22,54,76
p_9,2,0,e_1,845,878,886,28.0,8,8,6.5,4,1,8,33,8,41
p_6,14,0,e_3,858,895,947,15.0,8,1,1.0,5,0,8,37,52,89
p_7,12,0,e_2,851,890,950,18.0,8,2,0.0,3,0,8,39,60,99
p_1,2,0,e_2,889,942,950,22.0,9,6,6.0,5,0,9,53,8,61
p_287,12,0,e_1,51,65,103,13.0,2,1,7.0,5,0,3,14,38,52
p_300,8,0,e_0,4,31,105,8.0,0,0,0.0,3,0,0,27,74,101
p_282,6,0,e_0,62,83,105,17.5,3,2,6.5,4,1,2,21,22,43
p_285,2,0,e_0,54,97,105,22.5,2,2,7.5,3,1,1,43,8,51
p_279,2,0,e_0,76,97,105,5.0,4,4,4.0,4,1,3,21,8,29
p_275,2,0,e_0,84,97,105,5.0,6,6,3.0,4,1,2,13,8,21
p_298,4,0,e_2,10,25,113,4.0,0,0,0.0,3,0,0,15,88,103
p_283,10,0,e_2,55,77,113,14.0,2,2,7.0,5,1,5,22,36,58
p_291,6,0,e_2,35,91,113,21.5,2,2,3.5,5,1,1,56,22,78
p_290,4,0,e_2,43,99,113,22.0,2,2,5.0,5,1,2,56,14,70
p_259,6,0,e_1,174,179,199,16.5,7,4,4.0,4,0,3,5,20,25
p_268,10,0,e_2,150,177,213,12.5,6,2,6.0,5,0,4,27,36,63
p_262,6,0,e_2,164,191,213,1.0,6,6,7.0,4,0,6,27,22,49
p_269,4,0,e_2,146,199,213,3.0,6,6,5.5,5,0,3,53,14,67
p_252,2,0,e_0,212,287,295,20.5,8,5,2.0,5,0,4,75,8,83
p_251,4,0,e_1,228,281,297,3.0,8,8,4.5,5,0,4,53,16,69
p_244,2,0,e_1,271,289,297,20.5,9,6,3.5,4,0,5,18,8,26
p_247,12,0,e_2,248,251,311,5.0,8,8,5.5,5,0,4,3,60,63
p_246,12,0,e_2,257,273,311,10.5,8,2,7.0,5,1,4,16,38,54
p_226,12,0,e_1,331,335,401,10.5,9,2,5.5,5,0,7,4,66,70
p_240,14,0,e_1,301,343,401,7.0,9,9,0.5,5,0,5,42,58,100
p_217,8,0,e_1,345,371,401,1.0,9,9,7.0,5,1,7,26,30,56
p_210,4,0,e_1,353,385,401,18.5,10,7,7.0,4,1,8,32,16,48
p_233,2,0,e_1,319,393,401,5.0,9,9,3.5,5,0,6,74,8,82
p_242,4,0,e_0,287,309,401,18.5,9,6,1.0,1,0,5,22,92,114
p_234,14,0,e_0,314,341,401,8.5,9,1,2.5,5,1,5,27,60,87
p_225,10,0,e_0,333,363,401,12.5,9,3,6.0,5,1,7,30,38,68
p_215,6,0,e_0,346,377,401,16.5,9,6,7.5,3,1,8,31,24,55
p_221,4,0,e_0,341,385,401,3.0,9,9,7.0,5,1,7,44,16,60
p_209,2,0,e_0,354,393,401,5.0,10,10,6.5,4,1,9,39,8,47
p_199,2,0,e_0,368,393,401,20.5,11,7,4.5,4,1,9,25,8,33
p_238,2,0,e_2,311,319,423,20.5,9,6,0.0,5,0,4,8,104,112
p_236,8,0,e_2,313,339,423,1.0,9,9,0.0,5,0,5,26,84,110
p_235,8,0,e_2,314,339,423,14.5,9,5,0.0,5,0,6,25,84,109
p_231,10,0,e_2,320,347,423,12.5,9,3,1.0,5,1,5,27,76,103
p_213,12,0,e_2,347,355,423,10.5,9,2,5.0,5,1,7,8,68,76
p_207,12,0,e_2,355,357,423,10.5,10,3,6.0,5,1,8,2,66,68
p_203,12,0,e_2,365,379,423,10.5,11,3,7.0,5,1,9,14,44,58
p_200,12,0,e_2,367,379,423,5.0,11,11,7.5,5,1,10,12,44,56
p_204,8,0,e_2,364,393,423,14.5,11,6,7.0,5,1,8,29,30,59
p_214,4,0,e_2,346,407,423,18.5,9,6,5.0,2,1,6,61,16,77
p_185,2,0,e_2,392,415,423,20.5,13,8,4.0,4,1,9,23,8,31
p_175,2,0,e_2,399,415,423,20.5,13,8,3.0,4,1,9,16,8,24
p_173,10,0,e_1,405,433,507,12.5,13,5,0.5,5,0,9,28,74,102
p_170,10,0,e_1,408,433,507,12.5,13,5,1.0,5,0,10,25,74,99
p_160,10,0,e_1,421,433,507,3.0,13,13,3.0,5,0,10,12,74,86
p_180,14,0,e_1,396,447,507,7.0,13,13,1.0,4,1,8,51,60,111
p_145,12,0,e_1,451,463,507,5.0,13,13,7.5,5,1,9,12,44,56
p_153,8,0,e_1,438,477,507,14.5,13,7,5.5,5,1,9,39,30,69
p_133,4,0,e_1,463,491,507,3.0,13,13,6.0,4,1,10,28,16,44
p_136,2,0,e_1,460,499,507,20.5,13,8,6.5,4,1,10,39,8,47
p_188,8,0,e_0,390,427,507,14.5,13,7,1.5,4,1,7,37,80,117
p_183,12,0,e_0,393,441,507,5.0,13,13,1.0,1,1,7,48,66,114
p_164,12,0,e_0,416,441,507,5.0,13,13,2.5,5,0,10,25,66,91
p_172,14,0,e_0,405,449,507,8.5,13,1,0.5,5,0,9,44,58,102
p_165,14,0,e_0,416,449,507,8.5,13,1,2.5,5,0,10,33,58,91
p_162,14,0,e_0,417,449,507,8.5,13,1,2.5,5,0,10,32,58,90
p_158,14,0,e_0,426,449,507,7.0,13,13,4.0,2,0,9,23,58,81
p_146,10,0,e_0,451,471,507,12.5,13,5,7.0,5,1,10,20,36,56
p_144,4,0,e_0,451,491,507,3.0,13,13,7.0,5,1,8,40,16,56
p_125,4,0,e_0,474,491,507,18.5,13,8,5.0,4,1,10,17,16,33
p_143,2,0,e_0,451,499,507,20.5,13,8,7.0,5,1,9,48,8,56
p_163,4,0,e_2,417,437,533,18.5,13,8,1.0,4,1,7,20,96,116
p_152,10,0,e_2,439,457,533,3.0,13,13,2.0,5,1,8,18,76,94
p_157,12,0,e_2,427,465,533,10.5,13,3,0.5,5,0,8,38,68,106
p_134,12,0,e_2,462,465,533,10.5,13,3,5.5,5,1,8,3,68,71
p_124,14,0,e_2,474,481,533,8.5,13,1,7.0,5,1,9,7,52,59
p_123,12,0,e_2,474,489,533,5.0,13,13,7.0,5,1,10,15,44,59
p_128,10,0,e_2,471,497,533,12.5,13,5,6.5,5,1,7,26,36,62
p_126,6,0,e_2,473,511,533,1.0,13,13,7.0,5,1,8,38,22,60
p_118,4,0,e_2,488,519,533,18.5,13,8,6.0,4,1,10,31,14,45
p_106,4,0,e_1,512,521,535,18.5,13,8,0.5,5,0,8,9,14,23
p_105,4,0,e_1,515,521,535,18.5,13,8,1.0,5,0,9,6,14,20
p_98,6,0,e_0,524,527,617,1.0,13,13,2.5,5,0,11,3,90,93
p_95,6,0,e_0,527,527,617,1.0,13,13,3.0,2,0,11,0,90,90
p_94,6,0,e_0,528,529,617,16.5,13,8,3.0,2,1,11,1,88,89
p_100,10,0,e_0,522,545,617,12.5,13,5,2.0,5,0,10,23,72,95
p_97,10,0,e_0,526,545,617,3.0,13,13,3.0,5,0,12,19,72,91
p_117,12,0,e_0,490,553,617,5.0,13,13,2.0,1,1,9,63,64,127
p_101,12,0,e_0,521,553,617,5.0,13,13,2.0,5,0,10,32,64,96
p_73,6,0,e_0,568,593,617,1.0,13,13,7.0,4,1,10,25,24,49
p_78,4,0,e_0,555,601,617,18.5,13,8,6.0,5,1,9,46,16,62
p_102,2,0,e_0,521,609,617,5.0,13,13,2.0,5,0,9,88,8,96
p_81,2,0,e_0,547,609,617,20.5,13,8,5.0,5,1,10,62,8,70
p_71,2,0,e_0,569,609,617,20.5,13,8,7.0,4,1,11,40,8,48
p_56,2,0,e_0,588,609,617,20.5,13,8,4.0,4,1,11,21,8,29
p_48,2,0,e_0,593,609,617,5.0,13,13,3.0,1,1,10,16,8,24
p_88,14,0,e_1,538,579,639,8.5,13,1,0.5,5,0,8,41,60,101
p_79,14,0,e_1,549,579,639,7.0,13,13,2.0,5,0,9,30,60,90
p_75,14,0,e_1,563,579,639,7.0,13,13,4.5,5,0,9,16,60,76
p_68,14,0,e_1,574,579,639,8.5,13,1,6.0,5,0,9,5,60,65
p_65,12,0,e_1,578,595,639,5.0,13,13,7.0,2,0,9,17,44,61
p_67,8,0,e_1,574,609,639,1.0,13,13,6.5,5,0,9,35,30,65
p_63,8,0,e_1,581,609,639,1.0,13,13,7.0,5,1,10,28,30,58
p_59,6,0,e_1,584,617,639,1.0,13,13,7.5,4,1,10,33,22,55
p_57,6,0,e_1,587,617,639,16.5,13,8,7.5,4,1,11,30,22,52
p_55,4,0,e_1,590,625,639,18.5,13,8,6.5,4,1,11,35,14,49
p_40,4,0,e_1,601,625,639,3.0,13,13,5.5,4,1,11,24,14,38
p_90,2,0,e_2,536,541,639,5.0,13,13,0.5,5,0,8,5,98,103
p_86,6,0,e_2,541,555,639,16.5,13,8,1.0,5,1,8,14,84,98
p_80,6,0,e_2,548,555,639,16.5,13,8,2.0,5,1,9,7,84,91
p_66,12,0,e_2,577,595,639,5.0,13,13,6.5,5,1,10,18,44,62
p_69,10,0,e_2,573,603,639,3.0,13,13,6.0,5,1,9,30,36,66
p_77,6,0,e_2,557,617,639,16.5,13,8,3.0,5,1,8,60,22,82
p_54,6,0,e_2,590,617,639,16.5,13,8,7.0,4,1,11,27,22,49
p_42,4,0,e_2,600,625,639,3.0,13,13,5.5,4,1,10,25,14,39
p_38,4,0,e_0,627,631,717,3.0,13,13,1.5,5,0,8,4,86,90
p_35,4,0,e_0,640,701,717,18.5,13,8,3.5,5,1,8,61,16,77
p_27,2,0,e_0,693,709,717,5.0,13,13,3.5,4,1,9,16,8,24
p_33,8,0,e_1,647,665,735,1.0,13,13,1.0,5,0,8,18,70,88
p_28,6,0,e_2,679,715,735,1.0,13,13,6.5,5,0,8,36,20,56
p_21,10,0,e_0,732,749,817,12.5,13,5,2.0,5,0,8,17,68,85
p_19,12,0,e_0,740,757,817,5.0,13,13,3.5,5,0,9,17,60,77
p_18,2,0,e_0,768,809,817,5.0,13,13,7.5,3,1,8,41,8,49
p_9,2,0,e_0,845,905,913,5.0,13,13,4.5,5,0,8,60,8,68
p_1,2,0,e_0,889,905,913,20.5,13,8,3.5,4,0,9,16,8,24
p_6,14,0,e_2,858,873,925,8.5,13,1,4.5,5,0,8,15,52,67
p_7,12,0,e_1,851,867,925,10.5,13,3,3.5,5,0,8,16,58,74
p_291,6,0,e_3,35,40,60,6.5,1,0,2.5,5,0,1,5,20,25
p_298,4,0,e_2,10,25,105,4.0,0,0,0.0,3,0,0,15,80,95
p_284,14,0,e_2,55,57,105,17.0,2,2,6.5,5,1,1,2,48,50
p_282,6,0,e_2,62,83,105,6.0,1,0,6.5,4,1,1,21,22,43
p_279,2,0,e_2,76,97,105,19.5,3,2,4.0,4,1,2,21,8,29
p_275,2,0,e_2,84,97,105,18.5,4,3,3.0,4,1,2,13,8,21
p_287,12,0,e_1,51,66,106,19.5,2,2,7.0,5,0,5,15,40,55
p_290,4,0,e_1,43,92,106,29.0,2,2,5.5,5,0,3,49,14,63
p_281,10,0,e_3,63,92,158,9.5,1,0,0.5,5,0,1,29,66,95
p_277,10,0,e_3,81,92,158,11.0,3,1,3.0,5,0,3,11,66,77
p_280,12,0,e_3,65,100,158,11.5,2,0,0.5,5,0,2,35,58,93
p_269,4,0,e_2,146,187,201,28.0,5,5,6.5,5,0,1,41,14,55
p_268,10,0,e_1,150,170,202,21.5,5,5,7.0,5,0,4,20,32,52
p_257,12,0,e_3,179,196,262,14.5,4,2,3.5,5,0,4,17,66,83
p_255,10,0,e_3,192,224,262,14.5,6,3,5.5,5,0,6,32,38,70
p_256,8,0,e_3,191,232,262,17.0,5,3,5.0,5,0,5,41,30,71
p_251,4,0,e_3,228,246,262,0.0,8,0,4.5,4,1,7,18,16,34
p_252,2,0,e_3,212,254,262,5.0,8,2,7.0,4,1,7,42,8,50
p_244,2,0,e_2,271,289,297,27.0,6,5,4.0,4,0,4,18,8,26
p_247,12,0,e_1,248,260,298,20.0,7,7,7.5,3,0,4,12,38,50
p_243,8,0,e_3,285,288,362,18.5,6,3,3.5,5,0,6,3,74,77
p_242,4,0,e_3,287,346,362,22.0,6,4,4.0,2,0,6,59,16,75
p_238,2,0,e_3,311,354,362,5.0,8,8,7.5,3,1,7,43,8,51
p_233,2,0,e_3,319,354,362,4.0,9,3,6.5,4,1,8,35,8,43
p_226,12,0,e_1,331,336,394,22.5,9,9,5.5,5,0,7,5,58,63
p_240,14,0,e_1,301,344,394,10.0,8,1,0.5,5,0,5,43,50,93
p_234,14,0,e_1,314,344,394,23.5,9,9,2.5,5,0,6,30,50,80
p_215,6,0,e_1,346,370,394,26.0,8,8,7.0,4,1,6,24,24,48
p_214,4,0,e_1,346,378,394,28.0,8,8,7.0,4,1,7,32,16,48
p_210,4,0,e_1,353,378,394,27.0,8,8,6.0,4,1,8,25,16,41
p_209,2,0,e_1,354,386,394,29.0,7,7,5.5,4,1,8,32,8,40
p_199,2,0,e_1,368,386,394,27.0,8,7,3.0,4,1,9,18,8,26
p_236,8,0,e_2,313,323,403,29.5,9,9,2.5,5,0,4,10,80,90
p_235,8,0,e_2,314,323,403,29.5,9,9,2.5,5,0,5,9,80,89
p_231,10,0,e_2,320,331,403,26.0,9,9,3.5,5,0,5,11,72,83
p_213,12,0,e_2,347,359,403,20.0,8,8,7.5,5,1,7,12,44,56
p_225,10,0,e_2,333,367,403,24.0,9,9,5.0,5,1,4,34,36,70
p_217,8,0,e_2,345,375,403,24.0,9,9,7.0,5,1,6,30,28,58
p_221,4,0,e_2,341,389,403,28.5,9,9,6.5,5,1,5,48,14,62
p_206,6,0,e_3,362,382,470,6.0,6,6,0.0,3,1,6,20,88,108
p_204,8,0,e_3,364,390,470,22.0,7,3,0.0,5,0,7,26,80,106
p_193,12,0,e_3,378,404,470,15.5,9,2,2.5,5,0,9,26,66,92
p_190,14,0,e_3,382,412,470,13.0,10,1,3.0,5,1,9,30,58,88
p_165,14,0,e_3,416,422,470,8.5,9,1,7.5,5,1,8,6,48,54
p_163,4,0,e_3,417,454,470,3.0,10,1,7.5,4,1,9,37,16,53
p_143,2,0,e_3,451,462,470,0.0,10,0,2.5,4,1,9,11,8,19
p_176,6,0,e_1,398,414,492,19.0,11,7,0.5,5,0,8,16,78,94
p_183,12,0,e_1,393,434,492,14.0,11,3,0.0,3,1,6,41,58,99
p_164,12,0,e_1,416,434,492,5.0,10,10,3.0,5,1,8,18,58,76
p_157,12,0,e_1,427,434,492,24.5,10,10,5.0,5,1,8,7,58,65
p_180,14,0,e_1,396,442,492,11.5,11,1,0.0,5,0,7,46,50,96
p_172,14,0,e_1,405,442,492,10.0,10,1,1.5,5,0,9,37,50,87
p_162,14,0,e_1,417,442,492,23.5,11,11,3.5,5,1,8,25,50,75
p_158,14,0,e_1,426,442,492,22.5,10,10,4.5,5,1,8,16,50,66
p_153,8,0,e_1,438,462,492,26.5,10,10,6.5,5,1,7,24,30,54
p_144,4,0,e_1,451,476,492,28.5,11,11,5.5,4,1,7,25,16,41
p_136,2,0,e_1,460,484,492,29.5,10,10,4.5,4,1,9,24,8,32
p_175,2,0,e_2,399,411,507,22.5,11,7,0.5,4,1,5,12,96,108
p_173,10,0,e_2,405,437,507,14.0,10,4,0.0,5,0,7,32,70,102
p_170,10,0,e_2,408,437,507,13.5,10,4,0.5,5,0,8,29,70,99
p_160,10,0,e_2,421,437,507,27.0,10,10,2.5,5,1,7,16,70,86
p_145,12,0,e_2,451,465,507,20.5,11,11,7.0,5,1,8,14,42,56
p_152,10,0,e_2,439,473,507,24.5,10,10,5.0,5,1,6,34,34,68
p_146,10,0,e_2,451,473,507,22.5,11,11,7.0,5,1,9,22,34,56
p_133,4,0,e_2,463,493,507,27.0,9,9,6.5,4,1,9,30,14,44
p_125,4,0,e_2,474,493,507,25.5,9,7,5.0,4,1,8,19,14,33
p_128,10,0,e_3,471,502,576,20.0,8,3,0.0,5,0,8,31,74,105
p_123,12,0,e_3,474,510,576,17.5,9,2,0.5,5,0,9,36,66,102
p_117,12,0,e_3,490,510,576,15.0,10,2,3.0,5,0,10,20,66,86
p_109,14,0,e_3,506,518,576,10.5,10,1,5.5,5,1,9,12,58,70
p_98,6,0,e_3,524,552,576,1.0,11,0,7.5,4,1,10,28,24,52
p_95,6,0,e_3,527,552,576,1.0,12,0,7.0,4,1,11,25,24,49
p_94,6,0,e_3,528,552,576,1.0,12,0,7.0,4,1,11,24,24,48
p_105,4,0,e_3,515,560,576,19.5,10,6,6.5,5,1,9,45,16,61
p_102,2,0,e_3,521,568,576,21.0,10,4,7.0,5,1,9,47,8,55
p_90,2,0,e_3,536,568,576,3.0,12,2,5.5,4,1,11,32,8,40
p_81,2,0,e_3,547,568,576,1.0,12,0,3.5,4,1,11,21,8,29
p_115,10,0,e_1,494,524,598,16.0,10,4,0.0,5,0,7,30,74,104
p_101,12,0,e_1,521,532,598,10.5,11,2,4.5,5,0,8,11,66,77
p_88,14,0,e_1,538,540,598,21.0,12,12,6.5,5,1,7,2,58,60
p_86,6,0,e_1,541,574,598,28.5,12,12,7.0,5,1,7,33,24,57
p_80,6,0,e_1,548,574,598,27.5,12,12,7.5,4,1,8,26,24,50
p_78,4,0,e_1,555,582,598,29.0,11,11,6.0,4,1,8,27,16,43
p_71,2,0,e_1,569,590,598,29.0,9,9,4.0,4,1,9,21,8,29
p_106,4,0,e_2,512,521,611,20.0,10,6,0.5,5,0,7,9,90,99
p_100,10,0,e_2,522,541,611,12.5,11,3,2.0,5,1,7,19,70,89
p_97,10,0,e_2,526,541,611,27.0,12,12,2.5,5,1,8,15,70,85
p_79,14,0,e_2,549,555,611,19.5,12,12,6.0,5,1,7,6,56,62
p_77,6,0,e_2,557,589,611,26.5,11,11,7.0,5,1,7,32,22,54
p_73,6,0,e_2,568,589,611,25.0,9,9,6.5,4,1,8,21,22,43
p_56,2,0,e_2,588,603,611,26.0,12,11,3.0,1,1,7,15,8,23
p_48,2,0,e_2,593,603,611,25.5,12,11,2.5,4,1,8,10,8,18
p_42,4,0,e_1,600,612,626,22.0,12,10,0.0,5,0,8,12,14,26
p_63,8,0,e_3,581,602,680,21.5,10,6,0.5,5,0,10,21,78,99
p_58,10,0,e_3,586,610,680,18.5,11,5,1.5,5,0,11,24,70,94
p_66,12,0,e_3,577,618,680,18.0,9,3,0.0,5,0,9,41,62,103
p_68,14,0,e_3,574,626,680,16.5,9,9,0.5,4,1,8,52,54,106
p_38,4,0,e_3,627,666,680,19.0,9,4,7.0,5,1,8,39,14,53
p_35,4,0,e_3,640,666,680,2.0,10,1,6.0,4,1,9,26,14,40
p_33,8,0,e_2,647,681,709,27.0,10,10,6.0,5,0,8,34,28,62
p_27,2,0,e_2,693,701,709,26.0,8,7,2.5,4,1,8,8,8,16
p_41,10,0,e_1,600,658,724,16.0,12,5,0.0,5,0,9,58,66,124
p_28,6,0,e_1,679,704,724,24.0,9,9,7.0,4,1,8,25,20,45
p_22,10,0,e_3,712,744,776,15.0,8,3,5.0,5,0,8,32,32,64
p_21,10,0,e_2,732,741,809,26.0,9,9,3.5,5,0,8,9,68,77
p_19,12,0,e_2,740,749,809,22.5,9,9,5.0,2,0,8,9,60,69
p_18,2,0,e_2,768,801,809,29.0,9,9,6.5,4,1,8,33,8,41
p_10,14,0,e_3,810,820,874,10.5,8,1,5.5,5,0,8,10,54,64
p_9,2,0,e_3,845,866,874,2.0,9,1,4.5,4,1,8,21,8,29
p_7,12,0,e_2,851,867,907,21.5,10,10,6.5,5,0,8,16,40,56
p_1,2,0,e_2,889,899,907,25.5,8,7,2.5,4,1,8,10,8,18
p_6,14,0,e_1,858,862,914,18.0,10,10,6.5,5,0,8,4,52,56
p_298,4,0,e_2,10,25,39,4.0,0,0,0.0,3,0,0,15,14,29
p_291,6,0,e_3,35,41,61,6.0,1,0,2.0,5,0,1,6,20,26
p_287,12,0,e_1,51,66,106,19.5,2,2,7.0,5,0,3,15,40,55
p_275,2,0,e_1,84,98,106,18.5,4,3,3.5,4,1,3,14,8,22
p_300,8,0,e_0,4,30,108,8.0,0,0,0.0,3,0,0,26,78,104
p_297,12,0,e_0,18,44,108,12.0,0,0,2.0,5,0,1,26,64,90
p_283,10,0,e_0,55,72,108,21.0,2,2,7.5,3,1,2,17,36,53
p_282,6,0,e_0,62,86,108,6.0,1,0,6.5,4,1,3,24,22,46
p_279,2,0,e_0,76,100,108,20.0,3,2,4.5,4,1,3,24,8,32
p_281,10,0,e_3,63,93,141,10.0,1,0,0.0,5,0,1,30,48,78
p_277,10,0,e_3,81,93,141,11.0,3,1,3.0,5,0,3,12,48,60
p_280,12,0,e_3,65,101,141,11.5,2,0,0.5,5,0,2,36,40,76
p_274,4,0,e_3,84,127,141,16.5,4,3,3.5,5,0,4,43,14,57
p_290,4,0,e_2,43,58,144,29.0,2,2,0.0,3,0,0,15,86,101
p_284,14,0,e_2,55,90,144,17.0,2,2,1.5,5,0,4,35,54,89
p_285,2,0,e_2,54,136,144,29.0,2,2,1.5,5,0,3,82,8,90
p_269,4,0,e_3,146,155,169,5.5,2,1,0.5,5,0,2,9,14,23
p_262,6,0,e_0,164,184,204,25.0,4,4,6.5,4,0,5,20,20,40
p_265,12,0,e_2,157,182,246,20.0,4,4,2.0,5,0,4,25,64,89
p_263,12,0,e_2,163,182,246,19.0,4,4,3.0,5,0,5,19,64,83
p_255,10,0,e_2,192,210,246,13.0,6,2,7.5,3,1,6,18,36,54
p_256,8,0,e_2,191,218,246,15.0,6,3,7.5,5,1,5,27,28,55
p_252,2,0,e_2,212,238,246,22.0,5,2,5.0,4,1,6,26,8,34
p_259,6,0,e_3,174,189,271,19.5,5,3,0.5,5,0,5,15,82,97
p_268,10,0,e_3,150,203,271,8.5,3,0,1.5,5,0,3,53,68,121
p_261,12,0,e_3,170,211,271,12.0,3,0,0.0,5,0,3,41,60,101
p_257,12,0,e_3,179,211,271,12.5,6,1,1.5,5,0,6,32,60,92
p_251,4,0,e_3,228,257,271,3.0,5,1,7.0,4,1,4,29,14,43
p_244,2,0,e_1,271,288,296,28.0,4,3,4.0,4,0,6,17,8,25
p_247,12,0,e_0,248,262,300,21.5,6,6,7.0,5,0,5,14,38,52
p_246,12,0,e_2,257,284,346,20.0,5,5,1.5,5,0,5,27,62,89
p_243,8,0,e_2,285,318,346,20.0,4,2,6.0,5,1,6,33,28,61
p_238,2,0,e_2,311,338,346,21.5,6,3,5.0,4,1,7,27,8,35
p_233,2,0,e_2,319,338,346,5.0,7,7,4.0,4,1,7,19,8,27
p_240,14,0,e_3,301,315,373,11.0,5,1,5.0,5,0,5,14,58,72
p_234,14,0,e_3,314,315,373,9.0,7,1,7.0,5,0,7,1,58,59
p_236,8,0,e_3,313,343,373,15.5,6,3,6.5,5,0,6,30,30,60
p_235,8,0,e_3,314,343,373,15.0,6,2,7.0,2,0,6,29,30,59
p_242,4,0,e_3,287,357,373,23.5,4,3,2.5,5,0,4,70,16,86
p_209,2,0,e_3,354,365,373,0.0,7,0,2.5,4,1,6,11,8,19
p_231,10,0,e_1,320,328,400,27.5,7,7,4.0,5,0,6,8,72,80
p_225,10,0,e_1,333,362,400,25.5,7,7,5.5,5,1,6,29,38,67
p_217,8,0,e_1,345,370,400,26.0,7,7,7.5,3,1,8,25,30,55
p_215,6,0,e_1,346,378,400,28.0,7,7,7.5,4,1,9,32,22,54
p_221,4,0,e_1,341,386,400,30.0,8,8,7.0,5,1,7,45,14,59
p_226,12,0,e_0,331,338,404,24.0,7,7,5.0,5,0,6,7,66,73
p_211,14,0,e_0,348,354,404,19.5,7,7,7.5,3,1,7,6,50,56
p_213,12,0,e_0,347,362,404,21.5,7,7,7.5,5,1,6,15,42,57
p_210,4,0,e_0,353,388,404,28.5,7,7,7.0,4,1,8,35,16,51
p_199,2,0,e_0,368,396,404,28.5,6,6,5.0,4,1,7,28,8,36
p_214,4,0,e_2,346,360,458,30.0,7,7,0.0,3,1,6,14,98,112
p_206,6,0,e_2,362,368,458,25.5,7,7,2.0,5,1,8,6,90,96
p_204,8,0,e_2,364,376,458,23.0,7,7,2.5,5,1,9,12,82,94
p_207,12,0,e_2,355,390,458,20.5,8,8,1.0,5,0,8,35,68,103
p_203,12,0,e_2,365,390,458,19.0,6,6,2.5,5,1,10,25,68,93
p_200,12,0,e_2,367,390,458,19.0,6,6,3.0,2,1,9,23,68,91
p_190,14,0,e_2,382,398,458,14.5,7,1,5.0,5,1,9,16,60,76
p_180,14,0,e_2,396,398,458,12.5,9,1,7.0,5,1,11,2,60,62
p_188,8,0,e_2,390,426,458,19.5,8,3,6.0,5,1,9,36,32,68
p_179,6,0,e_2,397,434,458,20.5,9,6,7.0,2,1,10,37,24,61
p_163,4,0,e_2,417,442,458,20.0,10,5,5.5,4,1,11,25,16,41
p_185,2,0,e_2,392,450,458,25.0,8,6,6.0,5,1,10,58,8,66
p_175,2,0,e_2,399,450,458,24.0,10,7,7.0,5,1,11,51,8,59
p_197,8,0,e_3,375,399,487,22.0,5,2,0.0,5,0,5,24,88,112
p_173,10,0,e_3,405,407,487,15.0,10,4,5.0,5,1,9,2,80,82
p_193,12,0,e_3,378,415,487,17.5,6,2,0.5,5,0,6,37,72,109
p_183,12,0,e_3,393,415,487,15.0,8,2,3.0,5,0,8,22,72,94
p_164,12,0,e_3,416,417,487,12.0,10,3,6.0,5,1,9,1,70,71
p_172,14,0,e_3,405,425,487,11.0,11,1,5.0,5,1,10,20,62,82
p_165,14,0,e_3,416,425,487,10.0,10,1,6.0,2,1,9,9,62,71
p_162,14,0,e_3,417,425,487,10.0,10,1,6.0,5,1,9,8,62,70
p_157,12,0,e_3,427,441,487,11.0,10,2,7.0,5,1,9,14,46,60
p_160,10,0,e_3,421,449,487,13.5,10,4,6.5,5,1,9,28,38,66
p_176,6,0,e_3,398,463,487,20.0,8,5,4.0,2,0,8,65,24,89
p_144,4,0,e_3,451,471,487,1.0,10,0,5.0,4,1,9,20,16,36
p_143,2,0,e_3,451,479,487,3.0,9,1,5.0,4,1,8,28,8,36
p_136,2,0,e_3,460,479,487,1.0,11,0,3.5,4,1,10,19,8,27
p_170,10,0,e_1,408,432,502,15.0,11,5,1.0,5,0,6,24,70,94
p_152,10,0,e_1,439,466,502,26.0,11,11,6.0,5,1,7,27,36,63
p_153,8,0,e_1,438,474,502,28.5,11,11,6.0,5,1,6,36,28,64
p_133,4,0,e_1,463,488,502,29.0,10,10,5.5,4,1,8,25,14,39
p_158,14,0,e_0,426,448,506,9.0,10,1,3.5,5,0,6,22,58,80
p_145,12,0,e_0,451,464,506,23.0,11,11,7.0,5,1,6,13,42,55
p_146,10,0,e_0,451,472,506,25.0,11,11,7.5,5,1,7,21,34,55
p_125,4,0,e_0,474,492,506,27.5,9,9,5.0,4,1,6,18,14,32
p_118,4,0,e_3,488,501,515,26.0,7,5,0.0,5,0,7,13,14,27
p_105,4,0,e_3,515,529,543,4.0,7,7,0.0,3,1,7,14,14,28
p_126,6,0,e_2,473,478,566,26.0,9,9,2.5,5,0,10,5,88,93
p_128,10,0,e_2,471,492,566,22.0,9,9,2.0,5,0,9,21,74,95
p_120,10,0,e_2,481,492,566,21.0,8,8,3.0,5,1,11,11,74,85
p_134,12,0,e_2,462,500,566,21.0,11,11,0.5,5,0,8,38,66,104
p_123,12,0,e_2,474,500,566,20.0,9,9,2.5,5,0,11,26,66,92
p_117,12,0,e_2,490,500,566,18.0,8,2,5.0,5,1,11,10,66,76
p_124,14,0,e_2,474,508,566,18.0,9,9,2.5,5,0,11,34,58,92
p_109,14,0,e_2,506,508,566,17.5,8,8,6.5,5,1,10,2,58,60
p_115,10,0,e_2,494,530,566,19.0,8,3,5.0,5,1,10,36,36,72
p_106,4,0,e_2,512,550,566,26.5,8,8,7.5,5,1,9,38,16,54
p_102,2,0,e_2,521,558,566,27.5,8,7,6.5,4,1,10,37,8,45
p_90,2,0,e_2,536,558,566,29.0,8,8,4.0,4,1,10,22,8,30
p_81,2,0,e_2,547,558,566,27.5,7,6,2.5,4,1,10,11,8,19
p_101,12,0,e_1,521,540,604,17.5,8,2,3.0,5,0,7,19,64,83
p_79,14,0,e_1,549,556,604,15.5,7,1,7.5,5,1,8,7,48,55
p_98,6,0,e_1,524,582,604,23.0,8,4,3.5,5,0,8,58,22,80
p_86,6,0,e_1,541,582,604,24.0,8,8,6.0,5,1,8,41,22,63
p_80,6,0,e_1,548,582,604,23.5,7,4,7.0,5,1,8,34,22,56
p_78,4,0,e_1,555,590,604,24.5,7,5,7.0,4,1,9,35,14,49
p_100,10,0,e_0,522,538,608,19.0,8,3,2.5,5,0,6,16,70,86
p_97,10,0,e_0,526,538,608,18.5,8,3,3.0,5,0,7,12,70,82
p_88,14,0,e_0,538,552,608,17.0,8,8,5.0,2,0,7,14,56,70
p_95,6,0,e_0,527,586,608,22.0,8,4,3.5,5,0,7,59,22,81
p_94,6,0,e_0,528,586,608,22.0,8,4,3.5,5,0,8,58,22,80
p_77,6,0,e_0,557,586,608,22.0,7,4,7.5,4,1,7,29,22,51
p_71,2,0,e_0,569,600,608,24.0,9,7,5.5,4,1,7,31,8,39
p_56,2,0,e_0,588,600,608,21.5,13,8,3.0,4,1,7,12,8,20
p_69,10,0,e_3,573,575,653,15.5,9,4,4.5,5,0,9,2,78,80
p_66,12,0,e_3,577,583,653,13.0,11,3,5.0,5,1,10,6,70,76
p_75,14,0,e_3,563,591,653,13.0,7,1,3.0,5,0,7,28,62,90
p_68,14,0,e_3,574,591,653,11.0,10,1,5.0,2,0,10,17,62,79
p_58,10,0,e_3,586,613,653,14.0,12,4,6.0,5,1,11,27,40,67
p_50,10,0,e_3,592,613,653,13.0,13,3,7.0,5,1,12,21,40,61
p_67,8,0,e_3,574,621,653,17.0,9,4,5.0,2,0,9,47,32,79
p_63,8,0,e_3,581,621,653,16.0,12,5,6.0,5,1,11,40,32,72
p_73,6,0,e_3,568,629,653,20.0,8,5,4.0,5,0,8,61,24,85
p_59,6,0,e_3,584,629,653,18.0,11,6,6.0,5,1,10,45,24,69
p_55,4,0,e_3,590,637,653,19.0,13,7,7.0,5,1,12,47,16,63
p_42,4,0,e_3,600,637,653,3.0,14,2,7.0,4,1,13,37,16,53
p_40,4,0,e_3,601,637,653,3.0,14,2,7.0,4,1,13,36,16,52
p_48,2,0,e_3,593,645,653,21.0,13,6,7.0,5,1,12,52,8,60
p_65,12,0,e_2,578,604,668,12.5,12,3,2.0,5,0,8,26,64,90
p_41,10,0,e_2,600,632,668,27.0,14,14,5.5,5,0,10,32,36,68
p_57,6,0,e_2,587,646,668,17.5,13,8,3.0,5,0,9,59,22,81
p_54,6,0,e_2,590,646,668,17.0,14,7,4.0,5,0,10,56,22,78
p_47,6,0,e_2,594,646,668,17.0,14,6,4.5,5,0,10,52,22,74
p_38,4,0,e_2,627,654,668,29.5,12,12,6.0,4,1,10,27,14,41
p_33,8,0,e_1,647,674,702,23.0,9,9,7.0,5,0,8,27,28,55
p_35,4,0,e_1,640,688,702,27.5,10,10,6.0,5,0,7,48,14,62
p_28,6,0,e_3,679,729,751,20.0,8,5,4.0,5,0,8,50,22,72
p_27,2,0,e_3,693,743,751,21.5,9,5,6.5,5,0,9,50,8,58
p_22,10,0,e_2,712,732,764,24.5,10,10,7.0,5,0,8,20,32,52
p_18,2,0,e_1,768,790,798,25.5,8,7,4.5,4,0,8,22,8,30
p_21,10,0,e_0,732,734,800,22.5,10,10,5.0,5,0,7,2,66,68
p_19,12,0,e_0,740,742,800,19.5,10,10,6.0,5,1,7,2,58,60
p_10,14,0,e_2,810,816,862,20.5,8,8,7.5,3,0,8,6,46,52
p_9,2,0,e_2,845,854,862,28.0,8,7,2.5,4,1,8,9,8,17
p_7,12,0,e_3,851,883,945,17.5,8,2,0.5,5,0,8,32,62,94
p_6,14,0,e_3,858,891,945,14.0,9,1,2.0,5,0,9,33,54,87
p_1,2,0,e_3,889,937,945,21.5,10,6,6.5,5,1,9,48,8,56
p_291,6,0,e_3,35,40,60,6.0,1,0,2.0,5,0,1,5,20,25
p_287,12,0,e_1,51,65,107,19.5,2,2,7.0,5,0,5,14,42,56
p_290,4,0,e_1,43,91,107,28.5,2,2,6.0,5,0,3,48,16,64
p_285,2,0,e_1,54,99,107,29.0,2,2,7.5,3,0,6,45,8,53
p_298,4,0,e_2,10,24,112,4.0,0,0,0.0,3,0,0,14,88,102
p_283,10,0,e_2,55,76,112,21.0,2,2,7.0,5,1,2,21,36,57
p_282,6,0,e_2,62,90,112,6.0,1,0,7.0,4,1,3,28,22,50
p_279,2,0,e_2,76,104,112,19.5,3,2,5.0,1,1,3,28,8,36
p_275,2,0,e_2,84,104,112,18.0,4,2,4.0,4,1,4,20,8,28
p_281,10,0,e_3,63,92,160,10.0,1,0,0.0,5,0,1,29,68,97
p_280,12,0,e_3,65,100,160,11.5,2,0,0.5,5,0,2,35,60,95
p_274,4,0,e_3,84,146,160,16.0,3,2,4.0,5,0,3,62,14,76
p_268,10,0,e_1,150,171,203,21.5,3,3,7.0,5,0,4,21,32,53
p_265,12,0,e_2,157,170,210,18.5,3,3,7.0,5,0,3,13,40,53
p_262,6,0,e_2,164,190,210,19.5,3,2,7.0,4,0,5,26,20,46
p_263,12,0,e_3,163,198,262,14.0,2,1,0.0,5,0,2,35,64,99
p_261,12,0,e_3,170,198,262,12.5,3,1,1.5,5,0,3,28,64,92
p_257,12,0,e_3,179,198,262,11.0,3,1,3.0,5,0,3,19,64,83
p_255,10,0,e_3,192,226,262,11.0,3,2,5.0,5,0,3,34,36,70
p_251,4,0,e_3,228,246,262,1.0,5,0,5.0,4,1,4,18,16,34
p_252,2,0,e_3,212,254,262,5.0,5,0,7.0,4,1,4,42,8,50
p_247,12,0,e_1,248,261,301,20.0,5,5,7.0,5,0,5,13,40,53
p_244,2,0,e_1,271,293,301,26.5,4,3,4.5,4,1,5,22,8,30
p_246,12,0,e_2,257,268,306,18.5,4,4,7.5,3,0,4,11,38,49
p_243,8,0,e_3,285,288,364,18.5,4,3,3.5,5,0,4,3,76,79
p_240,14,0,e_3,301,308,364,10.0,5,1,6.0,5,1,4,7,56,63
p_236,8,0,e_3,313,336,364,1.0,6,6,7.5,3,1,5,23,28,51
p_233,2,0,e_3,319,356,364,4.0,7,1,6.5,4,1,6,37,8,45
p_226,12,0,e_1,331,339,395,22.5,8,8,4.5,5,0,8,8,56,64
p_234,14,0,e_1,314,347,395,23.5,7,7,2.0,5,0,6,33,48,81
p_214,4,0,e_1,346,379,395,28.5,8,8,7.0,5,1,8,33,16,49
p_210,4,0,e_1,353,379,395,27.5,8,8,6.0,4,1,8,26,16,42
p_209,2,0,e_1,354,387,395,29.5,8,8,6.0,4,1,8,33,8,41
p_199,2,0,e_1,368,387,395,27.5,7,6,3.5,4,1,9,19,8,27
p_231,10,0,e_2,320,338,412,26.5,8,8,2.0,5,0,4,18,74,92
p_225,10,0,e_2,333,338,412,24.5,8,8,4.5,5,0,6,5,74,79
p_211,14,0,e_2,348,352,412,18.0,8,8,6.5,5,1,8,4,60,64
p_213,12,0,e_2,347,368,412,20.5,8,8,6.5,5,1,7,21,44,65
p_207,12,0,e_2,355,368,412,19.0,8,8,7.0,5,1,8,13,44,57
p_215,6,0,e_2,346,388,412,26.5,8,8,6.0,5,1,6,42,24,66
p_206,6,0,e_2,362,388,412,24.0,7,7,7.0,4,1,8,26,24,50
p_221,4,0,e_2,341,396,412,29.5,8,8,5.0,5,1,5,55,16,71
p_185,2,0,e_2,392,404,412,24.0,10,7,2.5,4,1,7,12,8,20
p_197,8,0,e_3,375,390,472,20.5,7,4,1.5,5,0,7,15,82,97
p_203,12,0,e_3,365,404,472,18.0,6,2,0.0,5,0,6,39,68,107
p_200,12,0,e_3,367,404,472,17.5,7,2,0.5,5,0,7,37,68,105
p_193,12,0,e_3,378,404,472,16.0,9,2,2.0,5,0,9,26,68,94
p_183,12,0,e_3,393,404,472,14.0,10,3,4.0,5,1,9,11,68,79
p_190,14,0,e_3,382,412,472,13.5,9,1,2.5,5,0,9,30,60,90
p_170,10,0,e_3,408,434,472,13.5,10,4,6.5,5,1,9,26,38,64
p_176,6,0,e_3,398,448,472,19.0,10,6,5.0,5,1,9,50,24,74
p_163,4,0,e_3,417,456,472,3.0,11,11,7.5,3,1,10,39,16,55
p_143,2,0,e_3,451,464,472,1.0,10,0,3.0,4,1,9,13,8,21
p_173,10,0,e_1,405,427,495,14.0,10,4,1.5,5,0,8,22,68,90
p_160,10,0,e_1,421,427,495,27.0,12,12,4.0,5,0,10,6,68,74
p_164,12,0,e_1,416,435,495,5.0,11,11,3.5,5,0,9,19,60,79
p_157,12,0,e_1,427,435,495,24.0,12,12,5.0,5,1,9,8,60,68
p_180,14,0,e_1,396,443,495,11.0,10,1,0.0,5,0,7,47,52,99
p_172,14,0,e_1,405,443,495,10.0,10,1,1.5,5,0,8,38,52,90
p_165,14,0,e_1,416,443,495,7.0,11,11,3.5,5,0,9,27,52,79
p_162,14,0,e_1,417,443,495,7.0,11,11,3.5,5,0,10,26,52,78
p_158,14,0,e_1,426,443,495,22.5,12,12,5.0,5,0,10,17,52,69
p_152,10,0,e_1,439,457,495,24.5,11,11,6.5,5,1,9,18,38,56
p_153,8,0,e_1,438,465,495,26.5,11,11,6.5,5,1,8,27,30,57
p_144,4,0,e_1,451,479,495,29.0,10,10,6.0,4,1,9,28,16,44
p_133,4,0,e_1,463,479,495,27.0,9,9,4.5,4,1,10,16,16,32
p_136,2,0,e_1,460,487,495,29.5,10,10,5.0,4,1,9,27,8,35
p_145,12,0,e_2,451,470,512,20.5,11,11,6.0,5,0,7,19,42,61
p_146,10,0,e_2,451,478,512,22.5,11,11,6.0,5,0,8,27,34,61
p_125,4,0,e_2,474,498,512,26.0,10,8,5.5,4,1,8,24,14,38
p_128,10,0,e_3,471,504,578,10.0,8,8,0.0,3,1,8,33,74,107
p_117,12,0,e_3,490,512,578,15.0,10,3,3.0,5,0,10,22,66,88
p_124,14,0,e_3,474,520,578,16.0,9,1,0.0,5,0,9,46,58,104
p_101,12,0,e_3,521,536,578,11.0,9,2,7.0,5,1,8,15,42,57
p_98,6,0,e_3,524,556,578,1.0,10,10,7.5,3,1,9,32,22,54
p_95,6,0,e_3,527,556,578,1.0,11,0,7.5,4,1,10,29,22,51
p_94,6,0,e_3,528,556,578,1.0,11,0,7.0,4,1,10,28,22,50
p_90,2,0,e_3,536,570,578,4.0,10,2,6.0,1,1,9,34,8,42
p_81,2,0,e_3,547,570,578,2.0,11,1,4.5,4,1,10,23,8,31
p_115,10,0,e_1,494,527,601,16.5,11,5,0.0,3,1,7,33,74,107
p_100,10,0,e_1,522,527,601,13.0,10,4,4.5,5,0,9,5,74,79
p_97,10,0,e_1,526,527,601,27.5,11,11,5.0,2,0,8,1,74,75
p_109,14,0,e_1,506,543,601,11.0,11,1,1.5,5,0,8,37,58,95
p_88,14,0,e_1,538,543,601,22.0,11,11,6.0,5,1,8,5,58,63
p_86,6,0,e_1,541,577,601,29.5,11,11,7.0,5,1,9,36,24,60
p_80,6,0,e_1,548,577,601,28.5,11,11,7.5,3,1,9,29,24,53
p_77,6,0,e_1,557,577,601,27.0,10,10,6.5,4,1,10,20,24,44
p_78,4,0,e_1,555,585,601,29.0,10,10,6.5,4,1,9,30,16,46
p_71,2,0,e_1,569,593,601,29.0,9,9,4.0,4,1,10,24,8,32
p_106,4,0,e_2,512,526,614,20.0,10,6,0.0,3,1,7,14,88,102
p_79,14,0,e_2,549,558,614,20.0,11,11,5.5,5,1,7,9,56,65
p_73,6,0,e_2,568,592,614,25.5,10,10,7.0,4,1,7,24,22,46
p_56,2,0,e_2,588,606,614,26.5,10,9,3.5,4,1,8,18,8,26
p_48,2,0,e_2,593,606,614,26.0,11,10,3.0,4,1,8,13,8,21
p_40,4,0,e_1,601,615,629,23.0,11,8,0.0,3,1,8,14,14,28
p_54,6,0,e_3,590,598,680,22.5,10,7,1.5,5,0,10,8,82,90
p_47,6,0,e_3,594,598,680,21.5,11,7,2.5,5,0,11,4,82,86
p_58,10,0,e_3,586,612,680,19.0,9,4,1.0,5,0,9,26,68,94
p_50,10,0,e_3,592,612,680,18.0,11,4,2.0,5,0,11,20,68,88
p_41,10,0,e_3,600,612,680,17.0,11,4,3.0,5,1,10,12,68,80
p_66,12,0,e_3,577,620,680,12.0,8,8,0.0,3,1,8,43,60,103
p_65,12,0,e_3,578,620,680,18.0,9,2,0.0,5,0,9,42,60,102
p_38,4,0,e_3,627,666,680,19.0,9,4,7.0,5,1,8,39,14,53
p_35,4,0,e_3,640,666,680,2.0,10,1,6.5,4,1,9,26,14,40
p_33,8,0,e_2,647,684,712,27.0,10,10,5.5,5,0,7,37,28,65
p_27,2,0,e_2,693,704,712,26.0,8,7,3.0,4,1,7,11,8,19
p_28,6,0,e_1,679,705,725,6.0,8,8,7.5,4,0,8,26,20,46
p_22,10,0,e_2,712,744,812,15.0,8,3,0.0,3,1,7,32,68,100
p_21,10,0,e_2,732,744,812,26.0,8,8,3.0,5,0,8,12,68,80
p_19,12,0,e_2,740,752,812,22.5,8,8,4.5,5,0,9,12,60,72
p_18,2,0,e_2,768,804,812,28.0,8,8,7.0,4,1,8,36,8,44
p_10,14,0,e_3,810,818,872,10.5,8,1,5.5,5,0,8,8,54,62
p_9,2,0,e_3,845,864,872,2.0,9,1,4.0,4,1,8,19,8,27
p_7,12,0,e_2,851,870,910,21.0,10,10,6.0,5,0,8,19,40,59
p_1,2,0,e_2,889,902,910,25.5,8,7,3.0,4,1,8,13,8,21
p_6,14,0,e_1,858,863,915,18.0,10,10,6.0,5,0,8,5,52,57
p_287,12,0,e_1,51,65,103,13.0,2,1,7.0,5,0,3,14,38,52
p_300,8,0,e_0,4,31,105,8.0,0,0,0.0,3,0,0,27,74,101
p_282,6,0,e_0,62,83,105,17.5,3,2,6.5,4,1,2,21,22,43
p_285,2,0,e_0,54,97,105,22.5,2,2,7.5,4,1,1,43,8,51
p_279,2,0,e_0,76,97,105,5.0,4,4,4.0,4,1,3,21,8,29
p_275,2,0,e_0,84,97,105,20.5,5,3,3.0,4,1,2,13,8,21
p_298,4,0,e_2,10,25,113,4.0,0,0,0.0,3,0,0,15,88,103
p_283,10,0,e_2,55,77,113,14.5,2,2,6.5,5,1,4,22,36,58
p_291,6,0,e_2,35,91,113,21.5,2,2,3.5,5,1,1,56,22,78
p_290,4,0,e_2,43,99,113,22.5,2,2,4.5,5,1,2,56,14,70
p_269,4,0,e_1,146,185,199,3.0,7,7,7.0,5,0,4,39,14,53
p_259,6,0,e_0,174,181,201,16.5,7,4,4.0,4,0,4,7,20,27
p_265,12,0,e_2,157,171,213,5.0,7,7,7.0,5,0,5,14,42,56
p_268,10,0,e_2,150,179,213,3.0,7,7,6.0,5,0,3,29,34,63
p_262,6,0,e_2,164,193,213,1.0,7,7,7.0,4,0,6,29,20,49
p_244,2,0,e_1,271,287,295,20.5,9,6,3.5,4,0,5,16,8,24
p_251,4,0,e_0,228,283,297,18.5,8,5,4.0,5,0,4,55,14,69
p_252,2,0,e_2,212,221,315,5.0,8,8,0.0,3,1,4,9,94,103
p_247,12,0,e_2,248,253,315,10.5,8,2,5.5,5,1,4,5,62,67
p_246,12,0,e_2,257,275,315,5.0,8,8,6.5,5,1,4,18,40,58
p_243,8,0,e_2,285,289,315,14.5,9,5,4.5,4,1,4,4,26,30
p_235,8,0,e_0,314,323,399,14.5,9,5,2.5,5,0,6,9,76,85
p_240,14,0,e_0,301,343,399,7.0,9,9,0.5,5,0,5,42,56,98
p_234,14,0,e_0,314,343,399,7.0,9,9,2.5,5,0,6,29,56,85
p_210,4,0,e_0,353,383,399,3.0,9,9,7.0,4,1,7,30,16,46
p_209,2,0,e_0,354,391,399,20.5,9,6,6.5,4,1,8,37,8,45
p_236,8,0,e_1,313,321,401,1.0,9,9,3.0,5,0,6,8,80,88
p_226,12,0,e_1,331,335,401,10.5,9,2,5.5,5,1,6,4,66,70
p_217,8,0,e_1,345,369,401,14.5,9,5,7.5,5,1,7,24,32,56
p_215,6,0,e_1,346,377,401,1.0,9,9,7.5,3,1,8,31,24,55
p_221,4,0,e_1,341,385,401,3.0,9,9,7.0,5,1,6,44,16,60
p_214,4,0,e_1,346,385,401,3.0,9,9,7.5,3,1,8,39,16,55
p_199,2,0,e_1,368,393,401,5.0,9,9,4.0,1,1,8,25,8,33
p_238,2,0,e_2,311,323,423,20.5,9,6,0.5,4,1,4,12,100,112
p_233,2,0,e_2,319,323,423,5.0,9,9,0.5,5,0,5,4,100,104
p_231,10,0,e_2,320,349,423,12.5,9,3,0.5,5,0,5,29,74,103
p_225,10,0,e_2,333,349,423,3.0,9,9,2.5,5,1,6,16,74,90
p_213,12,0,e_2,347,357,423,5.0,9,9,4.5,5,1,6,10,66,76
p_207,12,0,e_2,355,357,423,10.5,9,2,6.0,5,1,7,2,66,68
p_211,14,0,e_2,348,365,423,8.5,9,1,5.0,2,1,6,17,58,75
p_203,12,0,e_2,365,381,423,10.5,9,2,7.0,5,1,7,16,42,58
p_206,6,0,e_2,362,401,423,16.5,9,6,6.5,5,1,7,39,22,61
p_185,2,0,e_2,392,415,423,20.5,12,8,4.5,4,1,8,23,8,31
p_175,2,0,e_2,399,415,423,20.5,13,8,3.0,4,1,9,16,8,24
p_173,10,0,e_1,405,433,507,3.0,13,13,0.5,5,0,9,28,74,102
p_183,12,0,e_1,393,441,507,10.5,12,3,1.0,1,1,6,48,66,114
p_164,12,0,e_1,416,441,507,5.0,13,13,2.0,5,0,10,25,66,91
p_165,14,0,e_1,416,449,507,7.0,13,13,2.0,5,0,10,33,58,91
p_146,10,0,e_1,451,471,507,3.0,13,13,7.0,5,1,8,20,36,56
p_144,4,0,e_1,451,491,507,3.0,13,13,7.0,5,1,9,40,16,56
p_133,4,0,e_1,463,491,507,18.5,13,8,6.5,4,1,11,28,16,44
p_125,4,0,e_1,474,491,507,18.5,13,8,4.5,4,1,10,17,16,33
p_143,2,0,e_1,451,499,507,5.0,13,13,7.0,5,1,10,48,8,56
p_176,6,0,e_0,398,419,509,16.5,13,8,0.0,3,1,9,21,90,111
p_188,8,0,e_0,390,427,509,14.5,12,7,1.0,1,1,7,37,82,119
p_170,10,0,e_0,408,435,509,3.0,13,13,1.0,5,0,10,27,74,101
p_160,10,0,e_0,421,435,509,12.5,13,5,3.0,5,1,10,14,74,88
p_180,14,0,e_0,396,449,509,7.0,12,12,0.5,4,1,8,53,60,113
p_172,14,0,e_0,405,449,509,7.0,13,13,1.0,5,0,10,44,60,104
p_162,14,0,e_0,417,449,509,7.0,13,13,2.5,5,0,11,32,60,92
p_145,12,0,e_0,451,465,509,5.0,13,13,7.0,5,1,10,14,44,58
p_152,10,0,e_0,439,473,509,3.0,13,13,5.5,5,1,10,34,36,70
p_153,8,0,e_0,438,481,509,14.5,13,7,5.0,5,1,9,43,28,71
p_136,2,0,e_0,460,501,509,20.5,13,8,6.5,4,1,11,41,8,49
p_106,4,0,e_1,512,521,535,3.0,13,13,0.5,5,0,9,9,14,23
p_163,4,0,e_2,417,437,535,18.5,13,8,1.0,4,1,7,20,98,118
p_157,12,0,e_2,427,463,535,10.5,13,3,0.5,5,0,9,36,72,108
p_134,12,0,e_2,462,463,535,5.0,13,13,6.0,5,1,9,1,72,73
p_158,14,0,e_2,426,471,535,7.0,13,13,0.0,5,0,8,45,64,109
p_124,14,0,e_2,474,481,535,8.5,13,1,7.0,5,1,9,7,54,61
p_123,12,0,e_2,474,489,535,10.5,13,3,7.0,5,1,10,15,46,61
p_128,10,0,e_2,471,497,535,12.5,13,5,7.0,5,1,7,26,38,64
p_126,6,0,e_2,473,511,535,1.0,13,13,7.0,5,1,8,38,24,62
p_118,4,0,e_2,488,519,535,18.5,13,8,6.0,4,1,10,31,16,47
p_102,2,0,e_2,521,527,535,5.0,13,13,2.0,4,1,7,6,8,14
p_105,4,0,e_0,515,523,617,3.0,13,13,1.0,5,0,9,8,94,102
p_98,6,0,e_0,524,531,617,16.5,13,8,2.0,5,1,10,7,86,93
p_100,10,0,e_0,522,545,617,3.0,13,13,2.0,5,0,10,23,72,95
p_97,10,0,e_0,526,545,617,3.0,13,13,2.5,5,1,11,19,72,91
p_117,12,0,e_0,490,553,617,5.0,13,13,3.0,4,1,9,63,64,127
p_101,12,0,e_0,521,553,617,10.5,13,3,1.5,5,0,10,32,64,96
p_73,6,0,e_0,568,593,617,1.0,13,13,7.0,4,1,10,25,24,49
p_78,4,0,e_0,555,601,617,3.0,13,13,6.0,5,1,9,46,16,62
p_81,2,0,e_0,547,609,617,5.0,13,13,5.0,5,1,9,62,8,70
p_71,2,0,e_0,569,609,617,5.0,13,13,7.0,4,1,11,40,8,48
p_56,2,0,e_0,588,609,617,20.5,13,8,4.0,4,1,11,21,8,29
p_48,2,0,e_0,593,609,617,20.5,13,8,3.0,1,1,10,16,8,24
p_109,14,0,e_1,506,579,639,7.0,13,13,0.0,4,1,8,73,60,133
p_88,14,0,e_1,538,579,639,7.0,13,13,0.0,5,0,9,41,60,101
p_79,14,0,e_1,549,579,639,8.5,13,1,2.0,5,0,9,30,60,90
p_66,12,0,e_1,577,595,639,10.5,13,3,6.5,5,0,10,18,44,62
p_69,10,0,e_1,573,603,639,12.5,13,5,6.0,5,0,9,30,36,66
p_59,6,0,e_1,584,617,639,1.0,13,13,7.5,3,1,10,33,22,55
p_57,6,0,e_1,587,617,639,16.5,13,8,7.5,4,1,11,30,22,52
p_54,6,0,e_1,590,617,639,16.5,13,8,6.5,4,1,12,27,22,49
p_55,4,0,e_1,590,625,639,3.0,13,13,7.0,4,1,11,35,14,49
p_42,4,0,e_1,600,625,639,18.5,13,8,5.5,4,1,11,25,14,39
p_40,4,0,e_1,601,625,639,3.0,13,13,5.0,4,1,11,24,14,38
p_90,2,0,e_2,536,543,645,5.0,13,13,0.0,5,0,8,7,102,109
p_95,6,0,e_2,527,557,645,16.5,13,8,1.0,1,1,7,30,88,118
p_86,6,0,e_2,541,557,645,1.0,13,13,1.0,5,0,9,16,88,104
p_80,6,0,e_2,548,557,645,1.0,13,13,1.5,5,1,8,9,88,97
p_77,6,0,e_2,557,559,645,16.5,13,8,3.0,5,1,7,2,86,88
p_65,12,0,e_2,578,579,645,5.0,13,13,6.0,5,1,9,1,66,67
p_75,14,0,e_2,563,587,645,8.5,13,1,3.5,5,1,7,24,58,82
p_68,14,0,e_2,574,587,645,7.0,13,13,5.0,5,1,8,13,58,71
p_58,10,0,e_2,586,609,645,12.5,13,5,7.0,2,1,8,23,36,59
p_50,10,0,e_2,592,609,645,3.0,13,13,7.5,3,1,9,17,36,53
p_67,8,0,e_2,574,617,645,1.0,13,13,5.0,5,1,8,43,28,71
p_63,8,0,e_2,581,617,645,1.0,13,13,6.0,5,1,9,36,28,64
p_47,6,0,e_2,594,625,645,16.5,13,8,7.5,4,1,9,31,20,51
p_35,4,0,e_1,640,653,667,18.5,13,8,0.0,5,0,8,13,14,27
p_38,4,0,e_0,627,631,717,18.5,13,8,1.5,5,0,8,4,86,90
p_33,8,0,e_0,647,689,717,1.0,13,13,4.5,5,1,8,42,28,70
p_27,2,0,e_0,693,709,717,5.0,13,13,3.5,4,1,8,16,8,24
p_28,6,0,e_2,679,721,741,1.0,13,13,5.5,5,0,8,42,20,62
p_22,10,0,e_1,712,731,763,3.0,13,13,7.0,5,0,8,19,32,51
p_21,10,0,e_0,732,749,817,12.5,13,5,2.5,5,0,8,17,68,85
p_19,12,0,e_0,740,757,817,10.5,13,3,3.5,5,0,9,17,60,77
p_18,2,0,e_0,768,809,817,5.0,13,13,7.5,4,1,8,41,8,49
p_6,14,0,e_0,858,861,915,8.5,13,1,6.5,5,0,9,3,54,57
p_9,2,0,e_0,845,907,915,20.5,13,8,4.5,5,0,8,62,8,70
p_1,2,0,e_0,889,907,915,5.0,13,13,4.0,4,1,9,18,8,26
p_7,12,0,e_2,851,873,931,10.5,13,3,2.5,5,0,8,22,58,80
p_300,8,0,e_0,4,31,105,8.0,0,0,0.0,3,0,0,27,74,101
p_282,6,0,e_0,62,83,105,17.5,3,2,6.5,4,1,2,21,22,43
p_285,2,0,e_0,54,97,105,22.5,2,2,7.5,3,1,1,43,8,51
p_279,2,0,e_0,76,97,105,5.0,4,4,4.0,4,1,3,21,8,29
p_275,2,0,e_0,84,97,105,20.5,5,3,3.0,4,1,2,13,8,21
p_291,6,0,e_1,35,84,106,21.5,2,2,4.5,5,0,2,49,22,71
p_290,4,0,e_1,43,92,106,22.0,2,2,5.5,5,0,3,49,14,63
p_298,4,0,e_2,10,24,112,4.0,0,0,0.0,3,0,0,14,88,102
p_287,12,0,e_2,51,70,112,13.0,2,1,6.0,5,1,2,19,42,61
p_283,10,0,e_2,55,78,112,14.0,2,2,7.0,5,1,3,23,34,57
p_274,4,0,e_2,84,98,112,3.0,5,5,4.5,4,1,2,14,14,28
p_269,4,0,e_1,146,188,202,18.5,6,4,6.5,5,0,3,42,14,56
p_265,12,0,e_2,157,170,212,10.5,6,2,7.0,5,0,4,13,42,55
p_268,10,0,e_2,150,178,212,3.0,6,6,6.0,5,0,2,28,34,62
p_262,6,0,e_2,164,192,212,1.0,6,6,7.0,4,0,5,28,20,48
p_257,12,0,e_0,179,237,297,5.0,7,7,3.5,4,0,4,58,60,118
p_244,2,0,e_0,271,289,297,20.5,10,6,4.0,4,1,5,18,8,26
p_255,10,0,e_1,192,234,300,12.5,8,3,1.5,4,1,3,42,66,108
p_247,12,0,e_1,248,262,300,5.0,9,9,7.0,5,1,4,14,38,52
p_252,2,0,e_2,212,220,312,5.0,9,9,0.0,3,1,3,8,92,100
p_246,12,0,e_2,257,272,312,10.5,9,2,7.0,5,1,4,15,40,55
p_251,4,0,e_2,228,298,312,3.0,9,9,2.0,5,1,3,70,14,84
p_242,4,0,e_2,287,298,312,18.5,10,6,4.0,4,1,4,11,14,25
p_226,12,0,e_0,331,335,401,10.5,10,2,5.5,5,0,7,4,66,70
p_240,14,0,e_0,301,343,401,8.5,10,1,0.5,5,0,5,42,58,100
p_217,8,0,e_0,345,371,401,1.0,10,10,7.0,5,1,7,26,30,56
p_221,4,0,e_0,341,385,401,18.5,10,6,7.0,5,1,7,44,16,60
p_210,4,0,e_0,353,385,401,18.5,10,6,7.0,4,1,8,32,16,48
p_209,2,0,e_0,354,393,401,20.5,10,6,6.5,4,1,8,39,8,47
p_199,2,0,e_0,368,393,401,5.0,10,10,4.5,4,1,9,25,8,33
p_243,8,0,e_1,285,326,402,14.5,10,5,2.5,4,1,4,41,76,117
p_235,8,0,e_1,314,326,402,14.5,10,5,2.0,5,0,6,12,76,88
p_215,6,0,e_1,346,378,402,16.5,10,6,7.0,5,1,8,32,24,56
p_214,4,0,e_1,346,386,402,3.0,10,10,7.0,5,1,7,40,16,56
p_233,2,0,e_1,319,394,402,5.0,10,10,3.0,5,0,6,75,8,83
p_238,2,0,e_2,311,320,424,5.0,10,10,0.0,4,1,3,9,104,113
p_236,8,0,e_2,313,340,424,14.5,10,5,0.0,5,0,4,27,84,111
p_231,10,0,e_2,320,348,424,3.0,10,10,1.0,2,0,5,28,76,104
p_225,10,0,e_2,333,348,424,3.0,10,10,3.0,5,1,6,15,76,91
p_213,12,0,e_2,347,356,424,5.0,10,10,5.0,2,1,6,9,68,77
p_207,12,0,e_2,355,356,424,5.0,10,10,6.0,2,1,7,1,68,69
p_234,14,0,e_2,314,366,424,8.5,10,1,0.0,5,0,5,52,58,110
p_211,14,0,e_2,348,366,424,8.5,10,1,5.0,5,1,8,18,58,76
p_203,12,0,e_2,365,382,424,5.0,10,10,7.0,2,1,8,17,42,59
p_206,6,0,e_2,362,402,424,16.5,10,6,6.5,5,1,8,40,22,62
p_185,2,0,e_2,392,416,424,5.0,13,13,4.5,4,1,8,24,8,32
p_175,2,0,e_2,399,416,424,5.0,13,13,3.5,4,1,9,17,8,25
p_179,6,0,e_1,397,422,508,16.5,13,8,1.0,4,1,7,25,86,111
p_173,10,0,e_1,405,436,508,12.5,13,5,0.0,5,0,8,31,72,103
p_160,10,0,e_1,421,436,508,12.5,13,5,3.0,2,0,9,15,72,87
p_183,12,0,e_1,393,444,508,10.5,13,3,1.0,1,1,6,51,64,115
p_164,12,0,e_1,416,444,508,5.0,13,13,2.0,5,0,10,28,64,92
p_157,12,0,e_1,427,444,508,5.0,13,13,3.5,5,1,9,17,64,81
p_152,10,0,e_1,439,472,508,12.5,13,5,5.5,5,1,8,33,36,69
p_146,10,0,e_1,451,472,508,3.0,13,13,7.0,5,1,9,21,36,57
p_144,4,0,e_1,451,492,508,3.0,13,13,7.0,5,1,8,41,16,57
p_125,4,0,e_1,474,492,508,18.5,13,8,5.0,4,1,9,18,16,34
p_136,2,0,e_1,460,500,508,5.0,13,13,7.0,4,1,9,40,8,48
p_176,6,0,e_0,398,421,511,16.5,13,8,0.5,4,1,8,23,90,113
p_188,8,0,e_0,390,429,511,1.0,13,13,1.5,4,1,7,39,82,121
p_170,10,0,e_0,408,437,511,3.0,13,13,1.0,5,0,9,29,74,103
p_180,14,0,e_0,396,451,511,7.0,13,13,0.5,4,1,7,55,60,115
p_172,14,0,e_0,405,451,511,7.0,13,13,0.5,5,0,9,46,60,106
p_165,14,0,e_0,416,451,511,8.5,13,1,2.0,5,0,10,35,60,95
p_162,14,0,e_0,417,451,511,7.0,13,13,2.5,5,0,10,34,60,94
p_145,12,0,e_0,451,467,511,5.0,13,13,7.0,2,1,9,16,44,60
p_153,8,0,e_0,438,481,511,14.5,13,7,5.0,5,1,8,43,30,73
p_133,4,0,e_0,463,495,511,18.5,13,8,6.5,4,1,10,32,16,48
p_143,2,0,e_0,451,503,511,5.0,13,13,7.0,2,1,8,52,8,60
p_163,4,0,e_2,417,438,534,3.0,13,13,1.0,4,1,7,21,96,117
p_134,12,0,e_2,462,464,534,10.5,13,3,5.5,5,1,9,2,70,72
p_158,14,0,e_2,426,472,534,7.0,13,13,0.0,5,0,8,46,62,108
p_124,14,0,e_2,474,482,534,7.0,13,13,7.0,5,1,10,8,52,60
p_123,12,0,e_2,474,490,534,10.5,13,3,7.0,5,1,11,16,44,60
p_128,10,0,e_2,471,498,534,12.5,13,5,7.0,5,1,9,27,36,63
p_126,6,0,e_2,473,512,534,1.0,13,13,7.0,5,1,9,39,22,61
p_118,4,0,e_2,488,520,534,18.5,13,8,6.0,4,1,11,32,14,46
p_106,4,0,e_1,512,522,538,3.0,13,13,0.5,5,0,8,10,16,26
p_102,2,0,e_1,521,530,538,20.5,13,8,2.0,5,0,9,9,8,17
p_105,4,0,e_0,515,525,621,3.0,13,13,0.5,5,0,8,10,96,106
p_98,6,0,e_0,524,533,621,1.0,13,13,2.0,3,0,10,9,88,97
p_100,10,0,e_0,522,547,621,12.5,13,5,1.5,5,0,10,25,74,99
p_97,10,0,e_0,526,547,621,3.0,13,13,2.0,5,1,11,21,74,95
p_101,12,0,e_0,521,555,621,5.0,13,13,1.5,5,0,9,34,66,100
p_109,14,0,e_0,506,563,621,7.0,13,13,1.0,4,1,7,57,58,115
p_77,6,0,e_0,557,597,621,16.5,13,8,6.0,5,1,10,40,24,64
p_73,6,0,e_0,568,597,621,16.5,13,8,7.5,4,1,11,29,24,53
p_78,4,0,e_0,555,605,621,3.0,13,13,6.0,5,1,9,50,16,66
p_81,2,0,e_0,547,613,621,20.5,13,8,5.0,2,1,9,66,8,74
p_71,2,0,e_0,569,613,621,5.0,13,13,7.5,4,1,11,44,8,52
p_56,2,0,e_0,588,613,621,20.5,13,8,4.5,4,1,11,25,8,33
p_48,2,0,e_0,593,613,621,20.5,13,8,3.5,4,1,11,20,8,28
p_90,2,0,e_2,536,542,640,20.5,13,8,0.0,5,0,9,6,98,104
p_95,6,0,e_2,527,556,640,16.5,13,8,1.0,4,1,8,29,84,113
p_86,6,0,e_2,541,556,640,1.0,13,13,1.0,2,0,9,15,84,99
p_79,14,0,e_2,549,582,640,7.0,13,13,2.0,5,1,9,33,58,91
p_75,14,0,e_2,563,582,640,8.5,13,1,4.0,5,1,9,19,58,77
p_69,10,0,e_2,573,604,640,3.0,13,13,5.5,5,1,9,31,36,67
p_59,6,0,e_2,584,618,640,16.5,13,8,7.0,5,1,9,34,22,56
p_57,6,0,e_2,587,618,640,16.5,13,8,7.5,4,1,10,31,22,53
p_54,6,0,e_2,590,618,640,1.0,13,13,7.5,4,1,10,28,22,50
p_55,4,0,e_2,590,626,640,3.0,13,13,7.0,4,1,10,36,14,50
p_42,4,0,e_2,600,626,640,18.5,13,8,5.5,4,1,11,26,14,40
p_40,4,0,e_2,601,626,640,3.0,13,13,5.5,4,1,11,25,14,39
p_80,6,0,e_1,548,558,646,1.0,13,13,1.5,5,0,9,10,88,98
p_117,12,0,e_1,490,578,646,5.0,13,13,2.5,4,1,9,88,68,156
p_66,12,0,e_1,577,578,646,10.5,13,3,6.0,5,1,10,1,68,69
p_65,12,0,e_1,578,578,646,10.5,13,3,6.0,2,1,9,0,68,68
p_88,14,0,e_1,538,588,646,8.5,13,1,0.0,5,0,8,50,58,108
p_68,14,0,e_1,574,588,646,7.0,13,13,5.5,5,1,9,14,58,72
p_58,10,0,e_1,586,610,646,3.0,13,13,7.0,5,1,9,24,36,60
p_50,10,0,e_1,592,610,646,3.0,13,13,7.5,5,1,10,18,36,54
p_67,8,0,e_1,574,618,646,14.5,13,7,5.5,5,1,9,44,28,72
p_63,8,0,e_1,581,618,646,1.0,13,13,6.0,5,1,9,37,28,65
p_47,6,0,e_1,594,626,646,16.5,13,8,7.5,4,1,10,32,20,52
p_38,4,0,e_0,627,635,723,18.5,13,8,0.5,5,0,8,8,88,96
p_33,8,0,e_0,647,649,723,14.5,13,7,3.5,5,1,8,2,74,76
p_28,6,0,e_0,679,701,723,1.0,13,13,6.5,4,1,8,22,22,44
p_27,2,0,e_0,693,715,723,20.5,13,8,4.5,4,1,9,22,8,30
p_35,4,0,e_2,640,654,736,3.0,13,13,0.0,3,1,8,14,82,96
p_21,10,0,e_0,732,755,821,3.0,13,13,1.0,5,0,8,23,66,89
p_18,2,0,e_0,768,813,821,20.5,13,8,7.0,5,1,8,45,8,53
p_19,12,0,e_2,740,774,832,5.0,13,13,0.5,5,0,8,34,58,92
p_22,10,0,e_1,712,772,836,3.0,13,13,4.5,4,0,8,60,64,124
p_9,2,0,e_0,845,909,917,20.5,13,8,3.5,5,0,8,64,8,72
p_1,2,0,e_0,889,909,917,5.0,13,13,4.5,4,0,9,20,8,28
p_7,12,0,e_2,851,870,928,5.0,13,13,3.0,5,0,8,19,58,77
p_6,14,0,e_1,858,880,932,8.5,13,1,3.5,5,0,8,22,52,74
p_291,6,0,e_3,35,40,60,6.5,1,0,2.5,5,0,1,5,20,25
p_287,12,0,e_1,51,66,108,19.5,2,2,7.0,5,0,5,15,42,57
p_283,10,0,e_1,55,74,108,21.0,2,2,7.5,3,0,6,19,34,53
p_290,4,0,e_1,43,94,108,29.0,2,2,5.5,5,0,3,51,14,65
p_298,4,0,e_2,10,24,110,4.0,0,0,0.0,3,0,0,14,86,100
p_282,6,0,e_2,62,88,110,6.0,1,0,7.0,4,1,3,26,22,48
p_285,2,0,e_2,54,102,110,29.0,2,2,7.0,5,1,2,48,8,56
p_279,2,0,e_2,76,102,110,19.5,3,2,5.0,4,1,4,26,8,34
p_275,2,0,e_2,84,102,110,18.0,4,2,3.5,4,1,4,18,8,26
p_281,10,0,e_3,63,92,160,9.5,1,0,0.5,5,0,1,29,68,97
p_280,12,0,e_3,65,100,160,11.5,2,0,0.5,5,0,2,35,60,95
p_274,4,0,e_3,84,146,160,16.5,3,2,3.5,5,0,3,62,14,76
p_269,4,0,e_1,146,190,204,28.0,4,4,6.0,5,0,4,44,14,58
p_262,6,0,e_2,164,186,206,23.5,3,2,6.5,4,0,4,22,20,42
p_259,6,0,e_3,174,180,260,22.0,3,2,2.0,5,0,3,6,80,86
p_251,4,0,e_3,228,244,260,0.0,6,0,4.5,4,1,5,16,16,32
p_252,2,0,e_3,212,252,260,5.0,5,1,7.5,4,1,4,40,8,48
p_247,12,0,e_1,248,262,300,19.5,6,6,7.0,5,0,4,14,38,52
p_244,2,0,e_2,271,294,302,26.5,5,4,5.0,4,0,4,23,8,31
p_243,8,0,e_3,285,286,362,18.0,5,3,4.0,5,0,5,1,76,77
p_240,14,0,e_3,301,306,362,10.0,7,1,6.0,5,1,6,5,56,61
p_242,4,0,e_3,287,346,362,22.0,6,3,4.0,5,1,5,59,16,75
p_238,2,0,e_3,311,354,362,5.0,7,7,7.5,3,1,6,43,8,51
p_233,2,0,e_3,319,354,362,4.0,9,3,6.5,4,1,8,35,8,43
p_226,12,0,e_1,331,338,396,22.5,9,9,5.0,5,0,7,7,58,65
p_234,14,0,e_1,314,346,396,23.0,9,9,2.0,5,0,5,32,50,82
p_215,6,0,e_1,346,372,396,26.0,8,8,7.0,4,1,7,26,24,50
p_214,4,0,e_1,346,380,396,28.0,8,8,7.0,4,1,6,34,16,50
p_210,4,0,e_1,353,380,396,27.0,8,8,6.0,4,1,8,27,16,43
p_209,2,0,e_1,354,388,396,29.0,7,7,6.0,4,1,8,34,8,42
p_199,2,0,e_1,368,388,396,27.5,6,5,3.5,4,1,9,20,8,28
p_231,10,0,e_2,320,334,410,26.0,9,9,3.0,5,0,4,14,76,90
p_225,10,0,e_2,333,334,410,24.0,9,9,5.0,5,0,5,1,76,77
p_211,14,0,e_2,348,356,410,18.0,8,8,7.0,5,1,7,8,54,62
p_213,12,0,e_2,347,364,410,20.0,8,8,7.0,5,1,6,17,46,63
p_217,8,0,e_2,345,378,410,24.0,9,9,6.5,5,1,5,33,32,65
p_206,6,0,e_2,362,386,410,6.0,6,6,6.5,4,1,7,24,24,48
p_221,4,0,e_2,341,394,410,29.0,9,9,6.0,5,1,4,53,16,69
p_185,2,0,e_2,392,402,410,23.5,10,8,2.5,4,1,6,10,8,18
p_193,12,0,e_3,378,400,466,15.5,7,2,2.5,5,0,7,22,66,88
p_190,14,0,e_3,382,408,466,13.0,8,1,3.0,5,0,8,26,58,84
p_172,14,0,e_3,405,408,466,9.5,11,1,6.5,5,1,10,3,58,61
p_173,10,0,e_3,405,430,466,13.5,11,4,6.5,5,1,10,25,36,61
p_170,10,0,e_3,408,430,466,13.0,11,3,7.0,2,1,10,22,36,58
p_163,4,0,e_3,417,450,466,3.0,11,1,7.0,4,1,10,33,16,49
p_175,2,0,e_3,399,458,466,22.0,10,7,6.0,5,0,10,59,8,67
p_179,6,0,e_1,397,416,502,18.5,10,7,0.0,5,0,7,19,86,105
p_164,12,0,e_1,416,436,502,25.5,11,11,3.0,2,0,7,20,66,86
p_157,12,0,e_1,427,436,502,23.5,12,12,4.5,5,1,8,9,66,75
p_180,14,0,e_1,396,444,502,10.5,10,1,0.0,5,0,6,48,58,106
p_165,14,0,e_1,416,444,502,23.0,11,11,3.0,2,0,8,28,58,86
p_162,14,0,e_1,417,444,502,23.0,12,12,3.0,5,1,8,27,58,85
p_158,14,0,e_1,426,444,502,21.5,12,12,4.5,5,1,8,18,58,76
p_152,10,0,e_1,439,466,502,23.5,11,11,6.5,5,1,7,27,36,63
p_144,4,0,e_1,451,486,502,28.0,10,10,7.5,4,1,9,35,16,51
p_133,4,0,e_1,463,486,502,26.5,9,9,5.5,4,1,10,23,16,39
p_143,2,0,e_1,451,494,502,30.0,10,10,7.5,4,1,8,43,8,51
p_160,10,0,e_2,421,442,514,26.5,12,12,1.5,5,0,5,21,72,93
p_145,12,0,e_2,451,470,514,20.0,10,10,6.5,5,1,6,19,44,63
p_146,10,0,e_2,451,478,514,22.0,10,10,6.0,5,1,5,27,36,63
p_125,4,0,e_2,474,498,514,25.0,9,7,5.5,4,1,8,24,16,40
p_136,2,0,e_2,460,506,514,29.0,9,9,7.5,4,1,8,46,8,54
p_126,6,0,e_3,473,486,576,23.0,8,5,1.0,5,0,8,13,90,103
p_115,10,0,e_3,494,500,576,16.0,10,4,4.0,5,1,9,6,76,82
p_117,12,0,e_3,490,508,576,14.5,9,2,3.5,5,1,8,18,68,86
p_109,14,0,e_3,506,516,576,10.0,10,1,6.0,5,1,9,10,60,70
p_101,12,0,e_3,521,532,576,5.0,10,10,7.5,3,1,9,11,44,55
p_98,6,0,e_3,524,552,576,1.0,12,0,7.0,4,1,11,28,24,52
p_95,6,0,e_3,527,552,576,0.0,13,0,6.5,4,1,12,25,24,49
p_94,6,0,e_3,528,552,576,0.0,13,0,6.5,4,1,12,24,24,48
p_105,4,0,e_3,515,560,576,19.0,9,4,7.0,2,1,8,45,16,61
p_102,2,0,e_3,521,568,576,5.0,11,11,7.5,3,1,10,47,8,55
p_90,2,0,e_3,536,568,576,3.0,12,2,5.5,4,1,11,32,8,40
p_81,2,0,e_3,547,568,576,2.0,12,1,4.0,4,1,11,21,8,29
p_88,14,0,e_1,538,546,604,21.0,12,12,6.0,5,0,7,8,58,66
p_79,14,0,e_1,549,556,604,19.5,12,12,7.0,5,1,7,7,48,55
p_77,6,0,e_1,557,582,604,26.5,11,11,7.0,4,1,8,25,22,47
p_78,4,0,e_1,555,590,604,29.0,11,11,7.0,1,1,7,35,14,49
p_80,6,0,e_2,548,590,612,27.5,12,12,5.5,5,0,6,42,22,64
p_73,6,0,e_2,568,590,612,25.0,9,9,6.5,4,0,7,22,22,44
p_71,2,0,e_2,569,604,612,29.0,9,9,6.5,4,0,7,35,8,43
p_56,2,0,e_2,588,604,612,26.5,9,8,3.5,4,0,8,16,8,24
p_48,2,0,e_2,593,604,612,25.5,9,8,2.5,4,1,7,11,8,19
p_59,6,0,e_3,584,596,674,23.0,8,5,1.0,5,0,8,12,78,90
p_57,6,0,e_3,587,596,674,22.5,9,5,1.5,5,0,9,9,78,87
p_42,4,0,e_3,600,660,674,22.5,9,6,3.5,5,1,8,60,14,74
p_38,4,0,e_3,627,660,674,3.0,10,1,7.5,4,1,9,33,14,47
p_35,4,0,e_3,640,660,674,1.0,10,0,5.5,4,1,9,20,14,34
p_33,8,0,e_1,647,674,700,26.0,10,10,7.0,5,0,8,27,26,53
p_22,10,0,e_3,712,738,770,14.0,8,3,6.0,5,0,8,26,32,58
p_21,10,0,e_1,732,764,798,25.0,9,9,5.0,5,0,8,32,34,66
p_18,2,0,e_1,768,790,798,28.5,9,9,4.5,4,1,8,22,8,30
p_19,12,0,e_2,740,744,802,23.0,9,9,5.5,5,0,7,4,58,62
p_10,14,0,e_3,810,814,868,9.5,8,1,6.5,5,0,8,4,54,58
p_9,2,0,e_3,845,860,868,1.0,9,0,3.5,4,1,8,15,8,23
p_1,2,0,e_3,889,956,964,24.5,8,6,3.5,5,0,8,67,8,75
p_300,8,0,e_0,4,31,105,8.0,0,0,0.0,3,0,0,27,74,101
p_282,6,0,e_0,62,83,105,17.0,4,3,6.5,4,1,2,21,22,43
p_285,2,0,e_0,54,97,105,22.0,2,2,7.5,3,1,1,43,8,51
p_275,2,0,e_0,84,97,105,20.5,5,3,3.0,4,1,2,13,8,21
p_291,6,0,e_1,35,84,106,21.5,2,2,4.0,5,0,2,49,22,71
p_290,4,0,e_1,43,92,106,22.0,2,2,5.5,5,0,3,49,14,63
p_298,4,0,e_2,10,24,110,4.0,0,0,0.0,3,0,0,14,86,100
p_287,12,0,e_2,51,70,110,13.0,2,1,6.0,5,1,2,19,40,59
p_279,2,0,e_2,76,102,110,20.5,4,3,5.5,4,1,2,26,8,34
p_269,4,0,e_1,146,188,202,3.0,6,6,6.5,5,0,3,42,14,56
p_263,12,0,e_2,163,168,210,5.0,6,6,6.5,4,0,4,5,42,47
p_268,10,0,e_2,150,176,210,12.5,6,2,6.5,5,0,2,26,34,60
p_262,6,0,e_2,164,190,210,16.5,6,3,6.5,4,0,5,26,20,46
p_256,8,0,e_0,191,225,297,1.0,7,7,1.5,4,0,4,34,72,106
p_244,2,0,e_0,271,289,297,5.0,9,9,4.0,4,1,4,18,8,26
p_255,10,0,e_1,192,234,300,3.0,7,7,1.5,4,1,3,42,66,108
p_247,12,0,e_1,248,262,300,10.5,8,1,7.0,5,1,4,14,38,52
p_252,2,0,e_2,212,218,310,5.0,8,8,0.0,5,0,3,6,92,98
p_246,12,0,e_2,257,270,310,5.0,8,8,7.0,5,1,4,13,40,53
p_251,4,0,e_2,228,296,310,18.5,8,3,2.5,5,1,3,68,14,82
p_242,4,0,e_2,287,296,310,3.0,9,9,3.5,4,1,4,9,14,23
p_240,14,0,e_0,301,341,399,8.5,9,1,0.5,5,0,4,40,58,98
p_234,14,0,e_0,314,341,399,7.0,9,9,2.5,5,0,5,27,58,85
p_217,8,0,e_0,345,369,399,1.0,9,9,7.5,5,1,8,24,30,54
p_221,4,0,e_0,341,383,399,3.0,9,9,7.0,5,1,7,42,16,58
p_214,4,0,e_0,346,383,399,3.0,9,9,7.5,4,1,9,37,16,53
p_233,2,0,e_0,319,391,399,5.0,9,9,3.5,5,0,5,72,8,80
p_199,2,0,e_0,368,391,399,5.0,9,9,4.0,1,1,8,23,8,31
p_243,8,0,e_1,285,326,406,14.5,9,4,2.5,4,1,4,41,80,121
p_225,10,0,e_1,333,334,406,12.5,9,2,5.0,5,1,6,1,72,73
p_211,14,0,e_1,348,356,406,8.5,9,1,7.0,5,1,7,8,50,58
p_206,6,0,e_1,362,382,406,16.5,9,4,6.5,4,1,9,20,24,44
p_210,4,0,e_1,353,390,406,3.0,9,9,7.5,4,1,8,37,16,53
p_209,2,0,e_1,354,398,406,20.5,9,4,7.5,4,1,9,44,8,52
p_238,2,0,e_2,311,318,422,20.5,9,4,0.0,5,0,3,7,104,111
p_236,8,0,e_2,313,338,422,14.5,9,4,0.5,5,0,4,25,84,109
p_235,8,0,e_2,314,338,422,1.0,9,9,0.5,5,0,5,24,84,108
p_231,10,0,e_2,320,346,422,12.5,9,2,1.0,5,1,4,26,76,102
p_226,12,0,e_2,331,354,422,10.5,9,1,3.0,5,1,5,23,68,91
p_207,12,0,e_2,355,356,422,5.0,9,9,6.0,5,1,6,1,66,67
p_203,12,0,e_2,365,378,422,5.0,9,9,7.0,5,1,7,13,44,57
p_200,12,0,e_2,367,378,422,5.0,9,9,7.5,3,1,8,11,44,55
p_204,8,0,e_2,364,392,422,1.0,9,9,7.0,5,1,6,28,30,58
p_215,6,0,e_2,346,400,422,16.5,9,4,5.0,2,1,6,54,22,76
p_185,2,0,e_2,392,414,422,20.5,12,6,4.0,1,1,7,22,8,30
p_175,2,0,e_2,399,414,422,20.5,13,7,3.0,1,1,7,15,8,23
p_176,6,0,e_0,398,419,507,1.0,13,13,0.0,3,1,9,21,88,109
p_173,10,0,e_0,405,433,507,12.5,13,4,1.0,5,0,10,28,74,102
p_183,12,0,e_0,393,441,507,5.0,12,12,1.0,4,1,7,48,66,114
p_172,14,0,e_0,405,449,507,8.5,13,1,1.0,5,0,11,44,58,102
p_152,10,0,e_0,439,471,507,3.0,13,13,5.5,5,1,10,32,36,68
p_146,10,0,e_0,451,471,507,12.5,13,4,7.0,5,1,11,20,36,56
p_144,4,0,e_0,451,491,507,18.5,13,7,7.0,5,1,10,40,16,56
p_125,4,0,e_0,474,491,507,18.5,13,7,5.0,4,1,10,17,16,33
p_143,2,0,e_0,451,499,507,5.0,13,13,7.0,5,1,9,48,8,56
p_170,10,0,e_1,408,438,512,3.0,13,13,0.0,5,0,8,30,74,104
p_164,12,0,e_1,416,446,512,5.0,13,13,1.5,5,0,10,30,66,96
p_165,14,0,e_1,416,454,512,8.5,13,1,1.5,5,0,9,38,58,96
p_162,14,0,e_1,417,454,512,7.0,13,13,1.5,5,0,11,37,58,95
p_145,12,0,e_1,451,470,512,10.5,13,2,6.5,5,1,9,19,42,61
p_133,4,0,e_1,463,496,512,3.0,13,13,7.0,4,1,10,33,16,49
p_136,2,0,e_1,460,504,512,20.5,13,7,7.5,4,1,9,44,8,52
p_163,4,0,e_2,417,436,534,3.0,13,13,0.5,4,1,7,19,98,117
p_153,8,0,e_2,438,450,534,1.0,13,13,2.0,5,1,9,12,84,96
p_157,12,0,e_2,427,464,534,5.0,13,13,0.5,5,0,8,37,70,107
p_134,12,0,e_2,462,464,534,5.0,13,13,6.0,5,1,9,2,70,72
p_190,14,0,e_2,382,472,534,7.0,12,12,5.5,4,1,7,90,62,152
p_158,14,0,e_2,426,472,534,7.0,13,13,0.5,5,0,8,46,62,108
p_124,14,0,e_2,474,482,534,8.5,13,1,7.0,5,1,10,8,52,60
p_123,12,0,e_2,474,490,534,5.0,13,13,7.0,5,1,11,16,44,60
p_128,10,0,e_2,471,498,534,3.0,13,13,7.0,5,1,9,27,36,63
p_126,6,0,e_2,473,512,534,1.0,13,13,7.0,5,1,9,39,22,61
p_118,4,0,e_2,488,520,534,3.0,13,13,6.0,4,1,11,32,14,46
p_106,4,0,e_1,512,526,540,3.0,13,13,0.0,3,1,8,14,14,28
p_105,4,0,e_1,515,526,540,3.0,13,13,0.0,5,0,9,11,14,25
p_100,10,0,e_0,522,539,613,3.0,13,13,2.5,5,0,10,17,74,91
p_97,10,0,e_0,526,539,613,3.0,13,13,3.0,5,0,11,13,74,87
p_117,12,0,e_0,490,547,613,5.0,13,13,2.0,1,1,9,57,66,123
p_79,14,0,e_0,549,555,613,8.5,13,1,6.0,5,1,10,6,58,64
p_95,6,0,e_0,527,589,613,16.5,13,7,3.0,5,0,11,62,24,86
p_80,6,0,e_0,548,589,613,1.0,13,13,6.0,5,1,10,41,24,65
p_77,6,0,e_0,557,589,613,16.5,13,7,7.0,5,1,11,32,24,56
p_73,6,0,e_0,568,589,613,16.5,13,7,6.5,4,1,11,21,24,45
p_78,4,0,e_0,555,597,613,18.5,13,7,7.0,5,1,10,42,16,58
p_102,2,0,e_0,521,605,613,5.0,13,13,2.0,5,0,9,84,8,92
p_81,2,0,e_0,547,605,613,5.0,13,13,6.0,2,1,10,58,8,66
p_71,2,0,e_0,569,605,613,5.0,13,13,6.5,4,1,11,36,8,44
p_56,2,0,e_0,588,605,613,5.0,13,13,3.0,4,1,11,17,8,25
p_48,2,0,e_0,593,605,613,20.5,13,7,2.5,4,1,10,12,8,20
p_90,2,0,e_2,536,542,640,5.0,13,13,0.0,5,0,8,6,98,104
p_86,6,0,e_2,541,556,640,16.5,13,7,1.0,2,0,9,15,84,99
p_88,14,0,e_2,538,582,640,8.5,13,1,0.5,5,0,9,44,58,102
p_75,14,0,e_2,563,582,640,8.5,13,1,4.0,5,1,9,19,58,77
p_68,14,0,e_2,574,582,640,8.5,13,1,6.0,5,1,10,8,58,66
p_69,10,0,e_2,573,604,640,12.5,13,4,5.5,5,1,9,31,36,67
p_59,6,0,e_2,584,618,640,16.5,13,7,7.0,5,1,9,34,22,56
p_54,6,0,e_2,590,618,640,1.0,13,13,7.5,4,1,10,28,22,50
p_47,6,0,e_2,594,618,640,1.0,13,13,6.5,4,1,11,24,22,46
p_55,4,0,e_2,590,626,640,3.0,13,13,7.0,4,1,10,36,14,50
p_42,4,0,e_2,600,626,640,18.5,13,7,5.5,4,1,11,26,14,40
p_40,4,0,e_2,601,626,640,18.5,13,7,5.5,4,1,11,25,14,39
p_98,6,0,e_1,524,560,644,1.0,13,13,1.5,5,0,10,36,84,120
p_101,12,0,e_1,521,580,644,5.0,13,13,1.0,5,0,9,59,64,123
p_66,12,0,e_1,577,580,644,10.5,13,2,5.5,5,1,10,3,64,67
p_65,12,0,e_1,578,580,644,10.5,13,2,6.0,5,1,10,2,64,66
p_58,10,0,e_1,586,608,644,12.5,13,4,6.5,5,1,9,22,36,58
p_67,8,0,e_1,574,616,644,14.5,13,6,5.0,5,1,9,42,28,70
p_63,8,0,e_1,581,616,644,14.5,13,6,6.0,5,1,9,35,28,63
p_57,6,0,e_1,587,624,644,16.5,13,7,7.0,5,1,10,37,20,57
p_41,10,0,e_0,600,645,713,3.0,13,13,1.5,4,1,9,45,68,113
p_38,4,0,e_0,627,697,713,3.0,13,13,2.0,5,0,9,70,16,86
p_27,2,0,e_0,693,705,713,5.0,13,13,2.5,4,1,9,12,8,20
p_35,4,0,e_2,640,654,738,3.0,13,13,0.0,5,0,8,14,84,98
p_28,6,0,e_2,679,718,738,1.0,13,13,6.0,5,1,8,39,20,59
p_33,8,0,e_1,647,670,740,14.5,13,6,0.5,5,0,8,23,70,93
p_22,10,0,e_0,712,745,813,12.5,13,4,0.0,3,1,8,33,68,101
p_21,10,0,e_0,732,745,813,12.5,13,4,3.0,5,0,9,13,68,81
p_19,12,0,e_0,740,753,813,10.5,13,2,4.0,5,0,9,13,60,73
p_18,2,0,e_0,768,805,813,5.0,13,13,7.0,4,1,8,37,8,45
p_6,14,0,e_0,858,865,911,7.0,14,14,7.5,5,0,9,7,46,53
p_9,2,0,e_0,845,903,911,5.0,14,14,5.0,5,0,8,58,8,66
p_1,2,0,e_0,889,903,911,5.0,14,14,3.0,4,1,9,14,8,22
p_10,14,0,e_2,810,876,928,7.0,14,14,3.5,4,0,8,66,52,118
p_7,12,0,e_1,851,872,930,5.0,14,14,2.5,5,0,8,21,58,79
p_291,6,0,e_3,35,41,61,6.0,1,0,2.0,5,0,1,6,20,26
p_298,4,0,e_2,10,25,105,4.0,0,0,0.0,3,0,0,15,80,95
p_284,14,0,e_2,55,57,105,17.0,2,2,7.0,5,1,3,2,48,50
p_282,6,0,e_2,62,83,105,6.0,1,0,6.5,4,1,3,21,22,43
p_285,2,0,e_2,54,97,105,29.0,2,2,6.5,5,1,2,43,8,51
p_279,2,0,e_2,76,97,105,20.0,3,2,4.0,4,1,4,21,8,29
p_275,2,0,e_2,84,97,105,18.5,3,2,3.0,4,1,3,13,8,21
p_287,12,0,e_1,51,66,106,19.5,2,2,7.0,5,0,5,15,40,55
p_290,4,0,e_1,43,92,106,29.0,2,2,5.5,5,0,3,49,14,63
p_281,10,0,e_3,63,93,159,10.0,1,0,0.0,5,0,1,30,66,96
p_277,10,0,e_3,81,93,159,11.0,3,1,3.0,5,0,3,12,66,78
p_280,12,0,e_3,65,101,159,11.5,2,0,0.5,5,0,2,36,58,94
p_269,4,0,e_2,146,187,201,28.0,4,4,6.5,5,0,2,41,14,55
p_268,10,0,e_1,150,170,202,21.5,4,4,7.0,5,0,4,20,32,52
p_262,6,0,e_3,164,179,265,23.5,3,2,0.5,5,0,3,15,86,101
p_255,10,0,e_3,192,193,265,15.0,6,3,5.0,5,1,5,1,72,73
p_261,12,0,e_3,170,201,265,16.5,4,2,1.5,5,0,4,31,64,95
p_256,8,0,e_3,191,235,265,17.0,5,3,5.0,5,1,4,44,30,74
p_251,4,0,e_3,228,249,265,1.0,6,0,5.0,4,1,5,21,16,37
p_252,2,0,e_3,212,257,265,5.0,5,5,7.5,3,1,4,45,8,53
p_244,2,0,e_2,271,289,297,27.0,5,4,4.0,4,0,4,18,8,26
p_247,12,0,e_1,248,260,298,20.0,5,5,7.5,5,0,4,12,38,50
p_243,8,0,e_3,285,291,365,19.0,5,4,3.0,5,0,5,6,74,80
p_246,12,0,e_3,257,305,365,19.0,4,4,1.0,4,1,3,48,60,108
p_238,2,0,e_3,311,357,365,21.0,5,3,7.0,5,1,4,46,8,54
p_233,2,0,e_3,319,357,365,5.0,6,0,7.0,4,1,5,38,8,46
p_240,14,0,e_2,301,341,393,10.5,6,1,0.5,5,0,4,40,52,92
p_234,14,0,e_2,314,341,393,9.0,6,1,2.5,5,0,5,27,52,79
p_225,10,0,e_2,333,355,393,25.0,7,7,5.5,5,0,6,22,38,60
p_215,6,0,e_2,346,369,393,26.5,8,8,6.5,4,1,7,23,24,47
p_221,4,0,e_2,341,377,393,29.5,8,8,7.0,2,0,6,36,16,52
p_214,4,0,e_2,346,377,393,28.5,8,8,6.5,4,1,8,31,16,47
p_210,4,0,e_2,353,377,393,27.5,8,8,5.0,4,1,8,24,16,40
p_209,2,0,e_2,354,385,393,29.5,8,8,5.0,1,1,7,31,8,39
p_199,2,0,e_2,368,385,393,27.5,7,6,3.0,1,1,7,17,8,25
p_236,8,0,e_1,313,324,408,15.0,6,3,2.5,5,0,5,11,84,95
p_235,8,0,e_1,314,324,408,15.0,6,3,2.5,5,0,6,10,84,94
p_231,10,0,e_1,320,332,408,27.0,6,6,3.5,5,0,6,12,76,88
p_226,12,0,e_1,331,340,408,23.0,7,7,5.0,2,1,5,9,68,77
p_211,14,0,e_1,348,356,408,18.5,8,8,7.0,5,1,8,8,52,60
p_213,12,0,e_1,347,364,408,20.5,8,8,7.0,5,1,7,17,44,61
p_217,8,0,e_1,345,378,408,25.0,8,8,6.5,5,1,6,33,30,63
p_206,6,0,e_1,362,386,408,24.5,7,7,6.5,4,1,8,24,22,46
p_185,2,0,e_1,392,400,408,24.0,11,8,2.5,4,1,7,8,8,16
p_197,8,0,e_3,375,391,473,20.5,7,4,1.5,5,0,7,16,82,98
p_188,8,0,e_3,390,391,473,18.0,9,5,4.0,2,0,9,1,82,83
p_200,12,0,e_3,367,407,473,18.0,6,2,0.0,5,0,6,40,66,106
p_193,12,0,e_3,378,407,473,16.0,8,2,2.0,5,0,8,29,66,95
p_183,12,0,e_3,393,407,473,14.0,10,3,4.0,2,1,9,14,66,80
p_190,14,0,e_3,382,415,473,13.5,9,1,2.5,5,0,9,33,58,91
p_164,12,0,e_3,416,431,473,11.0,9,2,7.0,5,1,8,15,42,57
p_163,4,0,e_3,417,457,473,19.0,10,4,7.0,5,1,9,40,16,56
p_175,2,0,e_3,399,465,473,23.5,10,7,4.5,5,1,9,66,8,74
p_143,2,0,e_3,451,465,473,1.0,10,0,3.0,4,1,9,14,8,22
p_179,6,0,e_2,397,413,493,19.5,10,6,0.5,5,0,8,16,80,96
p_176,6,0,e_2,398,413,493,19.5,10,6,0.5,5,0,9,15,80,95
p_173,10,0,e_2,405,427,493,14.0,11,4,2.0,5,0,9,22,66,88
p_160,10,0,e_2,421,427,493,27.5,11,11,4.0,5,1,9,6,66,72
p_157,12,0,e_2,427,435,493,24.5,11,11,5.0,2,1,8,8,58,66
p_180,14,0,e_2,396,443,493,11.5,10,1,0.5,5,0,7,47,50,97
p_172,14,0,e_2,405,443,493,10.5,11,1,1.5,5,0,9,38,50,88
p_162,14,0,e_2,417,443,493,9.0,11,1,3.5,5,1,9,26,50,76
p_158,14,0,e_2,426,443,493,22.5,11,11,5.0,5,1,9,17,50,67
p_153,8,0,e_2,438,463,493,27.0,10,10,6.5,5,1,8,25,30,55
p_144,4,0,e_2,451,477,493,29.0,10,10,6.0,4,1,8,26,16,42
p_136,2,0,e_2,460,485,493,29.5,9,9,4.5,4,1,9,25,8,33
p_170,10,0,e_1,408,440,512,14.0,10,3,0.0,5,0,7,32,72,104
p_152,10,0,e_1,439,440,512,25.0,10,10,5.0,5,0,9,1,72,73
p_165,14,0,e_1,416,454,512,9.0,9,1,1.0,5,0,8,38,58,96
p_145,12,0,e_1,451,470,512,21.0,10,10,6.5,5,1,9,19,42,61
p_146,10,0,e_1,451,478,512,23.0,10,10,6.5,5,1,10,27,34,61
p_133,4,0,e_1,463,498,512,27.5,9,9,7.0,4,1,10,35,14,49
p_125,4,0,e_1,474,498,512,26.0,9,7,5.5,4,1,10,24,14,38
p_126,6,0,e_3,473,493,581,24.0,7,4,0.0,5,0,7,20,88,108
p_123,12,0,e_3,474,513,581,18.0,8,2,0.0,5,0,8,39,68,107
p_117,12,0,e_3,490,513,581,15.5,10,3,2.5,5,0,10,23,68,91
p_124,14,0,e_3,474,521,581,16.0,9,1,0.0,5,0,9,47,60,107
p_109,14,0,e_3,506,521,581,11.0,10,1,5.0,5,1,9,15,60,75
p_100,10,0,e_3,522,543,581,13.0,10,2,7.0,5,1,9,21,38,59
p_98,6,0,e_3,524,557,581,16.5,11,4,7.5,5,1,10,33,24,57
p_95,6,0,e_3,527,557,581,1.0,12,0,7.5,4,1,11,30,24,54
p_94,6,0,e_3,528,557,581,1.0,12,0,7.5,4,1,11,29,24,53
p_105,4,0,e_3,515,565,581,20.0,9,5,6.0,5,1,8,50,16,66
p_102,2,0,e_3,521,573,581,21.0,9,3,7.0,2,1,8,52,8,60
p_90,2,0,e_3,536,573,581,4.0,12,3,6.0,4,1,11,37,8,45
p_81,2,0,e_3,547,573,581,2.0,11,1,4.5,4,1,10,26,8,34
p_118,4,0,e_2,488,507,595,23.5,10,8,1.0,4,1,7,19,88,107
p_115,10,0,e_2,494,527,595,17.0,10,4,0.0,5,0,8,33,68,101
p_97,10,0,e_2,526,527,595,3.0,12,12,5.0,2,1,9,1,68,69
p_101,12,0,e_2,521,537,595,11.0,10,2,4.0,5,1,9,16,58,74
p_88,14,0,e_2,538,545,595,22.0,12,12,6.0,5,1,8,7,50,57
p_86,6,0,e_2,541,571,595,29.0,12,12,6.5,5,1,9,30,24,54
p_80,6,0,e_2,548,571,595,28.5,11,11,7.0,4,1,9,23,24,47
p_106,4,0,e_2,512,579,595,20.0,10,6,2.5,5,1,8,67,16,83
p_78,4,0,e_2,555,579,595,29.0,11,11,5.5,4,1,9,24,16,40
p_71,2,0,e_2,569,587,595,29.5,10,10,3.0,4,1,9,18,8,26
p_79,14,0,e_1,549,556,612,20.0,11,11,6.0,5,0,8,7,56,63
p_77,6,0,e_1,557,590,612,27.0,10,10,7.0,5,1,8,33,22,55
p_73,6,0,e_1,568,590,612,25.5,10,10,6.5,4,1,9,22,22,44
p_56,2,0,e_1,588,604,612,27.0,11,10,3.0,4,1,9,16,8,24
p_48,2,0,e_1,593,604,612,26.5,11,10,3.0,4,1,9,11,8,19
p_59,6,0,e_3,584,601,683,24.0,10,7,0.0,5,0,10,17,82,99
p_57,6,0,e_3,587,601,683,23.0,11,7,1.0,5,0,11,14,82,96
p_54,6,0,e_3,590,601,683,22.5,11,7,1.5,5,0,11,11,82,93
p_47,6,0,e_3,594,601,683,22.0,11,7,2.0,5,0,11,7,82,89
p_67,8,0,e_3,574,609,683,23.0,10,10,1.0,4,1,9,35,74,109
p_63,8,0,e_3,581,609,683,8.0,10,10,0.0,3,1,10,28,74,102
p_69,10,0,e_3,573,617,683,21.0,9,9,1.0,1,1,8,44,66,110
p_58,10,0,e_3,586,617,683,19.5,11,3,0.5,5,0,11,31,66,97
p_50,10,0,e_3,592,617,683,18.5,11,3,1.5,5,0,11,25,66,91
p_41,10,0,e_3,600,617,683,17.0,10,3,3.0,2,0,10,17,66,83
p_38,4,0,e_3,627,669,683,19.5,9,5,6.5,5,1,8,42,14,56
p_35,4,0,e_3,640,669,683,2.0,10,1,6.5,4,1,9,29,14,43
p_42,4,0,e_2,600,609,693,23.0,10,8,0.5,5,0,9,9,84,93
p_40,4,0,e_2,601,609,693,23.0,10,8,0.5,5,0,10,8,84,92
p_66,12,0,e_2,577,635,693,18.5,11,11,2.0,4,1,9,58,58,116
p_33,8,0,e_1,647,682,710,27.5,10,10,5.5,5,0,8,35,28,63
p_27,2,0,e_1,693,702,710,26.5,8,7,2.5,4,1,8,9,8,17
p_22,10,0,e_3,712,715,779,15.5,8,3,4.5,5,0,8,3,64,67
p_21,10,0,e_2,732,757,791,3.0,9,9,6.0,5,0,8,25,34,59
p_18,2,0,e_2,768,783,791,30.0,9,9,3.5,4,1,8,15,8,23
p_19,12,0,e_1,740,748,806,24.5,9,9,4.5,5,0,8,8,58,66
p_10,14,0,e_3,810,823,877,11.0,8,1,5.0,5,0,8,13,54,67
p_9,2,0,e_3,845,869,877,3.0,9,1,5.0,4,1,8,24,8,32
p_7,12,0,e_1,851,864,902,22.0,10,10,7.5,5,0,8,13,38,51
p_1,2,0,e_3,889,965,973,26.0,8,7,2.0,5,0,8,76,8,84
p_6,14,0,e_2,858,929,981,19.0,10,10,4.5,4,0,8,71,52,123
p_298,4,0,e_2,10,24,38,4.0,0,0,0.0,3,0,0,14,14,28
p_291,6,0,e_3,35,40,60,6.5,1,0,2.5,5,0,1,5,20,25
p_300,8,0,e_0,4,31,105,8.0,0,0,0.0,3,0,0,27,74,101
p_297,12,0,e_0,18,45,105,12.0,0,0,2.0,5,0,1,27,60,87
p_279,2,0,e_0,76,97,105,19.5,3,2,4.5,4,1,2,21,8,29
p_275,2,0,e_0,84,97,105,18.0,5,3,3.0,4,1,3,13,8,21
p_287,12,0,e_1,51,66,106,19.5,2,2,7.0,5,0,3,15,40,55
p_282,6,0,e_1,62,86,106,6.0,1,0,6.5,4,0,4,24,20,44
p_290,4,0,e_2,43,58,146,28.5,2,2,0.0,3,0,0,15,88,103
p_283,10,0,e_2,55,78,146,21.0,2,2,1.5,5,0,3,23,68,91
p_284,14,0,e_2,55,92,146,17.0,2,2,1.5,5,0,4,37,54,91
p_285,2,0,e_2,54,138,146,29.0,2,2,1.5,5,0,2,84,8,92
p_281,10,0,e_3,63,92,160,9.5,1,0,0.5,5,0,1,29,68,97
p_277,10,0,e_3,81,92,160,10.5,3,1,3.5,5,0,3,11,68,79
p_280,12,0,e_3,65,100,160,11.5,2,0,0.5,5,0,2,35,60,95
p_274,4,0,e_3,84,146,160,16.5,4,3,3.5,5,0,4,62,14,76
p_268,10,0,e_1,150,170,202,21.5,5,5,7.0,5,0,4,20,32,52
p_269,4,0,e_2,146,160,250,28.0,5,5,0.0,3,1,2,14,90,104
p_265,12,0,e_2,157,186,250,18.5,5,5,1.5,5,0,3,29,64,93
p_263,12,0,e_2,163,186,250,18.0,4,2,2.0,5,1,3,23,64,87
p_261,12,0,e_2,170,186,250,16.5,5,2,3.5,5,1,3,16,64,80
p_257,12,0,e_2,179,186,250,15.0,4,2,5.0,5,1,4,7,64,71
p_255,10,0,e_2,192,214,250,15.0,5,2,7.0,5,1,4,22,36,58
p_256,8,0,e_2,191,222,250,17.5,5,2,6.5,5,1,3,31,28,59
p_252,2,0,e_2,212,242,250,5.0,5,1,5.0,4,1,6,30,8,38
p_262,6,0,e_3,164,180,258,23.5,4,2,0.5,5,0,4,16,78,94
p_259,6,0,e_3,174,180,258,22.0,5,2,2.0,5,0,5,6,78,84
p_251,4,0,e_3,228,244,258,0.0,5,0,4.5,4,1,4,16,14,30
p_244,2,0,e_0,271,287,295,26.0,5,4,3.5,4,0,5,16,8,24
p_247,12,0,e_1,248,260,298,19.5,5,5,7.5,3,0,4,12,38,50
p_246,12,0,e_2,257,288,350,12.0,4,4,1.0,5,0,4,31,62,93
p_243,8,0,e_2,285,322,350,17.5,5,3,5.5,5,0,5,37,28,65
p_238,2,0,e_2,311,342,350,4.0,6,2,6.0,4,1,5,31,8,39
p_233,2,0,e_2,319,342,350,3.0,6,1,4.5,4,1,7,23,8,31
p_242,4,0,e_3,287,340,354,21.5,5,4,4.5,5,0,5,53,14,67
p_226,12,0,e_1,331,336,394,20.5,6,6,5.0,5,0,7,5,58,63
p_240,14,0,e_1,301,344,394,9.0,6,1,0.5,5,0,5,43,50,93
p_234,14,0,e_1,314,344,394,21.0,6,6,2.5,5,0,6,30,50,80
p_215,6,0,e_1,346,370,394,25.5,6,6,7.0,4,1,6,24,24,48
p_210,4,0,e_1,353,378,394,26.0,7,7,5.5,4,1,8,25,16,41
p_209,2,0,e_1,354,386,394,2.0,6,6,5.5,4,1,9,32,8,40
p_199,2,0,e_1,368,386,394,26.0,7,6,3.0,4,1,10,18,8,26
p_236,8,0,e_0,313,321,399,27.5,6,6,2.5,5,0,5,8,78,86
p_235,8,0,e_0,314,321,399,27.5,6,6,3.0,5,0,6,7,78,85
p_231,10,0,e_0,320,329,399,24.0,6,6,4.0,2,0,5,9,70,79
p_225,10,0,e_0,333,363,399,22.0,6,6,5.5,5,1,5,30,36,66
p_217,8,0,e_0,345,371,399,23.5,6,6,7.5,5,1,8,26,28,54
p_221,4,0,e_0,341,385,399,28.0,6,6,7.0,5,1,7,44,14,58
p_214,4,0,e_0,346,385,399,27.5,6,6,7.5,4,1,9,39,14,53
p_204,8,0,e_2,364,376,456,20.5,7,4,2.0,5,0,7,12,80,92
p_197,8,0,e_2,375,376,456,19.0,7,4,4.0,5,0,8,1,80,81
p_213,12,0,e_2,347,390,456,19.0,6,6,0.5,4,1,5,43,66,109
p_207,12,0,e_2,355,390,456,18.0,6,3,0.5,5,0,7,35,66,101
p_203,12,0,e_2,365,390,456,16.5,7,3,2.5,5,0,8,25,66,91
p_200,12,0,e_2,367,390,456,16.0,7,3,2.5,5,0,8,23,66,89
p_193,12,0,e_2,378,390,456,14.5,7,3,4.0,5,1,8,12,66,78
p_190,14,0,e_2,382,398,456,12.0,8,1,5.0,5,1,8,16,58,74
p_183,12,0,e_2,393,414,456,12.0,9,3,6.5,5,1,9,21,42,63
p_179,6,0,e_2,397,434,456,17.5,9,6,7.0,2,1,9,37,22,59
p_176,6,0,e_2,398,434,456,17.5,9,6,7.0,2,1,10,36,22,58
p_185,2,0,e_2,392,448,456,22.5,9,6,6.0,5,1,8,56,8,64
p_206,6,0,e_3,362,374,458,23.0,6,4,1.0,5,0,6,12,84,96
p_211,14,0,e_3,348,400,458,17.0,6,6,1.0,4,1,5,52,58,110
p_188,8,0,e_3,390,428,458,16.5,8,4,5.5,5,1,7,38,30,68
p_163,4,0,e_3,417,442,458,1.0,10,0,5.5,4,1,9,25,16,41
p_175,2,0,e_3,399,450,458,21.0,9,5,7.0,5,1,8,51,8,59
p_180,14,0,e_1,396,438,494,9.5,9,1,0.0,5,0,7,42,56,98
p_172,14,0,e_1,405,438,494,23.5,10,10,1.5,5,0,8,33,56,89
p_165,14,0,e_1,416,438,494,22.0,10,10,3.5,5,0,9,22,56,78
p_162,14,0,e_1,417,438,494,21.5,10,10,3.5,5,0,9,21,56,77
p_158,14,0,e_1,426,438,494,20.5,11,11,5.0,5,0,9,12,56,68
p_144,4,0,e_1,451,478,494,27.0,9,9,6.5,4,1,9,27,16,43
p_133,4,0,e_1,463,478,494,25.5,9,7,4.5,4,1,10,15,16,31
p_143,2,0,e_1,451,486,494,29.0,9,9,6.5,4,1,8,35,8,43
p_136,2,0,e_1,460,486,494,28.0,8,7,5.0,4,1,10,26,8,34
p_173,10,0,e_0,405,431,501,27.5,10,10,1.0,5,0,6,26,70,96
p_170,10,0,e_0,408,431,501,27.0,10,10,1.5,5,0,7,23,70,93
p_160,10,0,e_0,421,431,501,25.0,11,11,3.5,5,0,8,10,70,80
p_164,12,0,e_0,416,439,501,24.0,10,10,2.5,5,0,7,23,62,85
p_157,12,0,e_0,427,439,501,22.0,11,11,4.5,5,0,8,12,62,74
p_152,10,0,e_0,439,467,501,22.5,10,10,6.0,2,1,7,28,34,62
p_153,8,0,e_0,438,475,501,24.5,10,10,6.0,2,1,6,37,26,63
p_146,10,0,e_3,451,490,562,21.0,8,8,1.0,4,1,7,39,72,111
p_128,10,0,e_3,471,490,562,18.0,9,3,2.0,5,0,9,19,72,91
p_120,10,0,e_3,481,490,562,16.5,10,3,3.5,5,0,10,9,72,81
p_134,12,0,e_3,462,498,562,17.5,8,2,0.5,5,0,8,36,64,100
p_117,12,0,e_3,490,498,562,13.0,10,2,5.0,5,1,9,8,64,72
p_115,10,0,e_3,494,526,562,14.5,10,3,5.5,5,1,9,32,36,68
p_125,4,0,e_3,474,546,562,23.5,9,7,2.5,5,0,9,72,16,88
p_118,4,0,e_3,488,546,562,21.5,10,7,4.5,5,0,10,58,16,74
p_105,4,0,e_3,515,546,562,2.0,10,1,6.5,4,1,9,31,16,47
p_90,2,0,e_3,536,554,562,1.0,9,0,3.5,4,1,8,18,8,26
p_126,6,0,e_2,473,476,562,21.5,9,6,2.5,5,0,9,3,86,89
p_145,12,0,e_2,451,496,562,19.0,9,9,0.5,4,1,8,45,66,111
p_123,12,0,e_2,474,496,562,15.5,9,2,3.0,5,0,10,22,66,88
p_124,14,0,e_2,474,504,562,13.5,10,1,3.0,5,0,10,30,58,88
p_109,14,0,e_2,506,514,562,9.0,10,1,7.0,5,1,8,8,48,56
p_106,4,0,e_2,512,546,562,3.0,10,1,7.0,4,1,9,34,16,50
p_102,2,0,e_2,521,554,562,4.0,10,3,6.0,4,1,9,33,8,41
p_101,12,0,e_1,521,532,598,23.5,10,10,4.5,5,0,8,11,66,77
p_88,14,0,e_1,538,540,598,19.0,10,10,7.0,5,1,8,2,58,60
p_80,6,0,e_1,548,574,598,26.0,9,9,7.0,4,1,9,26,24,50
p_78,4,0,e_1,555,582,598,27.0,8,8,6.0,4,1,10,27,16,43
p_81,2,0,e_1,547,590,598,30.0,9,9,7.5,4,1,8,43,8,51
p_100,10,0,e_0,522,533,603,25.5,10,10,3.5,5,0,6,11,70,81
p_97,10,0,e_0,526,533,603,25.0,9,9,4.0,5,0,8,7,70,77
p_79,14,0,e_0,549,555,603,17.5,9,9,7.5,3,1,7,6,48,54
p_98,6,0,e_0,524,581,603,29.0,10,10,3.5,5,0,7,57,22,79
p_95,6,0,e_0,527,581,603,29.0,9,9,4.0,5,0,8,54,22,76
p_94,6,0,e_0,528,581,603,29.0,9,9,4.5,5,0,8,53,22,75
p_86,6,0,e_0,541,581,603,27.0,10,10,6.0,5,1,7,40,22,62
p_77,6,0,e_0,557,581,603,24.5,8,8,7.0,4,1,7,24,22,46
p_71,2,0,e_0,569,595,603,27.0,8,7,5.0,4,1,7,26,8,34
p_56,2,0,e_0,588,595,603,24.0,11,9,2.0,4,1,7,7,8,15
p_73,6,0,e_2,568,582,668,23.5,8,5,1.0,5,0,8,14,86,100
p_63,8,0,e_2,581,590,668,19.0,11,6,3.0,5,0,11,9,78,87
p_65,12,0,e_2,578,604,668,15.5,11,3,2.5,5,0,10,26,64,90
p_68,14,0,e_2,574,612,668,14.0,9,1,2.0,5,0,9,38,56,94
p_54,6,0,e_2,590,646,668,20.0,12,7,4.0,5,1,10,56,22,78
p_47,6,0,e_2,594,646,668,19.5,13,7,4.5,5,1,11,52,22,74
p_38,4,0,e_2,627,654,668,2.0,11,1,6.0,4,1,9,27,14,41
p_67,8,0,e_3,574,588,670,20.0,9,5,2.0,5,0,9,14,82,96
p_69,10,0,e_3,573,596,670,18.5,8,3,1.5,5,0,8,23,74,97
p_58,10,0,e_3,586,596,670,16.5,12,4,3.5,5,0,12,10,74,84
p_50,10,0,e_3,592,596,670,15.5,12,4,4.5,5,1,11,4,74,78
p_66,12,0,e_3,577,604,670,15.5,10,3,2.5,5,0,10,27,66,93
p_75,14,0,e_3,563,612,670,16.0,7,1,0.0,5,0,7,49,58,107
p_59,6,0,e_3,584,646,670,20.5,11,8,3.5,5,0,11,62,24,86
p_57,6,0,e_3,587,646,670,20.0,11,7,4.0,2,0,11,59,24,83
p_42,4,0,e_3,600,654,670,20.5,12,7,5.5,5,1,11,54,16,70
p_40,4,0,e_3,601,654,670,20.5,13,7,5.5,5,1,12,53,16,69
p_48,2,0,e_3,593,662,670,23.5,12,9,4.5,5,1,11,69,8,77
p_41,10,0,e_1,600,630,694,14.5,12,4,0.0,5,0,8,30,64,94
p_55,4,0,e_0,590,617,703,22.0,12,9,1.5,4,1,7,27,86,113
p_33,8,0,e_0,647,675,703,25.0,10,10,7.0,5,1,7,28,28,56
p_35,4,0,e_0,640,689,703,30.0,11,11,5.5,5,1,6,49,14,63
p_28,6,0,e_3,679,690,770,22.5,7,4,1.5,5,0,7,11,80,91
p_22,10,0,e_3,712,736,770,13.5,9,2,6.5,5,1,8,24,34,58
p_27,2,0,e_3,693,762,770,24.5,8,5,3.5,5,1,7,69,8,77
p_18,2,0,e_1,768,782,790,28.0,8,8,3.0,4,0,8,14,8,22
p_21,10,0,e_0,732,735,801,25.5,10,10,4.5,5,0,6,3,66,69
p_19,12,0,e_0,740,743,801,22.5,9,9,5.5,5,1,7,3,58,61
p_10,14,0,e_3,810,814,868,9.5,7,1,6.5,5,0,7,4,54,58
p_9,2,0,e_3,845,860,868,1.0,8,0,3.5,4,1,7,15,8,23
p_7,12,0,e_0,851,859,897,20.5,9,9,7.5,4,0,7,8,38,46
p_6,14,0,e_2,858,900,952,17.5,9,9,0.0,5,0,8,42,52,94
p_1,2,0,e_3,889,956,964,25.0,7,5,3.0,5,0,7,67,8,75
p_298,4,0,e_2,10,25,39,4.0,0,0,0.0,3,0,0,15,14,29
p_291,6,0,e_3,35,40,60,6.0,1,0,2.0,5,0,1,5,20,25
p_287,12,0,e_1,51,66,106,19.5,2,2,7.0,5,0,3,15,40,55
p_282,6,0,e_1,62,86,106,6.0,1,0,6.5,4,0,4,24,20,44
p_300,8,0,e_0,4,31,107,8.0,0,0,0.0,3,0,0,27,76,103
p_297,12,0,e_0,18,45,107,12.0,0,0,2.0,5,0,1,27,62,89
p_284,14,0,e_0,55,61,107,17.0,2,2,7.5,5,1,2,6,46,52
p_275,2,0,e_0,84,99,107,14.0,4,2,3.5,4,1,2,15,8,23
p_277,10,0,e_3,81,92,128,9.5,2,0,3.5,5,0,2,11,36,47
p_274,4,0,e_3,84,112,128,12.0,4,2,4.0,5,0,4,28,16,44
p_279,2,0,e_3,76,120,128,2.5,1,0,2.5,5,0,1,44,8,52
p_290,4,0,e_2,43,58,146,28.5,2,2,0.0,3,0,0,15,88,103
p_283,10,0,e_2,55,78,146,20.5,2,2,1.5,5,0,4,23,68,91
p_281,10,0,e_2,63,78,146,10.0,1,0,2.5,5,1,4,15,68,83
p_280,12,0,e_2,65,86,146,11.5,1,0,3.0,5,1,4,21,60,81
p_285,2,0,e_2,54,138,146,29.0,2,2,1.5,5,0,3,84,8,92
p_268,10,0,e_1,150,170,202,6.5,4,0,7.0,5,0,3,20,32,52
p_265,12,0,e_3,157,166,232,13.5,5,1,4.5,5,0,5,9,66,75
p_263,12,0,e_3,163,166,232,12.5,6,1,5.5,5,0,6,3,66,69
p_261,12,0,e_3,170,188,232,11.5,7,1,6.5,5,1,6,18,44,62
p_262,6,0,e_3,164,208,232,18.5,6,3,5.5,5,0,6,44,24,68
p_259,6,0,e_3,174,208,232,17.0,9,3,7.0,5,1,8,34,24,58
p_269,4,0,e_3,146,216,232,7.0,3,2,3.0,5,0,3,70,16,86
p_252,2,0,e_3,212,224,232,0.0,8,0,2.5,4,1,7,12,8,20
p_257,12,0,e_2,179,184,246,25.5,9,9,5.0,5,0,4,5,62,67
p_255,10,0,e_2,192,212,246,25.5,8,8,7.0,5,1,5,20,34,54
p_256,8,0,e_2,191,220,246,28.0,8,8,7.0,5,1,4,29,26,55
p_247,12,0,e_1,248,260,298,15.5,6,2,7.5,5,0,5,12,38,50
p_251,4,0,e_0,228,283,299,26.5,7,7,4.5,5,0,4,55,16,71
p_244,2,0,e_0,271,291,299,22.0,8,4,4.0,4,0,6,20,8,28
p_246,12,0,e_3,257,270,332,14.0,6,2,4.0,5,0,6,13,62,75
p_242,4,0,e_3,287,316,332,2.0,8,1,6.5,4,1,7,29,16,45
p_238,2,0,e_3,311,324,332,0.0,9,0,2.5,4,1,8,13,8,21
p_243,8,0,e_2,285,316,344,29.0,8,8,6.0,5,0,4,31,28,59
p_233,2,0,e_2,319,336,344,29.5,9,9,3.5,4,1,4,17,8,25
p_226,12,0,e_1,331,336,404,12.0,7,7,5.0,5,0,8,5,68,73
p_234,14,0,e_1,314,344,404,18.5,10,10,2.5,5,0,6,30,60,90
p_213,12,0,e_1,347,360,404,16.0,7,2,7.5,5,1,11,13,44,57
p_217,8,0,e_1,345,374,404,20.0,7,3,7.0,5,1,7,29,30,59
p_215,6,0,e_1,346,382,404,22.0,7,4,7.0,5,1,10,36,22,58
p_214,4,0,e_1,346,390,404,24.0,7,5,7.0,5,1,8,44,14,58
p_210,4,0,e_1,353,390,404,22.5,7,5,7.0,4,1,12,37,14,51
p_236,8,0,e_0,313,325,407,24.5,10,10,2.0,5,0,6,12,82,94
p_235,8,0,e_0,314,325,407,24.5,10,10,2.0,5,0,7,11,82,93
p_231,10,0,e_0,320,333,407,21.5,9,9,3.0,5,0,7,13,74,87
p_225,10,0,e_0,333,333,407,20.0,7,2,5.0,2,1,6,0,74,74
p_240,14,0,e_0,301,349,407,20.5,9,9,0.0,5,0,5,48,58,106
p_211,14,0,e_0,348,349,407,13.5,7,1,7.0,5,1,9,1,58,59
p_206,6,0,e_0,362,383,407,19.5,8,5,6.5,4,1,9,21,24,45
p_221,4,0,e_0,341,391,407,24.5,7,5,6.0,5,1,7,50,16,66
p_209,2,0,e_0,354,399,407,24.5,7,5,7.5,4,1,8,45,8,53
p_199,2,0,e_0,368,399,407,22.5,8,5,5.5,4,1,10,31,8,39
p_207,12,0,e_3,355,370,434,14.5,7,2,3.5,5,0,7,15,64,79
p_203,12,0,e_3,365,370,434,12.5,8,2,5.5,5,0,8,5,64,69
p_200,12,0,e_3,367,370,434,12.5,8,2,5.5,5,0,8,3,64,67
p_193,12,0,e_3,378,392,434,11.0,10,2,7.0,5,1,9,14,42,56
p_197,8,0,e_3,375,406,434,15.5,8,3,6.5,5,1,7,31,28,59
p_185,2,0,e_3,392,426,434,4.0,10,2,6.0,4,1,9,34,8,42
p_175,2,0,e_3,399,426,434,3.0,11,1,5.0,4,1,10,27,8,35
p_204,8,0,e_2,364,370,450,17.0,8,4,3.0,5,0,5,6,80,86
p_190,14,0,e_2,382,390,450,23.5,11,11,5.5,5,1,6,8,60,68
p_183,12,0,e_2,393,406,450,24.0,11,11,7.5,5,1,7,13,44,57
p_188,8,0,e_2,390,420,450,28.5,11,11,7.0,2,1,6,30,30,60
p_179,6,0,e_2,397,428,450,29.5,11,11,7.5,4,1,9,31,22,53
p_176,6,0,e_2,398,428,450,29.0,11,11,7.5,4,1,10,30,22,52
p_163,4,0,e_2,417,436,450,28.5,10,10,4.5,4,1,9,19,14,33
p_173,10,0,e_1,405,436,512,24.0,11,11,0.0,5,0,9,31,76,107
p_164,12,0,e_1,416,444,512,20.5,10,10,2.0,5,0,10,28,68,96
p_157,12,0,e_1,427,444,512,19.0,9,9,3.5,5,0,11,17,68,85
p_172,14,0,e_1,405,452,512,20.0,11,11,0.0,5,0,8,47,60,107
p_162,14,0,e_1,417,452,512,18.5,10,10,2.0,5,0,11,35,60,95
p_158,14,0,e_1,426,452,512,17.0,9,9,3.5,5,0,11,26,60,86
p_145,12,0,e_1,451,468,512,15.5,8,2,7.0,2,1,9,17,44,61
p_146,10,0,e_1,451,476,512,17.5,8,3,7.0,5,1,9,25,36,61
p_144,4,0,e_1,451,496,512,23.5,8,6,7.0,2,1,11,45,16,61
p_143,2,0,e_1,451,504,512,25.5,8,7,7.0,2,1,10,53,8,61
p_170,10,0,e_0,408,439,513,24.0,10,10,0.0,5,0,8,31,74,105
p_160,10,0,e_0,421,439,513,22.0,10,10,2.0,5,0,9,18,74,92
p_152,10,0,e_0,439,439,513,19.5,8,3,5.0,2,0,10,0,74,74
p_180,14,0,e_0,396,455,513,21.5,11,11,1.5,4,1,8,59,58,117
p_165,14,0,e_0,416,455,513,18.5,10,10,1.5,5,0,9,39,58,97
p_153,8,0,e_0,438,483,513,21.5,8,4,5.0,5,0,10,45,30,75
p_133,4,0,e_0,463,497,513,21.5,9,7,7.0,4,1,10,34,16,50
p_125,4,0,e_0,474,497,513,20.0,13,8,5.5,4,1,11,23,16,39
p_136,2,0,e_0,460,505,513,24.0,8,6,7.5,4,1,9,45,8,53
p_134,12,0,e_3,462,472,542,13.5,8,2,4.5,5,0,8,10,70,80
p_124,14,0,e_3,474,480,542,10.0,12,1,6.0,5,1,11,6,62,68
p_123,12,0,e_3,474,496,542,12.0,11,2,6.0,5,1,10,22,46,68
p_128,10,0,e_3,471,504,542,14.0,8,3,6.0,2,0,8,33,38,71
p_126,6,0,e_3,473,518,542,18.0,10,6,6.0,5,1,9,45,24,69
p_118,4,0,e_3,488,526,542,3.0,12,2,7.5,4,1,11,38,16,54
p_102,2,0,e_3,521,534,542,1.0,10,0,3.0,4,1,9,13,8,21
p_120,10,0,e_2,481,482,554,13.0,12,4,5.0,5,0,8,1,72,73
p_117,12,0,e_2,490,510,554,25.0,13,13,6.0,5,1,8,20,44,64
p_115,10,0,e_2,494,518,554,26.0,13,13,7.0,5,1,9,24,36,60
p_106,4,0,e_2,512,538,554,30.0,11,11,6.0,4,1,9,26,16,42
p_105,4,0,e_2,515,538,554,29.5,11,11,5.5,4,1,10,23,16,39
p_90,2,0,e_2,536,546,554,29.0,9,9,2.5,4,1,9,10,8,18
p_100,10,0,e_0,522,545,613,22.5,11,11,1.5,5,0,9,23,68,91
p_97,10,0,e_0,526,545,613,22.0,10,10,2.0,5,0,10,19,68,87
p_109,14,0,e_0,506,559,613,21.0,11,11,1.0,4,1,8,53,54,107
p_88,14,0,e_0,538,559,613,16.5,9,9,4.0,5,0,10,21,54,75
p_79,14,0,e_0,549,559,613,15.0,9,1,5.5,5,1,10,10,54,64
p_80,6,0,e_0,548,593,613,23.0,9,5,5.5,5,1,9,45,20,65
p_77,6,0,e_0,557,593,613,22.0,9,5,7.0,5,1,10,36,20,56
p_73,6,0,e_0,568,593,613,20.0,10,6,7.0,4,1,9,25,20,45
p_98,6,0,e_1,524,532,614,26.0,11,11,2.0,5,0,9,8,82,90
p_95,6,0,e_1,527,532,614,26.0,10,10,2.5,5,0,10,5,82,87
p_94,6,0,e_1,528,532,614,26.0,10,10,2.5,5,0,10,4,82,86
p_101,12,0,e_1,521,552,614,21.0,10,10,1.5,5,0,8,31,62,93
p_78,4,0,e_1,555,598,614,24.0,9,7,6.5,5,1,9,43,16,59
p_81,2,0,e_1,547,606,614,27.5,9,8,5.5,5,1,9,59,8,67
p_71,2,0,e_1,569,606,614,24.0,10,7,6.5,4,1,10,37,8,45
p_56,2,0,e_1,588,606,614,21.5,13,8,3.5,4,1,10,18,8,26
p_48,2,0,e_1,593,606,614,20.5,13,6,2.5,4,1,10,13,8,21
p_86,6,0,e_3,541,562,650,6.0,8,8,0.0,3,1,8,21,88,109
p_66,12,0,e_3,577,582,650,12.5,11,3,5.5,5,1,10,5,68,73
p_75,14,0,e_3,563,590,650,13.0,9,1,3.0,5,1,8,27,60,87
p_68,14,0,e_3,574,590,650,11.0,10,1,5.0,5,1,9,16,60,76
p_58,10,0,e_3,586,612,650,13.5,12,4,6.5,5,1,11,26,38,64
p_50,10,0,e_3,592,612,650,13.0,13,3,7.0,5,1,12,20,38,58
p_67,8,0,e_3,574,620,650,17.0,10,5,5.0,5,1,9,46,30,76
p_63,8,0,e_3,581,620,650,16.0,11,5,6.0,2,1,10,39,30,69
p_59,6,0,e_3,584,628,650,18.0,11,7,6.0,5,1,10,44,22,66
p_54,6,0,e_3,590,628,650,17.0,13,6,7.0,5,1,12,38,22,60
p_47,6,0,e_3,594,628,650,1.0,13,13,7.5,3,1,12,34,22,56
p_55,4,0,e_3,590,636,650,19.0,12,6,7.0,2,1,11,46,14,60
p_42,4,0,e_3,600,636,650,3.0,13,2,7.0,4,1,12,36,14,50
p_40,4,0,e_3,601,636,650,3.0,13,2,7.0,4,1,12,35,14,49
p_69,10,0,e_2,573,586,658,15.5,10,4,3.0,5,0,8,13,72,85
p_65,12,0,e_2,578,594,658,12.5,12,3,3.5,5,0,9,16,64,80
p_41,10,0,e_2,600,622,658,27.0,13,13,7.0,5,1,9,22,36,58
p_57,6,0,e_2,587,636,658,17.5,13,8,5.0,5,1,9,49,22,71
p_38,4,0,e_2,627,644,658,29.0,11,11,4.5,4,1,9,17,14,31
p_27,2,0,e_1,693,702,710,21.0,9,4,2.5,4,0,8,9,8,17
p_33,8,0,e_0,647,683,711,22.5,9,9,5.5,5,0,9,36,28,64
p_35,4,0,e_0,640,697,711,27.5,9,9,4.0,5,0,8,57,14,71
p_28,6,0,e_3,679,726,746,19.5,8,5,4.5,5,0,8,47,20,67
p_21,10,0,e_1,732,742,806,22.5,9,9,3.5,5,0,8,10,64,74
p_22,10,0,e_0,712,743,811,24.5,9,9,0.0,5,0,8,31,68,99
p_19,12,0,e_0,740,751,811,19.0,9,9,4.5,5,0,9,11,60,71
p_18,2,0,e_0,768,803,811,24.5,8,6,6.5,4,1,8,35,8,43
p_10,14,0,e_1,810,850,904,20.0,8,8,0.5,5,0,8,40,54,94
p_7,12,0,e_1,851,866,904,16.5,8,2,7.0,5,1,8,15,38,53
p_9,2,0,e_0,845,899,907,27.5,8,7,5.5,5,0,8,54,8,62
p_1,2,0,e_0,889,899,907,5.0,9,2,2.5,4,0,9,10,8,18
p_6,14,0,e_3,858,884,936,13.5,8,1,2.5,5,0,8,26,52,78
p_300,8,0,e_0,4,30,102,8.0,0,0,0.0,3,0,0,26,72,98
p_285,2,0,e_0,54,94,102,16.5,2,1,7.5,4,1,2,40,8,48
p_275,2,0,e_0,84,94,102,3.0,4,2,2.5,4,1,4,10,8,18
p_282,6,0,e_1,62,83,103,15.5,3,1,6.5,4,0,3,21,20,41
p_298,4,0,e_2,10,24,112,4.0,0,0,0.0,3,0,0,14,88,102
p_283,10,0,e_2,55,76,112,12.5,3,2,7.0,5,1,5,21,36,57
p_291,6,0,e_2,35,90,112,15.5,1,1,3.5,5,1,1,55,22,77
p_290,4,0,e_2,43,98,112,16.0,1,1,5.0,5,1,2,55,14,69
p_297,12,0,e_3,18,57,119,12.0,0,0,0.0,3,0,0,39,62,101
p_287,12,0,e_3,51,57,119,7.0,2,0,5.0,5,0,2,6,62,68
p_284,14,0,e_3,55,65,119,8.5,2,0,5.5,5,0,2,10,54,64
p_280,12,0,e_3,65,73,119,5.0,3,0,7.0,2,1,2,8,46,54
p_281,10,0,e_3,63,81,119,11.5,3,1,6.5,5,1,2,18,38,56
p_277,10,0,e_3,81,83,119,25.0,3,3,5.0,4,1,2,2,36,38
p_274,4,0,e_3,84,103,119,1.0,3,0,5.0,4,1,2,19,16,35
p_279,2,0,e_3,76,111,119,4.0,3,1,6.0,4,1,2,35,8,43
p_265,12,0,e_2,157,170,212,12.0,4,1,7.0,5,0,4,13,42,55
p_262,6,0,e_2,164,190,212,17.0,5,4,7.0,4,0,5,26,22,48
p_269,4,0,e_2,146,198,212,14.0,2,1,5.5,5,0,3,52,14,66
p_263,12,0,e_3,163,177,219,11.0,4,1,7.0,5,0,4,14,42,56
p_268,10,0,e_3,150,185,219,7.0,2,1,5.0,5,0,2,35,34,69
p_259,6,0,e_3,174,199,219,0.0,5,0,6.5,4,0,5,25,20,45
p_256,8,0,e_1,191,223,293,26.5,5,5,1.0,4,0,5,32,70,102
p_255,10,0,e_0,192,228,294,24.0,5,5,0.5,4,0,5,36,66,102
p_261,12,0,e_0,170,236,294,22.0,5,5,4.5,4,0,4,66,58,124
p_257,12,0,e_0,179,236,294,24.0,6,6,2.5,4,0,5,57,58,115
p_252,2,0,e_2,212,220,312,29.0,4,4,0.0,5,0,4,8,92,100
p_246,12,0,e_2,257,272,312,12.0,4,1,7.0,5,1,5,15,40,55
p_251,4,0,e_2,228,298,312,25.0,3,2,2.0,5,1,4,70,14,84
p_247,12,0,e_3,248,257,321,13.5,3,1,4.5,5,0,3,9,64,73
p_242,4,0,e_3,287,303,321,0.0,5,0,4.5,4,1,4,16,18,34
p_244,2,0,e_3,271,311,321,5.0,4,1,7.0,4,1,3,40,10,50
p_238,2,0,e_3,311,311,321,29.0,4,4,1.0,1,1,3,0,10,10
p_226,12,0,e_1,331,351,393,17.0,6,1,6.0,5,0,7,20,42,62
p_221,4,0,e_1,341,377,393,23.0,6,4,7.5,4,0,8,36,16,52
p_214,4,0,e_1,346,377,393,22.5,6,4,6.5,4,0,9,31,16,47
p_210,4,0,e_1,353,377,393,21.0,7,5,6.0,4,1,8,24,16,40
p_209,2,0,e_1,354,385,393,23.0,6,4,6.0,4,1,8,31,8,39
p_243,8,0,e_0,285,320,398,27.0,5,5,1.5,4,1,5,35,78,113
p_240,14,0,e_0,301,340,398,18.0,6,6,1.0,5,0,6,39,58,97
p_225,10,0,e_0,333,362,398,18.5,6,2,6.0,5,1,6,29,36,65
p_217,8,0,e_0,345,370,398,18.5,6,4,7.5,3,1,7,25,28,53
p_215,6,0,e_0,346,378,398,20.5,6,4,7.5,4,1,8,32,20,52
p_236,8,0,e_2,313,338,408,23.0,4,4,0.0,5,0,4,25,70,95
p_235,8,0,e_2,314,338,408,23.0,4,4,0.0,5,0,5,24,70,94
p_234,14,0,e_2,314,358,408,17.0,4,4,0.0,5,0,5,44,50,94
p_211,14,0,e_2,348,358,408,12.0,7,1,5.5,5,1,7,10,50,60
p_207,12,0,e_2,355,366,408,13.0,7,2,6.5,5,1,7,11,42,53
p_206,6,0,e_2,362,386,408,18.0,6,4,6.5,4,1,7,24,22,46
p_199,2,0,e_2,368,400,408,21.5,8,6,6.0,4,1,7,32,8,40
p_185,2,0,e_2,392,400,408,3.0,8,1,2.5,4,1,8,8,8,16
p_233,2,0,e_3,319,329,427,28.5,4,4,0.5,4,1,3,10,98,108
p_231,10,0,e_3,320,355,427,10.0,4,4,0.0,3,1,4,35,72,107
p_213,12,0,e_3,347,363,427,14.0,6,1,4.0,5,1,5,16,64,80
p_203,12,0,e_3,365,385,427,12.0,7,2,6.0,5,1,6,20,42,62
p_200,12,0,e_3,367,385,427,11.5,8,2,6.5,5,1,7,18,42,60
p_204,8,0,e_3,364,399,427,16.0,6,4,6.0,5,1,5,35,28,63
p_175,2,0,e_3,399,419,427,2.0,7,1,4.0,4,1,6,20,8,28
p_163,4,0,e_3,417,441,455,27.0,8,8,1.0,4,1,7,24,14,38
p_179,6,0,e_1,397,413,501,28.5,8,8,0.5,5,0,9,16,88,104
p_173,10,0,e_1,405,427,501,23.0,8,8,1.5,5,0,10,22,74,96
p_183,12,0,e_1,393,435,501,23.0,8,8,0.0,3,1,8,42,66,108
p_190,14,0,e_1,382,443,501,22.5,9,9,1.5,4,1,8,61,58,119
p_180,14,0,e_1,396,443,501,20.5,8,8,0.5,5,0,9,47,58,105
p_158,14,0,e_1,426,443,501,16.0,8,8,5.0,2,1,9,17,58,75
p_153,8,0,e_1,438,471,501,20.5,8,5,6.5,5,1,8,33,30,63
p_144,4,0,e_1,451,485,501,26.5,8,8,7.5,4,1,8,34,16,50
p_143,2,0,e_1,451,493,501,28.5,8,8,7.5,4,1,9,42,8,50
p_176,6,0,e_0,398,418,506,28.0,8,8,0.0,3,1,9,20,88,108
p_197,8,0,e_0,375,426,506,29.5,8,8,3.5,4,1,7,51,80,131
p_193,12,0,e_0,378,440,506,25.0,9,9,3.0,1,1,7,62,66,128
p_164,12,0,e_0,416,440,506,19.5,8,8,3.0,5,0,10,24,66,90
p_162,14,0,e_0,417,448,506,17.0,8,8,3.0,2,0,9,31,58,89
p_152,10,0,e_0,439,470,506,18.5,8,4,6.0,2,1,8,31,36,67
p_146,10,0,e_0,451,470,506,20.5,8,8,7.5,5,1,8,19,36,55
p_133,4,0,e_0,463,490,506,25.0,7,6,6.0,4,1,9,27,16,43
p_136,2,0,e_0,460,498,506,27.5,7,7,6.5,4,1,8,38,8,46
p_188,8,0,e_2,390,434,512,27.5,8,8,2.5,4,1,7,44,78,122
p_170,10,0,e_2,408,442,512,23.0,8,8,0.0,3,1,8,34,70,104
p_160,10,0,e_2,421,442,512,21.0,8,8,2.0,5,0,10,21,70,91
p_172,14,0,e_2,405,456,512,19.5,8,8,0.5,4,1,7,51,56,107
p_165,14,0,e_2,416,456,512,17.5,8,8,1.0,5,0,10,40,56,96
p_145,12,0,e_2,451,472,512,18.5,8,8,6.0,5,1,8,21,40,61
p_125,4,0,e_2,474,498,512,23.0,9,8,6.0,4,1,8,24,14,38
p_126,6,0,e_3,473,475,563,21.5,8,6,2.5,5,0,8,2,88,90
p_128,10,0,e_3,471,489,563,17.5,7,4,2.5,5,0,7,18,74,92
p_120,10,0,e_3,481,489,563,16.0,10,5,4.0,5,1,9,8,74,82
p_157,12,0,e_3,427,497,563,18.0,7,2,0.0,5,0,7,70,66,136
p_134,12,0,e_3,462,497,563,17.0,7,2,1.0,5,0,7,35,66,101
p_123,12,0,e_3,474,497,563,15.0,10,3,3.0,5,0,10,23,66,89
p_117,12,0,e_3,490,497,563,13.0,10,3,5.0,5,1,9,7,66,73
p_124,14,0,e_3,474,505,563,13.0,9,1,3.0,5,0,9,31,58,89
p_109,14,0,e_3,506,515,563,9.0,9,1,7.0,5,1,8,9,48,57
p_118,4,0,e_3,488,547,563,21.0,10,7,5.0,5,1,9,59,16,75
p_105,4,0,e_3,515,547,563,3.0,9,1,7.0,1,1,8,32,16,48
p_102,2,0,e_3,521,555,563,4.0,9,3,6.0,4,1,8,34,8,42
p_90,2,0,e_3,536,555,563,1.0,11,0,3.5,4,1,10,19,8,27
p_115,10,0,e_1,494,533,603,14.5,11,5,1.0,4,1,7,39,70,109
p_100,10,0,e_1,522,533,603,26.0,10,10,3.5,5,0,8,11,70,81
p_98,6,0,e_1,524,579,603,30.0,11,11,3.5,5,0,8,55,24,79
p_95,6,0,e_1,527,579,603,29.5,11,11,4.0,5,0,9,52,24,76
p_94,6,0,e_1,528,579,603,29.0,11,11,4.5,5,0,9,51,24,75
p_86,6,0,e_1,541,579,603,27.0,11,11,6.0,5,1,8,38,24,62
p_77,6,0,e_1,557,579,603,25.0,9,9,6.5,4,1,10,22,24,46
p_78,4,0,e_1,555,587,603,27.0,9,9,7.0,4,1,9,32,16,48
p_81,2,0,e_1,547,595,603,30.0,10,10,7.0,5,1,8,48,8,56
p_97,10,0,e_0,526,538,612,25.5,11,11,3.0,5,0,8,12,74,86
p_101,12,0,e_0,521,546,612,24.0,10,10,2.5,5,0,7,25,66,91
p_88,14,0,e_0,538,554,612,19.5,11,11,5.0,2,0,8,16,58,74
p_80,6,0,e_0,548,588,612,26.0,10,10,6.0,5,1,8,40,24,64
p_73,6,0,e_0,568,588,612,23.5,8,5,6.5,4,1,8,20,24,44
p_55,4,0,e_0,590,596,612,22.0,13,10,3.0,4,1,8,6,16,22
p_71,2,0,e_0,569,604,612,27.5,8,7,6.0,4,1,8,35,8,43
p_56,2,0,e_0,588,604,612,24.0,12,10,3.0,4,1,8,16,8,24
p_106,4,0,e_2,512,526,614,3.0,10,1,0.0,3,1,8,14,88,102
p_79,14,0,e_2,549,558,614,18.0,10,10,5.5,5,1,8,9,56,65
p_75,14,0,e_2,563,568,614,14.0,8,8,7.5,3,1,8,5,46,51
p_48,2,0,e_2,593,606,614,23.5,13,10,3.0,4,1,9,13,8,21
p_42,4,0,e_1,600,617,631,20.5,13,9,0.5,4,1,9,17,14,31
p_67,8,0,e_3,574,589,671,20.5,9,5,1.5,5,0,9,15,82,97
p_63,8,0,e_3,581,589,671,19.0,12,7,3.0,5,0,12,8,82,90
p_69,10,0,e_3,573,597,671,18.5,8,3,1.5,5,0,8,24,74,98
p_66,12,0,e_3,577,605,671,16.0,11,3,2.0,5,0,11,28,66,94
p_65,12,0,e_3,578,605,671,16.0,12,3,2.0,5,0,12,27,66,93
p_68,14,0,e_3,574,613,671,14.5,10,1,1.5,5,0,10,39,58,97
p_41,10,0,e_3,600,635,671,14.5,12,5,5.5,5,1,11,35,36,71
p_59,6,0,e_3,584,649,671,21.0,12,9,3.0,5,0,12,65,22,87
p_47,6,0,e_3,594,649,671,19.5,13,8,4.5,5,1,12,55,22,77
p_38,4,0,e_3,627,657,671,2.0,11,1,6.0,4,1,10,30,14,44
p_35,4,0,e_3,640,657,671,0.0,11,0,4.5,4,1,10,17,14,31
p_58,10,0,e_2,586,646,710,16.5,13,5,4.5,4,1,8,60,64,124
p_40,4,0,e_0,601,626,714,20.5,13,9,1.5,4,1,9,25,88,113
p_50,10,0,e_0,592,646,714,16.0,13,5,2.5,4,1,9,54,68,122
p_33,8,0,e_0,647,686,714,25.0,11,11,5.0,5,1,7,39,28,67
p_27,2,0,e_0,693,706,714,24.5,8,6,3.0,4,1,7,13,8,21
p_57,6,0,e_1,587,651,729,20.5,13,9,2.0,4,1,8,64,78,142
p_54,6,0,e_1,590,651,729,20.0,13,8,1.5,4,1,9,61,78,139
p_28,6,0,e_1,679,709,729,23.0,8,5,7.5,3,1,8,30,20,50
p_22,10,0,e_3,712,735,767,13.5,8,3,6.5,5,0,8,23,32,55
p_19,12,0,e_2,740,748,806,22.5,9,9,5.0,5,0,8,8,58,66
p_21,10,0,e_0,732,746,812,24.5,9,9,3.0,5,0,7,14,66,80
p_18,2,0,e_0,768,804,812,28.0,8,7,7.0,4,1,7,36,8,44
p_10,14,0,e_3,810,811,865,9.0,8,1,7.0,5,0,8,1,54,55
p_9,2,0,e_3,845,857,865,1.0,9,0,3.0,4,1,8,12,8,20
p_6,14,0,e_0,858,864,912,17.0,9,9,7.5,5,0,8,6,48,54
p_7,12,0,e_0,851,872,912,20.0,10,10,6.5,5,0,7,21,40,61
p_1,2,0,e_0,889,904,912,24.5,8,6,3.5,4,1,7,15,8,23
p_291,6,0,e_3,35,40,60,6.5,1,0,2.5,5,0,1,5,20,25
p_298,4,0,e_2,10,24,106,4.0,0,0,0.0,3,0,0,14,82,96
p_284,14,0,e_2,55,56,106,17.0,2,2,7.0,5,1,2,1,50,51
p_283,10,0,e_2,55,70,106,21.0,2,2,7.0,5,1,1,15,36,51
p_282,6,0,e_2,62,84,106,6.0,1,0,6.5,4,1,2,22,22,44
p_275,2,0,e_2,84,98,106,4.0,4,1,3.0,4,1,1,14,8,22
p_287,12,0,e_1,51,65,107,19.5,2,2,7.0,5,0,5,14,42,56
p_290,4,0,e_1,43,91,107,28.5,2,2,6.0,5,0,3,48,16,64
p_285,2,0,e_1,54,99,107,29.0,2,2,7.5,4,0,6,45,8,53
p_274,4,0,e_3,84,142,158,2.0,3,1,4.0,5,0,3,58,16,74
p_279,2,0,e_3,76,150,158,2.5,1,0,2.5,5,0,1,74,8,82
p_268,10,0,e_1,150,171,205,21.0,5,5,7.0,5,0,5,21,34,55
p_269,4,0,e_1,146,191,205,27.5,6,6,6.5,5,0,4,45,14,59
p_252,2,0,e_3,212,246,254,4.0,5,2,6.5,4,0,5,34,8,42
p_244,2,0,e_2,271,288,296,25.5,5,4,3.5,4,0,3,17,8,25
p_247,12,0,e_1,248,263,301,19.0,6,6,7.0,5,0,4,15,38,53
p_242,4,0,e_3,287,336,352,21.0,5,2,5.0,5,0,5,49,16,65
p_238,2,0,e_3,311,344,352,4.0,6,3,6.0,4,0,6,33,8,41
p_233,2,0,e_3,319,344,352,3.0,7,2,5.0,4,0,7,25,8,33
p_240,14,0,e_2,301,340,390,22.5,6,6,0.5,5,0,3,39,50,89
p_234,14,0,e_2,314,340,390,20.5,7,7,3.0,5,0,4,26,50,76
p_225,10,0,e_2,333,354,390,21.5,7,7,6.0,5,0,5,21,36,57
p_221,4,0,e_2,341,374,390,27.5,7,7,7.0,4,1,6,33,16,49
p_214,4,0,e_2,346,374,390,27.0,6,6,6.5,4,1,7,28,16,44
p_210,4,0,e_2,353,374,390,26.0,5,3,5.0,4,1,7,21,16,37
p_209,2,0,e_2,354,382,390,28.0,5,4,5.0,1,1,6,28,8,36
p_199,2,0,e_2,368,382,390,25.5,6,5,3.0,4,1,7,14,8,22
p_231,10,0,e_1,320,333,399,23.5,7,7,3.0,5,0,5,13,66,79
p_226,12,0,e_1,331,341,399,20.0,7,7,4.5,5,0,6,10,58,68
p_211,14,0,e_1,348,349,399,16.5,6,6,7.0,5,1,9,1,50,51
p_213,12,0,e_1,347,357,399,18.5,6,6,7.0,5,1,8,10,42,52
p_217,8,0,e_1,345,371,399,23.0,6,6,6.5,5,1,6,26,28,54
p_215,6,0,e_1,346,379,399,25.0,6,6,6.5,5,1,7,33,20,53
p_206,6,0,e_3,362,372,454,22.5,5,2,1.5,5,0,5,10,82,92
p_197,8,0,e_3,375,380,454,19.0,7,3,3.0,5,1,6,5,74,79
p_180,14,0,e_3,396,400,454,9.5,9,1,6.5,5,1,8,4,54,58
p_163,4,0,e_3,417,440,454,1.0,9,0,5.5,4,1,8,23,14,37
p_173,10,0,e_1,405,431,495,27.5,9,9,0.5,5,0,7,26,64,90
p_170,10,0,e_1,408,431,495,27.5,9,9,1.5,5,0,8,23,64,87
p_160,10,0,e_1,421,431,495,25.0,10,10,3.5,5,0,10,10,64,74
p_164,12,0,e_1,416,439,495,24.0,9,9,2.5,5,0,9,23,56,79
p_157,12,0,e_1,427,439,495,22.0,10,10,4.5,5,0,10,12,56,68
p_165,14,0,e_1,416,447,495,22.0,9,9,2.5,5,0,8,31,48,79
p_162,14,0,e_1,417,447,495,22.0,9,9,3.0,5,0,10,30,48,78
p_158,14,0,e_1,426,447,495,20.0,10,10,4.5,5,0,10,21,48,69
p_152,10,0,e_1,439,461,495,22.0,10,10,6.0,2,1,8,22,34,56
p_143,2,0,e_1,451,487,495,28.5,9,9,6.5,4,1,8,36,8,44
p_179,6,0,e_2,397,410,496,17.5,10,6,1.0,5,0,7,13,86,99
p_188,8,0,e_2,390,418,496,16.5,8,3,0.0,3,1,5,28,78,106
p_183,12,0,e_2,393,432,496,12.0,8,2,0.0,5,0,6,39,64,103
p_172,14,0,e_2,405,440,496,23.5,9,9,2.0,5,0,8,35,56,91
p_144,4,0,e_2,451,480,496,26.5,9,9,6.5,4,1,6,29,16,45
p_133,4,0,e_2,463,480,496,25.0,8,6,4.5,4,1,8,17,16,33
p_136,2,0,e_2,460,488,496,27.5,8,7,5.0,4,1,7,28,8,36
p_128,10,0,e_3,471,486,560,17.5,8,3,2.5,5,0,8,15,74,89
p_123,12,0,e_3,474,494,560,15.0,10,3,3.0,5,0,10,20,66,86
p_124,14,0,e_3,474,502,560,13.0,9,1,3.0,5,0,9,28,58,86
p_109,14,0,e_3,506,512,560,8.5,10,1,7.5,5,1,9,6,48,54
p_118,4,0,e_3,488,544,560,21.0,11,7,5.0,5,1,10,56,16,72
p_106,4,0,e_3,512,544,560,3.0,10,1,7.0,1,1,9,32,16,48
p_105,4,0,e_3,515,544,560,3.0,10,1,7.0,4,1,9,29,16,45
p_102,2,0,e_3,521,552,560,4.0,10,3,6.0,4,1,9,31,8,39
p_90,2,0,e_3,536,552,560,1.0,11,0,3.0,4,1,10,16,8,24
p_115,10,0,e_1,494,527,593,14.0,11,4,0.0,3,1,7,33,66,99
p_100,10,0,e_1,522,527,593,25.5,11,11,4.5,5,0,9,5,66,71
p_97,10,0,e_1,526,527,593,25.0,11,11,5.0,2,0,8,1,66,67
p_101,12,0,e_1,521,537,593,23.5,11,11,4.0,5,0,8,16,56,72
p_88,14,0,e_1,538,545,593,19.0,11,11,6.0,5,1,7,7,48,55
p_78,4,0,e_1,555,577,593,26.5,9,9,5.5,4,1,8,22,16,38
p_81,2,0,e_1,547,585,593,30.0,10,10,7.0,4,1,7,38,8,46
p_98,6,0,e_2,524,572,594,29.0,11,11,4.5,5,0,6,48,22,70
p_86,6,0,e_2,541,572,594,26.5,11,11,7.5,5,0,7,31,22,53
p_80,6,0,e_2,548,572,594,25.5,10,10,7.0,4,0,7,24,22,46
p_71,2,0,e_2,569,586,594,27.0,9,8,3.5,4,0,7,17,8,25
p_48,2,0,e_1,593,601,623,22.5,11,8,0.0,3,1,8,8,22,30
p_40,4,0,e_1,601,609,623,20.0,11,6,1.0,2,0,8,8,14,22
p_66,12,0,e_3,577,598,662,15.5,9,3,2.5,5,0,9,21,64,85
p_65,12,0,e_3,578,598,662,15.5,10,3,2.5,5,0,10,20,64,84
p_75,14,0,e_3,563,606,662,15.5,8,1,0.5,5,0,8,43,56,99
p_68,14,0,e_3,574,606,662,14.0,9,1,2.0,5,0,9,32,56,88
p_59,6,0,e_3,584,640,662,20.5,10,7,3.5,5,0,10,56,22,78
p_54,6,0,e_3,590,640,662,19.0,11,7,5.0,5,0,11,50,22,72
p_38,4,0,e_3,627,648,662,1.0,10,0,5.0,4,1,9,21,14,35
p_47,6,0,e_2,594,614,690,18.5,11,7,0.0,3,1,6,20,76,96
p_50,10,0,e_1,592,655,723,15.0,11,5,0.0,3,1,7,63,68,131
p_41,10,0,e_1,600,655,723,14.0,11,4,1.0,5,0,9,55,68,123
p_28,6,0,e_1,679,701,723,21.5,8,5,6.5,4,1,8,22,22,44
p_27,2,0,e_1,693,715,723,23.0,8,5,4.0,4,1,9,22,8,30
p_22,10,0,e_2,712,722,790,26.5,8,8,3.5,5,0,7,10,68,78
p_21,10,0,e_2,732,756,790,23.0,8,8,6.5,5,1,7,24,34,58
p_18,2,0,e_2,768,782,790,26.0,8,7,3.0,4,1,7,14,8,22
p_19,12,0,e_1,740,761,819,19.5,8,8,2.5,5,0,8,21,58,79
p_10,14,0,e_2,810,834,888,21.5,8,8,3.0,5,0,7,24,54,78
p_9,2,0,e_2,845,880,888,28.5,8,8,6.5,4,1,7,35,8,43
p_7,12,0,e_1,851,857,919,18.0,8,2,5.0,5,0,8,6,62,68
p_6,14,0,e_1,858,865,919,15.0,8,1,6.0,5,1,8,7,54,61
p_1,2,0,e_1,889,911,919,21.5,8,5,4.5,4,1,8,22,8,30
p_291,6,0,e_3,35,40,60,6.5,1,0,2.5,5,0,1,5,20,25
p_290,4,0,e_1,43,89,105,28.5,2,2,6.0,5,0,3,46,16,62
p_285,2,0,e_1,54,97,105,29.0,2,2,7.5,4,0,5,43,8,51
p_298,4,0,e_2,10,24,112,4.0,0,0,0.0,3,0,0,14,88,102
p_287,12,0,e_2,51,70,112,19.5,2,2,6.0,5,1,1,19,42,61
p_283,10,0,e_2,55,78,112,21.0,2,2,7.0,5,1,2,23,34,57
p_279,2,0,e_2,76,104,112,19.5,2,1,5.0,4,1,2,28,8,36
p_275,2,0,e_2,84,104,112,24.5,3,2,4.5,4,1,2,20,8,28
p_280,12,0,e_3,65,98,158,11.5,1,0,0.5,5,0,1,33,60,93
p_274,4,0,e_3,84,144,158,22.5,3,2,3.5,5,0,3,60,14,74
p_268,10,0,e_1,150,169,201,21.5,3,3,7.5,5,0,4,19,32,51
p_265,12,0,e_2,157,170,210,18.0,3,3,7.0,5,0,2,13,40,53
p_262,6,0,e_2,164,190,210,23.0,2,1,7.0,4,0,4,26,20,46
p_259,6,0,e_3,174,178,264,21.5,4,3,2.5,5,0,4,4,86,90
p_261,12,0,e_3,170,198,264,16.0,2,1,2.0,5,0,2,28,66,94
p_257,12,0,e_3,179,198,264,15.0,5,2,3.0,5,1,4,19,66,85
p_255,10,0,e_3,192,226,264,15.0,6,3,5.0,5,1,5,34,38,72
p_256,8,0,e_3,191,234,264,17.0,5,3,5.0,5,1,4,43,30,73
p_251,4,0,e_3,228,248,264,1.0,7,0,5.0,4,1,6,20,16,36
p_252,2,0,e_3,212,256,264,5.0,7,1,7.0,4,1,6,44,8,52
p_247,12,0,e_1,248,259,297,20.0,6,6,7.5,3,0,5,11,38,49
p_246,12,0,e_2,257,268,308,19.0,5,5,7.5,3,0,3,11,40,51
p_244,2,0,e_2,271,300,308,27.0,5,4,6.0,4,1,3,29,8,37
p_243,8,0,e_3,285,290,368,18.5,5,3,3.5,5,0,5,5,78,83
p_240,14,0,e_3,301,310,368,10.5,6,1,5.5,5,1,5,9,58,67
p_234,14,0,e_3,314,320,368,7.0,7,7,7.5,3,1,6,6,48,54
p_236,8,0,e_3,313,340,368,15.0,6,3,7.0,5,1,5,27,28,55
p_235,8,0,e_3,314,340,368,1.0,7,7,7.5,3,1,6,26,28,54
p_233,2,0,e_3,319,360,368,5.0,8,1,7.0,4,1,7,41,8,49
p_226,12,0,e_1,331,335,401,23.5,9,9,5.5,5,0,7,4,66,70
p_217,8,0,e_1,345,369,401,25.5,8,8,7.5,5,1,7,24,32,56
p_215,6,0,e_1,346,377,401,27.0,8,8,7.5,4,1,8,31,24,55
p_214,4,0,e_1,346,385,401,29.0,8,8,7.5,4,1,9,39,16,55
p_210,4,0,e_1,353,385,401,28.0,8,8,6.5,4,1,10,32,16,48
p_209,2,0,e_1,354,393,401,30.0,8,8,6.5,4,1,10,39,8,47
p_225,10,0,e_2,333,340,414,25.0,9,9,4.0,5,0,3,7,74,81
p_213,12,0,e_2,347,348,414,21.0,8,8,6.0,5,1,3,1,66,67
p_211,14,0,e_2,348,356,414,19.0,8,8,6.0,5,1,4,8,58,66
p_207,12,0,e_2,355,372,414,20.0,8,8,7.0,5,1,5,17,42,59
p_206,6,0,e_2,362,392,414,25.0,7,7,7.5,4,1,6,30,22,52
p_185,2,0,e_2,392,406,414,24.5,10,7,3.0,4,1,5,14,8,22
p_199,2,0,e_3,368,376,476,2.0,7,7,0.0,3,1,7,8,100,108
p_200,12,0,e_3,367,408,476,12.0,6,6,0.0,3,1,6,41,68,109
p_193,12,0,e_3,378,408,476,17.0,8,2,1.0,5,1,7,30,68,98
p_190,14,0,e_3,382,416,476,14.5,8,1,1.5,5,1,7,34,60,94
p_180,14,0,e_3,396,416,476,12.0,10,1,4.0,5,1,9,20,60,80
p_170,10,0,e_3,408,438,476,14.0,11,3,6.0,5,1,10,30,38,68
p_179,6,0,e_3,397,452,476,19.5,10,6,4.5,5,1,9,55,24,79
p_163,4,0,e_3,417,460,476,19.0,11,4,7.0,5,1,10,43,16,59
p_175,2,0,e_3,399,468,476,23.5,11,8,4.5,5,1,10,69,8,77
p_143,2,0,e_3,451,468,476,1.0,10,0,3.0,1,1,9,17,8,25
p_173,10,0,e_1,405,433,499,14.5,12,4,0.5,5,0,7,28,66,94
p_157,12,0,e_1,427,441,499,24.5,12,12,4.0,5,0,9,14,58,72
p_172,14,0,e_1,405,449,499,10.5,12,1,0.5,5,0,8,44,50,94
p_165,14,0,e_1,416,449,499,9.0,11,1,2.5,5,0,9,33,50,83
p_162,14,0,e_1,417,449,499,9.0,12,1,2.5,5,0,9,32,50,82
p_158,14,0,e_1,426,449,499,23.0,12,12,4.0,5,0,9,23,50,73
p_152,10,0,e_1,439,463,499,25.0,11,11,5.5,5,1,9,24,36,60
p_144,4,0,e_1,451,483,499,29.0,10,10,7.0,4,1,8,32,16,48
p_133,4,0,e_1,463,483,499,28.0,9,9,5.0,1,1,9,20,16,36
p_136,2,0,e_1,460,491,499,30.0,9,9,5.5,4,1,9,31,8,39
p_160,10,0,e_2,421,446,518,27.5,12,12,1.0,5,0,6,25,72,97
p_164,12,0,e_2,416,454,518,11.0,11,2,0.0,5,0,5,38,64,102
p_145,12,0,e_2,451,454,518,21.0,10,10,5.5,5,1,7,3,64,67
p_134,12,0,e_2,462,476,518,20.0,9,9,7.0,5,1,6,14,42,56
p_126,6,0,e_2,473,496,518,24.5,8,8,6.5,4,1,7,23,22,45
p_125,4,0,e_2,474,504,518,26.5,9,9,6.0,4,1,8,30,14,44
p_118,4,0,e_2,488,504,518,24.0,9,7,4.5,4,1,8,16,14,30
p_120,10,0,e_3,481,508,580,19.5,8,3,0.5,5,0,8,27,72,99
p_124,14,0,e_3,474,522,580,16.5,8,8,0.5,4,1,7,48,58,106
p_100,10,0,e_3,522,544,580,13.0,9,2,7.0,5,1,8,22,36,58
p_97,10,0,e_3,526,544,580,3.0,11,11,7.5,3,1,10,18,36,54
p_98,6,0,e_3,524,558,580,17.0,10,4,7.0,5,1,9,34,22,56
p_95,6,0,e_3,527,558,580,1.0,11,11,7.5,3,1,10,31,22,53
p_94,6,0,e_3,528,558,580,1.0,11,0,7.5,4,1,10,30,22,52
p_102,2,0,e_3,521,572,580,21.0,8,3,7.0,2,1,7,51,8,59
p_90,2,0,e_3,536,572,580,4.0,11,2,6.0,4,1,10,36,8,44
p_81,2,0,e_3,547,572,580,3.0,10,1,5.0,4,1,9,25,8,33
p_101,12,0,e_1,521,537,595,11.0,9,3,3.5,5,0,8,16,58,74
p_109,14,0,e_1,506,545,595,11.5,9,1,1.0,5,0,7,39,50,89
p_88,14,0,e_1,538,545,595,22.0,11,11,6.0,5,1,8,7,50,57
p_86,6,0,e_1,541,571,595,29.5,11,11,6.5,5,1,8,30,24,54
p_80,6,0,e_1,548,571,595,28.5,10,10,6.5,4,1,8,23,24,47
p_78,4,0,e_1,555,579,595,29.5,10,10,5.5,4,1,8,24,16,40
p_71,2,0,e_1,569,587,595,29.5,9,9,3.0,4,1,9,18,8,26
p_79,14,0,e_2,549,562,622,20.5,10,10,5.0,5,0,6,13,60,73
p_75,14,0,e_2,563,564,622,18.5,9,9,7.0,5,1,7,1,58,59
p_77,6,0,e_2,557,598,622,27.0,10,10,6.5,5,0,7,41,24,65
p_73,6,0,e_2,568,598,622,25.5,9,9,7.5,5,1,8,30,24,54
p_55,4,0,e_2,590,606,622,24.5,9,7,4.5,4,1,10,16,16,32
p_56,2,0,e_2,588,614,622,27.0,9,8,4.5,4,1,9,26,8,34
p_48,2,0,e_2,593,614,622,26.0,10,9,3.5,4,1,11,21,8,29
p_59,6,0,e_3,584,600,680,23.5,8,5,0.5,5,0,8,16,80,96
p_54,6,0,e_3,590,600,680,22.5,9,5,1.5,5,0,9,10,80,90
p_69,10,0,e_3,573,614,680,21.0,8,8,1.0,4,1,7,41,66,107
p_50,10,0,e_3,592,614,680,18.0,10,3,2.0,5,0,10,22,66,88
p_40,4,0,e_3,601,666,680,23.0,10,7,3.0,5,1,9,65,14,79
p_38,4,0,e_3,627,666,680,19.0,10,4,7.0,5,1,9,39,14,53
p_35,4,0,e_3,640,666,680,2.0,10,1,6.5,4,1,9,26,14,40
p_47,6,0,e_1,594,615,691,22.0,10,6,0.0,3,1,7,21,76,97
p_27,2,0,e_2,693,710,718,26.0,9,8,4.0,4,0,8,17,8,25
p_28,6,0,e_3,679,700,776,6.0,8,8,0.0,3,1,8,21,76,97
p_22,10,0,e_1,712,723,793,15.5,9,3,3.5,5,0,8,11,70,81
p_19,12,0,e_1,740,751,793,24.0,9,9,7.5,3,1,9,11,42,53
p_21,10,0,e_1,732,759,793,27.0,9,9,6.0,5,1,8,27,34,61
p_18,2,0,e_1,768,785,793,29.0,9,9,4.0,4,1,8,17,8,25
p_10,14,0,e_3,810,820,874,10.5,8,1,5.5,5,0,8,10,54,64
p_9,2,0,e_3,845,866,874,2.0,9,1,4.5,4,1,8,21,8,29
p_6,14,0,e_2,858,864,912,18.5,10,10,7.5,5,0,9,6,48,54
p_7,12,0,e_2,851,872,912,21.5,10,10,6.5,5,0,8,21,40,61
p_1,2,0,e_2,889,904,912,26.0,8,7,3.5,4,1,8,15,8,23
p_7,2,0,e_3,55,63,71,2.0,0,0,0.0,3,0,0,8,8,16
p_11,4,0,e_1,84,102,116,13.0,1,1,5.0,4,0,2,18,14,32
p_3,4,0,e_2,25,39,123,4.0,0,0,0.0,3,0,0,14,84,98
p_9,10,0,e_2,67,91,123,20.5,1,1,6.5,5,1,2,24,32,56
p_12,0,8,e_1,86,116,142,16.5,1,1,4.5,4,0,3,30,26,56
p_13,8,0,e_3,87,103,177,16.5,2,2,1.5,5,0,2,16,74,90
p_17,10,0,e_3,112,143,177,11.0,5,1,5.0,5,1,4,31,34,65
p_16,4,0,e_3,101,163,177,18.0,4,4,4.0,5,0,4,62,14,76
p_21,0,10,e_3,142,177,209,5.0,8,0,5.0,4,1,7,35,32,67
p_24,14,0,e_2,157,167,213,19.0,7,7,5.5,5,0,3,10,46,56
p_22,6,0,e_2,146,193,213,28.5,7,7,3.5,5,0,2,47,20,67
p_26,6,0,e_1,169,194,214,25.0,6,6,7.0,4,0,3,25,20,45
p_32,0,10,e_2,209,213,245,25.0,8,8,0.5,4,1,2,4,32,36
p_29,14,0,e_3,192,223,277,13.5,7,1,2.5,5,2,5,31,54,85
p_30,2,0,e_3,200,269,277,24.5,8,7,3.5,5,2,6,69,8,77
p_42,4,0,e_0,269,284,298,27.0,7,7,4.5,4,0,3,15,14,29
p_43,4,0,e_1,270,296,310,27.0,7,7,6.0,4,0,4,26,14,40
p_44,4,0,e_1,275,296,310,26.0,7,7,5.5,4,0,5,21,14,35
p_38,12,0,e_2,240,253,311,24.0,8,8,4.5,5,1,5,13,58,71
p_51,0,4,e_1,309,310,326,25.0,8,8,0.0,3,1,4,1,16,17
p_35,0,6,e_2,222,311,331,23.0,7,7,1.5,5,1,4,89,20,109
p_46,8,0,e_3,291,303,377,20.0,7,4,2.0,5,1,6,12,74,86
p_52,14,0,e_3,312,323,377,11.0,8,1,5.0,5,2,6,11,54,65
p_55,14,0,e_3,314,323,377,10.5,9,1,5.5,5,2,7,9,54,63
p_60,2,0,e_3,338,369,377,4.0,9,2,6.0,4,2,7,31,8,39
p_53,8,0,e_0,313,324,394,16.5,9,5,2.5,5,0,5,11,70,81
p_58,0,6,e_3,330,377,397,7.5,9,0,7.5,4,2,7,47,20,67
p_68,2,0,e_1,389,402,410,26.5,9,8,3.0,4,0,5,13,8,21
p_69,2,0,e_1,391,402,410,26.0,9,8,2.5,4,0,6,11,8,19
p_56,8,0,e_2,324,339,411,15.0,8,4,2.0,5,1,6,15,72,87
p_61,12,0,e_2,341,353,411,23.5,10,10,4.0,5,1,6,12,58,70
p_74,10,0,e_0,424,426,492,12.5,8,3,5.0,5,0,5,2,66,68
p_77,4,0,e_0,455,478,492,28.0,8,8,5.5,4,1,5,23,14,37
p_67,12,0,e_1,377,448,506,18.0,9,2,5.0,4,0,4,71,58,129
p_72,6,0,e_2,417,431,511,18.0,8,5,1.0,5,0,6,14,80,94
p_76,10,0,e_2,440,445,511,24.5,8,8,4.0,5,1,6,5,66,71
p_78,12,0,e_2,455,473,511,20.0,8,8,6.5,5,1,6,18,38,56
p_82,0,12,e_1,494,506,544,27.0,8,8,2.0,4,1,5,12,38,50
p_83,0,12,e_1,501,506,544,25.5,8,8,0.5,4,1,5,5,38,43
p_84,12,0,e_3,504,511,573,13.0,8,2,5.0,5,2,6,7,62,69
p_86,14,0,e_3,518,519,573,9.0,9,1,7.0,5,3,6,1,54,55
p_93,4,0,e_3,543,559,573,0.0,9,0,4.5,4,3,6,16,14,30
p_85,14,0,e_0,517,536,590,9.5,9,1,4.0,5,0,5,19,54,73
p_91,14,0,e_0,539,546,590,21.0,9,9,7.5,5,1,5,7,44,51
p_98,6,0,e_1,555,584,604,26.5,10,10,7.5,3,0,5,29,20,49
p_88,10,0,e_2,531,543,609,26.5,9,9,3.0,5,0,6,12,66,78
p_92,10,0,e_2,540,543,609,25.0,9,9,4.5,5,0,7,3,66,69
p_95,10,0,e_2,547,577,609,24.0,10,10,5.5,5,1,6,30,32,62
p_100,10,0,e_2,557,577,609,22.5,10,10,7.0,5,1,7,20,32,52
p_105,12,0,e_3,582,611,673,16.5,9,3,1.5,5,2,7,29,62,91
p_102,14,0,e_3,568,619,673,16.5,9,9,0.5,4,3,6,51,54,105
p_103,14,0,e_3,577,619,673,15.5,9,1,0.5,5,2,7,42,54,96
p_104,14,0,e_3,581,619,673,15.0,9,1,1.0,5,2,7,38,54,92
p_111,2,0,e_3,607,665,673,22.5,10,7,5.5,5,2,8,58,8,66
p_117,0,2,e_3,636,673,681,6.0,10,0,6.0,4,3,7,37,8,45
p_123,0,2,e_3,661,673,681,1.5,10,0,1.5,4,3,7,12,8,20
p_109,10,0,e_0,590,622,690,17.5,10,5,0.0,5,0,6,32,68,100
p_110,12,0,e_0,590,630,690,15.5,10,3,0.0,5,0,7,40,60,100
p_125,2,0,e_0,668,682,690,28.5,9,9,3.0,4,1,6,14,8,22
p_119,8,0,e_1,650,674,700,25.5,10,10,7.5,3,0,5,24,26,50
p_118,8,0,e_2,649,679,705,25.5,10,10,6.5,5,0,7,30,26,56
p_132,4,0,e_3,730,757,771,2.0,8,1,6.5,4,2,6,27,14,41
p_134,14,0,e_0,734,742,786,20.5,9,9,7.0,5,0,6,8,44,52
p_133,6,0,e_1,734,776,796,28.5,9,9,5.5,5,0,5,42,20,62
p_136,14,0,e_2,749,751,803,18.0,9,9,7.0,5,1,7,2,52,54
p_138,12,0,e_3,756,809,867,19.0,9,9,2.0,4,2,7,53,58,111
p_141,12,0,e_3,770,809,867,12.0,9,9,0.0,3,3,7,39,58,97
p_144,6,0,e_0,815,862,882,17.5,9,5,4.5,5,0,6,47,20,67
p_147,6,0,e_1,849,872,894,27.0,9,9,6.5,4,0,5,23,22,45
p_152,2,0,e_1,868,886,894,28.0,8,7,3.5,4,0,7,18,8,26
p_146,10,0,e_2,846,867,901,23.5,9,9,7.0,5,1,7,21,34,55
p_149,6,0,e_2,859,881,901,25.0,9,9,6.5,4,1,8,22,20,42
p_154,4,0,e_3,874,881,967,25.0,9,7,1.0,5,2,7,7,86,93
p_153,6,0,e_3,872,889,967,23.5,8,5,0.5,5,2,6,17,78,95
p_156,12,0,e_3,884,909,967,15.5,10,2,2.5,5,3,7,25,58,83
p_159,8,0,e_1,893,920,992,18.5,10,5,0.0,3,1,6,27,72,99
p_151,12,0,e_1,863,934,992,18.5,9,9,4.5,4,0,6,71,58,129
p_3,4,0,e_2,25,40,54,4.0,0,0,0.0,3,0,0,15,14,29
p_7,2,0,e_2,55,63,71,13.0,2,2,0.0,3,0,0,8,8,16
p_11,4,0,e_1,84,102,116,3.0,3,1,5.0,4,0,2,18,14,32
p_9,10,0,e_3,67,99,133,5.0,2,0,5.0,5,0,2,32,34,66
p_16,4,0,e_3,101,119,133,1.0,3,0,5.0,4,1,2,18,14,32
p_12,0,8,e_1,86,116,142,7.0,3,0,4.5,4,0,3,30,26,56
p_13,8,0,e_2,87,104,174,24.0,3,3,1.5,5,0,2,17,70,87
p_17,10,0,e_0,112,140,204,23.0,4,4,0.5,5,0,1,28,64,92
p_21,0,10,e_2,142,174,206,16.5,3,3,5.0,4,1,5,32,32,64
p_24,14,0,e_1,157,162,218,10.5,4,0,6.0,5,0,2,5,56,61
p_26,6,0,e_1,169,196,218,6.5,4,2,7.5,4,1,2,27,22,49
p_30,2,0,e_1,200,210,218,3.0,4,0,2.5,4,1,3,10,8,18
p_22,6,0,e_3,146,153,229,10.0,3,2,2.0,5,1,2,7,76,83
p_35,0,6,e_3,222,229,249,1.0,5,0,1.0,4,2,3,7,20,27
p_32,0,10,e_1,209,218,250,3.5,4,0,1.0,1,1,3,9,32,41
p_29,14,0,e_2,192,220,272,22.0,4,4,2.5,5,1,5,28,52,80
p_42,4,0,e_0,269,286,300,2.0,5,1,4.5,4,0,4,17,14,31
p_43,4,0,e_0,270,286,300,2.0,5,1,4.5,4,0,5,16,14,30
p_38,12,0,e_3,240,269,307,10.5,5,0,1.5,5,2,3,29,38,67
p_44,4,0,e_1,275,302,316,1.0,5,0,6.5,4,0,3,27,14,41
p_51,0,4,e_1,309,316,330,18.0,4,4,1.0,4,1,5,7,14,21
p_60,2,0,e_2,338,360,368,21.5,6,4,4.5,4,0,8,22,8,30
p_58,0,6,e_2,330,368,388,24.5,6,6,6.0,4,0,7,38,20,58
p_53,8,0,e_3,313,333,399,19.5,5,2,0.5,5,1,4,20,66,86
p_56,8,0,e_3,324,333,399,17.5,6,2,2.5,5,1,5,9,66,75
p_61,12,0,e_3,341,347,399,11.0,6,1,5.0,5,2,4,6,52,58
p_52,14,0,e_3,312,355,399,13.5,4,0,0.5,5,1,3,43,44,87
p_55,14,0,e_3,314,355,399,13.0,6,0,1.0,5,1,5,41,44,85
p_46,8,0,e_1,291,344,416,24.5,5,5,3.5,4,0,4,53,72,125
p_68,2,0,e_1,389,408,416,29.5,5,5,4.0,4,1,4,19,8,27
p_69,2,0,e_1,391,408,416,29.0,5,5,3.5,4,1,5,17,8,25
p_67,12,0,e_2,377,408,466,21.5,5,5,1.5,5,1,7,31,58,89
p_77,4,0,e_0,455,476,490,2.0,8,1,5.5,4,0,6,21,14,35
p_74,10,0,e_3,424,431,497,16.0,6,1,4.0,5,2,4,7,66,73
p_76,10,0,e_3,440,465,497,14.0,7,1,6.0,5,3,4,25,32,57
p_72,6,0,e_1,417,436,514,21.5,6,3,0.0,5,0,4,19,78,97
p_78,12,0,e_1,455,476,514,24.5,8,8,6.0,5,1,4,21,38,59
p_82,0,12,e_3,494,497,535,0.5,7,0,0.5,4,3,4,3,38,41
p_83,0,12,e_1,501,514,552,29.5,7,7,2.0,4,1,6,13,38,51
p_84,12,0,e_2,504,524,562,17.0,7,1,6.0,5,0,7,20,38,58
p_85,14,0,e_0,517,534,588,13.0,7,1,4.5,5,0,6,17,54,71
p_86,14,0,e_0,518,534,588,13.0,7,1,4.5,5,0,7,16,54,70
p_93,4,0,e_0,543,574,588,19.0,7,3,7.0,4,1,6,31,14,45
p_91,14,0,e_3,539,543,599,9.5,7,1,6.5,5,2,5,4,56,60
p_88,10,0,e_3,531,565,599,14.5,7,2,5.5,5,3,4,34,34,68
p_92,10,0,e_3,540,565,599,13.5,8,2,6.5,5,2,6,25,34,59
p_98,6,0,e_3,555,579,599,0.0,8,0,6.5,4,3,5,24,20,44
p_95,10,0,e_1,547,580,612,3.0,8,8,5.0,5,1,6,33,32,65
p_100,10,0,e_1,557,580,612,26.5,9,9,6.5,5,0,8,23,32,55
p_105,12,0,e_2,582,600,660,20.5,7,7,3.0,5,0,8,18,60,78
p_102,14,0,e_2,568,608,660,20.5,8,8,0.5,5,0,7,40,52,92
p_103,14,0,e_2,577,608,660,19.0,8,8,2.5,5,0,8,31,52,83
p_104,14,0,e_2,581,608,660,19.0,7,7,3.0,5,0,8,27,52,79
p_117,0,2,e_2,636,660,668,24.0,8,8,4.0,4,1,8,24,8,32
p_109,10,0,e_0,590,620,688,21.5,7,7,0.0,5,0,6,30,68,98
p_110,12,0,e_0,590,628,688,19.5,7,7,0.0,5,0,7,38,60,98
p_125,2,0,e_0,668,680,688,2.0,8,1,3.0,4,1,7,12,8,20
p_111,2,0,e_3,607,687,695,27.0,6,5,1.0,5,2,4,80,8,88
p_123,0,2,e_0,661,688,696,5.0,8,0,4.0,4,1,7,27,8,35
p_118,8,0,e_1,649,682,708,28.0,8,8,6.0,5,0,7,33,26,59
p_119,8,0,e_1,650,682,708,28.0,8,8,6.0,5,0,8,32,26,58
p_132,4,0,e_2,730,744,758,20.5,7,4,4.5,4,0,8,14,14,28
p_134,14,0,e_0,734,742,786,10.0,7,1,7.0,5,0,7,8,44,52
p_133,6,0,e_3,734,771,791,17.5,7,4,6.5,5,2,5,37,20,57
p_136,14,0,e_1,749,752,806,21.5,8,8,6.5,5,1,7,3,54,57
p_138,12,0,e_1,756,768,806,22.5,8,8,7.5,5,2,7,12,38,50
p_141,12,0,e_2,770,796,856,20.0,7,7,1.5,5,0,8,26,60,86
p_144,6,0,e_2,815,836,856,20.0,7,4,6.5,4,1,8,21,20,41
p_152,2,0,e_3,868,879,887,1.0,7,0,3.0,4,2,5,11,8,19
p_146,10,0,e_1,846,870,906,25.5,7,7,6.5,5,1,7,24,36,60
p_147,6,0,e_1,849,884,906,29.0,7,7,7.0,5,1,8,35,22,57
p_149,6,0,e_1,859,884,906,27.0,7,7,7.0,4,1,9,25,22,47
p_154,4,0,e_1,874,892,906,26.5,8,8,4.5,4,2,8,18,14,32
p_153,6,0,e_2,872,876,954,25.0,8,8,2.5,5,0,9,4,78,82
p_151,12,0,e_2,863,896,954,20.5,7,7,1.0,5,0,8,33,58,91
p_156,12,0,e_0,884,918,976,18.5,8,8,0.5,5,1,6,34,58,92
p_159,8,0,e_3,893,913,983,21.0,7,3,1.0,5,2,5,20,70,90
p_7,2,0,e_3,55,63,71,2.0,0,0,0.0,3,0,0,8,8,16
p_11,4,0,e_1,84,102,116,13.0,1,1,5.0,4,0,2,18,14,32
p_3,4,0,e_2,25,39,123,4.0,0,0,0.0,3,0,0,14,84,98
p_9,10,0,e_2,67,91,123,20.5,1,1,6.5,5,1,2,24,32,56
p_12,0,8,e_1,86,116,142,17.0,1,1,4.5,4,0,3,30,26,56
p_13,8,0,e_3,87,103,177,16.5,2,2,1.5,5,0,2,16,74,90
p_17,10,0,e_3,112,143,177,11.0,5,1,5.0,5,1,4,31,34,65
p_16,4,0,e_3,101,163,177,18.0,4,4,4.0,5,0,4,62,14,76
p_21,0,10,e_3,142,177,209,5.0,7,0,5.0,1,1,6,35,32,67
p_24,14,0,e_2,157,167,213,19.0,7,7,5.5,5,0,4,10,46,56
p_22,6,0,e_2,146,193,213,29.0,7,7,3.5,5,0,3,47,20,67
p_26,6,0,e_1,169,194,214,25.0,6,6,7.0,4,0,2,25,20,45
p_32,0,10,e_2,209,213,245,25.0,7,7,0.5,4,1,2,4,32,36
p_29,14,0,e_3,192,223,275,13.5,7,1,2.5,5,1,6,31,52,83
p_30,2,0,e_0,200,209,299,24.5,8,7,0.0,3,0,2,9,90,99
p_42,4,0,e_0,269,285,299,27.0,7,7,4.5,4,1,3,16,14,30
p_43,4,0,e_0,270,285,299,26.5,7,7,4.5,4,1,4,15,14,29
p_44,4,0,e_1,275,296,310,26.0,6,5,5.5,4,0,3,21,14,35
p_38,12,0,e_2,240,253,311,23.5,7,7,4.5,5,2,5,13,58,71
p_51,0,4,e_1,309,310,324,25.0,8,8,0.0,4,1,3,1,14,15
p_35,0,6,e_2,222,311,331,23.0,7,7,1.0,5,2,4,89,20,109
p_46,8,0,e_3,291,301,377,19.5,7,4,2.5,5,0,7,10,76,86
p_52,14,0,e_3,312,321,377,10.5,8,1,5.5,5,1,7,9,56,65
p_55,14,0,e_3,314,321,377,10.0,9,1,6.0,5,1,8,7,56,63
p_56,8,0,e_3,324,349,377,14.5,8,4,7.5,5,1,7,25,28,53
p_60,2,0,e_3,338,369,377,4.0,10,2,6.0,4,1,9,31,8,39
p_53,8,0,e_0,313,325,395,16.5,9,5,2.0,5,0,4,12,70,82
p_58,0,6,e_3,330,377,397,7.0,10,0,7.0,4,1,9,47,20,67
p_68,2,0,e_1,389,400,408,26.0,9,8,3.0,4,0,4,11,8,19
p_69,2,0,e_1,391,400,408,26.0,9,8,2.5,4,0,5,9,8,17
p_61,12,0,e_2,341,351,409,23.0,11,11,4.5,5,1,5,10,58,68
p_76,10,0,e_0,440,459,493,24.5,8,8,7.5,5,0,5,19,34,53
p_77,4,0,e_0,455,479,493,28.0,8,8,5.5,4,0,6,24,14,38
p_67,12,0,e_1,377,446,504,18.0,9,2,4.5,4,0,3,69,58,127
p_72,6,0,e_2,417,429,509,18.0,8,5,1.0,5,1,5,12,80,92
p_74,10,0,e_2,424,443,509,13.0,8,3,2.0,5,1,6,19,66,85
p_78,12,0,e_2,455,471,509,20.0,8,8,7.0,5,2,5,16,38,54
p_82,0,12,e_1,494,504,542,26.5,8,8,1.5,4,1,4,10,38,48
p_83,0,12,e_1,501,504,542,25.5,8,8,0.5,4,1,4,3,38,41
p_84,12,0,e_3,504,511,573,13.0,8,2,5.0,5,2,6,7,62,69
p_85,14,0,e_3,517,519,573,9.5,9,1,6.5,5,3,6,2,54,56
p_86,14,0,e_3,518,519,573,9.0,10,1,7.0,5,3,7,1,54,55
p_93,4,0,e_3,543,559,573,0.0,9,0,4.5,4,3,6,16,14,30
p_91,14,0,e_0,539,545,591,21.5,9,9,7.5,5,0,5,6,46,52
p_92,10,0,e_0,540,559,591,25.0,9,9,7.5,3,0,6,19,32,51
p_98,6,0,e_1,555,582,602,26.5,10,10,7.5,4,0,4,27,20,47
p_88,10,0,e_2,531,541,607,26.5,9,9,3.5,5,1,5,10,66,76
p_95,10,0,e_2,547,575,607,24.0,10,10,6.0,5,2,5,28,32,60
p_100,10,0,e_2,557,575,607,22.5,10,10,7.5,5,2,6,18,32,50
p_109,10,0,e_3,590,605,673,17.5,10,5,2.5,5,2,8,15,68,83
p_105,12,0,e_3,582,613,673,16.5,9,3,1.5,5,2,7,31,60,91
p_110,12,0,e_3,590,613,673,15.5,11,3,2.5,5,2,9,23,60,83
p_102,14,0,e_3,568,621,673,16.5,9,9,0.5,4,3,6,53,52,105
p_103,14,0,e_3,577,621,673,15.5,9,1,0.5,5,2,7,44,52,96
p_104,14,0,e_3,581,621,673,15.0,9,1,1.0,5,2,7,40,52,92
p_117,0,2,e_3,636,673,681,6.0,9,0,6.0,4,3,6,37,8,45
p_123,0,2,e_3,661,673,681,2.0,9,0,2.0,4,3,6,12,8,20
p_111,2,0,e_0,607,679,687,23.0,11,7,2.5,5,0,5,72,8,80
p_125,2,0,e_0,668,679,687,28.5,9,9,3.0,4,0,6,11,8,19
p_118,8,0,e_2,649,677,703,26.0,9,9,7.0,5,1,6,28,26,54
p_119,8,0,e_2,650,677,703,26.0,9,9,7.0,5,1,7,27,26,53
p_132,4,0,e_3,730,757,771,2.0,8,1,6.5,4,2,6,27,14,41
p_133,6,0,e_0,734,763,783,29.0,9,9,7.5,3,0,6,29,20,49
p_134,14,0,e_2,734,747,791,21.0,9,9,5.0,5,1,6,13,44,57
p_138,12,0,e_3,756,809,867,19.0,9,9,2.0,4,2,7,53,58,111
p_141,12,0,e_3,770,809,867,12.0,9,9,0.0,3,3,7,39,58,97
p_147,6,0,e_0,849,859,881,27.0,9,9,4.5,4,1,5,10,22,32
p_149,6,0,e_0,859,859,881,25.5,9,9,3.0,1,1,5,0,22,22
p_144,6,0,e_2,815,867,887,17.0,9,4,4.0,5,1,6,52,20,72
p_136,14,0,e_1,749,834,888,18.0,9,9,6.5,4,0,5,85,54,139
p_152,2,0,e_1,868,880,888,28.0,9,8,3.0,4,1,6,12,8,20
p_153,6,0,e_3,872,887,965,23.5,9,6,0.5,5,2,7,15,78,93
p_151,12,0,e_3,863,907,965,18.5,9,9,0.5,4,3,6,44,58,102
p_156,12,0,e_3,884,907,965,15.5,10,2,2.5,5,2,8,23,58,81
p_154,4,0,e_0,874,895,979,25.0,10,8,1.0,4,2,5,21,84,105
p_146,10,0,e_0,846,915,979,23.5,9,9,5.0,4,1,4,69,64,133
p_159,8,0,e_2,893,913,983,18.0,10,5,0.5,5,1,6,20,70,90
p_3,4,0,e_2,25,40,54,4.0,0,0,0.0,3,0,0,15,14,29
p_7,2,0,e_2,55,64,72,13.0,2,2,0.0,3,0,0,9,8,17
p_11,4,0,e_1,84,101,115,3.0,3,1,5.0,4,0,2,17,14,31
p_9,10,0,e_3,67,99,133,5.0,2,0,5.0,5,0,2,32,34,66
p_16,4,0,e_3,101,119,133,1.0,3,0,5.0,4,1,2,18,14,32
p_12,0,8,e_1,86,115,141,7.0,3,0,4.5,4,0,3,29,26,55
p_13,8,0,e_2,87,103,173,24.0,3,3,1.5,5,0,2,16,70,86
p_17,10,0,e_0,112,140,204,23.0,4,4,0.5,5,0,1,28,64,92
p_21,0,10,e_2,142,173,205,17.0,3,3,5.0,4,1,3,31,32,63
p_24,14,0,e_1,157,161,217,10.5,4,0,6.5,5,0,2,4,56,60
p_26,6,0,e_1,169,195,217,6.5,4,2,7.0,4,1,2,26,22,48
p_30,2,0,e_1,200,209,217,2.0,4,0,2.5,4,1,3,9,8,17
p_22,6,0,e_3,146,153,229,10.0,3,2,2.0,5,1,2,7,76,83
p_32,0,10,e_1,209,217,249,3.5,4,0,1.0,1,1,3,8,32,40
p_35,0,6,e_3,222,229,249,1.0,5,0,1.0,4,2,3,7,20,27
p_29,14,0,e_2,192,219,263,22.0,4,4,3.0,5,1,4,27,44,71
p_42,4,0,e_0,269,286,300,8.0,4,2,4.5,4,0,3,17,14,31
p_43,4,0,e_0,270,286,300,2.0,5,1,4.5,4,0,4,16,14,30
p_38,12,0,e_3,240,269,309,10.5,5,0,1.5,5,2,3,29,40,69
p_44,4,0,e_3,275,295,309,1.0,5,0,5.5,4,2,3,20,14,34
p_51,0,4,e_1,309,313,327,0.0,4,4,0.5,4,0,4,4,14,18
p_46,8,0,e_2,291,333,361,24.5,6,6,4.5,5,0,6,42,28,70
p_60,2,0,e_2,338,353,361,22.0,6,4,3.5,4,1,6,15,8,23
p_58,0,6,e_2,330,361,381,25.0,6,6,4.5,4,0,7,31,20,51
p_53,8,0,e_3,313,335,401,19.5,5,2,0.5,5,1,4,22,66,88
p_56,8,0,e_3,324,335,401,17.5,6,2,2.5,5,1,5,11,66,77
p_61,12,0,e_3,341,349,401,11.0,6,1,5.0,5,2,4,8,52,60
p_52,14,0,e_3,312,357,401,14.0,4,0,0.0,5,1,3,45,44,89
p_55,14,0,e_3,314,357,401,13.5,6,0,0.5,5,1,5,43,44,87
p_68,2,0,e_1,389,403,411,30.0,5,5,3.0,4,0,5,14,8,22
p_69,2,0,e_1,391,403,411,29.5,5,5,3.0,4,0,6,12,8,20
p_67,12,0,e_2,377,401,461,22.0,5,5,2.5,5,1,6,24,60,84
p_72,6,0,e_2,417,441,461,21.5,5,3,7.0,4,1,7,24,20,44
p_77,4,0,e_0,455,476,490,3.0,7,1,5.5,4,0,6,21,14,35
p_74,10,0,e_3,424,433,499,16.5,5,1,3.5,5,2,3,9,66,75
p_76,10,0,e_3,440,467,499,14.0,6,1,6.0,5,3,3,27,32,59
p_78,12,0,e_1,455,469,507,25.0,7,7,7.0,5,0,5,14,38,52
p_82,0,12,e_3,494,499,537,1.0,6,0,1.0,4,3,3,5,38,43
p_83,0,12,e_1,501,507,545,30.0,6,6,1.0,4,1,6,6,38,44
p_84,12,0,e_2,504,519,557,17.5,6,1,7.0,5,0,7,15,38,53
p_85,14,0,e_0,517,534,588,13.5,6,1,4.0,5,0,6,17,54,71
p_93,4,0,e_0,543,574,588,19.0,7,4,7.0,4,1,6,31,14,45
p_86,14,0,e_3,518,545,601,13.0,6,1,3.0,5,3,3,27,56,83
p_91,14,0,e_3,539,545,601,10.0,7,1,6.0,5,2,5,6,56,62
p_88,10,0,e_3,531,567,601,15.0,7,3,5.0,5,3,4,36,34,70
p_92,10,0,e_3,540,567,601,14.0,7,2,6.0,5,2,5,27,34,61
p_95,10,0,e_3,547,567,601,13.0,7,1,7.0,5,3,4,20,34,54
p_98,6,0,e_3,555,581,601,1.0,7,0,7.0,4,3,4,26,20,46
p_100,10,0,e_2,557,589,653,26.5,8,8,0.0,3,1,7,32,64,96
p_105,12,0,e_2,582,597,653,21.0,6,6,4.0,5,0,9,15,56,71
p_102,14,0,e_2,568,605,653,21.0,7,7,1.5,5,0,8,37,48,85
p_103,14,0,e_2,577,605,653,19.5,7,7,3.0,5,0,9,28,48,76
p_104,14,0,e_2,581,605,653,19.0,6,6,4.0,5,0,9,24,48,72
p_109,10,0,e_2,590,619,653,21.5,6,6,5.0,5,1,9,29,34,63
p_111,2,0,e_2,607,645,653,27.0,5,4,7.0,4,1,8,38,8,46
p_117,0,2,e_2,636,653,661,24.5,7,7,2.5,4,1,8,17,8,25
p_110,12,0,e_0,590,626,686,20.0,6,6,0.0,5,0,6,36,60,96
p_125,2,0,e_0,668,678,686,2.0,7,0,2.5,4,1,6,10,8,18
p_123,0,2,e_0,661,686,694,5.5,7,0,3.5,4,1,6,25,8,33
p_118,8,0,e_1,649,673,699,28.5,7,7,7.5,3,0,7,24,26,50
p_119,8,0,e_1,650,673,699,28.5,7,7,7.5,3,0,8,23,26,49
p_133,6,0,e_0,734,764,786,17.5,8,6,7.5,3,0,7,30,22,52
p_132,4,0,e_0,730,772,786,20.5,7,5,7.0,5,0,6,42,14,56
p_134,14,0,e_3,734,739,791,9.5,7,1,6.5,5,2,5,5,52,57
p_138,12,0,e_2,756,787,847,23.5,8,8,1.0,5,1,8,31,60,91
p_141,12,0,e_2,770,787,847,21.5,8,8,3.5,5,1,9,17,60,77
p_136,14,0,e_2,749,795,847,23.0,8,8,0.0,3,0,7,46,52,98
p_146,10,0,e_0,846,850,886,25.5,7,7,5.5,4,0,7,4,36,40
p_144,6,0,e_0,815,864,886,20.0,7,5,4.5,5,0,6,49,22,71
p_152,2,0,e_0,868,878,886,1.0,8,0,2.5,4,1,6,10,8,18
p_147,6,0,e_1,849,869,889,29.0,7,7,6.5,4,1,6,20,20,40
p_149,6,0,e_2,859,867,947,27.5,7,7,1.5,5,1,7,8,80,88
p_151,12,0,e_2,863,887,947,20.5,8,8,2.5,5,1,8,24,60,84
p_156,12,0,e_2,884,887,947,12.0,9,9,5.5,5,2,9,3,60,63
p_153,6,0,e_2,872,927,947,25.0,8,8,3.5,5,2,8,55,20,75
p_154,4,0,e_3,874,899,981,26.5,8,8,1.5,4,2,6,25,82,107
p_159,8,0,e_0,893,912,982,21.0,9,4,1.0,5,0,6,19,70,89
p_3,4,0,e_2,25,39,53,4.0,0,0,0.0,3,0,0,14,14,28
p_11,4,0,e_1,84,102,116,3.0,3,1,5.0,4,0,2,18,14,32
p_9,10,0,e_3,67,99,133,5.0,2,0,5.0,5,0,2,32,34,66
p_16,4,0,e_3,101,119,133,1.0,3,0,5.0,4,1,2,18,14,32
p_12,0,8,e_0,86,107,133,7.0,3,0,3.5,4,0,2,21,26,47
p_17,10,0,e_0,112,141,205,23.0,4,4,0.5,5,1,2,29,64,93
p_22,6,0,e_1,146,192,212,10.0,4,2,5.0,5,0,3,46,20,66
p_26,6,0,e_1,169,192,212,16.5,5,3,7.0,4,0,4,23,20,43
p_24,14,0,e_3,157,177,223,10.5,4,0,3.5,5,1,3,20,46,66
p_30,2,0,e_3,200,215,223,1.0,4,0,3.5,4,2,2,15,8,23
p_32,0,10,e_1,209,212,244,2.0,5,0,0.5,4,1,4,3,32,35
p_35,0,6,e_3,222,223,245,0.0,3,3,0.0,3,2,2,1,22,23
p_21,0,10,e_3,142,223,259,16.5,3,3,1.5,5,1,2,81,36,117
p_43,4,0,e_0,270,287,301,15.5,5,3,4.5,4,0,6,17,14,31
p_29,14,0,e_1,192,258,312,21.0,4,4,3.0,1,0,3,66,54,120
p_42,4,0,e_1,269,298,312,16.0,5,3,7.0,4,1,4,29,14,43
p_44,4,0,e_1,275,298,312,15.0,5,2,5.5,4,1,5,23,14,37
p_51,0,4,e_1,309,312,326,3.0,6,0,0.5,4,1,4,3,14,17
p_38,12,0,e_3,240,267,327,10.0,5,0,2.0,5,3,2,27,60,87
p_46,8,0,e_3,291,301,327,27.5,5,5,5.5,4,2,3,10,26,36
p_53,8,0,e_0,313,327,399,24.5,6,6,1.5,5,0,6,14,72,86
p_60,2,0,e_0,338,391,399,22.5,7,5,5.5,5,1,6,53,8,61
p_56,8,0,e_1,324,340,416,22.5,6,6,1.5,5,1,5,16,76,92
p_61,12,0,e_1,341,354,416,12.0,7,1,4.0,5,1,5,13,62,75
p_52,14,0,e_1,312,362,416,18.5,6,6,0.0,5,1,4,50,54,104
p_55,14,0,e_1,314,362,416,18.0,6,6,0.0,5,1,5,48,54,102
p_68,2,0,e_1,389,408,416,3.0,7,1,4.0,4,1,5,19,8,27
p_69,2,0,e_1,391,408,416,3.0,7,1,3.5,4,1,6,17,8,25
p_58,0,6,e_3,330,421,441,25.5,6,6,0.5,5,1,5,91,20,111
p_77,4,0,e_0,455,481,495,17.0,7,3,6.5,4,1,6,26,14,40
p_72,6,0,e_1,417,436,516,24.5,7,7,0.0,5,1,4,19,80,99
p_74,10,0,e_1,424,450,516,15.5,7,1,1.0,5,1,5,26,66,92
p_78,12,0,e_1,455,458,516,9.0,7,1,5.5,5,2,4,3,58,61
p_76,10,0,e_3,440,455,519,13.0,6,1,3.0,2,2,5,15,64,79
p_82,0,12,e_3,494,519,559,4.0,7,0,4.0,4,2,5,25,40,65
p_83,0,12,e_3,501,519,559,3.0,7,0,3.0,4,2,5,18,40,58
p_84,12,0,e_0,504,533,597,20.5,7,7,1.0,5,1,6,29,64,93
p_86,14,0,e_0,518,541,597,14.0,6,6,3.5,5,1,7,23,56,79
p_98,6,0,e_0,555,575,597,16.5,9,5,6.5,4,2,8,20,22,42
p_93,4,0,e_0,543,583,597,20.5,9,7,7.0,5,2,6,40,14,54
p_88,10,0,e_3,531,551,613,14.0,7,2,2.0,5,2,5,20,62,82
p_91,14,0,e_3,539,567,613,11.0,8,0,3.0,5,2,6,28,46,74
p_100,10,0,e_3,557,581,613,12.0,9,3,6.0,5,3,6,24,32,56
p_92,10,0,e_1,540,548,618,15.0,9,3,3.5,5,1,7,8,70,78
p_95,10,0,e_1,547,548,618,13.5,9,3,5.0,2,1,7,1,70,71
p_85,14,0,e_1,517,564,618,16.0,7,7,0.0,5,1,6,47,54,101
p_102,14,0,e_1,568,574,618,23.0,8,8,7.5,3,2,6,6,44,50
p_111,2,0,e_0,607,685,693,29.0,8,8,1.5,5,1,7,78,8,86
p_125,2,0,e_0,668,685,693,4.0,9,2,3.5,4,1,9,17,8,25
p_123,0,2,e_0,661,693,701,18.5,9,9,5.0,4,1,8,32,8,40
p_105,12,0,e_3,582,651,711,23.0,7,7,5.0,4,2,5,69,60,129
p_119,8,0,e_3,650,685,711,12.0,9,4,6.0,5,1,8,35,26,61
p_118,8,0,e_1,649,688,714,12.0,9,4,5.0,5,1,7,39,26,65
p_117,0,2,e_3,636,711,719,22.5,8,8,3.5,5,1,7,75,8,83
p_132,4,0,e_0,730,777,791,23.5,8,6,5.5,5,1,7,47,14,61
p_134,14,0,e_1,734,758,810,13.0,8,1,3.0,5,1,7,24,52,76
p_136,14,0,e_3,749,757,813,10.0,9,1,6.0,5,2,7,8,56,64
p_138,12,0,e_3,756,773,813,11.0,9,2,7.0,2,2,7,17,40,57
p_133,6,0,e_3,734,793,813,21.0,8,5,3.0,5,2,6,59,20,79
p_144,6,0,e_0,815,867,889,24.0,8,5,3.5,5,1,7,52,22,74
p_152,2,0,e_0,868,881,889,4.0,9,2,3.0,4,2,8,13,8,21
p_146,10,0,e_1,846,874,908,14.5,8,3,5.5,5,1,7,28,34,62
p_149,6,0,e_1,859,888,908,16.5,9,4,7.5,4,1,8,29,20,49
p_147,6,0,e_3,849,889,911,18.0,8,5,6.0,5,2,6,40,22,62
p_153,6,0,e_3,872,889,911,29.0,9,9,6.0,4,2,7,17,22,39
p_154,4,0,e_3,874,897,911,1.0,9,0,5.5,4,2,7,23,14,37
p_159,8,0,e_0,893,915,987,24.5,10,10,0.5,5,1,8,22,72,94
p_151,12,0,e_0,863,929,987,24.0,9,9,3.5,4,1,8,66,58,124
p_3,4,0,e_2,25,40,54,4.0,0,0,0.0,3,0,0,15,14,29
p_7,2,0,e_2,55,63,71,12.5,2,2,0.0,3,0,0,8,8,16
p_12,0,8,e_2,86,87,115,7.0,3,0,0.0,3,0,0,1,28,29
p_11,4,0,e_1,84,101,115,3.0,3,1,4.5,4,0,2,17,14,31
p_9,10,0,e_3,67,98,132,5.0,2,0,5.0,5,0,2,31,34,65
p_16,4,0,e_3,101,118,132,1.0,3,0,5.0,4,1,2,17,14,31
p_13,8,0,e_2,87,115,189,23.5,3,3,0.0,5,1,2,28,74,102
p_17,10,0,e_2,112,123,189,23.0,4,4,3.5,5,1,2,11,66,77
p_22,6,0,e_2,146,169,189,10.0,3,2,6.5,4,1,3,23,20,43
p_24,14,0,e_1,157,159,213,10.0,3,0,7.0,5,0,2,2,54,56
p_26,6,0,e_1,169,193,213,6.0,3,2,7.0,4,1,2,24,20,44
p_21,0,10,e_2,142,189,221,16.5,3,3,7.5,4,1,2,47,32,79
p_30,2,0,e_3,200,220,228,2.0,3,0,4.5,4,1,2,20,8,28
p_32,0,10,e_1,209,213,245,2.5,4,0,0.5,4,1,2,4,32,36
p_35,0,6,e_3,222,228,248,1.0,5,0,1.0,4,2,3,6,20,26
p_29,14,0,e_2,192,235,279,16.5,3,3,0.5,5,1,3,43,44,87
p_42,4,0,e_0,269,283,297,2.0,5,1,4.5,4,0,3,14,14,28
p_38,12,0,e_3,240,268,306,10.5,5,0,1.5,5,2,3,28,38,66
p_43,4,0,e_1,270,297,311,2.0,5,1,6.5,4,0,3,27,14,41
p_44,4,0,e_1,275,297,311,1.0,5,0,5.5,4,0,4,22,14,36
p_51,0,4,e_1,309,311,325,17.5,4,4,0.0,4,1,3,2,14,16
p_46,8,0,e_2,291,305,371,24.5,5,5,2.0,5,0,4,14,66,80
p_52,14,0,e_2,312,325,371,13.5,4,0,5.0,5,1,5,13,46,59
p_55,14,0,e_2,314,325,371,13.0,5,0,5.5,5,1,6,11,46,57
p_60,2,0,e_2,338,363,371,11.0,5,2,5.0,4,1,6,25,8,33
p_53,8,0,e_3,313,332,384,9.0,4,1,1.0,5,1,3,19,52,71
p_56,8,0,e_3,324,332,384,7.5,5,1,2.5,5,1,4,8,52,60
p_61,12,0,e_3,341,346,384,7.0,5,0,5.0,5,2,3,5,38,43
p_58,0,6,e_2,330,371,391,14.5,5,5,6.5,4,1,6,41,20,61
p_68,2,0,e_1,389,401,409,15.5,4,3,3.0,4,0,3,12,8,20
p_69,2,0,e_1,391,401,409,15.0,4,3,2.5,4,0,4,10,8,18
p_67,12,0,e_2,377,411,469,19.0,5,5,1.0,5,1,6,34,58,92
p_74,10,0,e_3,424,448,482,3.5,6,0,6.5,5,1,5,24,34,58
p_72,6,0,e_3,417,462,482,6.5,5,2,5.5,5,1,4,45,20,65
p_77,4,0,e_0,455,473,487,30.0,7,7,5.0,4,1,3,18,14,32
p_76,10,0,e_1,440,441,507,25.0,7,7,5.0,5,0,3,1,66,67
p_78,12,0,e_1,455,469,507,22.0,7,7,7.0,5,1,3,14,38,52
p_82,0,12,e_1,494,507,545,16.5,5,5,2.0,4,1,5,13,38,51
p_83,0,12,e_1,501,507,545,15.0,5,5,1.0,4,1,5,6,38,44
p_84,12,0,e_3,504,520,574,8.5,5,0,3.5,5,1,4,16,54,70
p_85,14,0,e_3,517,528,574,8.5,6,0,5.5,5,1,5,11,46,57
p_86,14,0,e_3,518,528,574,8.5,7,0,5.5,5,1,6,10,46,56
p_93,4,0,e_3,543,560,574,1.0,6,0,5.0,4,2,4,17,14,31
p_88,10,0,e_0,531,551,583,27.0,6,6,7.0,5,1,3,20,32,52
p_91,14,0,e_1,539,553,609,21.5,6,6,5.0,5,1,5,14,56,70
p_92,10,0,e_1,540,575,609,25.5,6,6,5.0,5,1,6,35,34,69
p_95,10,0,e_1,547,575,609,24.0,7,7,6.0,5,0,7,28,34,62
p_100,10,0,e_1,557,575,609,22.5,7,7,7.5,5,1,8,18,34,52
p_98,6,0,e_1,555,589,609,26.5,7,7,7.0,5,1,7,34,20,54
p_105,12,0,e_2,582,601,655,15.0,6,1,3.0,5,0,7,19,54,73
p_102,14,0,e_2,568,609,655,17.0,6,6,0.5,5,0,6,41,46,87
p_104,14,0,e_2,581,609,655,13.0,6,0,3.0,5,0,7,28,46,74
p_111,2,0,e_2,607,647,655,21.0,8,4,6.5,5,1,7,40,8,48
p_117,0,2,e_2,636,655,663,5.0,6,0,2.5,4,1,7,19,8,27
p_109,10,0,e_3,590,606,666,15.5,6,1,2.5,5,1,5,16,60,76
p_110,12,0,e_3,590,614,666,13.5,7,1,2.5,5,1,6,24,52,76
p_103,14,0,e_3,577,622,666,14.0,5,0,0.0,5,1,4,45,44,89
p_123,0,2,e_3,661,666,674,0.5,6,0,0.5,4,2,4,5,8,13
p_118,8,0,e_1,649,679,707,24.5,6,6,6.5,5,0,8,30,28,58
p_119,8,0,e_1,650,679,707,24.5,6,6,6.5,5,0,9,29,28,57
p_125,2,0,e_1,668,699,707,16.0,6,4,6.0,4,0,9,31,8,39
p_132,4,0,e_3,730,750,764,1.0,6,0,5.5,4,1,5,20,14,34
p_134,14,0,e_1,734,751,805,19.5,7,7,4.5,5,1,8,17,54,71
p_136,14,0,e_1,749,751,805,17.0,6,6,7.0,5,1,9,2,54,56
p_133,6,0,e_1,734,785,805,27.5,7,7,4.0,5,1,7,51,20,71
p_138,12,0,e_2,756,789,847,19.0,7,7,0.5,5,0,7,33,58,91
p_141,12,0,e_2,770,789,847,17.0,7,1,3.0,5,0,8,19,58,77
p_144,6,0,e_3,815,840,860,1.0,7,0,7.0,4,2,5,25,20,45
p_147,6,0,e_1,849,881,903,25.5,8,8,7.0,5,1,7,32,22,54
p_149,6,0,e_1,859,881,903,6.0,7,7,6.5,4,1,8,22,22,44
p_152,2,0,e_1,868,895,903,27.0,7,6,5.0,4,1,8,27,8,35
p_146,10,0,e_2,846,879,951,22.5,8,8,0.0,3,1,7,33,72,105
p_151,12,0,e_2,863,887,951,18.0,7,1,2.5,5,0,8,24,64,88
p_156,12,0,e_2,884,887,951,14.5,7,1,5.5,5,1,10,3,64,67
p_159,8,0,e_2,893,921,951,16.5,7,3,7.0,5,1,9,28,30,58
p_153,6,0,e_2,872,929,951,22.5,7,4,4.0,5,0,9,57,22,79
p_154,4,0,e_2,874,937,951,24.0,7,5,4.0,5,0,10,63,14,77
p_7,2,0,e_3,55,64,72,2.0,0,0,0.0,3,0,0,9,8,17
p_11,4,0,e_1,84,101,115,13.5,1,1,4.5,4,0,2,17,14,31
p_3,4,0,e_2,25,39,123,4.0,0,0,0.0,3,0,0,14,84,98
p_9,10,0,e_2,67,91,123,21.0,1,1,6.5,5,1,2,24,32,56
p_12,0,8,e_1,86,115,141,17.0,1,1,4.5,4,0,3,29,26,55
p_13,8,0,e_3,87,104,178,17.0,2,2,1.0,5,0,2,17,74,91
p_17,10,0,e_3,112,144,178,11.0,5,1,5.0,5,1,4,32,34,66
p_16,4,0,e_3,101,164,178,18.5,4,4,3.5,5,0,4,63,14,77
p_21,0,10,e_3,142,178,210,5.0,7,0,5.0,4,1,6,36,32,68
p_26,6,0,e_1,169,193,213,25.5,6,6,7.0,4,0,3,24,20,44
p_24,14,0,e_2,157,167,213,19.0,7,7,5.5,5,0,4,10,46,56
p_22,6,0,e_2,146,193,213,29.0,7,7,3.5,5,0,3,47,20,67
p_32,0,10,e_2,209,213,245,25.0,8,8,0.5,4,1,2,4,32,36
p_29,14,0,e_3,192,224,278,14.0,7,1,2.0,5,1,6,32,54,86
p_30,2,0,e_3,200,270,278,24.5,8,7,3.5,5,1,7,70,8,78
p_42,4,0,e_0,269,283,297,27.0,8,8,4.5,4,0,2,14,14,28
p_43,4,0,e_1,270,295,309,27.0,7,7,6.0,4,0,3,25,14,39
p_44,4,0,e_1,275,295,309,26.5,7,7,5.5,4,0,4,20,14,34
p_38,12,0,e_2,240,253,311,24.0,8,8,4.0,5,2,5,13,58,71
p_51,0,4,e_2,309,311,325,25.5,8,8,0.5,4,2,5,2,14,16
p_35,0,6,e_2,222,311,333,23.0,8,8,1.5,5,2,4,89,22,111
p_46,8,0,e_3,291,304,380,20.0,7,4,2.0,5,0,7,13,76,89
p_52,14,0,e_3,312,324,380,11.0,8,1,5.0,5,1,7,12,56,68
p_55,14,0,e_3,314,324,380,10.5,9,1,5.5,5,1,8,10,56,66
p_56,8,0,e_3,324,352,380,15.0,8,4,7.0,2,1,7,28,28,56
p_60,2,0,e_3,338,372,380,4.0,10,2,6.0,4,1,9,34,8,42
p_58,0,6,e_3,330,380,400,7.5,10,0,7.5,4,1,9,50,20,70
p_53,8,0,e_2,313,341,415,17.0,9,5,0.0,5,3,5,28,74,102
p_61,12,0,e_2,341,355,415,23.5,11,11,4.0,5,2,5,14,60,74
p_68,2,0,e_2,389,407,415,26.5,9,8,4.0,4,2,5,18,8,26
p_69,2,0,e_2,391,407,415,26.5,9,8,3.5,4,2,6,16,8,24
p_74,10,0,e_3,424,446,480,13.0,9,3,7.0,5,2,7,22,34,56
p_72,6,0,e_3,417,460,480,18.5,8,5,5.5,5,2,6,43,20,63
p_67,12,0,e_0,377,429,489,18.5,9,9,2.5,4,0,5,52,60,112
p_77,4,0,e_0,455,475,489,29.5,10,10,5.0,4,1,5,20,14,34
p_76,10,0,e_2,440,447,513,25.0,10,10,4.0,5,1,5,7,66,73
p_78,12,0,e_2,455,475,513,21.5,10,10,6.0,5,2,5,20,38,58
p_82,0,12,e_2,494,513,551,28.0,8,8,3.0,4,2,5,19,38,57
p_83,0,12,e_2,501,513,551,26.5,8,8,2.0,4,2,5,12,38,50
p_84,12,0,e_3,504,518,582,14.5,8,2,3.5,5,2,6,14,64,78
p_85,14,0,e_3,517,526,582,10.0,8,1,6.0,2,2,6,9,56,65
p_86,14,0,e_3,518,526,582,10.0,10,1,6.0,5,3,7,8,56,64
p_88,10,0,e_3,531,548,582,3.0,9,9,7.5,3,3,6,17,34,51
p_93,4,0,e_3,543,568,582,1.0,10,0,5.5,4,3,7,25,14,39
p_92,10,0,e_1,540,561,593,26.5,10,10,7.0,5,0,5,21,32,53
p_91,14,0,e_2,539,559,607,22.5,10,10,4.0,5,2,5,20,48,68
p_95,10,0,e_2,547,573,607,25.0,10,10,5.5,5,2,6,26,34,60
p_100,10,0,e_2,557,573,607,24.0,10,10,6.5,5,1,8,16,34,50
p_98,6,0,e_2,555,587,607,28.0,10,10,6.5,5,1,7,32,20,52
p_105,12,0,e_3,582,620,680,12.0,9,9,0.0,3,3,7,38,60,98
p_104,14,0,e_3,581,628,680,14.0,8,8,0.0,3,3,6,47,52,99
p_109,10,0,e_0,590,615,685,19.0,10,5,1.0,5,0,9,25,70,95
p_110,12,0,e_0,590,623,685,17.0,10,3,1.0,5,0,10,33,62,95
p_102,14,0,e_0,568,631,685,18.0,9,9,2.5,4,0,7,63,54,117
p_103,14,0,e_0,577,631,685,17.0,9,9,1.0,4,0,8,54,54,108
p_125,2,0,e_0,668,677,685,30.0,9,9,2.5,4,1,8,9,8,17
p_117,0,2,e_3,636,680,688,7.5,9,0,7.5,4,3,6,44,8,52
p_123,0,2,e_3,661,680,688,3.0,9,0,3.0,4,3,6,19,8,27
p_111,2,0,e_2,607,615,705,24.0,10,8,0.0,5,1,6,8,90,98
p_118,8,0,e_2,649,679,705,27.0,9,9,6.5,5,2,6,30,26,56
p_119,8,0,e_2,650,679,705,27.0,9,9,6.5,5,2,7,29,26,55
p_132,4,0,e_3,730,764,778,3.0,8,1,7.5,4,2,6,34,14,48
p_133,6,0,e_0,734,761,781,1.0,9,0,7.5,4,0,8,27,20,47
p_134,14,0,e_2,734,751,803,22.0,9,9,4.5,5,2,6,17,52,69
p_136,14,0,e_2,749,751,803,19.5,9,9,6.5,5,2,7,2,52,54
p_141,12,0,e_3,770,816,876,19.0,9,9,1.0,4,3,6,46,60,106
p_144,6,0,e_3,815,856,876,18.0,8,5,6.0,2,2,6,41,20,61
p_138,12,0,e_1,756,819,877,20.0,9,9,4.0,4,0,6,63,58,121
p_146,10,0,e_2,846,867,903,24.5,10,10,7.0,5,2,6,21,36,57
p_147,6,0,e_2,849,881,903,28.0,10,10,7.5,3,2,7,32,22,54
p_149,6,0,e_2,859,881,903,26.5,9,9,6.5,4,2,8,22,22,44
p_152,2,0,e_2,868,895,903,29.5,9,9,5.0,4,3,7,27,8,35
p_154,4,0,e_0,874,889,973,26.5,9,9,0.0,3,0,9,15,84,99
p_151,12,0,e_0,863,915,973,20.0,9,9,2.0,4,0,8,52,58,110
p_156,12,0,e_0,884,915,973,17.0,8,2,1.5,5,0,10,31,58,89
p_153,6,0,e_1,872,897,975,24.5,9,9,0.5,4,1,6,25,78,103
p_159,8,0,e_1,893,905,975,19.5,8,4,2.5,5,0,7,12,70,82
p_11,4,0,e_1,84,101,115,8.0,1,1,4.5,4,0,2,17,14,31
p_3,4,0,e_2,25,40,126,4.0,0,0,0.0,3,0,0,15,86,101
p_9,10,0,e_2,67,92,126,6.5,1,0,6.5,5,1,3,25,34,59
p_7,2,0,e_2,55,118,126,14.5,1,1,4.5,5,1,2,63,8,71
p_12,0,8,e_1,86,115,141,11.5,1,1,4.5,4,0,3,29,26,55
p_13,8,0,e_3,87,115,143,11.5,2,2,6.5,5,0,2,28,28,56
p_16,4,0,e_3,101,129,143,2.0,4,1,6.5,4,0,4,28,14,42
p_21,0,10,e_3,142,143,177,0.0,3,3,0.0,3,1,3,1,34,35
p_17,10,0,e_0,112,140,204,20.5,5,5,0.5,5,0,1,28,64,92
p_24,14,0,e_1,157,161,217,12.0,5,0,6.5,5,0,2,4,56,60
p_26,6,0,e_1,169,195,217,16.5,5,3,7.0,4,1,2,26,22,48
p_30,2,0,e_1,200,209,217,5.0,6,2,2.5,4,1,3,9,8,17
p_22,6,0,e_2,146,202,222,20.0,5,3,3.0,5,1,2,56,20,76
p_29,14,0,e_3,192,199,243,7.0,5,0,7.0,5,0,5,7,44,51
p_35,0,6,e_2,222,222,244,3.5,6,0,0.0,3,2,3,0,22,22
p_32,0,10,e_1,209,217,249,5.5,6,0,1.0,4,1,3,8,32,40
p_42,4,0,e_0,269,286,300,18.0,6,4,5.0,4,0,2,17,14,31
p_43,4,0,e_0,270,286,300,17.5,6,4,4.5,4,0,3,16,14,30
p_38,12,0,e_2,240,264,304,18.5,7,7,2.5,5,2,3,24,40,64
p_44,4,0,e_2,275,290,304,17.0,6,3,4.5,4,2,3,15,14,29
p_51,0,4,e_3,309,337,351,4.5,6,0,4.5,4,0,6,28,14,42
p_58,0,6,e_3,330,337,359,1.0,7,0,1.0,4,0,7,7,22,29
p_56,8,0,e_2,324,330,396,24.0,7,7,3.0,5,1,4,6,66,72
p_52,14,0,e_2,312,350,396,20.0,7,7,1.0,5,1,3,38,46,84
p_55,14,0,e_2,314,350,396,19.5,7,7,1.5,5,1,4,36,46,82
p_60,2,0,e_2,338,388,396,24.0,8,7,5.0,5,2,4,50,8,58
p_61,12,0,e_0,341,358,396,13.5,8,1,6.5,5,0,5,17,38,55
p_46,8,0,e_1,291,339,411,28.5,6,6,3.5,4,0,3,48,72,120
p_53,8,0,e_1,313,339,411,26.0,7,7,0.0,3,0,6,26,72,98
p_68,2,0,e_1,389,403,411,5.0,8,8,3.0,4,1,5,14,8,22
p_69,2,0,e_1,391,403,411,5.0,8,2,3.0,4,1,6,12,8,20
p_67,12,0,e_3,377,379,437,8.5,7,1,5.5,5,0,7,2,58,60
p_74,10,0,e_2,424,428,462,22.0,8,8,4.5,5,1,5,4,34,38
p_72,6,0,e_2,417,442,462,27.5,8,8,3.0,5,1,3,25,20,45
p_76,10,0,e_0,440,460,494,15.5,7,2,7.0,5,1,4,20,34,54
p_77,4,0,e_0,455,480,494,19.0,7,5,5.5,4,1,5,25,14,39
p_78,12,0,e_1,455,469,507,11.0,7,1,7.0,5,0,5,14,38,52
p_82,0,12,e_1,494,507,545,6.0,7,0,2.0,4,1,6,13,38,51
p_83,0,12,e_1,501,507,545,5.0,7,0,1.0,4,1,6,6,38,44
p_84,12,0,e_2,504,520,558,21.5,7,7,6.5,5,1,4,16,38,54
p_85,14,0,e_0,517,538,596,17.0,7,7,3.5,5,1,5,21,58,79
p_86,14,0,e_0,518,538,596,17.0,7,7,3.5,5,1,6,20,58,78
p_91,14,0,e_0,539,540,596,13.0,7,0,7.0,5,2,7,1,56,57
p_88,10,0,e_0,531,562,596,16.0,7,2,6.0,5,1,6,31,34,65
p_93,4,0,e_0,543,582,596,20.5,7,5,7.5,5,2,7,39,14,53
p_92,10,0,e_1,540,573,607,15.0,7,2,5.5,5,1,6,33,34,67
p_98,6,0,e_1,555,587,607,16.5,8,5,7.5,5,0,7,32,20,52
p_95,10,0,e_3,547,563,625,13.5,7,2,2.5,5,0,7,16,62,78
p_102,14,0,e_3,568,577,625,8.5,8,0,5.5,5,1,7,9,48,57
p_103,14,0,e_3,577,577,625,7.0,8,0,7.0,2,1,7,0,48,48
p_111,2,0,e_3,607,617,625,0.0,8,0,2.5,4,1,7,10,8,18
p_100,10,0,e_2,557,590,652,12.0,8,2,0.0,3,2,4,33,62,95
p_109,10,0,e_2,590,592,652,25.5,8,8,5.0,5,2,6,2,60,62
p_105,12,0,e_2,582,600,652,24.5,8,8,3.5,5,1,6,18,52,70
p_110,12,0,e_2,590,600,652,23.5,8,8,5.0,2,1,6,10,52,62
p_104,14,0,e_2,581,608,652,23.0,8,8,3.5,5,1,5,27,44,71
p_117,0,2,e_2,636,652,660,24.5,7,7,2.5,4,2,4,16,8,24
p_125,2,0,e_0,668,684,692,17.5,8,4,3.5,4,1,8,16,8,24
p_123,0,2,e_0,661,692,700,20.5,8,8,4.5,4,1,7,31,8,39
p_119,8,0,e_1,650,677,703,14.0,8,3,7.0,5,0,6,27,26,53
p_118,8,0,e_3,649,651,721,14.5,7,3,3.5,5,0,7,2,70,72
p_133,6,0,e_0,734,770,792,22.0,8,5,6.5,5,1,8,36,22,58
p_132,4,0,e_0,730,778,792,25.0,8,6,6.0,5,1,7,48,14,62
p_134,14,0,e_1,734,747,801,14.0,8,1,5.0,5,0,7,13,54,67
p_136,14,0,e_1,749,757,801,11.5,8,1,7.0,5,1,7,8,44,52
p_138,12,0,e_2,756,786,844,12.5,8,2,1.0,5,1,5,30,58,88
p_141,12,0,e_2,770,786,844,24.5,8,8,3.5,5,1,6,16,58,74
p_152,2,0,e_0,868,880,888,5.0,10,2,3.0,4,1,7,12,8,20
p_146,10,0,e_1,846,865,899,15.5,9,3,7.5,5,0,7,19,34,53
p_147,6,0,e_1,849,879,899,19.0,9,5,7.5,4,0,8,30,20,50
p_144,6,0,e_3,815,835,917,6.0,8,8,0.0,3,1,7,20,82,102
p_151,12,0,e_3,863,875,917,5.0,9,9,7.5,3,2,7,12,42,54
p_153,6,0,e_3,872,895,917,0.0,10,0,6.5,4,2,8,23,22,45
p_154,4,0,e_3,874,903,917,2.0,10,1,6.0,1,2,8,29,14,43
p_149,6,0,e_2,859,864,944,17.5,9,5,2.5,5,1,5,5,80,85
p_156,12,0,e_2,884,904,944,23.0,11,11,6.0,5,2,5,20,40,60
p_159,8,0,e_2,893,918,944,25.5,11,11,7.5,3,2,7,25,26,51
p_7,2,0,e_3,55,63,71,2.0,0,0,0.0,3,0,0,8,8,16
p_11,4,0,e_1,84,102,116,13.0,1,1,5.0,4,0,2,18,14,32
p_3,4,0,e_2,25,39,123,4.0,0,0,0.0,3,0,0,14,84,98
p_9,10,0,e_2,67,91,123,20.5,1,1,6.5,5,1,2,24,32,56
p_12,0,8,e_1,86,116,142,17.0,1,1,4.5,4,0,3,30,26,56
p_13,8,0,e_3,87,104,178,17.0,2,2,1.0,5,0,2,17,74,91
p_17,10,0,e_3,112,144,178,11.0,5,1,5.0,5,1,4,32,34,66
p_16,4,0,e_3,101,164,178,18.5,4,4,3.5,5,0,4,63,14,77
p_21,0,10,e_3,142,178,210,5.5,7,0,5.5,4,1,6,36,32,68
p_24,14,0,e_2,157,167,213,19.0,7,7,5.5,5,0,3,10,46,56
p_22,6,0,e_2,146,193,213,29.0,7,7,3.5,5,0,2,47,20,67
p_26,6,0,e_1,169,194,216,25.5,6,6,7.0,4,0,2,25,22,47
p_30,2,0,e_1,200,208,216,24.5,7,6,2.5,4,1,3,8,8,16
p_32,0,10,e_2,209,213,245,25.0,7,7,0.5,4,1,2,4,32,36
p_29,14,0,e_3,192,224,276,14.0,6,1,2.0,5,1,5,32,52,84
p_38,12,0,e_2,240,253,311,24.0,7,7,4.0,5,1,4,13,58,71
p_42,4,0,e_1,269,298,312,27.0,7,7,7.0,4,0,5,29,14,43
p_43,4,0,e_1,270,298,312,27.0,7,7,6.5,4,0,6,28,14,42
p_44,4,0,e_1,275,298,312,4.0,6,6,5.5,4,0,6,23,14,37
p_51,0,4,e_1,309,312,326,25.0,8,8,0.5,4,1,4,3,14,17
p_35,0,6,e_1,222,312,334,23.5,6,6,0.5,5,0,3,90,22,112
p_46,8,0,e_3,291,302,374,20.0,7,4,2.0,5,0,7,11,72,83
p_60,2,0,e_3,338,366,374,3.0,8,1,5.5,4,1,7,28,8,36
p_58,0,6,e_3,330,374,394,7.0,8,0,7.0,4,1,7,44,20,64
p_52,14,0,e_2,312,355,399,10.5,8,1,0.0,5,0,5,43,44,87
p_55,14,0,e_2,314,355,399,10.5,8,1,0.5,5,0,6,41,44,85
p_53,8,0,e_1,313,342,416,16.5,8,4,0.0,5,2,4,29,74,103
p_56,8,0,e_1,324,342,416,14.5,8,4,1.5,5,2,5,18,74,92
p_61,12,0,e_1,341,356,416,23.0,9,9,4.0,5,0,5,15,60,75
p_68,2,0,e_1,389,408,416,25.5,10,9,4.0,4,1,4,19,8,27
p_69,2,0,e_1,391,408,416,25.5,10,9,3.5,4,1,5,17,8,25
p_67,12,0,e_3,377,414,472,17.5,9,2,0.5,5,3,6,37,58,95
p_77,4,0,e_0,455,471,485,28.5,9,9,4.5,4,1,5,16,14,30
p_74,10,0,e_2,424,431,497,3.0,9,9,4.0,5,0,7,7,66,73
p_76,10,0,e_2,440,465,497,25.5,9,9,6.0,5,1,7,25,32,57
p_72,6,0,e_1,417,436,514,18.0,9,5,0.0,5,0,4,19,78,97
p_78,12,0,e_1,455,456,514,20.5,9,9,6.0,5,1,4,1,58,59
p_82,0,12,e_2,494,497,535,26.5,8,8,0.5,4,1,7,3,38,41
p_83,0,12,e_1,501,514,554,25.5,8,8,2.0,4,1,6,13,40,53
p_93,4,0,e_0,543,567,581,29.0,8,8,6.0,4,1,5,24,14,38
p_84,12,0,e_2,504,535,589,13.0,8,2,1.0,5,1,7,31,54,85
p_85,14,0,e_2,517,543,589,8.5,8,1,3.0,5,1,7,26,46,72
p_86,14,0,e_2,518,543,589,8.5,8,1,3.5,5,1,8,25,46,71
p_91,14,0,e_2,539,543,589,19.5,8,8,6.5,5,1,8,4,46,50
p_92,10,0,e_2,540,557,589,23.0,8,8,6.5,5,1,8,17,32,49
p_88,10,0,e_1,531,546,616,24.5,8,8,2.5,5,1,6,15,70,85
p_95,10,0,e_1,547,582,616,22.0,8,8,5.0,5,2,6,35,34,69
p_100,10,0,e_1,557,582,616,20.5,8,8,6.0,5,1,8,25,34,59
p_98,6,0,e_1,555,596,616,25.0,8,8,6.0,5,1,7,41,20,61
p_102,14,0,e_3,568,610,664,16.0,8,1,0.0,5,2,6,42,54,96
p_103,14,0,e_3,577,610,664,14.5,9,1,1.5,5,2,7,33,54,87
p_104,14,0,e_3,581,610,664,13.5,9,1,2.5,5,2,7,29,54,83
p_111,2,0,e_3,607,656,664,21.5,9,6,6.5,5,2,7,49,8,57
p_117,0,2,e_3,636,664,672,4.5,10,0,4.5,4,3,7,28,8,36
p_123,0,2,e_3,661,664,672,0.5,9,0,0.5,4,3,6,3,8,11
p_105,12,0,e_0,582,619,677,15.5,9,3,0.0,5,1,5,37,58,95
p_109,10,0,e_2,590,621,689,16.0,9,4,0.0,5,0,8,31,68,99
p_110,12,0,e_2,590,629,689,14.0,9,3,0.0,5,0,7,39,60,99
p_125,2,0,e_2,668,681,689,27.5,9,7,3.0,4,1,7,13,8,21
p_118,8,0,e_1,649,686,712,24.0,10,10,5.5,5,0,7,37,26,63
p_119,8,0,e_1,650,686,712,24.0,10,10,5.5,5,0,8,36,26,62
p_132,4,0,e_3,730,748,762,1.0,8,0,5.0,4,2,6,18,14,32
p_134,14,0,e_2,734,741,787,19.5,9,9,7.0,5,0,8,7,46,53
p_133,6,0,e_2,734,767,787,27.5,9,9,7.0,5,0,7,33,20,53
p_136,14,0,e_1,749,756,810,18.0,9,9,6.0,5,1,7,7,54,61
p_138,12,0,e_1,756,772,810,19.0,9,9,7.0,5,2,7,16,38,54
p_141,12,0,e_3,770,800,860,17.0,8,2,1.0,5,2,6,30,60,90
p_144,6,0,e_3,815,840,860,1.0,9,0,7.0,4,3,6,25,20,45
p_146,10,0,e_1,846,874,912,22.0,9,9,6.0,5,1,7,28,38,66
p_147,6,0,e_1,849,888,912,25.5,9,9,6.0,5,1,8,39,24,63
p_149,6,0,e_1,859,888,912,6.0,8,8,7.5,4,1,9,29,24,53
p_154,4,0,e_1,874,896,912,24.0,9,7,5.0,1,1,9,22,16,38
p_152,2,0,e_1,868,904,912,27.0,9,8,6.0,4,1,9,36,8,44
p_151,12,0,e_3,863,898,956,17.5,8,2,0.5,5,2,6,35,58,93
p_153,6,0,e_0,872,885,963,22.0,9,6,1.0,5,1,6,13,78,91
p_159,8,0,e_0,893,937,963,17.0,9,5,4.0,5,2,6,44,26,70
p_156,12,0,e_2,884,919,977,14.5,9,2,0.0,5,0,7,35,58,93
p_11,4,0,e_1,84,101,115,8.0,1,1,4.5,4,0,2,17,14,31
p_3,4,0,e_2,25,39,125,4.0,0,0,0.0,3,0,0,14,86,100
p_9,10,0,e_2,67,91,125,7.0,1,0,6.5,5,1,3,24,34,58
p_7,2,0,e_2,55,117,125,15.0,1,1,4.5,5,1,2,62,8,70
p_12,0,8,e_1,86,115,141,11.5,1,1,4.5,4,0,3,29,26,55
p_13,8,0,e_3,87,116,144,11.5,2,2,6.5,5,0,2,29,28,57
p_16,4,0,e_3,101,130,144,2.0,4,1,6.5,4,0,4,29,14,43
p_21,0,10,e_3,142,144,176,0.5,4,0,0.5,4,1,3,2,32,34
p_17,10,0,e_0,112,140,206,20.5,5,5,0.5,5,0,1,28,66,94
p_24,14,0,e_0,157,162,206,12.0,5,0,7.5,3,1,2,5,44,49
p_26,6,0,e_1,169,193,213,16.0,5,4,7.0,4,0,3,24,20,44
p_22,6,0,e_2,146,201,223,20.0,5,4,3.5,5,0,3,55,22,77
p_30,2,0,e_2,200,215,223,5.0,5,1,3.0,4,0,4,15,8,23
p_29,14,0,e_3,192,198,242,6.5,4,0,7.5,5,1,3,6,44,50
p_32,0,10,e_1,209,213,245,5.5,5,0,0.5,4,1,3,4,32,36
p_35,0,6,e_2,222,223,245,3.5,6,0,0.0,3,1,3,1,22,23
p_42,4,0,e_0,269,288,302,17.5,5,4,5.0,4,0,3,19,14,33
p_43,4,0,e_0,270,288,302,17.5,5,4,5.0,4,0,4,18,14,32
p_44,4,0,e_1,275,297,311,17.0,5,3,5.5,4,0,3,22,14,36
p_38,12,0,e_2,240,265,323,18.5,6,6,2.5,5,1,3,25,58,83
p_51,0,4,e_1,309,311,325,4.5,5,0,0.0,4,1,4,2,14,16
p_58,0,6,e_3,330,336,356,1.0,5,0,1.0,4,1,4,6,20,26
p_52,14,0,e_0,312,346,398,19.0,5,5,1.5,5,0,4,34,52,86
p_55,14,0,e_0,314,346,398,18.5,5,5,1.5,5,0,6,32,52,84
p_46,8,0,e_1,291,339,411,28.5,5,5,3.0,4,0,4,48,72,120
p_53,8,0,e_1,313,339,411,25.0,5,5,0.0,5,1,4,26,72,98
p_56,8,0,e_1,324,339,411,23.0,5,5,2.0,3,1,4,15,72,87
p_68,2,0,e_1,389,403,411,5.0,8,2,3.5,4,1,4,14,8,22
p_69,2,0,e_1,391,403,411,5.0,8,2,3.0,4,1,5,12,8,20
p_61,12,0,e_2,341,361,421,13.5,7,1,2.5,5,0,6,20,60,80
p_60,2,0,e_2,338,413,421,24.0,7,6,2.5,5,0,5,75,8,83
p_67,12,0,e_3,377,396,434,8.0,7,1,6.0,5,1,6,19,38,57
p_77,4,0,e_0,455,480,494,19.0,7,5,6.0,4,2,4,25,14,39
p_72,6,0,e_1,417,431,507,27.0,8,8,1.0,5,0,4,14,76,90
p_74,10,0,e_2,424,453,519,21.5,8,8,0.5,5,0,5,29,66,95
p_76,10,0,e_2,440,453,519,15.0,7,2,3.0,5,0,6,13,66,79
p_78,12,0,e_2,455,461,519,11.0,7,1,5.0,5,1,5,6,58,64
p_82,0,12,e_1,494,507,545,5.5,7,0,2.0,4,1,4,13,38,51
p_83,0,12,e_1,501,507,545,4.5,7,0,1.0,4,1,4,6,38,44
p_84,12,0,e_0,504,532,600,21.0,7,7,1.5,5,2,4,28,68,96
p_85,14,0,e_0,517,540,600,16.5,7,7,3.5,5,2,5,23,60,83
p_91,14,0,e_0,539,540,600,12.5,7,0,7.0,2,3,4,1,60,61
p_95,10,0,e_0,547,564,600,13.0,7,2,7.5,3,3,5,17,36,53
p_98,6,0,e_0,555,578,600,16.0,7,4,6.5,4,3,7,23,22,45
p_93,4,0,e_0,543,586,600,20.0,7,5,7.0,5,3,4,43,14,57
p_86,14,0,e_1,518,553,607,16.5,7,7,1.5,5,1,4,35,54,89
p_100,10,0,e_1,557,575,607,11.5,7,2,7.5,3,1,5,18,32,50
p_88,10,0,e_2,531,551,615,15.5,7,2,2.0,5,0,5,20,64,84
p_92,10,0,e_2,540,551,615,14.0,7,2,3.5,5,0,7,11,64,75
p_102,14,0,e_3,568,572,616,7.5,7,0,6.5,5,1,6,4,44,48
p_109,10,0,e_0,590,632,698,24.5,8,8,1.5,4,3,5,42,66,108
p_125,2,0,e_0,668,690,698,5.0,8,2,4.5,4,3,5,22,8,30
p_123,0,2,e_0,661,698,706,18.5,8,8,5.5,4,3,5,37,8,45
p_111,2,0,e_1,607,615,707,29.5,8,8,0.0,5,0,7,8,92,100
p_105,12,0,e_1,582,647,707,23.5,8,8,4.0,4,1,6,65,60,125
p_103,14,0,e_1,577,655,707,22.5,8,8,5.0,4,1,5,78,52,130
p_104,14,0,e_1,581,655,707,22.0,8,8,4.5,4,1,6,74,52,126
p_118,8,0,e_3,649,686,712,12.5,7,3,5.5,5,1,6,37,26,63
p_110,12,0,e_2,590,653,713,22.0,8,8,4.0,4,1,6,63,60,123
p_119,8,0,e_2,650,687,713,12.5,8,3,5.5,5,0,8,37,26,63
p_117,0,2,e_2,636,713,721,23.0,7,7,3.0,5,0,7,77,8,85
p_134,14,0,e_3,734,756,802,10.5,7,0,3.5,5,1,6,22,46,68
p_136,14,0,e_3,749,756,802,8.0,8,0,6.0,5,1,7,7,46,53
p_138,12,0,e_3,756,764,802,7.0,7,1,7.0,2,1,6,8,38,46
p_133,6,0,e_2,734,735,813,18.5,8,5,3.0,5,0,7,1,78,79
p_132,4,0,e_2,730,799,813,19.0,7,5,2.5,5,0,6,69,14,83
p_141,12,0,e_0,770,832,892,23.5,8,8,4.0,4,2,6,62,60,122
p_152,2,0,e_0,868,884,892,3.0,10,1,3.5,4,3,6,16,8,24
p_147,6,0,e_1,849,877,897,16.5,10,5,7.5,4,1,6,28,20,48
p_144,6,0,e_3,815,822,902,18.0,7,4,2.0,5,1,6,7,80,87
p_146,10,0,e_3,846,868,902,9.0,8,2,7.0,5,2,6,22,34,56
p_149,6,0,e_3,859,882,902,0.0,10,0,6.5,4,2,8,23,20,43
p_153,6,0,e_2,872,889,911,28.5,10,10,5.5,4,0,7,17,22,39
p_154,4,0,e_2,874,897,911,30.0,10,10,5.5,4,0,8,23,14,37
p_159,8,0,e_0,893,918,990,23.5,9,9,0.0,5,2,7,25,72,97
p_156,12,0,e_0,884,932,990,21.0,9,9,1.0,4,3,6,48,58,106
p_151,12,0,e_1,863,935,993,24.0,11,11,5.0,4,1,7,72,58,130
p_7,2,0,e_3,55,63,71,2.0,0,0,0.0,3,0,0,8,8,16
p_11,4,0,e_1,84,102,116,13.0,1,1,5.0,4,0,2,18,14,32
p_3,4,0,e_2,25,40,124,4.0,0,0,0.0,3,0,0,15,84,99
p_9,10,0,e_2,67,92,124,20.5,1,1,6.0,5,1,2,25,32,57
p_12,0,8,e_1,86,116,142,16.5,1,1,4.5,4,0,3,30,26,56
p_13,8,0,e_3,87,103,177,8.5,1,1,1.5,5,0,1,16,74,90
p_17,10,0,e_3,112,143,177,10.5,5,1,5.5,5,1,4,31,34,65
p_16,4,0,e_3,101,163,177,18.0,4,4,4.0,5,0,4,62,14,76
p_21,0,10,e_3,142,177,209,5.0,7,0,5.0,4,1,6,35,32,67
p_24,14,0,e_2,157,168,214,19.0,7,7,5.5,5,0,3,11,46,57
p_22,6,0,e_2,146,194,214,29.0,7,7,3.5,5,0,2,48,20,68
p_26,6,0,e_1,169,194,216,25.0,6,6,7.0,4,0,2,25,22,47
p_30,2,0,e_1,200,208,216,24.5,8,7,2.5,4,1,3,8,8,16
p_32,0,10,e_2,209,214,246,25.0,7,7,1.0,4,1,2,5,32,37
p_29,14,0,e_3,192,223,275,14.0,7,1,2.0,5,2,5,31,52,83
p_38,12,0,e_2,240,254,312,24.0,7,7,4.0,5,1,5,14,58,72
p_42,4,0,e_1,269,298,312,27.0,7,7,6.5,4,0,3,29,14,43
p_43,4,0,e_1,270,298,312,26.5,7,7,6.5,4,0,4,28,14,42
p_44,4,0,e_1,275,298,312,4.0,6,6,6.0,4,0,4,23,14,37
p_51,0,4,e_1,309,312,326,25.0,8,8,0.5,4,1,3,3,14,17
p_35,0,6,e_2,222,312,332,23.0,6,6,1.0,5,1,4,90,20,110
p_46,8,0,e_3,291,301,377,19.5,7,4,2.5,5,1,6,10,76,86
p_52,14,0,e_3,312,321,377,10.5,8,1,5.5,5,2,6,9,56,65
p_55,14,0,e_3,314,321,377,10.0,10,1,6.0,5,2,8,7,56,63
p_53,8,0,e_3,313,349,377,16.5,9,5,5.5,5,2,7,36,28,64
p_56,8,0,e_3,324,349,377,14.5,9,4,7.5,5,2,7,25,28,53
p_60,2,0,e_3,338,369,377,3.0,10,1,5.5,4,2,8,31,8,39
p_58,0,6,e_3,330,377,397,7.0,10,0,7.0,4,2,8,47,20,67
p_68,2,0,e_1,389,402,410,26.0,10,9,3.0,4,0,3,13,8,21
p_69,2,0,e_1,391,402,410,26.0,10,9,3.0,4,0,4,11,8,19
p_61,12,0,e_2,341,352,410,23.5,11,11,4.5,5,0,6,11,58,69
p_67,12,0,e_3,377,417,475,12.0,8,8,0.0,3,2,7,40,58,98
p_72,6,0,e_0,417,465,487,18.0,8,5,4.5,5,0,4,48,22,70
p_77,4,0,e_0,455,473,487,29.5,9,9,4.5,4,0,5,18,14,32
p_74,10,0,e_2,424,442,508,13.0,9,3,2.0,5,0,6,18,66,84
p_76,10,0,e_2,440,442,508,26.0,9,9,4.5,5,0,7,2,66,68
p_78,12,0,e_2,455,470,508,21.5,9,9,7.0,5,1,6,15,38,53
p_82,0,12,e_1,494,504,542,27.0,8,8,1.5,4,0,5,10,38,48
p_83,0,12,e_1,501,504,542,26.0,8,8,0.5,4,0,6,3,38,41
p_84,12,0,e_3,504,513,575,13.5,8,2,4.5,5,2,6,9,62,71
p_85,14,0,e_3,517,521,575,9.5,9,1,6.5,5,3,6,4,54,58
p_86,14,0,e_3,518,521,575,9.5,10,1,6.5,5,3,7,3,54,57
p_93,4,0,e_3,543,561,575,1.0,9,0,5.0,4,3,6,18,14,32
p_88,10,0,e_2,531,540,600,27.0,9,9,3.5,5,0,6,9,60,69
p_92,10,0,e_2,540,542,600,25.5,9,9,5.0,5,1,7,2,58,60
p_91,14,0,e_2,539,556,600,21.5,9,9,5.0,2,0,6,17,44,61
p_95,10,0,e_1,547,570,604,24.5,10,10,6.5,5,0,5,23,34,57
p_98,6,0,e_1,555,584,604,27.0,10,10,7.5,4,0,6,29,20,49
p_109,10,0,e_3,590,607,675,17.5,10,5,2.5,5,2,8,17,68,85
p_105,12,0,e_3,582,615,675,17.0,9,3,1.0,5,2,7,33,60,93
p_110,12,0,e_3,590,615,675,15.5,10,3,2.5,5,2,8,25,60,85
p_103,14,0,e_3,577,623,675,16.0,8,1,0.0,5,2,6,46,52,98
p_104,14,0,e_3,581,623,675,15.0,9,1,1.0,5,2,7,42,52,94
p_100,10,0,e_0,557,613,679,22.5,10,10,4.0,4,0,5,56,66,122
p_102,14,0,e_0,568,627,679,17.0,9,9,2.0,4,0,7,59,52,111
p_117,0,2,e_3,636,675,683,6.5,9,0,6.5,4,3,6,39,8,47
p_123,0,2,e_3,661,675,683,2.0,9,0,2.0,4,3,6,14,8,22
p_111,2,0,e_2,607,688,696,23.0,10,7,1.0,5,0,6,81,8,89
p_125,2,0,e_2,668,688,696,29.0,9,9,4.5,4,0,7,20,8,28
p_118,8,0,e_1,649,674,700,26.5,9,9,7.0,5,0,5,25,26,51
p_119,8,0,e_1,650,674,700,26.0,9,9,7.5,3,0,6,24,26,50
p_132,4,0,e_3,730,759,773,2.0,8,1,6.5,4,2,6,29,14,43
p_133,6,0,e_0,734,755,775,29.0,9,9,6.5,4,0,6,21,20,41
p_134,14,0,e_2,734,740,784,21.0,9,9,6.0,5,0,7,6,44,50
p_138,12,0,e_3,756,811,871,19.5,9,9,2.5,4,2,7,55,60,115
p_144,6,0,e_3,815,851,871,17.5,9,5,6.5,5,3,6,36,20,56
p_141,12,0,e_0,770,813,873,18.5,10,10,1.0,4,1,7,43,60,103
p_136,14,0,e_0,749,821,873,18.5,9,9,4.0,4,0,7,72,52,124
p_146,10,0,e_2,846,848,880,24.0,10,10,5.5,4,1,6,2,32,34
p_147,6,0,e_1,849,870,892,27.0,10,10,6.5,4,0,5,21,22,43
p_152,2,0,e_1,868,884,892,28.5,9,9,3.5,4,0,7,16,8,24
p_153,6,0,e_3,872,891,969,24.0,8,5,0.0,5,2,6,19,78,97
p_156,12,0,e_3,884,911,969,16.0,9,2,2.0,5,2,7,27,58,85
p_154,4,0,e_0,874,887,973,26.0,9,7,0.0,5,0,8,13,86,99
p_149,6,0,e_0,859,895,973,26.0,9,9,2.5,4,1,7,36,78,114
p_159,8,0,e_0,893,903,973,19.0,10,5,3.0,5,1,8,10,70,80
p_151,12,0,e_1,863,930,988,19.5,9,9,4.0,4,0,6,67,58,125
p_3,4,0,e_2,25,40,54,4.0,0,0,0.0,3,0,0,15,14,29
p_7,2,0,e_2,55,64,72,13.0,2,2,0.0,3,0,0,9,8,17
p_11,4,0,e_1,84,101,115,3.0,3,1,5.0,4,0,3,17,14,31
p_9,10,0,e_3,67,99,133,5.0,2,0,5.0,5,0,2,32,34,66
p_16,4,0,e_3,101,119,133,1.0,3,0,5.0,4,1,2,18,14,32
p_12,0,8,e_3,86,133,161,7.0,3,0,7.0,4,0,3,47,28,75
p_13,8,0,e_2,87,103,173,29.0,4,4,1.5,5,0,1,16,70,86
p_17,10,0,e_0,112,139,203,23.0,4,4,0.5,5,0,1,27,64,91
p_21,0,10,e_2,142,173,205,17.0,4,4,5.0,4,1,3,31,32,63
p_24,14,0,e_1,157,159,213,10.5,5,0,6.5,5,0,3,2,54,56
p_26,6,0,e_1,169,193,213,7.0,4,2,7.0,4,1,3,24,20,44
p_22,6,0,e_3,146,153,233,10.0,4,3,2.0,5,2,2,7,80,87
p_30,2,0,e_3,200,225,233,3.0,4,0,5.0,4,2,2,25,8,33
p_32,0,10,e_1,209,213,245,3.5,5,0,0.5,4,1,3,4,32,36
p_35,0,6,e_3,222,233,253,1.5,6,0,1.5,4,2,4,11,20,31
p_29,14,0,e_2,192,219,263,22.5,4,4,3.0,5,1,4,27,44,71
p_38,12,0,e_0,240,241,301,11.0,5,0,6.0,5,0,3,1,60,61
p_42,4,0,e_0,269,287,301,8.5,4,2,5.0,4,1,3,18,14,32
p_43,4,0,e_1,270,297,311,8.5,4,2,6.5,4,0,4,27,14,41
p_44,4,0,e_1,275,297,311,7.5,4,2,5.5,4,0,5,22,14,36
p_51,0,4,e_1,309,311,325,3.0,5,0,0.0,4,1,4,2,14,16
p_46,8,0,e_2,291,333,361,27.0,4,4,4.5,5,0,6,42,28,70
p_60,2,0,e_2,338,353,361,14.5,5,4,3.5,4,1,7,15,8,23
p_58,0,6,e_2,330,361,381,18.0,5,5,4.5,4,0,8,31,20,51
p_53,8,0,e_0,313,327,399,23.5,5,5,2.0,5,0,4,14,72,86
p_52,14,0,e_0,312,347,399,18.0,5,5,1.5,5,0,3,35,52,87
p_55,14,0,e_0,314,347,399,17.5,5,5,2.0,5,0,5,33,52,85
p_61,12,0,e_3,341,367,405,10.5,5,0,1.5,5,1,4,26,38,64
p_56,8,0,e_1,324,339,411,22.0,5,5,2.0,3,1,4,15,72,87
p_68,2,0,e_1,389,403,411,0.0,6,0,3.0,4,1,4,14,8,22
p_69,2,0,e_1,391,403,411,30.0,6,6,3.0,4,1,5,12,8,20
p_67,12,0,e_2,377,401,461,22.5,6,6,2.5,5,1,7,24,60,84
p_72,6,0,e_2,417,441,461,10.5,5,2,7.0,4,1,7,24,20,44
p_74,10,0,e_3,424,437,469,7.0,5,0,3.0,5,1,4,13,32,45
p_76,10,0,e_0,440,463,497,24.5,6,6,6.5,5,2,3,23,34,57
p_77,4,0,e_0,455,483,497,28.0,6,6,6.0,4,2,4,28,14,42
p_78,12,0,e_1,455,469,507,20.0,6,6,7.0,5,0,4,14,38,52
p_82,0,12,e_0,494,497,535,22.0,6,6,0.5,4,3,3,3,38,41
p_83,0,12,e_1,501,507,547,21.0,6,6,1.0,4,1,5,6,40,46
p_84,12,0,e_3,504,507,567,8.5,6,1,5.5,5,1,5,3,60,63
p_85,14,0,e_3,517,523,567,6.5,7,0,7.5,5,2,5,6,44,50
p_86,14,0,e_0,518,543,601,23.5,8,8,3.5,5,3,3,25,58,83
p_91,14,0,e_0,539,543,601,20.5,7,7,6.5,5,2,4,4,58,62
p_92,10,0,e_0,540,565,601,24.5,7,7,6.5,5,2,4,25,36,61
p_98,6,0,e_0,555,579,601,26.0,7,7,6.5,4,3,5,24,22,46
p_93,4,0,e_0,543,587,601,30.0,7,7,7.0,2,2,4,44,14,58
p_88,10,0,e_1,531,539,607,26.0,7,7,3.5,5,1,5,8,68,76
p_95,10,0,e_1,547,575,607,23.0,7,7,6.0,2,2,5,28,32,60
p_100,10,0,e_1,557,575,607,21.5,7,7,7.5,3,1,6,18,32,50
p_110,12,0,e_2,590,593,647,12.5,8,2,5.5,5,0,8,3,54,57
p_103,14,0,e_2,577,601,647,12.5,7,0,3.5,5,0,7,24,46,70
p_111,2,0,e_2,607,639,647,20.0,8,4,6.0,4,1,7,32,8,40
p_109,10,0,e_3,590,599,659,14.5,8,3,3.5,5,1,7,9,60,69
p_105,12,0,e_3,582,607,659,14.0,7,2,2.0,5,1,6,25,52,77
p_102,14,0,e_3,568,615,659,14.0,6,0,0.0,5,1,5,47,44,91
p_104,14,0,e_3,581,615,659,12.0,7,0,2.0,5,1,6,34,44,78
p_117,0,2,e_3,636,659,667,4.0,7,0,4.0,4,2,5,23,8,31
p_125,2,0,e_0,668,689,697,23.0,6,5,4.5,4,2,6,21,8,29
p_118,8,0,e_1,649,677,703,23.5,7,7,6.5,5,0,7,28,26,54
p_123,0,2,e_0,661,697,705,26.0,7,7,5.5,4,2,5,36,8,44
p_119,8,0,e_2,650,673,743,23.5,7,7,0.0,5,0,7,23,70,93
p_133,6,0,e_0,734,775,797,26.5,7,7,5.5,5,2,6,41,22,63
p_132,4,0,e_0,730,783,797,29.0,7,7,5.0,5,2,5,53,14,67
p_134,14,0,e_1,734,747,801,18.5,7,7,5.0,5,0,7,13,54,67
p_136,14,0,e_1,749,757,801,16.0,7,7,7.0,5,1,7,8,44,52
p_138,12,0,e_3,756,793,851,14.0,7,1,0.0,5,1,6,37,58,95
p_141,12,0,e_3,770,793,851,12.0,8,1,2.0,5,1,7,23,58,81
p_144,6,0,e_0,815,817,897,30.0,8,8,3.0,5,2,5,2,80,82
p_146,10,0,e_0,846,863,897,21.0,8,8,7.5,3,3,5,17,34,51
p_152,2,0,e_0,868,889,897,21.5,9,8,4.5,4,3,5,21,8,29
p_147,6,0,e_1,849,877,897,24.0,8,8,7.5,4,1,7,28,20,48
p_153,6,0,e_2,872,913,933,17.0,9,5,5.5,5,1,7,41,20,61
p_149,6,0,e_3,859,871,953,19.0,7,4,1.0,5,1,6,12,82,94
p_151,12,0,e_3,863,891,953,12.5,8,1,1.5,5,1,7,28,62,90
p_156,12,0,e_3,884,891,953,9.0,10,1,5.0,5,2,8,7,62,69
p_159,8,0,e_3,893,925,953,12.0,9,3,6.0,5,2,7,32,28,60
p_154,4,0,e_3,874,939,953,18.5,9,6,3.5,5,2,7,65,14,79
p_3,4,0,e_2,25,39,53,4.0,0,0,0.0,3,0,0,14,14,28
p_7,2,0,e_2,55,64,72,12.5,2,2,0.0,3,0,0,9,8,17
p_11,4,0,e_1,84,102,116,3.0,3,1,5.0,4,0,2,18,14,32
p_9,10,0,e_3,67,98,132,4.5,2,0,5.5,5,0,2,31,34,65
p_16,4,0,e_3,101,118,132,0.0,3,0,4.5,4,1,2,17,14,31
p_12,0,8,e_1,86,116,142,7.0,3,0,4.5,4,0,3,30,26,56
p_13,8,0,e_2,87,103,173,24.0,3,3,1.5,5,0,1,16,70,86
p_17,10,0,e_0,112,139,203,23.0,4,4,0.5,5,0,1,27,64,91
p_21,0,10,e_2,142,173,205,16.5,3,3,5.0,4,1,5,31,32,63
p_24,14,0,e_1,157,162,218,10.5,4,0,6.5,5,0,2,5,56,61
p_26,6,0,e_1,169,196,218,6.5,4,2,7.5,4,1,2,27,22,49
p_30,2,0,e_1,200,210,218,2.0,4,0,2.5,4,1,3,10,8,18
p_22,6,0,e_3,146,152,228,10.0,3,2,2.0,5,1,2,6,76,82
p_35,0,6,e_3,222,228,248,1.0,5,0,1.0,4,2,3,6,20,26
p_32,0,10,e_1,209,218,250,3.0,4,0,1.0,4,1,4,9,32,41
p_29,14,0,e_2,192,219,271,22.0,4,4,3.0,5,1,5,27,52,79
p_42,4,0,e_0,269,285,299,2.0,5,1,4.5,4,0,3,16,14,30
p_43,4,0,e_0,270,285,299,2.0,5,1,4.5,4,0,4,15,14,29
p_38,12,0,e_3,240,268,306,10.5,5,0,1.5,5,2,3,28,38,66
p_44,4,0,e_1,275,302,316,1.0,5,0,6.5,4,0,3,27,14,41
p_51,0,4,e_1,309,316,330,18.0,4,4,1.0,4,1,5,7,14,21
p_55,14,0,e_2,314,315,369,13.0,6,0,7.0,5,0,7,1,54,55
p_60,2,0,e_2,338,361,369,21.0,6,3,5.0,4,1,7,23,8,31
p_58,0,6,e_2,330,369,389,24.5,6,6,6.0,4,1,7,39,20,59
p_53,8,0,e_3,313,332,398,19.0,5,2,1.0,5,1,4,19,66,85
p_56,8,0,e_3,324,332,398,17.5,6,2,2.5,5,1,5,8,66,74
p_61,12,0,e_3,341,346,398,10.5,6,1,5.5,5,2,4,5,52,57
p_52,14,0,e_3,312,354,398,13.0,4,0,1.0,5,1,3,42,44,86
p_46,8,0,e_1,291,344,416,24.5,5,5,3.5,4,0,4,53,72,125
p_68,2,0,e_1,389,408,416,29.5,5,5,4.0,4,1,4,19,8,27
p_69,2,0,e_1,391,408,416,29.0,5,5,4.0,4,1,5,17,8,25
p_72,6,0,e_3,417,418,464,9.0,5,2,3.0,5,1,4,1,46,47
p_74,10,0,e_3,424,432,464,6.0,6,0,4.0,5,2,4,8,32,40
p_67,12,0,e_2,377,409,467,21.5,5,5,1.0,5,1,7,32,58,90
p_77,4,0,e_0,455,475,489,27.5,6,6,5.0,4,1,4,20,14,34
p_76,10,0,e_1,440,448,514,24.0,6,6,4.0,5,0,4,8,66,74
p_78,12,0,e_1,455,476,514,19.5,6,6,6.0,5,1,4,21,38,59
p_82,0,12,e_1,494,514,556,21.0,6,6,3.0,4,1,6,20,42,62
p_83,0,12,e_1,501,514,556,20.0,6,6,2.0,4,1,6,13,42,55
p_84,12,0,e_3,504,522,560,7.5,6,1,6.5,5,1,5,18,38,56
p_85,14,0,e_0,517,533,589,21.5,7,7,4.5,5,1,4,16,56,72
p_86,14,0,e_0,518,533,589,21.5,7,7,4.5,5,1,5,15,56,71
p_88,10,0,e_0,531,555,589,24.5,7,7,7.0,5,1,5,24,34,58
p_93,4,0,e_0,543,575,589,28.5,7,7,7.0,4,2,5,32,14,46
p_92,10,0,e_1,540,546,620,23.5,7,7,4.0,5,1,7,6,74,80
p_95,10,0,e_1,547,548,620,22.0,7,7,5.0,5,2,7,1,72,73
p_91,14,0,e_1,539,564,620,19.5,7,7,4.0,5,1,6,25,56,81
p_100,10,0,e_1,557,586,620,20.5,7,7,6.0,5,1,9,29,34,63
p_98,6,0,e_1,555,600,620,25.0,7,7,6.0,5,2,8,45,20,65
p_109,10,0,e_3,590,592,652,13.0,8,3,5.0,5,1,7,2,60,62
p_105,12,0,e_3,582,600,652,12.5,7,2,3.5,5,1,6,18,52,70
p_110,12,0,e_3,590,600,652,11.5,8,2,4.5,5,1,7,10,52,62
p_102,14,0,e_3,568,608,652,13.0,6,0,1.0,5,1,5,40,44,84
p_103,14,0,e_3,577,608,652,11.5,7,0,2.5,5,1,6,31,44,75
p_104,14,0,e_3,581,608,652,11.0,7,0,3.0,5,1,6,27,44,71
p_111,2,0,e_2,607,649,657,17.0,7,2,7.5,3,0,7,42,8,50
p_117,0,2,e_3,636,652,660,2.5,7,0,2.5,4,2,5,16,8,24
p_125,2,0,e_0,668,677,685,22.0,6,5,2.5,4,1,7,9,8,17
p_123,0,2,e_0,661,685,693,25.0,6,6,3.5,4,1,6,24,8,32
p_118,8,0,e_1,649,690,716,22.5,7,7,4.5,5,0,7,41,26,67
p_119,8,0,e_1,650,690,716,22.0,7,7,5.0,5,0,8,40,26,66
p_133,6,0,e_0,734,763,785,25.0,6,6,7.5,4,1,7,29,22,51
p_132,4,0,e_0,730,771,785,28.0,6,6,7.0,5,1,6,41,14,55
p_134,14,0,e_1,734,760,814,17.0,6,6,2.5,5,1,6,26,54,80
p_138,12,0,e_1,756,776,814,15.0,7,2,6.5,5,1,7,20,38,58
p_141,12,0,e_3,770,786,838,12.5,7,2,3.5,5,1,6,16,52,68
p_136,14,0,e_3,749,794,838,14.0,6,0,0.0,5,1,5,45,44,89
p_144,6,0,e_0,815,861,881,27.5,7,7,5.0,5,1,6,46,20,66
p_147,6,0,e_1,849,890,914,18.5,7,4,5.5,5,1,6,41,24,65
p_149,6,0,e_1,859,890,914,16.5,7,4,7.5,5,1,7,31,24,55
p_154,4,0,e_1,874,898,914,16.5,9,5,5.5,4,1,8,24,16,40
p_152,2,0,e_1,868,906,914,19.0,8,5,6.5,4,1,7,38,8,46
p_146,10,0,e_3,846,870,940,15.0,6,1,1.0,5,1,5,24,70,94
p_151,12,0,e_3,863,878,940,10.0,7,1,4.0,5,1,6,15,62,77
p_156,12,0,e_3,884,900,940,7.5,8,1,6.5,5,2,6,16,40,56
p_153,6,0,e_3,872,920,940,15.0,8,4,5.0,5,2,6,48,20,68
p_159,8,0,e_0,893,907,977,29.0,10,10,2.0,5,1,6,14,70,84
p_3,4,0,e_2,25,40,54,4.0,0,0,0.0,3,0,0,15,14,29
p_7,2,0,e_2,55,64,72,13.0,2,2,0.0,3,0,0,9,8,17
p_11,4,0,e_1,84,102,116,3.0,3,1,5.0,4,0,2,18,14,32
p_9,10,0,e_3,67,98,132,4.5,2,0,5.5,5,0,2,31,34,65
p_16,4,0,e_3,101,118,132,1.0,3,0,5.0,4,1,2,17,14,31
p_12,0,8,e_1,86,116,142,7.0,3,0,4.5,4,0,3,30,26,56
p_13,8,0,e_2,87,104,174,23.5,3,3,1.0,5,0,1,17,70,87
p_17,10,0,e_0,112,139,203,23.0,4,4,0.5,5,0,1,27,64,91
p_21,0,10,e_2,142,174,206,16.5,3,3,5.5,4,1,4,32,32,64
p_24,14,0,e_1,157,162,218,10.5,4,0,6.0,5,0,2,5,56,61
p_26,6,0,e_1,169,196,218,6.5,4,2,7.5,4,1,2,27,22,49
p_30,2,0,e_1,200,210,218,2.0,4,0,2.5,4,1,3,10,8,18
p_22,6,0,e_3,146,152,228,10.0,3,2,2.0,5,1,2,6,76,82
p_35,0,6,e_3,222,228,248,1.0,5,0,1.0,4,2,3,6,20,26
p_32,0,10,e_3,209,228,262,3.0,4,0,3.0,4,2,2,19,34,53
p_29,14,0,e_2,192,220,264,22.0,4,4,3.0,5,1,5,28,44,72
p_42,4,0,e_0,269,285,299,29.0,4,4,4.5,4,0,4,16,14,30
p_43,4,0,e_0,270,285,299,29.0,4,4,4.5,4,0,5,15,14,29
p_38,12,0,e_1,240,256,316,10.5,6,0,3.5,5,0,3,16,60,76
p_44,4,0,e_1,275,302,316,28.0,4,4,6.5,4,1,3,27,14,41
p_51,0,4,e_1,309,316,330,20.0,6,6,1.0,4,1,4,7,14,21
p_46,8,0,e_2,291,334,362,22.5,4,4,4.5,5,0,7,43,28,71
p_60,2,0,e_2,338,354,362,13.5,8,4,3.5,4,1,7,16,8,24
p_58,0,6,e_2,330,362,382,16.5,8,8,4.5,4,0,8,32,20,52
p_53,8,0,e_3,313,320,394,11.0,6,2,3.0,5,1,5,7,74,81
p_61,12,0,e_3,341,354,394,4.5,8,0,7.5,5,2,6,13,40,53
p_56,8,0,e_3,324,368,394,9.5,7,2,4.5,5,2,5,44,26,70
p_52,14,0,e_0,312,343,395,11.0,6,0,2.0,5,0,4,31,52,83
p_55,14,0,e_0,314,343,395,11.0,7,0,2.5,5,0,5,29,52,81
p_68,2,0,e_1,389,406,414,28.5,7,7,3.5,4,0,5,17,8,25
p_69,2,0,e_1,391,406,414,28.5,7,7,3.5,4,0,6,15,8,23
p_67,12,0,e_2,377,402,462,20.5,7,7,2.5,5,1,7,25,60,85
p_72,6,0,e_2,417,442,462,12.5,6,3,7.0,4,1,7,25,20,45
p_77,4,0,e_0,455,477,491,1.0,8,0,5.5,4,1,4,22,14,36
p_74,10,0,e_3,424,426,492,7.0,6,1,5.0,5,1,5,2,66,68
p_76,10,0,e_3,440,460,492,5.0,7,1,7.0,5,2,5,20,32,52
p_78,12,0,e_1,455,472,510,23.5,8,8,6.5,5,1,4,17,38,55
p_82,0,12,e_1,494,510,548,22.0,6,6,2.5,4,2,6,16,38,54
p_83,0,12,e_1,501,510,548,20.5,6,6,1.5,4,2,6,9,38,47
p_84,12,0,e_3,504,530,584,10.5,6,0,1.5,5,1,5,26,54,80
p_86,14,0,e_3,518,538,584,10.0,7,0,4.0,5,1,6,20,46,66
p_93,4,0,e_3,543,570,584,2.0,7,1,6.5,4,2,5,27,14,41
p_85,14,0,e_0,517,535,589,10.0,7,0,4.0,5,1,4,18,54,72
p_88,10,0,e_0,531,557,589,12.0,8,2,6.5,5,1,5,26,32,58
p_92,10,0,e_0,540,557,589,27.0,7,7,7.5,3,2,5,17,32,49
p_91,14,0,e_1,539,556,612,23.0,7,7,4.5,5,2,6,17,56,73
p_95,10,0,e_1,547,578,612,26.0,8,8,6.0,2,2,7,31,34,65
p_98,6,0,e_1,555,592,612,28.5,8,8,7.0,5,1,8,37,20,57
p_100,10,0,e_2,557,588,650,24.0,8,8,0.0,5,0,7,31,62,93
p_105,12,0,e_2,582,596,650,18.0,7,7,4.0,5,0,9,14,54,68
p_102,14,0,e_2,568,604,650,18.0,8,8,2.0,5,0,8,36,46,82
p_103,14,0,e_2,577,604,650,17.0,7,7,3.0,5,0,9,27,46,73
p_104,14,0,e_2,581,604,650,16.5,7,7,4.0,5,0,9,23,46,69
p_111,2,0,e_2,607,642,650,18.5,8,6,7.0,4,1,7,35,8,43
p_109,10,0,e_3,590,616,662,11.0,6,1,1.0,5,1,5,26,46,72
p_110,12,0,e_3,590,624,662,11.0,7,0,1.0,5,1,6,34,38,72
p_117,0,2,e_3,636,662,670,4.0,7,0,4.0,4,2,5,26,8,34
p_125,2,0,e_0,668,677,685,19.5,7,5,2.5,4,1,7,9,8,17
p_123,0,2,e_0,661,685,693,0.0,6,6,3.5,4,1,6,24,8,32
p_119,8,0,e_1,650,682,708,24.0,7,7,6.0,5,1,6,32,26,58
p_118,8,0,e_2,649,676,746,24.0,7,7,0.0,3,1,7,27,70,97
p_132,4,0,e_3,730,746,760,0.0,6,0,4.5,4,1,5,16,14,30
p_133,6,0,e_0,734,763,783,27.0,7,7,7.5,4,1,6,29,20,49
p_134,14,0,e_1,734,752,806,19.0,7,7,4.0,5,2,6,18,54,72
p_138,12,0,e_1,756,768,806,18.5,7,7,7.5,5,3,6,12,38,50
p_136,14,0,e_2,749,790,834,17.5,7,7,0.0,5,0,7,41,44,85
p_141,12,0,e_3,770,798,858,16.5,7,1,1.5,5,2,5,28,60,88
p_144,6,0,e_3,815,838,858,0.0,8,0,6.5,4,3,5,23,20,43
p_147,6,0,e_1,849,882,904,25.5,8,8,7.0,5,2,6,33,22,55
p_149,6,0,e_1,859,882,904,24.0,7,4,6.5,4,2,7,23,22,45
p_152,2,0,e_1,868,896,904,26.5,7,6,5.0,4,2,7,28,8,36
p_146,10,0,e_2,846,866,936,22.0,8,8,1.5,5,0,7,20,70,90
p_151,12,0,e_2,863,874,936,17.5,7,1,4.5,5,0,8,11,62,73
p_153,6,0,e_2,872,914,936,22.0,7,4,6.0,5,1,8,42,22,64
p_154,4,0,e_2,874,922,936,23.5,7,5,6.0,5,1,8,48,14,62
p_156,12,0,e_3,884,896,956,14.0,7,1,4.0,5,2,5,12,60,72
p_159,8,0,e_3,893,930,956,16.5,8,4,5.5,5,2,6,37,26,63
p_3,4,0,e_2,25,40,54,4.0,0,0,0.0,3,0,0,15,14,29
p_11,4,0,e_1,84,101,115,3.0,3,1,5.0,4,0,2,17,14,31
p_9,10,0,e_3,67,98,132,4.5,2,0,5.5,5,0,2,31,34,65
p_16,4,0,e_3,101,118,132,1.0,3,0,5.0,4,1,2,17,14,31
p_12,0,8,e_1,86,115,141,7.0,3,0,4.5,4,0,3,29,26,55
p_13,8,0,e_0,87,133,209,23.5,3,3,3.0,4,0,1,46,76,122
p_17,10,0,e_0,112,141,209,23.0,4,4,0.5,5,0,2,29,68,97
p_24,14,0,e_0,157,163,209,10.5,4,0,7.5,5,1,2,6,46,52
p_26,6,0,e_0,169,189,209,6.5,4,2,6.5,4,1,2,20,20,40
p_22,6,0,e_3,146,152,230,10.0,3,2,2.0,5,1,2,6,78,84
p_30,2,0,e_3,200,222,230,2.0,4,0,4.5,4,2,2,22,8,30
p_21,0,10,e_1,142,211,243,16.5,3,3,4.0,5,0,2,69,32,101
p_32,0,10,e_1,209,211,243,3.0,5,0,0.0,4,0,4,2,32,34
p_35,0,6,e_3,222,230,250,1.0,5,0,1.0,4,2,3,8,20,28
p_29,14,0,e_0,192,253,307,22.0,4,4,2.5,4,1,2,61,54,115
p_42,4,0,e_0,269,293,307,8.0,4,2,6.0,4,1,3,24,14,38
p_43,4,0,e_0,270,293,307,8.0,4,2,6.0,4,1,4,23,14,37
p_44,4,0,e_0,275,293,307,7.0,4,1,5.0,4,1,4,18,14,32
p_38,12,0,e_1,240,251,309,10.5,5,0,4.5,5,1,3,11,58,69
p_51,0,4,e_3,309,326,340,3.0,5,0,3.0,4,1,4,17,14,31
p_53,8,0,e_1,313,335,401,24.0,6,6,0.5,5,0,5,22,66,88
p_56,8,0,e_1,324,335,401,22.0,6,6,2.5,5,0,6,11,66,77
p_52,14,0,e_1,312,355,401,18.0,6,6,0.5,5,0,4,43,46,89
p_55,14,0,e_1,314,355,401,18.0,6,6,0.5,5,0,6,41,46,87
p_60,2,0,e_1,338,393,401,14.5,7,5,4.0,5,1,5,55,8,63
p_69,2,0,e_0,391,395,403,30.0,7,7,1.5,4,0,6,4,8,12
p_61,12,0,e_3,341,366,406,10.0,6,0,2.0,5,1,5,25,40,65
p_68,2,0,e_3,389,398,406,0.0,6,0,2.5,4,2,4,9,8,17
p_58,0,6,e_3,330,406,426,17.5,6,6,0.5,5,2,4,76,20,96
p_72,6,0,e_3,417,426,474,10.5,6,2,1.5,5,2,4,9,48,57
p_74,10,0,e_3,424,440,474,7.5,6,0,2.5,5,2,4,16,34,50
p_76,10,0,e_3,440,440,474,5.0,6,0,5.0,2,2,4,0,34,34
p_77,4,0,e_1,455,483,497,29.0,7,7,6.5,4,2,4,28,14,42
p_82,0,12,e_0,494,497,535,23.0,7,7,0.5,4,0,6,3,38,41
p_78,12,0,e_3,455,512,564,21.0,6,6,3.0,4,2,4,57,52,109
p_84,12,0,e_3,504,512,564,9.0,7,1,5.0,5,1,6,8,52,60
p_85,14,0,e_3,517,520,564,7.5,7,0,6.5,5,2,5,3,44,47
p_86,14,0,e_3,518,520,564,7.0,8,0,7.0,5,2,6,2,44,46
p_88,10,0,e_1,531,561,595,25.5,7,7,5.5,5,2,5,30,34,64
p_92,10,0,e_1,540,561,595,24.0,7,7,7.0,5,2,6,21,34,55
p_93,4,0,e_1,543,581,595,29.5,7,7,7.5,3,2,6,38,14,52
p_91,14,0,e_0,539,543,599,20.0,7,7,6.5,5,0,7,4,56,60
p_95,10,0,e_0,547,565,599,22.5,7,7,7.5,5,1,7,18,34,52
p_98,6,0,e_0,555,579,599,25.5,7,7,6.5,4,1,8,24,20,44
p_83,0,12,e_1,501,595,633,21.5,7,7,0.5,5,2,4,94,38,132
p_100,10,0,e_3,557,596,658,21.0,7,7,1.0,4,2,5,39,62,101
p_109,10,0,e_3,590,596,658,14.0,9,3,4.0,5,1,8,6,62,68
p_105,12,0,e_3,582,604,658,13.0,8,2,3.0,5,1,7,22,54,76
p_110,12,0,e_3,590,604,658,12.0,9,2,4.0,5,1,8,14,54,68
p_102,14,0,e_3,568,612,658,13.5,7,0,0.5,5,1,6,44,46,90
p_103,14,0,e_3,577,612,658,12.0,8,0,2.0,5,1,7,35,46,81
p_104,14,0,e_3,581,612,658,11.5,8,0,2.5,5,1,7,31,46,77
p_111,2,0,e_3,607,650,658,19.5,8,4,6.5,5,2,6,43,8,51
p_117,0,2,e_3,636,658,666,3.5,8,0,3.5,4,2,6,22,8,30
p_119,8,0,e_1,650,667,693,23.0,8,8,7.0,4,2,5,17,26,43
p_125,2,0,e_0,668,687,695,23.0,7,6,4.0,4,0,8,19,8,27
p_123,0,2,e_1,661,693,701,25.5,8,8,5.0,4,2,6,32,8,40
p_118,8,0,e_3,649,686,758,23.0,7,7,1.0,1,2,5,37,72,109
p_132,4,0,e_3,730,744,758,0.0,8,0,4.5,4,2,6,14,14,28
p_134,14,0,e_1,734,739,791,19.5,9,9,6.5,5,2,6,5,52,57
p_133,6,0,e_0,734,771,791,27.5,9,9,6.5,5,0,8,37,20,57
p_141,12,0,e_3,770,796,858,16.0,9,3,2.0,5,2,7,26,62,88
p_136,14,0,e_3,749,804,858,17.5,8,8,1.5,4,2,6,55,54,109
p_144,6,0,e_3,815,838,858,0.0,9,0,6.5,4,3,6,23,20,43
p_152,2,0,e_1,868,879,887,26.5,10,9,2.5,4,2,6,11,8,19
p_146,10,0,e_0,846,855,887,22.0,9,9,6.5,4,1,7,9,32,41
p_149,6,0,e_3,859,878,956,24.0,8,5,0.0,5,2,6,19,78,97
p_153,6,0,e_3,872,878,956,22.0,10,6,2.0,5,2,8,6,78,84
p_151,12,0,e_3,863,898,956,17.5,9,2,0.5,5,2,7,35,58,93
p_156,12,0,e_3,884,898,956,14.0,10,2,4.0,5,3,7,14,58,72
p_159,8,0,e_0,893,913,983,17.0,10,5,0.5,5,1,7,20,70,90
p_154,4,0,e_1,874,901,983,23.5,10,8,2.0,4,2,7,27,82,109
p_3,4,0,e_2,25,40,54,4.0,0,0,0.0,3,0,0,15,14,29
p_7,2,0,e_2,55,64,72,13.0,2,2,0.0,3,0,0,9,8,17
p_11,4,0,e_1,84,101,115,3.0,3,1,4.5,4,0,2,17,14,31
p_12,0,8,e_0,86,107,133,7.0,3,0,3.5,4,0,1,21,26,47
p_9,10,0,e_3,67,99,133,5.0,2,0,5.0,5,0,2,32,34,66
p_16,4,0,e_3,101,119,133,1.0,3,0,5.0,4,1,2,18,14,32
p_13,8,0,e_2,87,104,174,24.0,3,3,1.0,5,0,1,17,70,87
p_21,0,10,e_2,142,174,206,17.0,3,3,5.5,4,1,3,32,32,64
p_17,10,0,e_0,112,141,209,23.0,4,4,0.5,5,1,1,29,68,97
p_24,14,0,e_0,157,163,209,10.0,3,0,7.5,5,1,2,6,46,52
p_22,6,0,e_0,146,189,209,10.0,3,2,5.5,5,1,1,43,20,63
p_26,6,0,e_1,169,191,211,6.0,3,2,6.5,4,0,2,22,20,42
p_30,2,0,e_3,200,221,229,2.0,3,0,4.5,4,1,2,21,8,29
p_32,0,10,e_1,209,211,243,3.0,4,0,0.5,4,1,3,2,32,34
p_29,14,0,e_2,192,220,264,17.0,3,3,3.0,5,1,3,28,44,72
p_35,0,6,e_2,222,264,284,1.0,5,0,7.0,4,1,3,42,20,62
p_38,12,0,e_3,240,267,305,10.5,4,0,1.5,5,1,3,27,38,65
p_43,4,0,e_0,270,291,305,2.0,5,1,5.5,4,0,5,21,14,35
p_42,4,0,e_1,269,295,309,2.0,5,1,6.5,4,0,4,26,14,40
p_44,4,0,e_1,275,295,309,1.0,5,0,5.0,4,0,5,20,14,34
p_46,8,0,e_2,291,292,366,24.5,5,5,4.0,5,0,5,1,74,75
p_55,14,0,e_2,314,320,366,12.5,6,0,7.5,5,1,5,6,46,52
p_60,2,0,e_2,338,358,366,21.0,6,3,4.5,4,1,5,20,8,28
p_58,0,6,e_2,330,366,386,24.0,7,7,5.5,4,1,5,36,20,56
p_56,8,0,e_3,324,331,397,17.0,6,2,3.0,5,1,5,7,66,73
p_61,12,0,e_3,341,345,397,10.5,6,1,5.5,5,2,4,4,52,56
p_52,14,0,e_3,312,353,397,13.0,5,0,1.0,5,1,4,41,44,85
p_53,8,0,e_1,313,335,407,19.0,6,2,0.5,5,0,4,22,72,94
p_68,2,0,e_1,389,399,407,29.0,6,6,2.5,4,1,4,10,8,18
p_69,2,0,e_1,391,399,407,29.0,6,6,2.5,4,1,5,8,8,16
p_51,0,4,e_3,309,397,411,17.5,4,4,0.5,5,1,3,88,14,102
p_67,12,0,e_2,377,406,464,21.0,6,6,1.5,5,1,5,29,58,87
p_72,6,0,e_3,417,419,465,9.5,5,2,2.5,5,1,4,2,46,48
p_74,10,0,e_3,424,433,465,6.5,6,0,3.5,5,2,4,9,32,41
p_78,12,0,e_0,455,457,495,19.5,6,6,6.0,4,1,4,2,38,40
p_76,10,0,e_1,440,471,505,24.0,6,6,5.0,5,1,3,31,34,65
p_77,4,0,e_1,455,491,505,27.5,6,6,7.5,4,1,4,36,14,50
p_82,0,12,e_1,494,505,543,13.5,5,5,1.5,4,2,4,11,38,49
p_83,0,12,e_1,501,505,543,12.5,5,5,0.5,4,2,4,4,38,42
p_84,12,0,e_3,504,523,561,5.5,5,0,6.5,5,1,4,19,38,57
p_85,14,0,e_0,517,539,597,22.0,6,6,3.5,5,1,4,22,58,80
p_86,14,0,e_0,518,539,597,21.5,6,6,3.5,5,1,5,21,58,79
p_91,14,0,e_0,539,539,597,19.5,6,6,7.0,2,1,5,0,58,58
p_88,10,0,e_0,531,563,597,25.0,6,6,6.0,5,1,5,32,34,66
p_93,4,0,e_0,543,583,597,29.0,6,6,7.0,5,2,5,40,14,54
p_92,10,0,e_1,540,571,605,23.5,6,6,5.5,5,2,4,31,34,65
p_95,10,0,e_1,547,571,605,22.0,6,6,6.5,5,1,6,24,34,58
p_98,6,0,e_1,555,585,605,25.0,6,6,7.5,4,1,6,30,20,50
p_102,14,0,e_2,568,602,648,13.0,6,0,1.5,5,0,6,34,46,80
p_104,14,0,e_2,581,602,648,11.0,7,0,3.5,5,0,7,21,46,67
p_111,2,0,e_2,607,640,648,19.5,7,3,6.5,4,1,7,33,8,41
p_100,10,0,e_3,557,593,653,20.5,6,6,0.5,4,2,4,36,60,96
p_109,10,0,e_3,590,593,653,13.5,8,2,4.5,5,1,7,3,60,63
p_105,12,0,e_3,582,601,653,13.0,7,1,3.0,5,1,6,19,52,71
p_110,12,0,e_3,590,601,653,11.5,8,1,4.5,5,1,7,11,52,63
p_103,14,0,e_3,577,609,653,11.5,6,0,2.5,5,1,5,32,44,76
p_117,0,2,e_3,636,653,661,2.5,6,0,2.5,4,2,4,17,8,25
p_125,2,0,e_0,668,685,693,22.0,6,5,3.5,4,1,6,17,8,25
p_123,0,2,e_0,661,693,701,25.0,6,6,5.0,4,1,5,32,8,40
p_118,8,0,e_1,649,675,701,22.5,6,6,7.0,5,1,5,26,26,52
p_119,8,0,e_1,650,675,701,22.5,6,6,7.5,5,1,6,25,26,51
p_134,14,0,e_0,734,739,791,18.5,7,7,6.5,5,1,5,5,52,57
p_133,6,0,e_1,734,777,799,26.5,7,7,5.5,5,1,6,43,22,65
p_132,4,0,e_1,730,785,799,29.0,7,7,4.5,5,1,5,55,14,69
p_141,12,0,e_2,770,780,832,14.5,8,2,4.5,5,0,8,10,52,62
p_136,14,0,e_2,749,788,832,16.0,7,1,1.0,5,0,7,39,44,83
p_138,12,0,e_3,756,787,845,17.0,7,2,1.0,5,2,5,31,58,89
p_152,2,0,e_0,868,879,887,24.5,8,5,2.5,4,1,6,11,8,19
p_144,6,0,e_1,815,819,897,29.0,8,8,2.5,5,1,5,4,78,82
p_147,6,0,e_1,849,877,897,23.5,7,4,7.5,4,2,5,28,20,48
p_146,10,0,e_2,846,864,934,20.0,7,2,2.0,5,0,7,18,70,88
p_151,12,0,e_2,863,872,934,15.5,8,2,5.0,5,0,8,9,62,71
p_153,6,0,e_2,872,912,934,20.0,8,4,6.0,5,1,7,40,22,62
p_154,4,0,e_2,874,920,934,21.5,8,5,6.0,5,1,8,46,14,60
p_149,6,0,e_3,859,865,943,22.0,7,4,2.0,5,2,5,6,78,84
p_156,12,0,e_3,884,905,943,12.0,9,2,6.0,5,3,6,21,38,59
p_159,8,0,e_0,893,913,983,14.5,10,5,0.5,5,1,6,20,70,90
p_3,4,0,e_2,25,40,54,4.0,0,0,0.0,3,0,0,15,14,29
p_11,4,0,e_1,84,101,115,3.0,3,1,4.5,4,0,2,17,14,31
p_9,10,0,e_3,67,98,132,5.0,2,0,5.0,5,0,2,31,34,65
p_16,4,0,e_3,101,118,132,1.0,3,0,5.0,4,1,2,17,14,31
p_12,0,8,e_0,86,108,134,7.0,3,0,3.5,4,0,2,22,26,48
p_17,10,0,e_0,112,142,206,23.0,4,4,0.5,5,1,3,30,64,94
p_22,6,0,e_1,146,191,211,10.0,4,2,5.0,5,0,3,45,20,65
p_26,6,0,e_1,169,191,211,16.0,5,3,6.5,4,0,4,22,20,42
p_24,14,0,e_3,157,176,222,10.0,4,0,4.0,5,1,3,19,46,65
p_30,2,0,e_3,200,214,222,1.0,4,0,3.5,4,2,2,14,8,22
p_32,0,10,e_1,209,211,243,2.0,5,0,0.5,4,1,4,2,32,34
p_35,0,6,e_3,222,222,244,0.0,3,3,0.0,3,2,2,0,22,22
p_21,0,10,e_3,142,222,258,16.5,3,3,1.5,5,1,2,80,36,116
p_43,4,0,e_0,270,288,302,15.0,5,2,5.0,4,0,6,18,14,32
p_38,12,0,e_1,240,251,311,9.5,6,0,4.5,5,1,4,11,60,71
p_42,4,0,e_1,269,297,311,15.5,5,3,6.5,4,1,4,28,14,42
p_44,4,0,e_3,275,310,324,3.0,5,1,7.5,4,1,4,35,14,49
p_51,0,4,e_1,309,311,325,2.0,6,0,0.0,4,1,5,2,14,16
p_52,14,0,e_0,312,346,390,18.0,7,7,1.5,5,0,6,34,44,78
p_46,8,0,e_1,291,339,413,26.0,6,6,3.0,4,1,5,48,74,122
p_53,8,0,e_1,313,339,413,24.0,7,7,0.0,5,1,5,26,74,100
p_56,8,0,e_1,324,339,413,8.0,6,6,2.0,3,1,6,15,74,89
p_55,14,0,e_1,314,359,413,17.5,7,7,0.0,5,1,5,45,54,99
p_60,2,0,e_1,338,405,413,22.0,7,5,4.0,2,0,5,67,8,75
p_68,2,0,e_1,389,405,413,3.0,7,1,3.5,4,1,6,16,8,24
p_69,2,0,e_1,391,405,413,2.0,7,1,3.5,4,1,6,14,8,22
p_61,12,0,e_3,341,362,420,11.5,7,1,2.5,5,1,6,21,58,79
p_58,0,6,e_3,330,420,440,25.0,6,6,1.0,5,1,5,90,20,110
p_77,4,0,e_0,455,472,486,17.0,7,3,5.0,4,0,7,17,14,31
p_72,6,0,e_1,417,433,513,24.5,7,7,0.5,5,2,3,16,80,96
p_67,12,0,e_1,377,453,513,25.0,7,7,5.5,4,1,5,76,60,136
p_78,12,0,e_1,455,475,513,9.0,7,1,6.0,5,3,2,20,38,58
p_74,10,0,e_3,424,454,518,15.5,7,1,0.5,5,2,5,30,64,94
p_76,10,0,e_3,440,454,518,13.0,7,1,3.0,2,2,6,14,64,78
p_82,0,12,e_1,494,513,551,4.0,7,0,3.0,4,3,3,19,38,57
p_83,0,12,e_1,501,513,551,3.0,7,0,2.0,4,3,3,12,38,50
p_84,12,0,e_0,504,524,584,20.0,7,7,3.0,5,0,7,20,60,80
p_93,4,0,e_0,543,570,584,20.0,8,6,6.5,4,1,7,27,14,41
p_88,10,0,e_3,531,550,610,16.0,7,2,2.0,5,1,6,19,60,79
p_92,10,0,e_3,540,550,610,14.5,8,2,3.5,5,1,7,10,60,70
p_95,10,0,e_3,547,550,610,13.5,8,2,4.5,5,1,7,3,60,63
p_86,14,0,e_3,518,564,610,14.0,6,0,0.0,5,1,5,46,46,92
p_100,10,0,e_3,557,578,610,12.0,8,2,6.0,5,2,6,21,32,53
p_85,14,0,e_1,517,559,613,16.0,7,7,0.5,5,3,3,42,54,96
p_91,14,0,e_1,539,559,613,10.5,8,0,4.0,5,3,4,20,54,74
p_98,6,0,e_1,555,593,613,16.5,8,4,6.5,5,2,5,38,20,58
p_109,10,0,e_0,590,616,682,23.0,7,7,1.0,5,0,8,26,66,92
p_110,12,0,e_0,590,624,682,21.5,7,7,1.0,5,0,7,34,58,92
p_117,0,2,e_0,636,682,690,22.5,7,7,7.5,4,1,7,46,8,54
p_111,2,0,e_3,607,618,708,28.5,7,7,0.5,4,2,5,11,90,101
p_118,8,0,e_3,649,682,708,12.0,7,2,6.0,5,2,5,33,26,59
p_119,8,0,e_3,650,682,708,12.0,8,2,6.0,5,2,6,32,26,58
p_125,2,0,e_1,668,701,709,4.0,8,2,6.5,4,2,6,33,8,41
p_123,0,2,e_1,661,709,717,7.5,8,0,7.5,4,2,5,48,8,56
p_133,6,0,e_0,734,760,782,20.0,7,4,7.0,4,0,8,26,22,48
p_132,4,0,e_0,730,768,782,22.5,7,5,7.5,5,0,7,38,14,52
p_134,14,0,e_3,734,752,806,12.0,7,1,4.0,5,2,5,18,54,72
p_138,12,0,e_3,756,768,806,10.5,8,2,7.5,5,3,5,12,38,50
p_136,14,0,e_1,749,755,807,9.5,8,1,6.0,5,2,5,6,52,58
p_146,10,0,e_1,846,871,905,14.0,8,2,6.5,5,2,5,25,34,59
p_149,6,0,e_1,859,885,905,1.0,9,0,7.0,4,2,6,26,20,46
p_144,6,0,e_3,815,826,908,23.0,7,4,1.0,5,2,5,11,82,93
p_147,6,0,e_3,849,884,908,17.5,8,4,6.5,5,3,5,35,24,59
p_154,4,0,e_3,874,892,908,0.0,10,0,4.5,4,3,7,18,16,34
p_152,2,0,e_3,868,900,908,3.0,9,1,5.5,4,3,6,32,8,40
p_159,8,0,e_0,893,902,974,24.0,9,9,2.5,5,1,8,9,72,81
p_151,12,0,e_0,863,916,974,24.5,9,9,2.0,4,1,7,53,58,111
p_156,12,0,e_0,884,916,974,21.0,10,10,1.0,5,1,8,32,58,90
p_7,2,0,e_3,55,64,72,2.0,0,0,0.0,3,0,0,9,8,17
p_11,4,0,e_1,84,102,116,13.5,1,1,5.0,4,0,2,18,14,32
p_3,4,0,e_2,25,40,124,4.0,0,0,0.0,3,0,0,15,84,99
p_9,10,0,e_2,67,92,124,21.0,1,1,6.5,5,1,2,25,32,57
p_12,0,8,e_1,86,116,142,17.0,1,1,4.5,4,0,3,30,26,56
p_13,8,0,e_3,87,104,178,17.0,2,2,1.0,5,0,2,17,74,91
p_17,10,0,e_3,112,144,178,11.0,5,1,5.0,5,1,4,32,34,66
p_16,4,0,e_3,101,164,178,18.5,4,4,3.5,5,0,4,63,14,77
p_21,0,10,e_3,142,178,210,5.0,8,0,5.0,4,1,7,36,32,68
p_26,6,0,e_1,169,194,214,25.5,6,6,7.0,4,0,2,25,20,45
p_24,14,0,e_2,157,168,214,19.0,7,7,5.5,5,0,4,11,46,57
p_22,6,0,e_2,146,194,214,29.0,7,7,3.5,5,0,3,48,20,68
p_32,0,10,e_2,209,214,246,25.0,9,9,1.0,4,1,2,5,32,37
p_29,14,0,e_3,192,224,278,14.0,7,1,2.0,5,1,6,32,54,86
p_30,2,0,e_3,200,270,278,24.5,8,7,3.5,5,1,7,70,8,78
p_42,4,0,e_1,269,296,310,27.0,7,7,6.5,4,0,3,27,14,41
p_43,4,0,e_1,270,296,310,27.0,7,7,6.0,4,0,4,26,14,40
p_44,4,0,e_1,275,296,310,26.5,7,7,5.5,4,0,4,21,14,35
p_38,12,0,e_2,240,254,312,24.0,8,8,4.0,5,2,5,14,58,72
p_51,0,4,e_2,309,312,326,25.5,8,8,0.5,4,2,5,3,14,17
p_35,0,6,e_2,222,312,334,23.0,8,8,1.0,5,2,4,90,22,112
p_46,8,0,e_3,291,304,380,20.0,7,4,2.0,5,0,7,13,76,89
p_52,14,0,e_3,312,324,380,11.0,8,1,5.0,5,1,7,12,56,68
p_55,14,0,e_3,314,324,380,10.5,9,1,5.5,5,1,8,10,56,66
p_56,8,0,e_3,324,352,380,15.0,8,4,7.0,2,1,7,28,28,56
p_60,2,0,e_3,338,372,380,4.0,9,2,6.0,4,1,8,34,8,42
p_53,8,0,e_0,313,321,391,17.0,9,5,2.5,5,0,4,8,70,78
p_58,0,6,e_3,330,380,400,7.5,9,0,7.5,4,1,8,50,20,70
p_68,2,0,e_1,389,398,406,27.0,9,8,2.5,4,0,5,9,8,17
p_61,12,0,e_2,341,354,414,23.5,10,10,4.0,5,1,5,13,60,73
p_69,2,0,e_2,391,406,414,26.5,9,8,3.5,4,2,5,15,8,23
p_74,10,0,e_3,424,446,478,13.0,8,3,7.0,5,2,6,22,32,54
p_72,6,0,e_0,417,467,489,18.5,8,5,4.0,5,0,6,50,22,72
p_77,4,0,e_0,455,475,489,29.5,9,9,5.0,4,0,7,20,14,34
p_67,12,0,e_1,377,444,504,18.5,9,9,4.5,4,0,4,67,60,127
p_78,12,0,e_1,455,466,504,21.5,9,9,7.5,3,1,4,11,38,49
p_76,10,0,e_2,440,446,510,25.0,9,9,4.0,5,1,5,6,64,70
p_82,0,12,e_1,494,504,542,27.5,8,8,1.5,4,1,5,10,38,48
p_83,0,12,e_1,501,504,542,26.5,8,8,0.5,4,1,5,3,38,41
p_84,12,0,e_3,504,516,578,14.0,8,2,4.0,5,2,6,12,62,74
p_85,14,0,e_3,517,524,578,10.0,9,1,6.0,5,3,6,7,54,61
p_86,14,0,e_3,518,524,578,10.0,10,1,6.0,5,3,7,6,54,60
p_93,4,0,e_3,543,564,578,1.0,9,0,5.5,4,3,6,21,14,35
p_88,10,0,e_2,531,542,600,27.5,9,9,3.5,5,1,5,11,58,69
p_92,10,0,e_2,540,542,600,26.0,9,9,5.0,5,1,7,2,58,60
p_91,14,0,e_2,539,556,600,22.0,9,9,4.5,5,1,6,17,44,61
p_95,10,0,e_1,547,570,604,24.5,10,10,6.5,5,0,5,23,34,57
p_98,6,0,e_1,555,584,604,27.5,10,10,7.5,4,0,7,29,20,49
p_105,12,0,e_3,582,616,676,17.5,9,3,0.5,5,2,7,34,60,94
p_110,12,0,e_3,590,616,676,16.0,10,3,2.0,5,2,8,26,60,86
p_103,14,0,e_3,577,624,676,14.0,8,8,0.0,3,3,6,47,52,99
p_104,14,0,e_3,581,624,676,16.0,9,1,0.0,5,2,7,43,52,95
p_100,10,0,e_0,557,615,681,23.0,10,10,4.5,4,0,7,58,66,124
p_109,10,0,e_0,590,615,681,18.5,10,5,1.0,5,0,9,25,66,91
p_102,14,0,e_0,568,629,681,17.5,9,9,2.5,4,0,8,61,52,113
p_117,0,2,e_3,636,676,684,6.5,9,0,6.5,4,3,6,40,8,48
p_123,0,2,e_3,661,676,684,2.5,9,0,2.5,4,3,6,15,8,23
p_111,2,0,e_2,607,608,698,23.5,10,8,1.0,5,1,5,1,90,91
p_125,2,0,e_2,668,690,698,29.0,9,9,4.5,4,2,5,22,8,30
p_118,8,0,e_1,649,674,700,26.5,9,9,7.0,5,0,6,25,26,51
p_119,8,0,e_1,650,674,700,26.0,9,9,7.5,5,0,7,24,26,50
p_133,6,0,e_0,734,757,779,0.0,8,0,6.5,4,0,8,23,22,45
p_132,4,0,e_0,730,765,779,3.0,8,1,7.5,4,0,7,35,14,49
p_134,14,0,e_2,734,742,786,21.5,8,8,5.5,5,1,6,8,44,52
p_138,12,0,e_3,756,810,870,19.5,9,9,2.5,4,2,7,54,60,114
p_136,14,0,e_3,749,818,870,19.0,8,8,4.0,4,2,6,69,52,121
p_144,6,0,e_0,815,855,875,17.5,10,6,5.5,5,0,7,40,20,60
p_146,10,0,e_2,846,850,884,24.0,9,9,5.5,4,2,5,4,34,38
p_152,2,0,e_2,868,876,884,28.5,10,10,2.5,4,3,6,8,8,16
p_141,12,0,e_1,770,832,892,18.0,11,11,4.0,4,0,6,62,60,122
p_147,6,0,e_1,849,872,892,27.5,9,9,6.5,4,1,6,23,20,43
p_154,4,0,e_3,874,884,970,25.5,10,8,0.5,5,2,8,10,86,96
p_153,6,0,e_3,872,892,970,24.0,9,6,0.0,5,2,7,20,78,98
p_151,12,0,e_3,863,912,970,19.0,9,9,1.0,4,3,6,49,58,107
p_149,6,0,e_0,859,895,973,26.0,9,9,2.5,4,1,7,36,78,114
p_156,12,0,e_0,884,915,973,16.0,11,2,1.5,5,0,9,31,58,89
p_159,8,0,e_1,893,918,988,19.0,10,5,0.0,5,0,6,25,70,95
p_7,2,0,e_3,55,63,71,2.0,0,0,0.0,3,0,0,8,8,16
p_9,10,0,e_1,67,84,118,20.5,1,1,7.5,3,0,2,17,34,51
p_11,4,0,e_1,84,104,118,13.0,1,1,5.0,4,1,2,20,14,34
p_3,4,0,e_2,25,39,121,4.0,0,0,0.0,3,0,0,14,82,96
p_12,0,8,e_1,86,118,144,17.0,1,1,5.0,4,1,3,32,26,58
p_13,8,0,e_3,87,104,178,16.5,2,2,1.5,5,0,2,17,74,91
p_17,10,0,e_3,112,144,178,11.0,5,1,5.0,5,1,4,32,34,66
p_16,4,0,e_3,101,164,178,18.5,4,4,3.5,5,0,4,63,14,77
p_21,0,10,e_3,142,178,210,5.5,7,0,5.5,4,1,6,36,32,68
p_24,14,0,e_2,157,165,211,19.0,7,7,5.5,5,0,4,8,46,54
p_22,6,0,e_2,146,191,211,29.0,7,7,4.0,5,0,3,45,20,65
p_26,6,0,e_2,169,191,211,25.5,6,6,6.5,4,1,3,22,20,42
p_30,2,0,e_1,200,208,216,24.5,7,6,2.5,4,0,4,8,8,16
p_32,0,10,e_2,209,211,243,25.0,6,6,0.5,4,1,2,2,32,34
p_29,14,0,e_3,192,224,276,14.0,6,1,2.0,5,1,5,32,52,84
p_42,4,0,e_0,269,284,298,27.0,6,6,4.5,4,0,2,15,14,29
p_43,4,0,e_0,270,284,298,27.0,6,6,4.5,4,0,3,14,14,28
p_38,12,0,e_2,240,251,311,24.0,6,6,4.5,5,2,5,11,60,71
p_44,4,0,e_2,275,297,311,26.0,6,6,5.5,4,2,5,22,14,36
p_51,0,4,e_2,309,311,325,25.0,7,7,0.5,4,2,5,2,14,16
p_35,0,6,e_2,222,311,333,23.5,6,6,1.5,5,2,4,89,22,111
p_46,8,0,e_3,291,302,376,20.0,6,4,2.0,5,0,6,11,74,85
p_52,14,0,e_3,312,322,376,10.5,7,1,5.5,5,1,6,10,54,64
p_55,14,0,e_3,314,322,376,10.5,9,1,5.5,5,1,8,8,54,62
p_60,2,0,e_3,338,368,376,4.0,9,2,6.0,4,1,8,30,8,38
p_53,8,0,e_0,313,324,394,16.5,8,5,2.0,5,0,3,11,70,81
p_58,0,6,e_3,330,376,396,7.5,9,0,7.5,4,1,8,46,20,66
p_68,2,0,e_1,389,398,406,26.0,9,8,2.5,4,0,5,9,8,17
p_56,8,0,e_2,324,341,415,15.0,8,4,2.0,3,3,5,17,74,91
p_61,12,0,e_2,341,355,415,23.5,10,10,4.0,5,2,5,14,60,74
p_69,2,0,e_2,391,407,415,26.0,9,8,3.5,4,2,5,16,8,24
p_74,10,0,e_3,424,442,476,12.5,9,3,7.5,5,2,7,18,34,52
p_72,6,0,e_3,417,456,476,17.5,8,5,6.5,5,2,6,39,20,59
p_76,10,0,e_0,440,458,492,24.5,10,10,7.5,3,0,4,18,34,52
p_77,4,0,e_0,455,478,492,29.0,9,9,5.5,4,0,5,23,14,37
p_67,12,0,e_1,377,444,504,18.0,9,2,4.5,4,0,4,67,60,127
p_78,12,0,e_1,455,466,504,21.0,10,10,7.5,3,1,4,11,38,49
p_82,0,12,e_1,494,504,542,27.5,8,8,1.5,4,1,5,10,38,48
p_83,0,12,e_1,501,504,542,26.0,8,8,0.5,4,1,5,3,38,41
p_85,14,0,e_3,517,520,574,9.5,8,1,6.5,5,2,6,3,54,57
p_86,14,0,e_3,518,520,574,9.5,9,1,6.5,5,2,7,2,54,56
p_93,4,0,e_3,543,560,574,0.0,9,0,4.5,4,3,6,17,14,31
p_91,14,0,e_0,539,544,588,21.5,9,9,7.5,3,0,4,5,44,49
p_84,12,0,e_1,504,542,602,13.5,8,2,0.0,3,1,5,38,60,98
p_98,6,0,e_1,555,582,602,26.5,10,10,7.5,4,1,5,27,20,47
p_88,10,0,e_2,531,541,607,27.0,9,9,3.5,5,1,5,10,66,76
p_92,10,0,e_2,540,541,607,25.5,9,9,5.0,5,1,6,1,66,67
p_95,10,0,e_2,547,575,607,24.0,10,10,6.0,5,2,5,28,32,60
p_100,10,0,e_2,557,575,607,22.5,10,10,7.5,3,2,6,18,32,50
p_105,12,0,e_3,582,612,672,17.0,9,3,1.0,5,2,7,30,60,90
p_110,12,0,e_3,590,612,672,15.5,10,3,2.5,5,2,8,22,60,82
p_102,14,0,e_3,568,620,672,17.0,9,9,1.0,4,3,6,52,52,104
p_103,14,0,e_3,577,620,672,16.0,9,1,0.0,5,2,7,43,52,95
p_104,14,0,e_3,581,620,672,15.0,9,1,1.0,5,2,7,39,52,91
p_117,0,2,e_3,636,672,680,6.0,9,0,6.0,4,3,6,36,8,44
p_123,0,2,e_3,661,672,680,1.5,9,0,1.5,4,3,6,11,8,19
p_109,10,0,e_0,590,620,686,17.5,10,5,0.0,5,0,6,30,66,96
p_125,2,0,e_0,668,678,686,28.5,9,9,2.5,4,1,6,10,8,18
p_111,2,0,e_2,607,615,705,23.0,10,7,0.0,3,2,6,8,90,98
p_118,8,0,e_2,649,679,705,25.5,9,9,6.5,5,2,6,30,26,56
p_119,8,0,e_2,650,679,705,25.5,9,9,6.5,5,2,7,29,26,55
p_132,4,0,e_3,730,756,770,2.0,8,1,6.0,4,2,6,26,14,40
p_133,6,0,e_0,734,762,782,28.5,9,9,7.5,4,0,6,28,20,48
p_134,14,0,e_1,734,740,792,20.5,9,9,6.0,5,0,5,6,52,58
p_136,14,0,e_2,749,751,803,18.0,9,9,6.5,5,2,6,2,52,54
p_141,12,0,e_3,770,808,868,12.0,8,8,0.0,3,3,6,38,60,98
p_144,6,0,e_3,815,848,868,17.0,9,4,7.0,5,3,6,33,20,53
p_138,12,0,e_0,756,820,878,20.0,9,9,4.0,4,0,7,64,58,122
p_152,2,0,e_1,868,880,888,28.0,8,7,3.0,4,0,7,12,8,20
p_146,10,0,e_2,846,867,901,23.0,10,10,7.0,5,2,6,21,34,55
p_147,6,0,e_2,849,881,901,27.0,9,9,7.5,5,2,7,32,20,52
p_149,6,0,e_2,859,881,901,25.5,9,9,6.5,4,2,8,22,20,42
p_154,4,0,e_3,874,882,968,25.5,9,7,0.5,5,2,7,8,86,94
p_153,6,0,e_3,872,890,968,23.5,8,5,0.5,5,2,6,18,78,96
p_159,8,0,e_3,893,898,968,19.0,9,4,3.0,5,3,6,5,70,75
p_156,12,0,e_0,884,916,974,16.0,10,2,0.5,5,0,6,32,58,90
p_151,12,0,e_1,863,926,984,19.0,9,9,4.0,4,0,6,63,58,121
p_3,4,0,e_2,25,39,53,4.0,0,0,0.0,3,0,0,14,14,28
p_7,2,0,e_2,55,63,71,13.0,2,2,0.0,3,0,0,8,8,16
p_11,4,0,e_1,84,101,115,3.0,3,1,5.0,4,0,3,17,14,31
p_9,10,0,e_3,67,99,133,5.0,2,0,5.0,5,0,2,32,34,66
p_16,4,0,e_3,101,119,133,1.0,3,0,5.0,4,1,2,18,14,32
p_12,0,8,e_3,86,133,161,7.0,3,0,7.0,4,0,3,47,28,75
p_13,8,0,e_2,87,103,173,29.0,4,4,1.5,5,0,2,16,70,86
p_17,10,0,e_0,112,140,204,23.0,4,4,0.5,5,0,1,28,64,92
p_21,0,10,e_2,142,173,205,17.0,4,4,5.0,4,1,4,31,32,63
p_24,14,0,e_1,157,159,213,10.5,5,0,6.5,5,0,3,2,54,56
p_26,6,0,e_1,169,193,213,7.0,4,2,7.0,4,1,3,24,20,44
p_22,6,0,e_3,146,153,233,10.0,4,3,2.0,5,2,2,7,80,87
p_30,2,0,e_3,200,225,233,3.0,4,0,5.0,4,2,2,25,8,33
p_32,0,10,e_1,209,213,245,3.5,5,0,0.5,4,1,3,4,32,36
p_35,0,6,e_3,222,233,253,1.5,5,0,1.5,4,2,3,11,20,31
p_29,14,0,e_2,192,219,263,22.5,4,4,3.0,5,1,4,27,44,71
p_42,4,0,e_0,269,286,300,14.5,4,3,5.0,4,0,3,17,14,31
p_43,4,0,e_0,270,286,300,14.5,4,3,4.5,4,0,4,16,14,30
p_38,12,0,e_3,240,273,311,11.0,4,0,1.0,5,2,2,33,38,71
p_44,4,0,e_1,275,297,311,2.0,4,1,5.5,4,0,4,22,14,36
p_51,0,4,e_3,309,311,325,0.0,4,0,0.0,4,2,2,2,14,16
p_46,8,0,e_2,291,333,361,25.0,4,4,4.5,5,0,6,42,28,70
p_60,2,0,e_2,338,353,361,22.0,5,5,3.5,4,1,6,15,8,23
p_58,0,6,e_2,330,361,381,25.5,5,5,4.5,4,0,7,31,20,51
p_53,8,0,e_0,313,326,396,20.0,5,2,2.0,5,0,4,13,70,83
p_56,8,0,e_3,324,339,405,6.0,4,4,2.0,3,2,3,15,66,81
p_52,14,0,e_3,312,359,405,14.0,4,0,0.0,5,2,2,47,46,93
p_55,14,0,e_3,314,359,405,13.5,5,0,0.5,5,2,3,45,46,91
p_68,2,0,e_3,389,397,405,0.0,5,0,2.5,4,2,3,8,8,16
p_61,12,0,e_1,341,349,409,12.0,5,1,5.0,5,0,4,8,60,68
p_69,2,0,e_1,391,401,409,30.0,6,6,2.5,4,1,4,10,8,18
p_67,12,0,e_2,377,401,459,22.0,5,5,2.5,5,1,6,24,58,82
p_72,6,0,e_3,417,425,471,10.5,4,2,1.5,5,1,3,8,46,54
p_74,10,0,e_3,424,439,471,7.0,4,0,3.0,2,1,3,15,32,47
p_77,4,0,e_0,455,478,492,28.5,5,5,5.5,4,2,3,23,14,37
p_78,12,0,e_1,455,467,507,20.5,5,5,7.5,5,0,5,12,40,52
p_76,10,0,e_1,440,475,507,25.0,5,5,5.0,5,0,4,35,32,67
p_82,0,12,e_1,494,507,545,22.5,5,5,2.0,4,1,4,13,38,51
p_83,0,12,e_1,501,507,545,21.0,5,5,1.0,4,1,4,6,38,44
p_84,12,0,e_3,504,509,571,9.0,5,1,5.0,5,1,4,5,62,67
p_85,14,0,e_3,517,525,571,7.0,6,0,7.0,5,2,4,8,46,54
p_86,14,0,e_3,518,525,571,7.0,7,0,7.0,5,2,5,7,46,53
p_93,4,0,e_3,543,557,571,0.0,6,0,4.5,4,2,4,14,14,28
p_88,10,0,e_0,531,556,588,26.0,6,6,6.5,5,2,3,25,32,57
p_91,14,0,e_1,539,553,609,21.0,6,6,5.0,5,1,4,14,56,70
p_92,10,0,e_1,540,575,609,24.5,6,6,5.5,5,1,5,35,34,69
p_95,10,0,e_1,547,575,609,23.5,7,7,6.0,5,0,6,28,34,62
p_100,10,0,e_1,557,575,609,22.0,6,6,7.5,3,1,7,18,34,52
p_98,6,0,e_1,555,589,609,26.5,7,7,7.0,5,1,6,34,20,54
p_102,14,0,e_2,568,597,643,16.5,6,6,2.5,5,0,7,29,46,75
p_111,2,0,e_2,607,635,643,20.5,7,5,5.5,4,1,7,28,8,36
p_105,12,0,e_3,582,609,661,14.5,6,2,1.5,5,1,5,27,52,79
p_110,12,0,e_3,590,609,661,13.0,7,2,3.0,5,1,6,19,52,71
p_103,14,0,e_3,577,617,661,13.5,5,0,0.5,5,1,4,40,44,84
p_104,14,0,e_3,581,617,661,12.5,6,0,1.5,5,1,5,36,44,80
p_117,0,2,e_3,636,661,669,4.0,7,0,4.0,4,2,5,25,8,33
p_109,10,0,e_0,590,620,686,15.0,7,3,0.0,5,2,3,30,66,96
p_125,2,0,e_0,668,678,686,23.0,6,6,2.5,4,3,4,10,8,18
p_123,0,2,e_0,661,686,694,0.0,6,6,4.0,4,3,4,25,8,33
p_118,8,0,e_1,649,679,705,24.0,7,7,6.5,5,0,6,30,26,56
p_119,8,0,e_1,650,679,705,23.5,7,7,6.5,5,0,7,29,26,55
p_132,4,0,e_3,730,745,759,0.0,6,0,4.5,4,1,5,15,14,29
p_133,6,0,e_0,734,764,784,24.5,7,7,7.5,3,2,4,30,20,50
p_134,14,0,e_1,734,749,805,16.5,7,7,4.5,5,0,7,15,56,71
p_136,14,0,e_1,749,751,805,17.5,7,7,7.0,5,1,7,2,54,56
p_138,12,0,e_1,756,767,805,18.5,7,7,7.5,3,1,7,11,38,49
p_141,12,0,e_3,770,797,857,12.5,6,1,1.5,5,1,5,27,60,87
p_144,6,0,e_3,815,837,857,0.0,7,0,6.5,4,2,5,22,20,42
p_146,10,0,e_1,846,869,907,21.5,7,7,6.5,5,0,8,23,38,61
p_147,6,0,e_1,849,883,907,25.5,7,7,7.0,5,0,9,34,24,58
p_149,6,0,e_1,859,883,907,20.0,6,4,6.5,4,0,10,24,24,48
p_154,4,0,e_1,874,891,907,19.5,8,7,4.5,4,1,10,17,16,33
p_152,2,0,e_1,868,899,907,22.5,7,7,5.0,4,0,10,31,8,39
p_153,6,0,e_3,872,877,955,18.0,7,5,2.0,5,1,6,5,78,83
p_151,12,0,e_3,863,897,955,13.0,6,1,1.0,5,1,5,34,58,92
p_156,12,0,e_3,884,897,955,10.0,8,1,4.0,5,2,6,13,58,71
p_159,8,0,e_0,893,904,974,12.5,8,4,2.5,5,2,4,11,70,81
