p_299,3,0,e_1,7,19,30,3,0,0,0,3,0,0,12,11,23
p_296,1,0,e_3,20,26,31,1,0,0,0,3,0,0,6,5,11
p_298,4,0,e_2,10,25,47,4,0,0,0,3,0,0,15,22,37
p_295,5,0,e_2,22,30,47,5,1,0,3,5,0,1,8,17,25
p_288,1,0,e_2,49,55,98,3,2,2,0,3,0,0,6,43,49
p_285,2,0,e_2,54,60,98,7,3,2,1,2,0,1,6,38,44
p_286,3,0,e_2,51,65,98,7,3,2,0,5,0,1,14,33,47
p_282,6,0,e_2,62,76,98,7,2,1,2,5,1,1,14,22,36
p_279,2,0,e_2,76,90,98,8,1,0,6,4,1,0,14,8,22
p_275,2,0,e_2,84,90,98,5,2,0,4,4,1,2,6,8,14
p_290,4,0,e_3,43,50,106,6,1,1,2,5,0,1,7,56,63
p_291,6,0,e_3,35,58,106,6,0,0,0,3,0,0,23,48,71
p_289,7,0,e_3,47,63,106,4,2,0,3,5,0,2,16,43,59
p_283,10,0,e_3,55,74,106,5,3,0,5,5,1,2,19,32,51
p_300,8,0,e_0,4,31,111,8,0,0,0,3,0,0,27,80,107
p_297,12,0,e_0,18,45,111,12,0,0,4,5,0,1,27,66,93
p_294,13,0,e_0,23,50,111,13,1,0,6,5,0,2,27,61,88
p_293,15,0,e_0,26,58,111,16,1,1,7,5,0,3,32,53,85
p_284,14,0,e_0,55,63,111,9,4,0,14,5,1,1,8,48,56
p_281,10,0,e_0,63,77,111,3,2,0,14,4,1,0,14,34,48
p_276,5,0,e_0,82,94,111,3,2,0,9,4,1,0,12,17,29
p_292,11,0,e_1,30,66,111,11,0,0,0,3,0,0,36,45,81
p_287,12,0,e_1,51,71,111,8,3,0,6,5,0,1,20,40,60
p_280,12,0,e_1,65,71,111,5,2,0,11,2,0,1,6,40,46
p_274,4,0,e_1,84,97,111,3,2,0,8,4,1,0,13,14,27
p_269,4,0,e_1,146,161,177,6,1,0,0,3,0,0,15,16,31
p_267,1,0,e_1,153,172,177,7,1,0,2,5,0,1,19,5,24
p_277,10,0,e_3,81,138,178,28,1,1,8,4,1,0,57,40,97
p_271,11,0,e_3,127,143,178,4,1,0,7,5,0,1,16,35,51
p_273,13,0,e_2,95,139,200,20,2,2,1,4,1,1,44,61,105
p_278,15,0,e_2,80,147,200,23,1,1,5,4,1,1,67,53,120
p_272,15,0,e_2,105,147,200,15,1,1,2,5,0,2,42,53,95
p_268,10,0,e_2,150,164,200,29,1,1,14,4,1,0,14,36,50
p_262,6,0,e_2,164,178,200,28,1,1,10,4,1,1,14,22,36
p_259,6,0,e_2,174,178,200,25,1,1,7,4,1,2,4,22,26
p_264,5,0,e_2,162,183,200,30,1,1,10,4,1,1,21,17,38
p_258,5,0,e_2,175,183,200,26,1,1,7,4,1,2,8,17,25
p_254,3,0,e_2,199,211,224,11,1,1,0,3,1,0,12,13,25
p_252,2,0,e_2,212,216,224,8,1,1,3,4,1,0,4,8,12
p_270,7,0,e_0,133,157,238,6,2,2,0,3,0,0,24,81,105
p_263,12,0,e_0,163,174,238,23,1,1,9,5,1,1,11,64,75
p_261,12,0,e_0,170,174,238,20,1,1,11,5,1,2,4,64,68
p_260,13,0,e_0,171,179,238,19,1,1,11,5,1,2,8,59,67
p_266,15,0,e_0,155,187,238,22,1,1,7,5,0,1,32,51,83
p_257,12,0,e_0,179,198,238,12,0,0,13,5,1,1,19,40,59
p_255,10,0,e_0,192,206,238,10,1,0,14,4,1,1,14,32,46
p_256,8,0,e_3,191,218,246,8,0,0,0,3,0,0,27,28,55
p_251,4,0,e_3,228,232,246,1,1,0,5,4,1,0,4,14,18
p_265,12,0,e_1,157,215,275,25,1,1,3,5,0,2,58,60,118
p_253,15,0,e_1,208,226,275,10,1,0,10,5,0,1,18,49,67
p_250,7,0,e_1,236,252,275,26,1,1,12,4,1,0,16,23,39
p_249,7,0,e_1,238,252,275,25,1,1,11,4,1,1,14,23,37
p_248,7,0,e_1,246,252,275,7,0,0,9,4,1,1,6,23,29
p_244,2,0,e_3,271,280,288,2,0,0,0,3,0,0,9,8,17
p_247,12,0,e_0,248,287,329,12,0,0,0,3,0,0,39,42,81
p_246,12,0,e_0,257,287,329,12,0,0,2,5,0,1,30,42,72
p_243,8,0,e_0,285,301,329,23,1,1,12,5,0,1,16,28,44
p_238,2,0,e_0,311,321,329,23,1,1,5,4,1,0,10,8,18
p_245,9,0,e_2,269,299,330,9,0,0,0,3,0,0,30,31,61
p_233,2,0,e_2,319,322,330,20,2,2,3,4,1,0,3,8,11
p_242,4,0,e_1,287,302,400,4,0,0,0,3,0,0,15,98,113
p_236,8,0,e_1,313,316,400,16,2,1,7,5,1,2,3,84,87
p_235,8,0,e_1,314,316,400,16,2,1,8,5,1,3,2,84,86
p_228,11,0,e_1,325,327,400,10,3,1,11,5,1,4,2,73,75
p_241,13,0,e_1,300,335,400,13,0,0,4,5,0,1,35,65,100
p_224,13,0,e_1,335,337,400,4,4,0,13,5,1,3,2,63,65
p_240,14,0,e_1,301,342,400,14,0,0,4,3,0,1,41,58,99
p_234,14,0,e_1,314,342,400,12,2,0,8,5,1,3,28,58,86
p_213,12,0,e_1,347,350,400,2,3,1,13,4,1,3,3,50,53
p_219,11,0,e_1,342,355,400,5,3,2,14,4,1,2,13,45,58
p_229,9,0,e_1,323,363,400,12,3,2,10,5,1,3,40,37,77
p_227,9,0,e_1,326,363,400,11,3,2,11,2,1,4,37,37,74
p_220,9,0,e_1,342,363,400,7,3,2,14,4,1,2,21,37,58
p_232,5,0,e_1,320,377,400,17,2,1,9,5,1,2,57,23,80
p_230,5,0,e_1,323,377,400,16,3,2,10,5,1,3,54,23,77
p_237,5,0,e_3,313,323,420,19,1,1,2,5,0,1,10,97,107
p_231,10,0,e_3,320,340,420,12,2,1,4,5,0,2,20,80,100
p_226,12,0,e_3,331,348,420,7,3,1,7,5,1,2,17,72,89
p_239,13,0,e_3,305,353,420,13,0,0,0,3,0,0,48,67,115
p_223,13,0,e_3,339,353,420,3,3,0,10,2,1,2,14,67,81
p_211,14,0,e_3,348,358,420,2,4,0,12,5,1,3,10,62,72
p_208,13,0,e_3,355,363,420,2,5,1,13,5,1,4,8,57,65
p_207,12,0,e_3,355,368,420,3,4,1,13,5,1,3,13,52,65
p_203,12,0,e_3,365,368,420,1,4,0,13,4,1,3,3,52,55
p_212,9,0,e_3,348,379,420,5,3,1,12,5,1,2,31,41,72
p_198,9,0,e_3,368,379,420,3,3,0,12,4,1,2,11,41,52
p_195,9,0,e_3,376,379,420,1,5,0,10,4,1,4,3,41,44
p_197,8,0,e_3,375,384,420,2,3,1,10,4,1,2,9,36,45
p_191,7,0,e_3,382,389,420,1,4,0,8,4,1,3,7,31,38
p_196,5,0,e_3,376,397,420,5,4,2,10,4,1,3,21,23,44
p_218,9,0,e_0,343,363,432,6,3,2,3,5,0,1,20,69,89
p_225,10,0,e_0,333,368,432,8,4,2,0,3,0,0,35,64,99
p_202,13,0,e_0,365,379,432,30,4,4,9,5,1,3,14,53,67
p_201,13,0,e_0,366,379,432,29,4,4,10,5,1,4,13,53,66
p_188,8,0,e_0,390,396,432,29,3,3,10,4,1,3,6,36,42
p_189,7,0,e_0,387,401,432,30,4,4,11,4,1,2,14,31,45
p_187,7,0,e_0,391,401,432,30,3,3,9,4,1,4,10,31,41
p_206,6,0,e_0,362,406,432,7,4,2,9,2,0,2,44,26,70
p_179,6,0,e_0,397,406,432,29,3,3,8,4,1,3,9,26,35
p_176,6,0,e_0,398,406,432,29,3,3,8,4,1,4,8,26,34
p_178,5,0,e_0,398,411,432,30,3,3,8,4,1,3,13,21,34
p_171,3,0,e_0,408,419,432,29,5,5,6,4,1,2,11,13,24
p_209,2,0,e_0,354,424,432,13,4,1,6,5,0,2,70,8,78
p_222,3,0,e_2,339,351,454,13,3,2,0,3,0,0,12,103,115
p_221,4,0,e_2,341,356,454,12,3,2,0,5,0,1,15,98,113
p_214,4,0,e_2,346,356,454,10,4,1,2,5,0,3,10,98,108
p_215,6,0,e_2,346,364,454,8,4,1,2,5,0,3,18,90,108
p_217,8,0,e_2,345,372,454,7,3,2,1,5,0,2,27,82,109
p_204,8,0,e_2,364,372,454,5,4,2,6,5,1,1,8,82,90
p_194,11,0,e_2,377,383,454,28,5,5,9,5,1,1,6,71,77
p_200,12,0,e_2,367,388,454,30,3,3,7,5,1,1,21,66,87
p_193,12,0,e_2,378,388,454,27,4,4,10,5,1,2,10,66,76
p_190,14,0,e_2,382,396,454,24,5,5,11,2,1,1,14,58,72
p_183,12,0,e_2,393,404,454,24,4,4,13,5,1,1,11,50,61
p_181,11,0,e_2,395,409,454,24,4,4,14,2,1,1,14,45,59
p_173,10,0,e_2,405,414,454,23,4,4,12,4,1,2,9,40,49
p_170,10,0,e_2,408,414,454,22,5,5,11,1,1,2,6,40,46
p_177,9,0,e_2,398,419,454,26,3,3,14,4,1,2,21,35,56
p_216,1,0,e_3,346,425,514,13,3,1,12,5,1,2,79,89,168
p_185,2,0,e_3,392,430,514,4,3,1,6,4,1,2,38,84,122
p_175,2,0,e_3,399,430,514,3,3,0,5,4,1,2,31,84,115
p_174,3,0,e_3,402,435,514,1,4,0,4,4,1,3,33,79,112
p_192,5,0,e_3,380,443,514,4,4,1,9,4,1,3,63,71,134
p_184,5,0,e_3,393,443,514,1,4,0,6,4,1,3,50,71,121
p_182,5,0,e_3,394,443,514,1,4,0,6,4,1,3,49,71,120
p_160,10,0,e_3,421,460,514,10,4,0,0,5,0,4,39,54,93
p_159,11,0,e_3,424,465,514,10,4,0,1,2,0,4,41,49,90
p_157,12,0,e_3,427,470,514,11,6,0,1,5,1,5,43,44,87
p_145,12,0,e_3,451,470,514,5,5,0,7,5,1,4,19,44,63
p_129,5,0,e_3,470,493,514,7,2,0,12,4,1,1,23,21,44
p_122,5,0,e_3,477,493,514,5,3,0,10,4,1,2,16,21,37
p_119,5,0,e_3,483,493,514,3,3,0,8,4,1,2,10,21,31
p_144,4,0,e_3,451,498,514,13,4,3,7,5,1,3,47,16,63
p_205,1,0,e_1,362,405,524,12,4,2,9,1,1,2,43,119,162
p_186,1,0,e_1,391,405,524,6,3,1,2,4,1,2,14,119,133
p_199,2,0,e_1,368,410,524,10,3,1,8,4,1,3,42,114,156
p_210,4,0,e_1,353,418,524,11,4,1,11,4,1,3,65,106,171
p_163,4,0,e_1,417,418,524,27,4,4,4,3,1,4,1,106,107
p_169,11,0,e_1,410,443,524,21,4,4,2,5,1,2,33,81,114
p_164,12,0,e_1,416,448,524,19,4,4,4,5,1,4,32,76,108
p_161,13,0,e_1,418,453,524,17,5,5,4,5,1,5,35,71,106
p_180,14,0,e_1,396,458,524,21,3,3,1,4,1,2,62,66,128
p_172,14,0,e_1,405,458,524,19,4,4,1,5,1,3,53,66,119
p_165,14,0,e_1,416,458,524,17,4,4,4,5,1,5,42,66,108
p_162,14,0,e_1,417,458,524,17,4,4,4,3,1,5,41,66,107
p_158,14,0,e_1,426,458,524,13,6,0,6,5,1,5,32,66,98
p_168,15,0,e_1,412,463,524,17,4,4,2,5,1,3,51,61,112
p_151,15,0,e_1,443,463,524,10,4,0,11,5,1,4,20,61,81
p_110,1,0,e_3,501,519,550,2,1,0,3,4,1,0,18,31,49
p_102,2,0,e_3,521,524,550,5,2,1,1,5,1,1,3,26,29
p_125,4,0,e_3,474,532,550,7,3,1,11,4,1,2,58,18,76
p_118,4,0,e_3,488,532,550,2,3,1,6,4,1,2,44,18,62
p_105,4,0,e_3,515,532,550,4,2,0,0,5,0,2,17,18,35
p_90,2,0,e_3,536,540,550,1,5,0,3,4,1,4,4,10,14
p_99,1,0,e_3,522,545,550,5,3,1,2,5,1,2,23,5,28
p_155,3,0,e_0,434,446,555,18,5,4,0,3,0,0,12,109,121
p_150,3,0,e_0,444,446,555,16,4,3,3,5,0,4,2,109,111
p_154,7,0,e_0,438,460,555,13,5,3,1,5,0,1,22,95,117
p_147,7,0,e_0,450,460,555,10,4,3,4,5,1,4,10,95,105
p_153,8,0,e_0,438,465,555,12,5,3,1,5,0,2,27,90,117
p_131,9,0,e_0,467,470,555,4,3,1,8,5,1,2,3,85,88
p_130,9,0,e_0,469,470,555,13,2,0,9,2,1,2,1,85,86
p_152,10,0,e_0,439,477,555,10,5,2,1,5,0,3,38,78,116
p_146,10,0,e_0,451,477,555,7,5,2,4,5,1,4,26,78,104
p_128,10,0,e_0,471,477,555,2,3,0,9,2,1,2,6,78,84
p_124,14,0,e_0,474,491,555,27,3,3,9,5,1,3,17,64,81
p_127,15,0,e_0,473,496,555,26,3,3,9,5,1,2,23,59,82
p_115,10,0,e_0,494,513,555,25,2,2,15,5,1,2,19,42,61
p_104,7,0,e_0,516,524,555,7,2,0,9,4,1,3,8,31,39
p_98,6,0,e_0,524,529,555,4,3,0,7,4,1,3,5,26,31
p_156,1,0,e_2,428,459,584,21,7,5,7,4,1,1,31,125,156
p_136,2,0,e_2,460,464,584,12,4,2,1,5,1,2,4,120,124
p_133,4,0,e_2,463,472,584,9,4,1,2,2,1,2,9,112,121
p_166,5,0,e_2,415,477,584,26,4,4,10,4,1,2,62,107,169
p_126,6,0,e_2,473,482,584,5,3,0,4,5,1,2,9,102,111
p_167,7,0,e_2,412,487,584,25,4,4,10,4,1,2,75,97,172
p_138,7,0,e_2,456,487,584,8,5,3,0,5,0,3,31,97,128
p_135,7,0,e_2,461,487,584,7,4,2,1,5,1,3,26,97,123
p_132,7,0,e_2,463,487,584,6,4,1,2,2,1,3,24,97,121
p_113,11,0,e_2,496,501,584,23,2,2,10,5,1,2,5,83,88
p_123,12,0,e_2,474,506,584,29,3,3,4,5,1,3,32,78,110
p_117,12,0,e_2,490,506,584,24,3,3,8,5,1,1,16,78,94
p_109,14,0,e_2,506,514,584,18,3,3,12,5,1,2,8,70,78
p_112,15,0,e_2,497,519,584,19,1,1,10,5,1,3,22,65,87
p_111,15,0,e_2,501,519,584,18,3,3,11,5,1,3,18,65,83
p_107,1,0,e_1,512,529,646,29,3,3,2,4,1,7,17,117,134
p_143,2,0,e_1,451,534,646,15,4,3,13,5,1,3,83,112,195
p_116,7,0,e_1,490,551,646,29,3,3,9,4,1,5,61,95,156
p_121,9,0,e_1,480,559,646,30,3,3,11,4,1,4,79,87,166
p_120,10,0,e_1,481,564,646,29,3,3,11,4,1,5,83,82,165
p_134,12,0,e_1,462,572,646,2,4,0,15,2,1,2,110,74,184
p_140,13,0,e_1,455,577,646,4,5,0,13,5,1,3,122,69,191
p_139,13,0,e_1,456,577,646,4,5,0,14,5,1,4,121,69,190
p_137,13,0,e_1,458,577,646,3,5,0,14,5,1,3,119,69,188
p_92,13,0,e_1,533,577,646,21,5,5,2,2,1,6,44,69,113
p_91,13,0,e_1,535,577,646,20,5,5,2,5,1,6,42,69,111
p_88,14,0,e_1,538,582,646,18,6,6,3,5,1,6,44,64,108
p_75,14,0,e_1,563,582,646,10,4,0,10,2,1,4,19,64,83
p_149,15,0,e_1,444,587,646,10,4,0,11,5,1,4,143,59,202
p_142,15,0,e_1,452,587,646,7,5,0,13,2,1,3,135,59,194
p_148,3,0,e_0,447,566,651,15,4,3,3,5,1,3,119,85,204
p_106,4,0,e_0,512,571,651,26,3,3,10,1,1,2,59,80,139
p_78,4,0,e_0,555,571,651,23,4,4,0,5,0,3,16,80,96
p_108,5,0,e_0,509,576,651,26,2,2,11,4,1,2,67,75,142
p_77,6,0,e_0,557,581,651,20,4,2,0,5,0,3,24,70,94
p_76,7,0,e_0,559,586,651,18,4,1,1,5,0,4,27,65,92
p_67,8,0,e_0,574,591,651,14,3,1,5,5,1,5,17,60,77
p_60,9,0,e_0,584,596,651,10,4,2,7,5,1,6,12,55,67
p_53,9,0,e_0,590,596,651,8,6,2,8,2,1,6,6,55,61
p_69,10,0,e_0,573,601,651,12,3,1,4,5,1,4,28,50,78
p_50,10,0,e_0,592,601,651,6,6,1,8,5,1,6,9,50,59
p_74,11,0,e_0,567,606,651,12,4,1,3,5,1,4,39,45,84
p_52,11,0,e_0,591,606,651,6,6,2,8,5,1,6,15,45,60
p_59,6,0,e_0,584,623,651,13,4,2,7,5,1,5,39,28,67
p_54,6,0,e_0,590,623,651,11,6,2,8,2,1,6,33,28,61
p_96,5,0,e_3,527,567,664,2,3,0,3,5,1,2,40,97,137
p_95,6,0,e_3,527,572,664,3,4,0,3,5,1,3,45,92,137
p_94,6,0,e_3,528,572,664,3,5,0,3,5,1,4,44,92,136
p_93,7,0,e_3,529,577,664,4,5,0,3,5,1,4,48,87,135
p_66,12,0,e_3,577,594,664,9,2,1,7,5,1,1,17,70,87
p_46,13,0,e_3,596,599,664,3,5,1,12,5,1,4,3,65,68
p_79,14,0,e_3,549,604,664,14,3,3,0,3,1,3,55,60,115
p_68,14,0,e_3,574,604,664,8,3,0,6,5,1,2,30,60,90
p_44,15,0,e_3,598,609,664,2,5,0,13,2,1,4,11,55,66
p_57,6,0,e_3,587,638,664,12,4,2,10,5,1,3,51,26,77
p_47,6,0,e_3,594,638,664,10,5,1,12,5,1,4,44,26,70
p_61,5,0,e_3,583,643,664,14,3,2,9,5,1,2,60,21,81
p_49,5,0,e_3,592,643,664,11,6,1,12,5,1,5,51,21,72
p_35,4,0,e_3,640,648,664,2,3,1,6,4,1,2,8,16,24
p_56,2,0,e_3,588,656,664,16,5,2,10,5,1,4,68,8,76
p_48,2,0,e_3,593,672,680,14,5,1,12,2,1,4,79,8,87
p_64,1,0,e_0,579,656,691,20,3,2,6,5,1,5,77,35,112
p_51,1,0,e_0,591,656,691,16,6,2,8,5,1,6,65,35,100
p_43,3,0,e_0,599,664,691,14,6,2,10,5,1,6,65,27,92
p_55,4,0,e_0,590,669,691,13,6,2,8,2,1,5,79,22,101
p_42,4,0,e_0,600,669,691,13,6,2,10,2,1,6,69,22,91
p_40,4,0,e_0,601,669,691,13,6,2,10,5,1,6,68,22,90
p_38,4,0,e_0,627,669,691,5,4,2,5,1,1,3,42,22,64
p_45,5,0,e_0,597,674,691,10,6,1,9,5,1,5,77,17,94
p_32,5,0,e_0,657,674,691,27,1,1,1,5,1,3,17,17,34
p_31,5,0,e_0,662,674,691,25,2,2,3,5,1,3,12,17,29
p_81,2,0,e_2,547,592,704,29,4,4,9,4,1,7,45,112,157
p_71,2,0,e_2,569,592,704,21,4,3,3,4,1,9,23,112,135
p_85,3,0,e_2,542,597,704,29,5,5,10,4,1,5,55,107,162
p_84,3,0,e_2,546,597,704,28,4,4,9,4,1,6,51,107,158
p_82,3,0,e_2,547,597,704,28,4,4,9,4,1,8,50,107,157
p_83,5,0,e_2,546,605,704,26,4,4,9,4,1,6,59,99,158
p_86,6,0,e_2,541,610,704,26,5,5,10,4,1,4,69,94,163
p_80,6,0,e_2,548,610,704,24,4,4,8,4,1,8,62,94,156
p_89,7,0,e_2,537,615,704,26,6,6,11,4,1,4,78,89,167
p_114,9,0,e_2,494,623,704,26,2,2,9,5,1,1,129,81,210
p_100,10,0,e_2,522,628,704,8,4,0,14,4,1,3,106,76,182
p_97,10,0,e_2,526,628,704,8,3,0,13,1,1,3,102,76,178
p_101,12,0,e_2,521,636,704,11,3,0,15,4,1,2,115,68,183
p_103,13,0,e_2,517,641,704,12,2,0,15,5,1,2,124,63,187
p_39,15,0,e_2,609,649,704,30,4,4,6,2,1,5,40,55,95
p_28,6,0,e_3,679,700,720,6,0,0,0,3,1,0,21,20,41
p_27,2,0,e_0,693,702,746,6,1,1,0,3,0,0,9,44,53
p_26,3,0,e_0,698,707,746,3,1,0,1,5,0,1,9,39,48
p_24,5,0,e_0,707,715,746,29,1,1,3,5,1,1,8,31,39
p_25,7,0,e_0,703,723,746,28,1,1,2,5,1,1,20,23,43
p_70,3,0,e_1,572,657,756,19,3,2,12,5,1,4,85,99,184
p_62,5,0,e_1,582,665,756,15,3,2,14,5,1,5,83,91,174
p_73,6,0,e_1,568,670,756,17,4,2,11,5,1,4,102,86,188
p_63,8,0,e_1,581,678,756,12,3,2,14,2,1,4,97,78,175
p_58,10,0,e_1,586,686,756,8,4,2,15,2,1,5,100,70,170
p_41,10,0,e_1,600,686,756,7,6,2,12,4,1,6,86,70,156
p_65,12,0,e_1,578,694,756,9,3,1,13,5,1,4,116,62,178
p_141,15,0,e_1,455,705,756,6,5,0,13,5,1,4,250,51,301
p_87,15,0,e_1,539,705,756,17,5,5,3,5,1,7,166,51,217
p_72,15,0,e_1,569,705,756,10,4,0,11,5,1,5,136,51,187
p_29,15,0,e_1,678,705,756,15,1,1,8,5,1,3,27,51,78
p_22,10,0,e_1,712,722,756,22,1,1,13,4,1,1,10,34,44
p_23,5,0,e_1,709,739,756,28,1,1,14,4,1,0,30,17,47
p_20,9,0,e_3,737,762,799,10,1,1,1,5,0,1,25,37,62
p_21,10,0,e_3,732,767,799,10,0,0,0,3,0,0,35,32,67
p_30,5,0,e_2,676,721,808,26,1,1,8,4,1,3,45,87,132
p_37,7,0,e_2,633,729,808,30,4,4,11,5,1,3,96,79,175
p_33,8,0,e_2,647,734,808,26,2,2,15,5,1,3,87,74,161
p_36,11,0,e_2,635,745,808,26,4,4,12,2,1,3,110,63,173
p_19,12,0,e_2,740,750,808,10,2,0,10,5,1,2,10,58,68
p_34,15,0,e_2,643,761,808,20,3,3,13,5,1,3,118,47,165
p_18,2,0,e_0,768,777,857,8,1,0,0,3,0,0,9,80,89
p_13,11,0,e_0,794,806,857,20,1,1,7,5,1,1,12,51,63
p_16,13,0,e_0,774,814,857,25,1,1,1,5,0,1,40,43,83
p_12,13,0,e_0,796,814,857,18,1,1,8,5,1,2,18,43,61
p_11,11,0,e_0,810,822,857,11,0,0,12,5,1,1,12,35,47
p_8,1,0,e_3,847,853,858,1,0,0,0,3,0,0,6,5,11
p_10,14,0,e_1,810,817,869,14,0,0,12,5,0,1,7,52,59
p_17,15,0,e_1,772,822,869,24,1,1,0,3,0,0,50,47,97
p_15,15,0,e_1,782,822,869,20,1,1,3,5,0,1,40,47,87
p_14,15,0,e_1,790,822,869,18,1,1,5,5,0,1,32,47,79
p_4,1,0,e_3,864,870,875,1,0,0,0,3,0,0,6,5,11
p_3,1,0,e_1,876,882,887,1,0,0,0,3,0,0,6,5,11
p_5,5,0,e_0,860,878,895,5,0,0,0,3,0,0,18,17,35
p_2,3,0,e_3,878,890,901,3,0,0,0,3,0,0,12,11,23
p_1,2,0,e_1,889,898,906,5,0,0,0,3,0,0,9,8,17
p_9,2,0,e_2,845,854,938,2,0,0,0,3,0,0,9,84,93
p_7,12,0,e_2,851,886,938,11,1,0,1,5,0,1,35,52,87
p_6,14,0,e_2,858,894,938,14,0,0,3,5,1,1,36,44,80
p_299,3,0,e_1,7,19,30,3,0,0,0,3,0,0,12,11,23
p_296,1,0,e_3,20,26,31,1,0,0,0,3,0,0,6,5,11
p_298,4,0,e_2,10,25,47,4,0,0,0,3,0,0,15,22,37
p_295,5,0,e_2,22,30,47,5,1,0,3,5,0,1,8,17,25
p_288,1,0,e_2,49,55,98,3,2,2,0,3,0,0,6,43,49
p_285,2,0,e_2,54,60,98,7,3,2,1,2,0,1,6,38,44
p_286,3,0,e_2,51,65,98,7,3,2,0,5,0,1,14,33,47
p_282,6,0,e_2,62,76,98,7,2,1,2,5,1,1,14,22,36
p_279,2,0,e_2,76,90,98,8,1,0,6,4,1,0,14,8,22
p_275,2,0,e_2,84,90,98,5,2,0,4,4,1,2,6,8,14
p_290,4,0,e_3,43,50,106,6,1,1,2,5,0,1,7,56,63
p_291,6,0,e_3,35,58,106,6,0,0,0,3,0,0,23,48,71
p_289,7,0,e_3,47,63,106,4,2,0,3,5,0,2,16,43,59
p_283,10,0,e_3,55,74,106,5,3,0,5,5,1,2,19,32,51
p_300,8,0,e_0,4,31,111,8,0,0,0,3,0,0,27,80,107
p_297,12,0,e_0,18,45,111,12,0,0,4,5,0,1,27,66,93
p_294,13,0,e_0,23,50,111,13,1,0,6,5,0,2,27,61,88
p_293,15,0,e_0,26,58,111,16,1,1,7,5,0,3,32,53,85
p_284,14,0,e_0,55,63,111,9,4,0,14,5,1,1,8,48,56
p_281,10,0,e_0,63,77,111,3,2,0,14,4,1,0,14,34,48
p_276,5,0,e_0,82,94,111,3,2,0,9,4,1,0,12,17,29
p_292,11,0,e_1,30,66,111,11,0,0,0,3,0,0,36,45,81
p_287,12,0,e_1,51,71,111,8,3,0,6,5,0,1,20,40,60
p_280,12,0,e_1,65,71,111,5,2,0,11,2,0,1,6,40,46
p_274,4,0,e_1,84,97,111,3,2,0,8,4,1,0,13,14,27
p_269,4,0,e_1,146,161,177,6,1,0,0,3,0,0,15,16,31
p_267,1,0,e_1,153,172,177,7,1,0,2,5,0,1,19,5,24
p_277,10,0,e_3,81,138,178,28,1,1,8,4,1,0,57,40,97
p_271,11,0,e_3,127,143,178,4,1,0,7,5,0,1,16,35,51
p_273,13,0,e_2,95,139,200,20,2,2,1,4,1,1,44,61,105
p_278,15,0,e_2,80,147,200,23,1,1,5,4,1,1,67,53,120
p_272,15,0,e_2,105,147,200,15,1,1,2,5,0,2,42,53,95
p_268,10,0,e_2,150,164,200,29,1,1,14,4,1,0,14,36,50
p_262,6,0,e_2,164,178,200,28,1,1,10,4,1,1,14,22,36
p_259,6,0,e_2,174,178,200,25,1,1,7,4,1,2,4,22,26
p_264,5,0,e_2,162,183,200,30,1,1,10,4,1,1,21,17,38
p_258,5,0,e_2,175,183,200,26,1,1,7,4,1,2,8,17,25
p_254,3,0,e_2,199,211,224,11,1,1,0,3,1,0,12,13,25
p_252,2,0,e_2,212,216,224,8,1,1,3,4,1,0,4,8,12
p_270,7,0,e_0,133,157,238,6,2,2,0,3,0,0,24,81,105
p_263,12,0,e_0,163,174,238,23,1,1,9,5,1,1,11,64,75
p_261,12,0,e_0,170,174,238,20,1,1,11,5,1,2,4,64,68
p_260,13,0,e_0,171,179,238,19,1,1,11,5,1,2,8,59,67
p_266,15,0,e_0,155,187,238,22,1,1,7,5,0,1,32,51,83
p_257,12,0,e_0,179,198,238,12,0,0,13,5,1,1,19,40,59
p_255,10,0,e_0,192,206,238,10,1,0,14,4,1,1,14,32,46
p_256,8,0,e_3,191,218,246,8,0,0,0,3,0,0,27,28,55
p_251,4,0,e_3,228,232,246,1,1,0,5,4,1,0,4,14,18
p_265,12,0,e_1,157,215,275,25,1,1,3,5,0,2,58,60,118
p_253,15,0,e_1,208,226,275,10,1,0,10,5,0,1,18,49,67
p_250,7,0,e_1,236,252,275,26,1,1,12,4,1,0,16,23,39
p_249,7,0,e_1,238,252,275,25,1,1,11,4,1,1,14,23,37
p_248,7,0,e_1,246,252,275,7,0,0,9,4,1,1,6,23,29
p_244,2,0,e_3,271,280,288,2,0,0,0,3,0,0,9,8,17
p_247,12,0,e_0,248,287,329,12,0,0,0,3,0,0,39,42,81
p_246,12,0,e_0,257,287,329,12,0,0,2,5,0,1,30,42,72
p_243,8,0,e_0,285,301,329,23,1,1,12,5,0,1,16,28,44
p_238,2,0,e_0,311,321,329,23,1,1,5,4,1,0,10,8,18
p_245,9,0,e_2,269,299,330,9,0,0,0,3,0,0,30,31,61
p_233,2,0,e_2,319,322,330,20,2,2,3,4,1,0,3,8,11
p_242,4,0,e_1,287,302,402,4,0,0,0,3,0,0,15,100,115
p_235,8,0,e_1,314,316,402,16,2,1,8,5,1,3,2,86,88
p_231,10,0,e_1,320,324,402,12,2,1,9,5,1,3,4,78,82
p_241,13,0,e_1,300,335,402,13,0,0,4,5,0,1,35,67,102
p_224,13,0,e_1,335,337,402,4,5,0,13,5,1,3,2,65,67
p_240,14,0,e_1,301,342,402,14,0,0,4,3,0,1,41,60,101
p_234,14,0,e_1,314,342,402,12,2,0,8,5,1,4,28,60,88
p_223,13,0,e_1,339,347,402,4,4,0,13,5,1,3,8,55,63
p_219,11,0,e_1,342,355,402,5,4,2,14,4,1,3,13,47,60
p_229,9,0,e_1,323,363,402,12,2,1,10,2,1,3,40,39,79
p_220,9,0,e_1,342,363,402,7,4,3,14,4,1,3,21,39,60
p_206,6,0,e_1,362,374,402,8,3,2,9,1,1,3,12,28,40
p_237,5,0,e_1,313,379,402,19,1,1,7,5,1,2,66,23,89
p_232,5,0,e_1,320,379,402,17,2,2,9,5,1,3,59,23,82
p_230,5,0,e_1,323,379,402,16,2,2,10,2,1,3,56,23,79
p_222,3,0,e_2,339,351,410,14,4,3,0,3,0,0,12,59,71
p_221,4,0,e_2,341,356,410,12,4,3,0,5,0,1,15,54,69
p_217,8,0,e_2,345,370,410,7,3,2,1,5,0,2,25,40,65
p_204,8,0,e_2,364,370,410,6,3,2,6,5,1,2,6,40,46
p_198,9,0,e_2,368,375,410,3,3,0,8,5,1,3,7,35,42
p_197,8,0,e_2,375,380,410,3,2,1,9,4,1,2,5,30,35
p_199,2,0,e_2,368,400,410,10,3,1,8,5,1,2,32,10,42
p_185,2,0,e_2,392,400,410,4,2,1,4,4,1,2,8,10,18
p_216,1,0,e_2,346,405,410,14,3,2,2,5,0,3,59,5,64
p_205,1,0,e_2,362,405,410,13,3,2,6,5,1,2,43,5,48
p_236,8,0,e_3,313,332,418,16,1,1,2,5,0,1,19,86,105
p_227,9,0,e_3,326,337,418,11,3,2,6,5,0,3,11,81,92
p_228,11,0,e_3,325,345,418,9,2,1,6,5,0,2,20,73,93
p_226,12,0,e_3,331,350,418,6,3,1,8,2,0,3,19,68,87
p_213,12,0,e_3,347,350,418,3,3,1,11,5,1,2,3,68,71
p_239,13,0,e_3,305,355,418,13,0,0,0,3,0,0,50,63,113
p_208,13,0,e_3,355,357,418,2,4,1,13,5,1,3,2,61,63
p_211,14,0,e_3,348,362,418,2,4,0,12,5,1,3,14,56,70
p_207,12,0,e_3,355,370,418,3,3,1,13,5,1,2,15,48,63
p_203,12,0,e_3,365,370,418,1,3,0,13,4,1,2,5,48,53
p_200,12,0,e_3,367,370,418,1,3,0,13,4,1,2,3,48,51
p_212,9,0,e_3,348,381,418,5,3,1,12,5,1,2,33,37,70
p_195,9,0,e_3,376,381,418,1,2,0,10,4,1,1,5,37,42
p_191,7,0,e_3,382,389,418,2,2,0,9,4,1,1,7,29,36
p_192,5,0,e_3,380,397,418,4,1,0,9,1,1,0,17,21,38
p_215,6,0,e_0,346,354,440,9,3,2,4,5,0,2,8,86,94
p_218,9,0,e_0,343,365,440,6,4,2,3,5,0,1,22,75,97
p_225,10,0,e_0,333,370,440,8,5,3,0,3,0,0,37,70,107
p_202,13,0,e_0,365,381,440,30,3,3,9,5,1,2,16,59,75
p_201,13,0,e_0,366,381,440,30,3,3,9,5,1,3,15,59,74
p_193,12,0,e_0,378,386,440,28,2,2,12,5,1,3,8,54,62
p_194,11,0,e_0,377,391,440,29,2,2,12,5,1,2,14,49,63
p_188,8,0,e_0,390,402,440,29,2,2,11,1,1,2,12,38,50
p_189,7,0,e_0,387,407,440,30,3,3,12,4,1,2,20,33,53
p_187,7,0,e_0,391,407,440,30,2,2,11,4,1,3,16,33,49
p_179,6,0,e_0,397,412,440,29,3,3,9,4,1,3,15,28,43
p_176,6,0,e_0,398,412,440,29,3,3,9,4,1,5,14,28,42
p_178,5,0,e_0,398,417,440,30,3,3,9,4,1,4,19,23,42
p_210,4,0,e_0,353,422,440,11,4,1,6,2,0,2,69,18,87
p_163,4,0,e_0,417,422,440,4,5,5,5,4,1,2,5,18,23
p_186,1,0,e_1,391,407,524,6,2,1,2,1,1,3,16,117,133
p_209,2,0,e_1,354,412,524,13,3,1,11,1,1,3,58,112,170
p_214,4,0,e_1,346,420,524,11,3,2,13,1,1,3,74,104,178
p_196,5,0,e_1,376,425,524,5,2,1,6,4,1,3,49,99,148
p_173,10,0,e_1,405,442,524,23,5,5,1,5,0,5,37,82,119
p_159,11,0,e_1,424,447,524,15,6,1,5,2,1,4,23,77,100
p_161,13,0,e_1,418,455,524,15,5,1,4,5,1,5,37,69,106
p_140,13,0,e_1,455,457,524,6,4,1,13,5,1,3,2,67,69
p_190,14,0,e_1,382,462,524,25,3,3,4,4,1,3,80,62,142
p_172,14,0,e_1,405,462,524,19,5,5,1,5,0,6,57,62,119
p_168,15,0,e_1,412,467,524,17,5,5,2,5,1,4,55,57,112
p_151,15,0,e_1,443,467,524,9,5,0,10,5,1,5,24,57,81
p_149,15,0,e_1,444,467,524,9,5,0,10,5,1,5,23,57,80
p_142,15,0,e_1,452,467,524,7,4,0,12,5,1,4,15,57,72
p_141,15,0,e_1,455,467,524,6,4,0,13,5,1,4,12,57,69
p_156,1,0,e_0,428,445,526,25,6,5,3,4,1,0,17,81,98
p_171,3,0,e_0,408,453,526,29,6,6,7,4,1,3,45,73,118
p_150,3,0,e_0,444,453,526,19,5,4,1,2,0,2,9,73,82
p_148,3,0,e_0,447,453,526,18,4,3,1,5,1,2,6,73,79
p_144,4,0,e_0,451,458,526,16,4,3,3,5,1,4,7,68,75
p_147,7,0,e_0,450,469,526,13,4,3,2,5,1,2,19,57,76
p_138,7,0,e_0,456,469,526,11,4,2,4,5,1,4,13,57,70
p_135,7,0,e_0,461,469,526,10,4,2,5,5,1,3,8,57,65
p_130,9,0,e_0,469,477,526,6,3,1,7,5,1,3,8,49,57
p_152,10,0,e_0,439,482,526,13,5,2,0,3,1,2,43,44,87
p_121,9,0,e_0,480,487,526,14,2,0,10,5,1,5,7,39,46
p_126,6,0,e_0,473,498,526,9,3,1,8,5,1,4,25,28,53
p_122,5,0,e_0,477,503,526,11,3,1,9,5,1,4,26,23,49
p_133,4,0,e_0,463,508,526,13,3,2,5,5,1,3,45,18,63
p_143,2,0,e_0,451,516,526,18,4,3,3,5,1,3,65,10,75
p_166,5,0,e_2,415,427,526,26,6,6,1,5,0,5,12,99,111
p_167,7,0,e_2,412,435,526,25,5,5,0,5,0,4,23,91,114
p_177,9,0,e_2,398,443,526,26,3,3,2,4,1,3,45,83,128
p_170,10,0,e_2,408,448,526,22,6,6,0,4,1,2,40,78,118
p_169,11,0,e_2,410,453,526,21,5,5,0,5,0,3,43,73,116
p_183,12,0,e_2,393,458,526,24,2,2,4,4,1,2,65,68,133
p_164,12,0,e_2,416,458,526,18,6,6,2,5,0,6,42,68,110
p_157,12,0,e_2,427,458,526,14,6,1,5,5,1,6,31,68,99
p_145,12,0,e_2,451,458,526,8,4,1,11,5,1,5,7,68,75
p_139,13,0,e_2,456,463,526,5,4,1,12,5,1,4,7,63,70
p_165,14,0,e_2,416,468,526,16,6,6,2,5,0,6,52,58,110
p_162,14,0,e_2,417,468,526,14,5,5,2,5,0,7,51,58,109
p_158,14,0,e_2,426,468,526,12,6,0,5,2,0,6,42,58,100
p_134,12,0,e_2,462,476,526,5,3,2,13,2,1,3,14,50,64
p_146,10,0,e_2,451,484,526,10,4,2,11,5,1,4,33,42,75
p_175,2,0,e_3,399,426,542,3,3,0,5,4,1,2,27,116,143
p_174,3,0,e_3,402,431,542,1,5,0,4,4,1,4,29,111,140
p_184,5,0,e_3,393,439,542,1,2,0,6,4,1,1,46,103,149
p_182,5,0,e_3,394,439,542,1,2,0,6,4,1,1,45,103,148
p_154,7,0,e_3,438,447,542,16,4,3,5,2,1,3,9,95,104
p_160,10,0,e_3,421,458,542,17,5,2,1,5,0,5,37,84,121
p_181,11,0,e_3,395,463,542,24,2,2,5,4,1,1,68,79,147
p_137,13,0,e_3,458,471,542,5,3,1,10,5,1,2,13,71,84
p_180,14,0,e_3,396,476,542,21,2,2,5,1,1,1,80,66,146
p_124,14,0,e_3,474,476,542,2,4,1,14,5,1,3,2,66,68
p_127,15,0,e_3,473,481,542,2,3,0,13,5,1,2,8,61,69
p_117,12,0,e_3,490,492,542,30,2,2,12,4,1,1,2,50,52
p_115,10,0,e_3,494,500,542,2,3,0,12,4,1,2,6,42,48
p_114,9,0,e_3,494,505,542,3,2,0,12,4,1,1,11,37,48
p_129,5,0,e_3,470,519,542,10,2,1,13,2,1,1,49,23,72
p_136,2,0,e_1,460,532,642,16,4,3,14,5,1,3,72,110,182
p_96,5,0,e_1,527,543,642,28,6,6,1,5,0,6,16,99,115
p_98,6,0,e_1,524,548,642,28,5,5,0,5,0,5,24,94,118
p_95,6,0,e_1,527,548,642,27,6,6,1,5,0,7,21,94,115
p_94,6,0,e_1,528,548,642,27,6,6,1,5,0,7,20,94,114
p_132,7,0,e_1,463,553,642,10,3,2,14,5,1,3,90,89,179
p_93,7,0,e_1,529,553,642,26,6,6,1,5,0,7,24,89,113
p_89,7,0,e_1,537,553,642,24,5,5,3,5,1,7,16,89,105
p_153,8,0,e_1,438,558,642,15,5,3,9,5,1,5,120,84,204
p_128,10,0,e_1,471,566,642,5,3,1,14,4,1,3,95,76,171
p_120,10,0,e_1,481,566,642,5,2,0,11,4,1,4,85,76,161
p_100,10,0,e_1,522,566,642,24,6,6,0,4,1,5,44,76,120
p_97,10,0,e_1,526,566,642,24,5,5,0,5,0,6,40,76,116
p_123,12,0,e_1,474,574,642,4,4,1,13,4,1,4,100,68,168
p_92,13,0,e_1,533,579,642,19,5,5,2,5,1,6,46,63,109
p_155,3,0,e_2,434,537,644,21,5,4,7,2,1,5,103,107,210
p_125,4,0,e_2,474,542,644,12,4,1,12,4,1,4,68,102,170
p_118,4,0,e_2,488,542,644,9,2,1,9,1,1,3,54,102,156
p_119,5,0,e_2,483,547,644,10,2,0,10,1,1,3,64,97,161
p_86,6,0,e_2,541,552,644,6,5,5,4,3,1,6,11,92,103
p_80,6,0,e_2,548,552,644,23,5,1,5,5,1,7,4,92,96
p_116,7,0,e_2,490,557,644,5,2,0,9,4,1,3,67,87,154
p_131,9,0,e_2,467,565,644,7,3,2,14,2,1,3,98,79,177
p_74,11,0,e_2,567,573,644,14,3,1,9,5,1,5,6,71,77
p_91,13,0,e_2,535,581,644,18,6,6,3,5,0,6,46,63,109
p_109,14,0,e_2,506,586,644,25,3,3,5,4,1,4,80,58,138
p_75,14,0,e_2,563,586,644,11,4,1,9,5,1,6,23,58,81
p_68,14,0,e_2,574,586,644,9,2,1,11,5,1,5,12,58,70
p_53,9,0,e_2,590,603,644,9,4,1,13,4,1,6,13,41,54
p_63,8,0,e_2,581,608,644,13,2,1,13,5,1,5,27,36,63
p_110,1,0,e_0,501,531,648,9,3,2,5,4,1,5,30,117,147
p_107,1,0,e_0,512,531,648,6,3,1,3,4,1,4,19,117,136
p_104,7,0,e_0,516,551,648,29,4,4,2,4,1,3,35,97,132
p_113,11,0,e_0,496,565,648,30,4,4,6,4,1,4,69,83,152
p_101,12,0,e_0,521,570,648,23,4,4,1,4,1,4,49,78,127
p_103,13,0,e_0,517,575,648,22,4,4,2,4,1,4,58,73,131
p_79,14,0,e_0,549,580,648,15,5,1,7,5,1,6,31,68,99
p_112,15,0,e_0,497,585,648,26,4,4,6,1,1,4,88,63,151
p_87,15,0,e_0,539,585,648,16,5,5,3,5,1,5,46,63,109
p_72,15,0,e_0,569,585,648,9,3,0,12,2,1,6,16,63,79
p_58,10,0,e_0,586,602,648,9,2,1,15,4,1,4,16,46,62
p_50,10,0,e_0,592,602,648,7,5,1,13,4,1,6,10,46,56
p_67,8,0,e_0,574,610,648,15,2,1,13,2,1,5,36,38,74
p_73,6,0,e_0,568,618,648,18,3,2,12,5,1,5,50,30,80
p_59,6,0,e_0,584,618,648,14,2,1,15,2,1,4,34,30,64
p_99,1,0,e_3,522,547,658,3,4,1,4,4,1,3,25,111,136
p_102,2,0,e_3,521,552,658,3,3,1,5,4,1,2,31,106,137
p_106,4,0,e_3,512,560,658,3,3,1,7,4,1,2,48,98,146
p_105,4,0,e_3,515,560,658,2,4,1,6,4,1,3,45,98,143
p_108,5,0,e_3,509,565,658,3,3,0,8,4,1,2,56,93,149
p_76,7,0,e_3,559,573,658,3,3,3,4,3,1,2,14,85,99
p_111,15,0,e_3,501,599,658,25,3,3,10,4,1,2,98,59,157
p_44,15,0,e_3,598,599,658,4,5,0,15,2,1,4,1,59,60
p_46,13,0,e_3,596,609,658,3,5,1,14,5,1,4,13,49,62
p_41,10,0,e_3,600,620,658,5,5,1,15,1,1,4,20,38,58
p_49,5,0,e_3,592,637,658,12,4,1,13,5,1,3,45,21,66
p_55,4,0,e_3,590,642,658,14,3,1,12,5,1,2,52,16,68
p_38,4,0,e_3,627,642,658,4,4,1,8,4,1,3,15,16,31
p_35,4,0,e_3,640,642,658,30,4,4,4,4,1,3,2,16,18
p_56,2,0,e_3,588,650,658,16,2,1,12,5,1,1,62,8,70
p_51,1,0,e_0,591,653,720,16,4,1,13,4,1,5,62,67,129
p_71,2,0,e_0,569,658,720,22,3,2,12,2,1,5,89,62,151
p_48,2,0,e_0,593,658,720,15,5,1,13,4,1,6,65,62,127
p_85,3,0,e_0,542,663,720,27,5,3,4,5,1,5,121,57,178
p_82,3,0,e_0,547,663,720,26,5,3,6,5,1,6,116,57,173
p_42,4,0,e_0,600,668,720,11,5,2,10,4,1,7,68,52,120
p_45,5,0,e_0,597,673,720,10,6,0,11,4,1,6,76,47,123
p_31,5,0,e_0,662,673,720,24,3,2,3,2,1,4,11,47,58
p_47,6,0,e_0,594,678,720,10,5,1,12,4,1,6,84,42,126
p_33,8,0,e_0,647,686,720,25,4,4,0,3,1,6,39,34,73
p_28,6,0,e_0,679,694,720,18,3,2,6,5,1,2,15,26,41
p_30,5,0,e_0,676,699,720,20,3,2,6,5,1,2,23,21,44
p_26,3,0,e_0,698,707,720,15,2,1,5,1,1,1,9,13,22
p_27,2,0,e_0,693,712,720,17,3,1,6,1,1,1,19,8,27
p_81,2,0,e_1,547,650,748,27,5,3,6,2,1,7,103,98,201
p_83,5,0,e_1,546,661,748,24,4,1,6,5,1,7,115,87,202
p_62,5,0,e_1,582,661,748,15,2,1,14,5,1,6,79,87,166
p_61,5,0,e_1,583,661,748,15,2,1,14,2,1,5,78,87,165
p_77,6,0,e_1,557,666,748,21,4,1,8,2,1,6,109,82,191
p_60,9,0,e_1,584,677,748,11,2,1,14,4,1,5,93,71,164
p_69,10,0,e_1,573,682,748,13,2,1,12,2,1,5,109,66,175
p_52,11,0,e_1,591,687,748,6,4,1,12,1,1,6,96,61,157
p_66,12,0,e_1,577,692,748,10,2,1,13,5,1,6,115,56,171
p_65,12,0,e_1,578,692,748,10,2,1,13,2,1,6,114,56,170
p_88,14,0,e_1,538,700,748,17,5,5,4,5,1,7,162,48,210
p_25,7,0,e_1,703,723,748,10,2,1,13,4,1,0,20,25,45
p_24,5,0,e_1,707,731,748,10,2,0,12,4,1,1,24,17,41
p_64,1,0,e_2,579,649,754,20,2,1,13,5,1,5,70,105,175
p_90,2,0,e_2,536,654,754,29,5,5,3,2,0,6,118,100,218
p_84,3,0,e_2,546,659,754,26,4,3,5,2,1,6,113,95,208
p_70,3,0,e_2,572,659,754,20,2,1,11,2,1,5,87,95,182
p_43,3,0,e_2,599,659,754,12,6,3,10,4,1,7,60,95,155
p_78,4,0,e_2,555,664,754,23,4,2,7,5,1,6,109,90,199
p_40,4,0,e_2,601,664,754,11,6,3,9,4,1,7,63,90,153
p_57,6,0,e_2,587,672,754,13,2,1,14,4,1,5,85,82,167
p_54,6,0,e_2,590,672,754,12,4,1,13,4,1,6,82,82,164
p_37,7,0,e_2,633,677,754,29,4,4,2,1,1,5,44,77,121
p_39,15,0,e_2,609,703,754,28,5,5,8,4,1,5,94,51,145
p_29,15,0,e_2,678,703,754,9,3,0,7,5,1,1,25,51,76
p_22,10,0,e_2,712,720,754,4,1,0,12,4,1,1,8,34,42
p_23,5,0,e_2,709,737,754,10,1,0,13,4,1,0,28,17,45
p_32,5,0,e_3,657,675,756,5,2,2,0,3,1,2,18,81,99
p_36,11,0,e_3,635,695,756,24,4,4,5,4,1,3,60,61,121
p_34,15,0,e_3,643,709,756,19,3,3,4,4,1,2,66,47,113
p_18,2,0,e_1,768,777,785,2,0,0,0,3,0,0,9,8,17
p_20,9,0,e_0,737,762,837,27,1,1,1,5,0,1,25,75,100
p_21,10,0,e_0,732,767,837,28,1,1,0,3,0,0,35,70,105
p_19,12,0,e_0,740,775,837,23,1,1,2,5,0,2,35,62,97
p_16,13,0,e_0,774,780,837,13,0,0,12,2,1,1,6,57,63
p_17,15,0,e_0,772,788,837,15,0,0,11,5,1,1,16,49,65
p_15,15,0,e_0,782,788,837,15,0,0,13,5,1,1,6,49,55
p_13,11,0,e_0,794,802,837,11,0,0,13,4,1,0,8,35,43
p_11,11,0,e_3,810,846,885,11,0,0,0,3,0,0,36,39,75
p_5,5,0,e_3,860,866,885,2,1,0,7,4,1,0,6,19,25
p_4,1,0,e_3,864,880,885,4,2,0,5,4,1,1,16,5,21
p_14,15,0,e_1,790,838,887,15,0,0,0,3,0,0,48,49,97
p_3,1,0,e_1,876,882,887,1,2,0,3,4,1,0,6,5,11
p_12,13,0,e_2,796,838,887,13,0,0,0,3,0,0,42,49,91
p_10,14,0,e_2,810,843,887,14,1,1,4,5,0,1,33,44,77
p_1,2,0,e_1,889,898,906,2,0,0,0,3,0,0,9,8,17
p_8,1,0,e_0,847,851,942,10,1,0,0,5,0,1,4,91,95
p_9,2,0,e_0,845,856,942,13,0,0,0,3,0,0,11,86,97
p_7,12,0,e_0,851,888,942,28,1,1,1,5,1,1,37,54,91
p_6,14,0,e_0,858,896,942,23,1,1,2,5,1,1,38,46,84
p_2,3,0,e_0,878,931,942,28,2,2,9,5,1,2,53,11,64
p_299,3,0,e_1,7,19,30,3,0,0,0,3,0,0,12,11,23
p_296,1,0,e_3,20,26,31,1,0,0,0,3,0,0,6,5,11
p_298,4,0,e_2,10,25,47,4,0,0,0,3,0,0,15,22,37
p_295,5,0,e_2,22,30,47,5,1,0,3,5,0,1,8,17,25
p_288,1,0,e_2,49,55,98,3,2,2,0,3,0,0,6,43,49
p_285,2,0,e_2,54,60,98,7,3,2,1,2,0,1,6,38,44
p_286,3,0,e_2,51,65,98,7,3,2,0,5,0,1,14,33,47
p_282,6,0,e_2,62,76,98,7,2,1,2,5,1,1,14,22,36
p_279,2,0,e_2,76,90,98,8,1,0,6,4,1,0,14,8,22
p_275,2,0,e_2,84,90,98,5,2,0,4,4,1,2,6,8,14
p_290,4,0,e_3,43,50,106,6,1,1,2,5,0,1,7,56,63
p_291,6,0,e_3,35,58,106,6,0,0,0,3,0,0,23,48,71
p_289,7,0,e_3,47,63,106,4,2,0,3,5,0,2,16,43,59
p_283,10,0,e_3,55,74,106,5,3,0,5,5,1,2,19,32,51
p_300,8,0,e_0,4,31,111,8,0,0,0,3,0,0,27,80,107
p_297,12,0,e_0,18,45,111,12,0,0,4,5,0,1,27,66,93
p_294,13,0,e_0,23,50,111,13,1,0,6,5,0,2,27,61,88
p_293,15,0,e_0,26,58,111,16,1,1,7,5,0,3,32,53,85
p_284,14,0,e_0,55,63,111,9,4,0,14,5,1,1,8,48,56
p_281,10,0,e_0,63,77,111,3,2,0,14,4,1,0,14,34,48
p_276,5,0,e_0,82,94,111,3,2,0,9,4,1,0,12,17,29
p_292,11,0,e_1,30,66,111,11,0,0,0,3,0,0,36,45,81
p_287,12,0,e_1,51,71,111,8,3,0,6,5,0,1,20,40,60
p_280,12,0,e_1,65,71,111,5,2,0,11,2,0,1,6,40,46
p_274,4,0,e_1,84,97,111,3,2,0,8,4,1,0,13,14,27
p_269,4,0,e_1,146,148,186,13,1,1,4,5,0,1,2,38,40
p_270,7,0,e_1,133,159,186,14,1,1,0,3,0,0,26,27,53
p_264,5,0,e_1,162,167,186,7,2,0,6,4,1,1,5,19,24
p_267,1,0,e_1,153,181,186,14,1,0,5,5,1,1,28,5,33
p_277,10,0,e_2,81,130,202,28,2,2,5,4,1,1,49,72,121
p_273,13,0,e_2,95,141,202,20,2,2,1,4,1,1,46,61,107
p_272,15,0,e_2,105,149,202,15,1,1,2,5,0,2,44,53,97
p_268,10,0,e_2,150,166,202,6,1,1,15,4,1,0,16,36,52
p_262,6,0,e_2,164,180,202,6,1,0,10,4,1,1,16,22,38
p_258,5,0,e_2,175,185,202,4,2,1,7,4,1,1,10,17,27
p_278,15,0,e_3,80,153,204,23,1,1,8,4,1,0,73,51,124
p_265,12,0,e_3,157,164,204,2,1,0,14,4,1,0,7,40,47
p_259,6,0,e_3,174,184,204,3,1,0,9,4,1,0,10,20,30
p_252,2,0,e_2,212,221,229,2,0,0,0,3,0,0,9,8,17
p_271,11,0,e_0,127,163,234,12,1,1,0,3,0,0,36,71,107
p_263,12,0,e_0,163,168,234,30,1,1,11,5,1,1,5,66,71
p_260,13,0,e_0,171,173,234,27,1,1,13,5,1,2,2,61,63
p_266,15,0,e_0,155,181,234,30,1,1,9,5,0,1,26,53,79
p_261,12,0,e_0,170,192,234,28,1,1,12,5,1,1,22,42,64
p_257,12,0,e_0,179,192,234,25,2,2,15,5,1,2,13,42,55
p_255,10,0,e_0,192,200,234,24,1,1,12,4,1,1,8,34,42
p_256,8,0,e_0,191,208,234,26,1,1,12,1,1,0,17,26,43
p_244,2,0,e_0,271,280,288,2,0,0,0,3,0,0,9,8,17
p_254,3,0,e_1,199,211,298,28,1,1,0,3,0,0,12,87,99
p_253,15,0,e_1,208,249,298,15,0,0,2,5,0,1,41,49,90
p_246,12,0,e_1,257,260,298,12,0,0,13,4,1,0,3,38,41
p_251,4,0,e_2,228,243,311,4,0,0,0,3,1,0,15,68,83
p_250,7,0,e_2,236,254,311,7,0,0,2,5,0,1,18,57,75
p_249,7,0,e_2,238,254,311,7,0,0,3,5,0,2,16,57,73
p_248,7,0,e_2,246,254,311,7,0,0,5,5,1,1,8,57,65
p_247,12,0,e_2,248,271,311,12,0,0,5,5,1,1,23,40,63
p_245,9,0,e_2,269,282,311,9,0,0,12,5,1,1,13,29,42
p_242,4,0,e_0,287,302,390,12,1,1,0,3,1,0,15,88,103
p_241,13,0,e_0,300,331,390,9,1,0,4,5,0,1,31,59,90
p_239,13,0,e_0,305,331,390,9,2,1,5,5,1,1,26,59,85
p_234,14,0,e_0,314,336,390,6,2,0,8,5,1,1,22,54,76
p_220,9,0,e_0,342,353,390,3,2,1,12,4,1,2,11,37,48
p_215,6,0,e_0,346,364,390,5,4,2,11,4,1,3,18,26,44
p_221,4,0,e_0,341,372,390,8,2,1,13,4,1,1,31,18,49
p_214,4,0,e_0,346,372,390,7,4,2,11,4,1,3,26,18,44
p_222,3,0,e_0,339,377,390,9,2,1,13,4,1,0,38,13,51
p_205,1,0,e_0,362,385,390,6,4,2,6,4,1,3,23,5,28
p_243,8,0,e_3,285,312,392,8,0,0,0,3,0,0,27,80,107
p_240,14,0,e_3,301,332,392,9,1,0,5,5,0,1,31,60,91
p_226,12,0,e_3,331,340,392,4,2,0,14,2,1,1,9,52,61
p_228,11,0,e_3,325,345,392,5,2,1,12,5,1,1,20,47,67
p_219,11,0,e_3,342,345,392,1,2,0,12,4,1,1,3,47,50
p_218,9,0,e_3,343,353,392,2,2,0,11,4,1,1,10,39,49
p_212,9,0,e_3,348,353,392,1,4,0,10,4,1,3,5,39,44
p_217,8,0,e_3,345,358,392,3,2,1,11,4,1,1,13,34,47
p_206,6,0,e_3,362,366,392,1,4,0,7,4,1,3,4,26,30
p_210,4,0,e_3,353,374,392,5,3,1,9,4,1,2,21,18,39
p_209,2,0,e_3,354,382,392,7,4,2,9,4,1,3,28,10,38
p_199,2,0,e_3,368,382,392,4,4,1,6,4,1,3,14,10,24
p_216,1,0,e_3,346,387,392,10,3,2,11,4,1,2,41,5,46
p_237,5,0,e_2,313,331,418,15,2,1,0,3,0,0,18,87,105
p_232,5,0,e_2,320,331,418,13,2,1,2,5,0,2,11,87,98
p_235,8,0,e_2,314,342,418,12,2,1,0,5,0,1,28,76,104
p_231,10,0,e_2,320,350,418,8,2,1,2,5,0,2,30,68,98
p_213,12,0,e_2,347,358,418,29,4,4,9,5,1,2,11,60,71
p_207,12,0,e_2,355,358,418,27,5,5,11,5,1,2,3,60,63
p_224,13,0,e_2,335,363,418,30,3,3,6,5,1,2,28,55,83
p_208,13,0,e_2,355,363,418,26,5,5,11,5,1,2,8,55,63
p_203,12,0,e_2,365,368,418,24,4,4,13,4,1,1,3,50,53
p_198,9,0,e_2,368,379,418,27,4,4,12,4,1,1,11,39,50
p_195,9,0,e_2,376,379,418,25,3,3,10,4,1,3,3,39,42
p_204,8,0,e_2,364,384,418,28,5,5,13,4,1,0,20,34,54
p_197,8,0,e_2,375,384,418,26,3,3,10,4,1,2,9,34,43
p_191,7,0,e_2,382,389,418,25,2,2,8,4,1,2,7,29,36
p_196,5,0,e_2,376,397,418,29,3,3,10,4,1,2,21,21,42
p_238,2,0,e_1,311,320,432,18,1,1,0,3,0,0,9,112,121
p_233,2,0,e_1,319,320,432,16,2,1,2,2,0,1,1,112,113
p_230,5,0,e_1,323,333,432,12,2,1,2,5,1,1,10,99,109
p_236,8,0,e_1,313,344,432,12,2,1,0,5,0,1,31,88,119
p_229,9,0,e_1,323,349,432,8,2,1,2,5,1,2,26,83,109
p_227,9,0,e_1,326,349,432,7,3,1,3,5,1,3,23,83,106
p_225,10,0,e_1,333,354,432,4,3,2,5,5,1,2,21,78,99
p_223,13,0,e_1,339,365,432,29,2,2,7,5,1,3,26,67,93
p_202,13,0,e_1,365,367,432,23,4,4,13,5,1,1,2,65,67
p_201,13,0,e_1,366,367,432,23,4,4,13,2,1,1,1,65,66
p_211,14,0,e_1,348,374,432,26,4,4,9,2,1,2,26,58,84
p_200,12,0,e_1,367,382,432,24,4,4,13,5,1,2,15,50,65
p_193,12,0,e_1,378,382,432,21,3,3,13,4,1,2,4,50,54
p_194,11,0,e_1,377,387,432,22,3,3,13,4,1,1,10,45,55
p_188,8,0,e_1,390,398,432,22,1,1,10,4,1,1,8,34,42
p_171,3,0,e_1,408,443,500,17,3,2,6,4,1,2,35,57,92
p_155,3,0,e_1,434,443,500,14,5,3,0,5,0,4,9,57,66
p_178,5,0,e_1,398,451,500,18,4,2,8,4,1,2,53,49,102
p_179,6,0,e_1,397,456,500,17,4,2,8,1,1,1,59,44,103
p_176,6,0,e_1,398,456,500,17,4,2,8,4,1,3,58,44,102
p_189,7,0,e_1,387,461,500,24,1,1,11,4,1,0,74,39,113
p_187,7,0,e_1,391,461,500,7,1,1,10,4,1,2,70,39,109
p_154,7,0,e_1,438,461,500,9,4,2,2,5,0,4,23,39,62
p_147,7,0,e_1,450,461,500,9,4,1,5,2,1,3,11,39,50
p_138,7,0,e_1,456,461,500,7,5,1,6,5,1,2,5,39,44
p_135,7,0,e_1,461,463,500,6,4,0,7,5,1,2,2,37,39
p_153,8,0,e_1,438,468,500,8,4,2,2,5,0,4,30,32,62
p_126,6,0,e_1,473,476,500,4,6,1,7,4,1,2,3,24,27
p_129,5,0,e_1,470,481,500,6,6,1,8,4,1,1,11,19,30
p_122,5,0,e_1,477,481,500,4,6,0,6,4,1,2,4,19,23
p_177,9,0,e_0,398,419,504,14,4,2,2,5,0,1,21,85,106
p_173,10,0,e_0,405,424,504,11,3,2,5,5,0,2,19,80,99
p_170,10,0,e_0,408,424,504,10,3,2,6,5,0,3,16,80,96
p_157,12,0,e_0,427,432,504,7,6,2,11,5,1,2,5,72,77
p_190,14,0,e_0,382,440,504,18,2,2,2,4,1,1,58,64,122
p_180,14,0,e_0,396,440,504,13,3,0,2,5,0,1,44,64,108
p_172,14,0,e_0,405,440,504,11,3,0,5,5,0,3,35,64,99
p_168,15,0,e_0,412,445,504,10,4,0,7,5,0,3,33,59,92
p_151,15,0,e_0,443,445,504,2,3,0,15,5,1,3,2,59,61
p_145,12,0,e_0,451,456,504,3,5,0,13,4,1,4,5,48,53
p_152,10,0,e_0,439,464,504,6,4,2,14,2,1,2,25,40,65
p_146,10,0,e_0,451,464,504,5,5,0,13,4,1,4,13,40,53
p_132,7,0,e_0,463,475,504,6,5,1,10,1,1,3,12,29,41
p_144,4,0,e_0,451,486,504,11,5,0,13,4,1,3,35,18,53
p_133,4,0,e_0,463,486,504,9,5,2,10,1,1,3,23,18,41
p_186,1,0,e_3,391,397,518,1,0,0,0,3,1,0,6,121,127
p_185,2,0,e_3,392,402,518,2,1,0,0,5,0,1,10,116,126
p_167,7,0,e_3,412,419,518,12,3,2,5,5,1,2,7,99,106
p_181,11,0,e_3,395,433,518,12,3,1,1,5,0,3,38,85,123
p_169,11,0,e_3,410,433,518,9,3,1,4,5,1,2,23,85,108
p_183,12,0,e_3,393,438,518,12,2,0,0,5,0,2,45,80,125
p_164,12,0,e_3,416,438,518,6,5,0,6,5,1,4,22,80,102
p_161,13,0,e_3,418,443,518,8,5,1,7,2,1,4,25,75,100
p_165,14,0,e_3,416,448,518,8,5,0,6,5,1,4,32,70,102
p_162,14,0,e_3,417,448,518,7,6,0,7,5,1,5,31,70,101
p_158,14,0,e_3,426,448,518,5,6,0,9,5,1,5,22,70,92
p_149,15,0,e_3,444,453,518,2,3,0,13,5,1,2,9,65,74
p_140,13,0,e_3,455,461,518,2,4,0,15,4,1,3,6,57,63
p_139,13,0,e_3,456,461,518,1,5,0,14,4,1,4,5,57,62
p_137,13,0,e_3,458,461,518,1,5,0,14,4,1,4,3,57,60
p_175,2,0,e_2,399,426,542,21,4,2,5,4,1,0,27,116,143
p_174,3,0,e_2,402,431,542,19,3,2,4,4,1,2,29,111,140
p_163,4,0,e_2,417,436,542,17,6,3,0,3,1,3,19,106,125
p_192,5,0,e_2,380,441,542,27,3,3,9,4,1,2,61,101,162
p_184,5,0,e_2,393,441,542,5,2,0,6,4,1,1,48,101,149
p_182,5,0,e_2,394,441,542,19,3,1,6,4,1,1,47,101,148
p_160,10,0,e_2,421,458,542,11,6,4,1,5,0,4,37,84,121
p_159,11,0,e_2,424,463,542,9,6,3,2,5,0,5,39,79,118
p_142,15,0,e_2,452,477,542,20,4,0,8,5,1,2,25,65,90
p_141,15,0,e_2,455,477,542,30,5,5,9,5,1,3,22,65,87
p_127,15,0,e_2,473,477,542,25,6,6,14,5,1,1,4,65,69
p_124,14,0,e_2,474,482,542,26,6,6,14,5,1,2,8,60,68
p_123,12,0,e_2,474,490,542,28,6,6,14,5,1,1,16,52,68
p_120,10,0,e_2,481,498,542,29,6,6,14,1,1,2,17,44,61
p_115,10,0,e_2,494,498,542,25,7,7,11,4,1,3,4,44,48
p_136,2,0,e_1,460,508,618,11,4,2,7,2,1,1,48,110,158
p_113,11,0,e_1,496,537,618,23,8,8,1,4,1,2,41,81,122
p_117,12,0,e_1,490,542,618,24,8,8,2,4,1,1,52,76,128
p_109,14,0,e_1,506,550,618,18,9,9,2,5,0,4,44,68,112
p_88,14,0,e_1,538,550,618,10,6,0,11,5,1,4,12,68,80
p_79,14,0,e_1,549,550,618,8,4,0,14,2,1,4,1,68,69
p_111,15,0,e_1,501,557,618,18,9,9,0,5,0,3,56,61,117
p_87,15,0,e_1,539,557,618,11,6,0,11,5,1,4,18,61,79
p_67,8,0,e_1,574,580,618,10,4,1,10,4,1,5,6,38,44
p_76,7,0,e_1,559,585,618,8,3,2,15,4,1,4,26,33,59
p_86,6,0,e_1,541,590,618,13,6,3,12,2,1,3,49,28,77
p_80,6,0,e_1,548,590,618,12,4,3,14,5,1,5,42,28,70
p_77,6,0,e_1,557,590,618,9,4,2,15,4,1,4,33,28,61
p_59,6,0,e_1,584,590,618,9,4,0,7,1,1,5,6,28,34
p_57,6,0,e_1,587,590,618,9,4,1,7,4,1,5,3,28,31
p_156,1,0,e_0,428,509,630,17,6,4,11,5,1,3,81,121,202
p_150,3,0,e_0,444,517,630,12,3,1,15,2,1,2,73,113,186
p_125,4,0,e_0,474,522,630,6,6,2,7,1,1,3,48,108,156
p_98,6,0,e_0,524,530,630,17,8,3,4,5,1,3,6,100,106
p_94,6,0,e_0,528,530,630,16,8,3,6,5,1,4,2,100,102
p_104,7,0,e_0,516,535,630,23,9,9,3,2,1,2,19,95,114
p_93,7,0,e_0,529,535,630,15,8,3,6,2,1,3,6,95,101
p_103,13,0,e_0,517,555,630,13,8,8,3,5,1,3,38,75,113
p_92,13,0,e_0,533,555,630,10,7,0,7,5,1,3,22,75,97
p_91,13,0,e_0,535,555,630,10,7,0,7,5,1,2,20,75,95
p_112,15,0,e_0,497,563,630,19,7,7,1,4,1,3,66,67,133
p_75,14,0,e_0,563,568,630,4,2,0,15,4,1,2,5,62,67
p_74,11,0,e_0,567,579,630,2,2,1,14,1,1,2,12,51,63
p_60,9,0,e_0,584,587,630,6,4,0,10,4,1,4,3,43,46
p_63,8,0,e_0,581,592,630,8,4,1,11,4,1,3,11,38,49
p_107,1,0,e_2,512,547,642,30,8,8,7,4,1,2,35,95,130
p_99,1,0,e_2,522,547,642,22,7,7,4,4,1,5,25,95,120
p_102,2,0,e_2,521,552,642,21,8,6,5,4,1,4,31,90,121
p_106,4,0,e_2,512,560,642,27,8,8,7,4,1,3,48,82,130
p_105,4,0,e_2,515,560,642,27,8,8,6,4,1,5,45,82,127
p_108,5,0,e_2,509,565,642,27,8,8,7,4,1,2,56,77,133
p_83,5,0,e_2,546,565,642,13,5,3,1,2,0,5,19,77,96
p_116,7,0,e_2,490,573,642,29,8,8,12,4,1,2,83,69,152
p_121,9,0,e_2,480,581,642,30,6,6,14,4,1,2,101,61,162
p_114,9,0,e_2,494,581,642,26,7,7,11,4,1,3,87,61,148
p_69,10,0,e_2,573,586,642,8,4,1,7,5,1,2,13,56,69
p_58,10,0,e_2,586,588,642,5,4,1,10,5,1,2,2,54,56
p_66,12,0,e_2,577,596,642,5,5,2,8,5,1,3,19,46,65
p_65,12,0,e_2,578,596,642,4,5,1,8,5,1,4,18,46,64
p_50,10,0,e_2,592,604,642,4,6,1,11,5,1,4,12,38,50
p_110,1,0,e_3,501,523,642,2,7,1,3,4,1,6,22,119,141
p_143,2,0,e_3,451,528,642,13,4,0,15,5,1,3,77,114,191
p_148,3,0,e_3,447,533,642,13,3,1,14,2,1,2,86,109,195
p_118,4,0,e_3,488,538,642,2,7,1,6,4,1,6,50,104,154
p_166,5,0,e_3,415,543,642,13,4,3,6,5,1,3,128,99,227
p_119,5,0,e_3,483,543,642,3,7,0,8,4,1,6,60,99,159
p_96,5,0,e_3,527,543,642,17,7,3,2,2,1,6,16,99,115
p_95,6,0,e_3,527,548,642,16,7,3,2,2,1,6,21,94,115
p_131,9,0,e_3,467,559,642,3,4,0,12,4,1,3,92,83,175
p_130,9,0,e_3,469,559,642,2,5,0,11,4,1,4,90,83,173
p_128,10,0,e_3,471,564,642,1,6,0,11,4,1,5,93,78,171
p_100,10,0,e_3,522,564,642,13,7,1,1,2,0,7,42,78,120
p_97,10,0,e_3,526,564,642,12,8,1,2,5,1,7,38,78,116
p_134,12,0,e_3,462,572,642,1,4,0,13,4,1,3,110,70,180
p_101,12,0,e_3,521,572,642,11,8,0,1,5,0,8,51,70,121
p_51,1,0,e_2,591,647,722,13,5,3,11,5,1,3,56,75,131
p_56,2,0,e_2,588,652,722,12,4,1,10,5,1,2,64,70,134
p_70,3,0,e_2,572,657,722,15,4,1,7,2,1,1,85,65,150
p_32,5,0,e_2,657,665,722,21,6,5,3,5,1,2,8,57,65
p_31,5,0,e_2,662,665,722,19,6,4,4,5,1,3,3,57,60
p_33,8,0,e_2,647,676,722,21,6,4,1,5,1,3,29,46,75
p_41,10,0,e_2,600,684,722,1,6,0,11,4,1,4,84,38,122
p_28,6,0,e_2,679,698,722,14,4,3,9,5,1,2,19,24,43
p_30,5,0,e_2,676,703,722,16,4,3,8,5,1,1,27,19,46
p_26,3,0,e_2,698,711,722,18,1,0,6,4,1,1,13,11,24
p_90,2,0,e_1,536,626,730,18,7,5,11,2,1,3,90,104,194
p_48,2,0,e_1,593,626,730,11,6,3,5,4,1,4,33,104,137
p_85,3,0,e_1,542,631,730,16,5,4,12,5,1,4,89,99,188
p_84,3,0,e_1,546,631,730,15,5,3,13,5,1,5,85,99,184
p_82,3,0,e_1,547,631,730,15,4,3,13,5,1,5,84,99,183
p_43,3,0,e_1,599,631,730,8,7,2,4,1,1,4,32,99,131
p_78,4,0,e_1,555,636,730,12,4,3,15,5,1,4,81,94,175
p_55,4,0,e_1,590,636,730,10,4,1,6,4,1,4,46,94,140
p_38,4,0,e_1,627,636,730,30,7,7,2,5,1,5,9,94,103
p_62,5,0,e_1,582,641,730,11,4,1,8,4,1,5,59,89,148
p_61,5,0,e_1,583,641,730,10,4,0,7,4,1,6,58,89,147
p_49,5,0,e_1,592,641,730,9,6,3,6,4,1,4,49,89,138
p_37,7,0,e_1,633,649,730,25,6,6,3,5,1,4,16,81,97
p_36,11,0,e_1,635,663,730,21,6,6,4,3,1,4,28,67,95
p_46,13,0,e_1,596,671,730,29,7,7,5,4,1,3,75,59,134
p_64,1,0,e_0,579,635,740,15,4,1,11,4,1,2,56,105,161
p_81,2,0,e_0,547,640,740,16,4,3,11,5,1,3,93,100,193
p_42,4,0,e_0,600,648,740,7,6,2,6,4,1,5,48,92,140
p_40,4,0,e_0,601,648,740,7,6,2,6,1,1,6,47,92,139
p_45,5,0,e_0,597,653,740,7,7,3,7,4,1,3,56,87,143
p_54,6,0,e_0,590,658,740,8,4,0,8,4,1,4,68,82,150
p_47,6,0,e_0,594,658,740,7,7,2,8,4,1,4,64,82,146
p_89,7,0,e_0,537,663,740,3,6,6,7,5,1,2,126,77,203
p_44,15,0,e_0,598,689,740,27,7,7,7,4,1,4,91,51,142
p_29,15,0,e_0,678,689,740,5,4,0,12,5,1,1,11,51,62
p_25,7,0,e_0,703,715,740,7,1,0,11,4,1,1,12,25,37
p_27,2,0,e_0,693,732,740,14,2,1,14,4,1,0,39,8,47
p_71,2,0,e_3,569,650,750,11,3,1,11,5,1,2,81,100,181
p_73,6,0,e_3,568,664,750,7,2,1,11,5,1,1,96,86,182
p_53,9,0,e_3,590,675,750,5,4,0,14,4,1,3,85,75,160
p_52,11,0,e_3,591,683,750,3,5,0,14,4,1,4,92,67,159
p_68,14,0,e_3,574,694,750,4,4,1,12,5,1,3,120,56,176
p_72,15,0,e_3,569,699,750,4,4,0,11,5,1,3,130,51,181
p_22,10,0,e_3,712,716,750,1,2,0,11,4,1,1,4,34,38
p_23,5,0,e_3,709,733,750,7,1,0,12,4,1,0,24,17,41
p_18,2,0,e_3,768,777,785,2,0,0,0,3,0,0,9,8,17
p_20,9,0,e_2,737,762,799,25,1,1,1,5,0,1,25,37,62
p_21,10,0,e_2,732,767,799,25,1,1,0,3,0,0,35,32,67
p_35,4,0,e_1,640,744,828,26,7,7,5,2,1,4,104,84,188
p_24,5,0,e_1,707,749,828,8,1,0,6,4,1,2,42,79,121
p_39,15,0,e_1,609,781,828,24,6,6,2,1,1,4,172,47,219
p_34,15,0,e_1,643,781,828,15,6,0,5,5,1,5,138,47,185
p_17,15,0,e_1,772,781,828,14,1,0,12,5,1,1,9,47,56
p_19,12,0,e_0,740,779,843,21,1,1,0,3,0,0,39,64,103
p_16,13,0,e_0,774,784,843,12,1,0,11,5,0,1,10,59,69
p_15,15,0,e_0,782,792,843,16,1,1,13,5,1,1,10,51,61
p_14,15,0,e_0,790,792,843,15,0,0,15,5,1,1,2,51,53
p_12,13,0,e_0,796,800,843,13,0,0,14,4,1,1,4,43,47
p_13,11,0,e_0,794,808,843,11,0,0,15,4,1,0,14,35,49
p_8,1,0,e_1,847,853,858,15,1,1,0,3,0,0,6,5,11
p_9,2,0,e_0,845,854,862,15,1,1,0,3,0,0,9,8,17
p_4,1,0,e_0,864,870,875,11,1,0,0,3,0,0,6,5,11
p_11,11,0,e_2,810,846,883,11,0,0,0,3,0,0,36,37,73
p_5,5,0,e_2,860,866,883,8,2,1,7,4,1,0,6,17,23
p_3,1,0,e_0,876,882,901,7,1,0,0,3,0,0,6,19,25
p_2,3,0,e_0,878,890,901,4,1,0,0,5,0,1,12,11,23
p_10,14,0,e_3,810,855,901,14,0,0,0,3,0,0,45,46,91
p_7,12,0,e_3,851,863,901,3,1,1,13,5,0,1,12,38,50
p_1,2,0,e_2,889,898,906,2,1,0,0,3,0,0,9,8,17
p_6,14,0,e_1,858,903,947,29,2,2,0,3,0,0,45,44,89
p_299,3,0,e_1,7,19,30,3,0,0,0,3,0,0,12,11,23
p_296,1,0,e_3,20,26,31,1,0,0,0,3,0,0,6,5,11
p_298,4,0,e_2,10,25,47,4,0,0,0,3,0,0,15,22,37
p_295,5,0,e_2,22,30,47,5,1,0,3,5,0,1,8,17,25
p_290,4,0,e_3,43,50,82,6,1,1,2,5,0,1,7,32,39
p_291,6,0,e_3,35,58,82,6,0,0,0,3,0,0,23,24,47
p_286,3,0,e_3,51,69,82,5,3,1,4,5,1,2,18,13,31
p_288,1,0,e_3,49,77,82,3,1,1,4,3,0,1,28,5,33
p_292,11,0,e_1,30,66,113,11,0,0,0,3,0,0,36,47,83
p_287,12,0,e_1,51,71,113,8,4,0,6,5,0,1,20,42,62
p_280,12,0,e_1,65,71,113,22,3,3,11,2,0,1,6,42,48
p_276,5,0,e_1,82,94,113,15,1,1,9,4,1,1,12,19,31
p_279,2,0,e_1,76,105,113,29,1,1,11,4,1,0,29,8,37
p_300,8,0,e_0,4,31,115,8,0,0,0,3,0,0,27,84,111
p_297,12,0,e_0,18,45,115,12,0,0,4,5,0,1,27,70,97
p_294,13,0,e_0,23,50,115,13,1,0,6,5,0,2,27,65,92
p_293,15,0,e_0,26,58,115,16,1,1,7,5,0,3,32,57,89
p_284,14,0,e_0,55,63,115,9,4,0,14,5,1,1,8,52,60
p_281,10,0,e_0,63,77,115,25,3,3,14,4,1,1,14,38,52
p_282,6,0,e_0,62,91,115,29,3,3,14,1,1,0,29,24,53
p_274,4,0,e_0,84,99,115,16,1,1,8,4,1,2,15,16,31
p_275,2,0,e_0,84,107,115,18,1,1,8,4,1,1,23,8,31
p_285,2,0,e_2,54,56,150,5,4,1,2,5,0,1,2,94,96
p_289,7,0,e_2,47,73,150,4,2,0,0,3,0,0,26,77,103
p_283,10,0,e_2,55,84,150,5,4,0,2,2,0,1,29,66,95
p_278,15,0,e_2,80,101,150,15,1,1,9,5,1,1,21,49,70
p_273,13,0,e_2,95,109,150,9,1,0,13,5,1,1,14,41,55
p_267,1,0,e_2,153,159,164,8,1,0,0,3,0,0,6,5,11
p_277,10,0,e_3,81,114,182,10,0,0,0,3,1,0,33,68,101
p_272,15,0,e_3,105,131,182,8,1,0,7,5,0,1,26,51,77
p_271,11,0,e_3,127,145,182,5,2,1,14,5,1,1,18,37,55
p_264,5,0,e_3,162,165,182,1,1,0,6,4,1,0,3,17,20
p_258,5,0,e_2,175,182,207,27,1,1,3,5,0,1,7,25,32
p_262,6,0,e_2,164,187,207,29,1,1,0,3,0,0,23,20,43
p_259,6,0,e_2,174,187,207,26,1,1,3,5,0,1,13,20,33
p_252,2,0,e_2,212,221,229,22,2,2,0,3,0,0,9,8,17
p_269,4,0,e_1,146,161,235,7,1,0,0,3,0,0,15,74,89
p_265,12,0,e_1,157,187,235,25,1,1,3,5,0,1,30,48,78
p_263,12,0,e_1,163,187,235,23,2,2,4,5,1,1,24,48,72
p_261,12,0,e_1,170,187,235,22,1,1,7,5,1,1,17,48,65
p_260,13,0,e_1,171,192,235,20,1,1,7,5,1,1,21,43,64
p_255,10,0,e_1,192,203,235,10,1,0,13,4,1,0,11,32,43
p_270,7,0,e_0,133,157,236,8,2,1,0,3,0,0,24,79,103
p_268,10,0,e_0,150,168,236,30,1,1,5,5,0,1,18,68,86
p_266,15,0,e_0,155,185,236,23,1,1,7,5,0,2,30,51,81
p_257,12,0,e_0,179,196,236,19,1,1,13,5,1,1,17,40,57
p_254,3,0,e_0,199,225,236,11,1,1,11,4,1,0,26,11,37
p_251,4,0,e_2,228,243,277,15,2,1,0,3,1,0,15,34,49
p_250,7,0,e_2,236,254,277,9,2,1,2,5,0,1,18,23,41
p_248,7,0,e_2,246,254,277,7,1,0,5,5,1,1,8,23,31
p_256,8,0,e_3,191,218,292,8,0,0,0,3,0,0,27,74,101
p_253,15,0,e_3,208,241,292,10,1,0,5,5,0,1,33,51,84
p_247,12,0,e_3,248,252,292,1,1,0,13,4,1,0,4,40,44
p_244,2,0,e_3,271,284,292,4,1,0,6,4,1,0,13,8,21
p_249,7,0,e_0,238,262,319,9,2,1,0,3,0,0,24,57,81
p_246,12,0,e_0,257,279,319,29,1,1,6,5,0,1,22,40,62
p_243,8,0,e_0,285,293,319,24,1,1,10,4,1,0,8,26,34
p_245,9,0,e_1,269,299,330,28,1,1,0,3,0,0,30,31,61
p_238,2,0,e_1,311,322,330,23,1,1,5,4,1,0,11,8,19
p_242,4,0,e_2,287,302,392,27,1,1,0,3,0,0,15,90,105
p_236,8,0,e_2,313,316,392,17,1,1,7,5,1,2,3,76,79
p_235,8,0,e_2,314,316,392,16,1,1,8,5,1,3,2,76,78
p_228,11,0,e_2,325,327,392,10,1,1,11,5,1,3,2,65,67
p_241,13,0,e_2,300,335,392,13,0,0,4,5,0,1,35,57,92
p_239,13,0,e_2,305,335,392,14,1,1,5,5,1,1,30,57,87
p_226,12,0,e_2,331,340,392,7,2,1,12,5,1,3,9,52,61
p_219,11,0,e_2,342,345,392,5,3,2,12,4,1,3,3,47,50
p_229,9,0,e_2,323,353,392,12,1,1,10,5,1,2,30,39,69
p_220,9,0,e_2,342,353,392,7,3,2,12,4,1,3,11,39,50
p_218,9,0,e_2,343,353,392,6,3,1,11,4,1,4,10,39,49
p_212,9,0,e_2,348,353,392,5,4,0,10,4,1,4,5,39,44
p_217,8,0,e_2,345,358,392,7,2,1,11,4,1,3,13,34,47
p_206,6,0,e_2,362,366,392,5,3,0,7,4,1,2,4,26,30
p_237,5,0,e_2,313,371,392,20,1,1,7,5,1,1,58,21,79
p_233,2,0,e_0,319,328,394,21,1,1,0,3,0,0,9,66,75
p_232,5,0,e_0,320,339,394,17,1,1,0,5,0,1,19,55,74
p_231,10,0,e_0,320,356,394,12,1,1,0,5,0,2,36,38,74
p_214,4,0,e_0,346,376,394,11,2,1,7,5,1,2,30,18,48
p_222,3,0,e_0,339,381,394,14,3,2,5,5,1,1,42,13,55
p_209,2,0,e_0,354,386,394,11,3,2,10,5,1,3,32,8,40
p_227,9,0,e_3,326,331,406,11,1,1,8,5,0,1,5,75,80
p_224,13,0,e_3,335,345,406,5,2,1,10,5,1,1,10,61,71
p_223,13,0,e_3,339,345,406,4,3,1,11,5,1,2,6,61,67
p_240,14,0,e_3,301,350,406,14,0,0,0,3,0,0,49,56,105
p_234,14,0,e_3,314,350,406,10,1,0,4,5,0,1,36,56,92
p_211,14,0,e_3,348,350,406,0,4,0,14,5,1,3,2,56,58
p_213,12,0,e_3,347,358,406,3,3,1,13,5,1,2,11,48,59
p_207,12,0,e_3,355,358,406,1,3,0,13,4,1,2,3,48,51
p_204,8,0,e_3,364,372,406,2,3,0,10,4,1,2,8,34,42
p_215,6,0,e_3,346,380,406,9,2,1,13,5,1,1,34,26,60
p_196,5,0,e_3,376,385,406,2,3,1,7,4,1,2,9,21,30
p_192,5,0,e_3,380,385,406,1,3,0,6,4,1,2,5,21,26
p_185,2,0,e_3,392,396,406,1,2,0,3,4,1,1,4,10,14
p_205,1,0,e_3,362,401,406,10,2,1,11,4,1,1,39,5,44
p_186,1,0,e_3,391,401,406,2,2,0,3,4,1,1,10,5,15
p_225,10,0,e_1,333,366,442,9,2,1,0,3,0,0,33,76,109
p_203,12,0,e_1,365,374,442,28,4,4,10,2,0,3,9,68,77
p_200,12,0,e_1,367,374,442,27,4,4,10,5,1,4,7,68,75
p_208,13,0,e_1,355,379,442,30,3,3,7,5,0,3,24,63,87
p_202,13,0,e_1,365,379,442,27,4,4,10,2,0,4,14,63,77
p_201,13,0,e_1,366,379,442,27,4,4,10,5,1,4,13,63,76
p_193,12,0,e_1,378,384,442,24,4,4,13,2,1,5,6,58,64
p_194,11,0,e_1,377,389,442,26,4,4,13,5,1,5,12,53,65
p_198,9,0,e_1,368,397,442,30,4,4,10,5,1,4,29,45,74
p_195,9,0,e_1,376,397,442,28,4,4,12,5,1,5,21,45,66
p_197,8,0,e_1,375,402,442,29,3,3,12,5,1,4,27,40,67
p_188,8,0,e_1,390,402,442,26,2,2,11,4,1,5,12,40,52
p_191,7,0,e_1,382,407,442,29,3,3,12,4,1,6,25,35,60
p_189,7,0,e_1,387,407,442,28,2,2,11,4,1,6,20,35,55
p_187,7,0,e_1,391,407,442,26,2,2,11,4,1,5,16,35,51
p_199,2,0,e_2,368,400,508,7,4,2,6,4,1,2,32,108,140
p_221,4,0,e_2,341,408,508,12,3,2,12,4,1,2,67,100,167
p_230,5,0,e_2,323,413,508,16,1,1,10,5,1,2,90,95,185
p_167,7,0,e_2,412,421,508,13,3,2,5,2,1,2,9,87,96
p_181,11,0,e_2,395,435,508,21,2,2,1,5,0,4,40,73,113
p_183,12,0,e_2,393,440,508,21,3,3,0,5,0,3,47,68,115
p_164,12,0,e_2,416,440,508,9,3,0,6,5,1,3,24,68,92
p_157,12,0,e_2,427,440,508,9,4,1,9,5,1,3,13,68,81
p_165,14,0,e_2,416,448,508,11,3,0,6,5,1,3,32,60,92
p_162,14,0,e_2,417,448,508,11,4,0,6,5,1,4,31,60,91
p_158,14,0,e_2,426,448,508,9,4,0,8,5,1,3,22,60,82
p_145,12,0,e_2,451,456,508,2,4,1,13,4,1,4,5,52,57
p_152,10,0,e_2,439,464,508,7,4,2,12,2,1,4,25,44,69
p_153,8,0,e_2,438,472,508,9,4,3,12,5,1,4,34,36,70
p_154,7,0,e_2,438,477,508,10,4,3,12,5,1,3,39,31,70
p_184,5,0,e_0,393,411,510,28,3,3,0,3,1,1,18,99,117
p_177,9,0,e_0,398,425,510,23,2,2,1,5,0,2,27,85,112
p_160,10,0,e_0,421,430,510,12,5,2,8,5,1,3,9,80,89
p_190,14,0,e_0,382,444,510,22,3,3,3,4,1,1,62,66,128
p_180,14,0,e_0,396,444,510,18,2,2,0,5,0,2,48,66,114
p_172,14,0,e_0,405,444,510,14,1,1,3,5,0,3,39,66,105
p_168,15,0,e_0,412,449,510,13,3,0,5,5,1,2,37,61,98
p_151,15,0,e_0,443,449,510,5,3,0,14,2,1,1,6,61,67
p_149,15,0,e_0,444,449,510,5,3,0,14,5,1,2,5,61,66
p_146,10,0,e_0,451,466,510,4,4,1,15,4,1,2,15,44,59
p_131,9,0,e_0,467,471,510,6,5,0,10,4,1,2,4,39,43
p_147,7,0,e_0,450,479,510,7,2,1,15,4,1,1,29,31,60
p_135,7,0,e_0,461,479,510,10,4,1,11,4,1,3,18,31,49
p_129,5,0,e_0,470,487,510,10,4,1,9,1,1,2,17,23,40
p_122,5,0,e_0,477,487,510,8,4,1,7,4,1,4,10,23,33
p_171,3,0,e_3,408,417,530,17,1,1,0,5,0,1,9,113,122
p_166,5,0,e_3,415,425,530,14,3,2,3,5,0,3,10,105,115
p_173,10,0,e_3,405,442,530,10,0,0,0,3,1,0,37,88,125
p_170,10,0,e_3,408,442,530,10,2,0,0,5,0,2,34,88,122
p_169,11,0,e_3,410,447,530,10,2,0,1,5,0,2,37,83,120
p_159,11,0,e_3,424,447,530,10,4,1,5,2,1,3,23,83,106
p_161,13,0,e_3,418,455,530,10,4,0,3,5,1,3,37,75,112
p_140,13,0,e_3,455,457,530,4,4,1,13,5,1,3,2,73,75
p_139,13,0,e_3,456,457,530,4,4,1,13,2,1,3,1,73,74
p_137,13,0,e_3,458,459,530,4,4,1,13,2,1,3,1,71,72
p_142,15,0,e_3,452,469,530,3,4,0,12,5,1,3,17,61,78
p_141,15,0,e_3,455,469,530,2,5,0,13,5,1,4,14,61,75
p_134,12,0,e_3,462,480,530,5,4,1,13,5,1,3,18,50,68
p_123,12,0,e_3,474,480,530,2,4,0,14,4,1,3,6,50,56
p_120,10,0,e_3,481,488,530,2,4,0,12,4,1,3,7,42,49
p_110,1,0,e_0,501,515,544,6,4,2,2,4,1,2,14,29,43
p_150,3,0,e_0,444,523,544,13,3,2,14,5,1,1,79,21,100
p_148,3,0,e_0,447,523,544,12,2,1,15,5,1,2,76,21,97
p_125,4,0,e_0,474,528,544,10,4,1,8,4,1,3,54,16,70
p_118,4,0,e_0,488,528,544,6,4,1,5,4,1,2,40,16,56
p_106,4,0,e_0,512,528,544,30,5,5,0,5,0,3,16,16,32
p_105,4,0,e_0,515,528,544,29,6,6,1,5,1,2,13,16,29
p_102,2,0,e_0,521,536,544,30,5,5,3,5,1,3,15,8,23
p_216,1,0,e_1,346,447,580,14,2,1,4,5,0,1,101,133,234
p_156,1,0,e_1,428,447,580,19,4,3,3,4,1,5,19,133,152
p_175,2,0,e_1,399,452,580,29,2,2,9,4,1,6,53,128,181
p_174,3,0,e_1,402,457,580,28,1,1,8,4,1,6,55,123,178
p_210,4,0,e_1,353,462,580,9,3,2,6,5,0,2,109,118,227
p_163,4,0,e_1,417,462,580,15,4,3,5,4,1,5,45,118,163
p_182,5,0,e_1,394,467,580,27,3,3,10,4,1,5,73,113,186
p_178,5,0,e_1,398,467,580,27,2,2,9,4,1,6,69,113,182
p_179,6,0,e_1,397,472,580,26,2,2,9,4,1,5,75,108,183
p_176,6,0,e_1,398,472,580,26,2,2,9,4,1,6,74,108,182
p_138,7,0,e_1,456,477,580,10,4,1,3,2,1,3,21,103,124
p_132,7,0,e_1,463,477,580,10,5,1,4,5,1,4,14,103,117
p_130,9,0,e_1,469,485,580,6,4,1,5,5,1,3,16,95,111
p_128,10,0,e_1,471,490,580,5,4,1,6,2,1,3,19,90,109
p_117,12,0,e_1,490,498,580,28,5,5,10,5,1,3,8,82,90
p_84,3,0,e_0,546,555,604,12,4,3,0,5,0,3,9,49,58
p_82,3,0,e_0,547,555,604,12,5,3,1,5,0,4,8,49,57
p_96,5,0,e_0,527,563,604,26,5,5,4,3,1,3,36,41,77
p_83,5,0,e_0,546,563,604,10,4,2,0,5,0,4,17,41,58
p_98,6,0,e_0,524,568,604,25,5,5,3,5,1,3,44,36,80
p_80,6,0,e_0,548,568,604,8,5,2,1,5,0,4,20,36,56
p_77,6,0,e_0,557,568,604,6,4,2,3,5,1,3,11,36,47
p_73,6,0,e_0,568,570,604,7,3,1,6,5,1,1,2,34,36
p_104,7,0,e_0,516,575,604,26,6,6,1,5,1,2,59,29,88
p_76,7,0,e_0,559,575,604,4,4,1,4,5,1,3,16,29,45
p_70,3,0,e_0,572,589,604,9,3,1,6,5,1,2,17,15,32
p_71,2,0,e_0,569,594,604,11,3,1,6,2,1,1,25,10,35
p_56,2,0,e_0,588,594,604,12,6,4,3,1,1,2,6,10,16
p_64,1,0,e_0,579,599,604,16,4,1,6,4,1,2,20,5,25
p_51,1,0,e_0,591,599,604,12,6,5,3,4,1,2,8,5,13
p_155,3,0,e_2,434,519,636,15,4,3,11,2,1,2,85,117,202
p_133,4,0,e_2,463,524,636,13,5,1,10,1,1,3,61,112,173
p_119,5,0,e_2,483,529,636,6,5,2,6,4,1,2,46,107,153
p_108,5,0,e_2,509,529,636,30,5,5,0,5,0,4,20,107,127
p_126,6,0,e_2,473,534,636,8,4,1,8,4,1,3,61,102,163
p_95,6,0,e_2,527,534,636,25,5,5,5,5,1,3,7,102,109
p_94,6,0,e_2,528,534,636,24,6,6,5,2,1,2,6,102,108
p_93,7,0,e_2,529,539,636,7,5,5,5,5,1,2,10,97,107
p_100,10,0,e_2,522,550,636,22,5,5,4,5,1,3,28,86,114
p_97,10,0,e_2,526,550,636,21,5,5,4,5,1,3,24,86,110
p_92,13,0,e_2,533,561,636,12,5,0,6,2,1,2,28,75,103
p_91,13,0,e_2,535,561,636,12,5,0,6,5,1,3,26,75,101
p_88,14,0,e_2,538,566,636,12,5,0,7,2,1,2,28,70,98
p_79,14,0,e_2,549,566,636,10,4,4,10,2,1,3,17,70,87
p_75,14,0,e_2,563,566,636,7,3,0,13,5,1,2,3,70,73
p_107,1,0,e_3,512,535,646,3,4,1,4,4,1,3,23,111,134
p_99,1,0,e_3,522,535,646,1,5,0,2,4,1,4,13,111,124
p_143,2,0,e_3,451,540,646,12,2,1,12,5,1,1,89,106,195
p_85,3,0,e_3,542,545,646,13,4,3,2,5,1,3,3,101,104
p_144,4,0,e_3,451,550,646,10,3,1,12,5,1,2,99,96,195
p_116,7,0,e_3,490,561,646,3,4,1,10,4,1,3,71,85,156
p_121,9,0,e_3,480,569,646,3,3,0,12,4,1,2,89,77,166
p_74,11,0,e_3,567,577,646,2,3,0,9,5,1,2,10,69,79
p_68,14,0,e_3,574,588,646,4,4,0,10,5,1,3,14,58,72
p_52,11,0,e_3,591,599,646,2,6,0,13,4,1,5,8,47,55
p_58,10,0,e_3,586,604,646,4,5,0,14,5,1,4,18,42,60
p_50,10,0,e_3,592,604,646,3,7,1,13,4,1,6,12,42,54
p_41,10,0,e_3,600,604,646,1,6,0,11,4,1,5,4,42,46
p_67,8,0,e_3,574,612,646,4,3,1,10,5,1,2,38,34,72
p_57,6,0,e_3,587,620,646,8,5,0,14,2,1,4,33,26,59
p_136,2,0,e_1,460,588,700,15,4,1,4,5,1,4,128,112,240
p_90,2,0,e_1,536,588,700,15,5,3,10,4,1,7,52,112,164
p_78,4,0,e_1,555,596,700,9,4,2,6,1,1,9,41,104,145
p_86,6,0,e_1,541,604,700,10,4,2,9,4,1,8,63,96,159
p_89,7,0,e_1,537,609,700,10,5,1,10,1,1,7,72,91,163
p_114,9,0,e_1,494,617,700,30,4,4,11,5,1,4,123,83,206
p_115,10,0,e_1,494,622,700,29,4,4,11,5,1,5,128,78,206
p_113,11,0,e_1,496,627,700,27,5,5,12,5,1,6,131,73,204
p_101,12,0,e_1,521,632,700,20,5,5,13,4,1,6,111,68,179
p_103,13,0,e_1,517,637,700,20,6,6,14,1,1,5,120,63,183
p_124,14,0,e_1,474,642,700,30,4,4,6,5,1,5,168,58,226
p_109,14,0,e_1,506,642,700,22,5,5,14,5,1,5,136,58,194
p_127,15,0,e_1,473,647,700,29,4,4,6,5,1,4,174,53,227
p_112,15,0,e_1,497,647,700,23,5,5,12,2,1,6,150,53,203
p_111,15,0,e_1,501,647,700,22,4,4,13,5,1,6,146,53,199
p_46,13,0,e_0,596,645,706,29,7,7,2,4,1,1,49,61,110
p_44,15,0,e_0,598,653,706,26,6,6,1,1,1,1,55,53,108
p_39,15,0,e_0,609,653,706,24,5,5,1,5,0,2,44,53,97
p_34,15,0,e_0,643,653,706,16,4,4,13,5,0,3,10,53,63
p_37,7,0,e_0,633,679,706,26,4,4,9,5,0,2,46,27,73
p_28,6,0,e_0,679,684,706,2,2,0,7,4,1,0,5,22,27
p_27,2,0,e_0,693,698,706,2,1,0,3,4,1,0,5,8,13
p_81,2,0,e_3,547,654,706,13,4,3,3,5,1,3,107,52,159
p_38,4,0,e_3,627,662,706,1,2,0,5,4,1,1,35,44,79
p_61,5,0,e_3,583,667,706,10,4,1,13,5,1,3,84,39,123
p_33,8,0,e_3,647,678,706,8,3,0,0,5,0,3,31,28,59
p_30,5,0,e_3,676,689,706,3,2,0,8,5,1,1,13,17,30
p_24,5,0,e_0,707,725,742,5,0,0,0,3,0,0,18,17,35
p_23,5,0,e_3,709,727,744,5,0,0,0,3,0,0,18,17,35
p_48,2,0,e_2,593,644,756,11,7,5,9,4,1,7,51,112,163
p_43,3,0,e_2,599,649,756,8,6,4,8,1,1,8,50,107,157
p_55,4,0,e_2,590,654,756,10,6,4,10,4,1,6,64,102,166
p_42,4,0,e_2,600,654,756,7,6,4,8,4,1,9,54,102,156
p_40,4,0,e_2,601,654,756,7,6,4,8,4,1,9,53,102,155
p_62,5,0,e_2,582,659,756,11,4,1,12,4,1,3,77,97,174
p_49,5,0,e_2,592,659,756,8,7,4,10,4,1,7,67,97,164
p_45,5,0,e_2,597,659,756,6,7,3,9,4,1,8,62,97,159
p_59,6,0,e_2,584,664,756,9,5,1,12,4,1,4,80,92,172
p_54,6,0,e_2,590,664,756,8,6,2,10,4,1,7,74,92,166
p_47,6,0,e_2,594,664,756,6,7,3,9,1,1,8,70,92,162
p_63,8,0,e_2,581,672,756,8,4,1,12,1,1,2,91,84,175
p_60,9,0,e_2,584,677,756,6,5,1,12,4,1,5,93,79,172
p_53,9,0,e_2,590,677,756,5,6,1,10,4,1,7,87,79,166
p_69,10,0,e_2,573,682,756,2,3,1,15,4,1,0,109,74,183
p_35,4,0,e_1,640,714,786,28,3,3,14,5,1,3,74,72,146
p_32,5,0,e_1,657,719,786,8,4,1,12,4,1,2,62,67,129
p_31,5,0,e_1,662,719,786,7,3,1,11,4,1,2,57,67,124
p_21,10,0,e_1,732,736,786,24,1,1,9,5,1,1,4,50,54
p_36,11,0,e_1,635,741,786,22,4,4,13,5,1,3,106,45,151
p_19,12,0,e_1,740,746,786,19,1,1,11,2,1,1,6,40,46
p_20,9,0,e_1,737,757,786,23,1,1,10,5,1,1,20,29,49
p_26,3,0,e_2,698,767,860,29,1,1,14,5,1,2,69,93,162
p_25,7,0,e_2,703,781,860,24,1,1,15,4,1,2,78,79,157
p_22,10,0,e_2,712,792,860,10,1,0,12,4,1,3,80,68,148
p_66,12,0,e_2,577,800,860,5,4,1,13,4,1,2,223,60,283
p_65,12,0,e_2,578,800,860,5,4,1,13,4,1,3,222,60,282
p_87,15,0,e_2,539,811,860,13,4,0,7,5,1,3,272,49,321
p_72,15,0,e_2,569,811,860,6,3,0,15,5,1,1,242,49,291
p_29,15,0,e_2,678,811,860,23,2,2,9,5,1,3,133,49,182
p_9,2,0,e_2,845,852,860,5,1,0,4,4,1,0,7,8,15
p_18,2,0,e_0,768,777,865,2,0,0,0,3,0,0,9,88,97
p_16,13,0,e_0,774,812,865,17,1,1,1,5,0,1,38,53,91
p_12,13,0,e_0,796,812,865,10,1,1,8,5,1,1,16,53,69
p_10,14,0,e_0,810,817,865,4,1,1,13,5,1,2,7,48,55
p_11,11,0,e_0,810,828,865,7,1,1,13,5,1,1,18,37,55
p_8,1,0,e_0,847,860,865,5,1,0,5,4,1,0,13,5,18
p_13,11,0,e_1,794,830,865,12,1,1,0,3,0,0,36,35,71
p_17,15,0,e_3,772,820,867,15,0,0,0,3,0,0,48,47,95
p_15,15,0,e_3,782,820,867,12,1,0,3,5,0,1,38,47,85
p_14,15,0,e_3,790,820,867,10,1,0,5,5,0,1,30,47,77
p_4,1,0,e_0,864,870,875,30,1,1,0,3,1,0,6,5,11
p_3,1,0,e_0,876,882,887,1,0,0,0,3,0,0,6,5,11
p_2,3,0,e_3,878,890,901,3,0,0,0,3,0,0,12,11,23
p_1,2,0,e_0,889,898,906,5,0,0,0,3,0,0,9,8,17
p_5,5,0,e_2,860,877,938,27,1,1,0,5,0,1,17,61,78
p_7,12,0,e_2,851,900,938,23,1,1,2,1,1,0,49,38,87
p_6,14,0,e_1,858,909,953,19,1,1,2,4,1,0,51,44,95
p_299,3,0,e_1,7,19,30,3,0,0,0,3,0,0,12,11,23
p_296,1,0,e_3,20,26,31,1,0,0,0,3,0,0,6,5,11
p_298,4,0,e_2,10,25,47,4,0,0,0,3,0,0,15,22,37
p_295,5,0,e_2,22,30,47,5,1,0,3,5,0,1,8,17,25
p_288,1,0,e_2,49,55,98,3,2,2,0,3,0,0,6,43,49
p_285,2,0,e_2,54,60,98,7,3,2,1,2,0,1,6,38,44
p_286,3,0,e_2,51,65,98,7,3,2,0,5,0,1,14,33,47
p_282,6,0,e_2,62,76,98,7,2,1,2,5,1,1,14,22,36
p_279,2,0,e_2,76,90,98,8,1,0,6,4,1,0,14,8,22
p_275,2,0,e_2,84,90,98,5,1,0,4,4,1,3,6,8,14
p_290,4,0,e_3,43,50,108,6,1,1,2,5,0,1,7,58,65
p_291,6,0,e_3,35,58,108,6,0,0,0,3,0,0,23,50,73
p_289,7,0,e_3,47,63,108,4,2,0,3,5,0,2,16,45,61
p_283,10,0,e_3,55,74,108,5,3,0,5,5,1,2,19,34,53
p_281,10,0,e_3,63,74,108,3,2,0,7,5,1,1,11,34,45
p_274,4,0,e_3,84,94,108,3,1,0,7,4,1,0,10,14,24
p_300,8,0,e_0,4,31,109,8,0,0,0,3,0,0,27,78,105
p_297,12,0,e_0,18,45,109,12,0,0,4,5,0,1,27,64,91
p_294,13,0,e_0,23,50,109,13,1,0,6,5,0,2,27,59,86
p_293,15,0,e_0,26,58,109,16,1,1,7,5,0,3,32,51,83
p_284,14,0,e_0,55,63,109,9,4,0,14,5,1,1,8,46,54
p_276,5,0,e_0,82,92,109,3,1,0,8,4,1,0,10,17,27
p_292,11,0,e_1,30,66,109,11,0,0,0,3,0,0,36,43,79
p_287,12,0,e_1,51,71,109,8,3,0,6,5,0,1,20,38,58
p_280,12,0,e_1,65,71,109,5,2,0,11,2,0,1,6,38,44
p_269,4,0,e_3,146,161,177,4,0,0,0,3,0,0,15,16,31
p_267,1,0,e_3,153,172,177,5,1,1,2,5,0,1,19,5,24
p_277,10,0,e_2,81,130,202,28,1,1,5,4,1,2,49,72,121
p_273,13,0,e_2,95,141,202,21,1,1,1,4,1,2,46,61,107
p_278,15,0,e_2,80,149,202,23,1,1,5,4,1,1,69,53,122
p_272,15,0,e_2,105,149,202,16,1,1,2,5,0,3,44,53,97
p_265,12,0,e_2,157,160,202,9,2,0,13,4,1,0,3,42,45
p_262,6,0,e_2,164,180,202,27,2,2,11,4,1,1,16,22,38
p_259,6,0,e_2,174,180,202,25,1,1,8,4,1,2,6,22,28
p_264,5,0,e_2,162,185,202,29,2,2,12,4,1,0,23,17,40
p_258,5,0,e_2,175,185,202,25,1,1,7,4,1,2,10,17,27
p_270,7,0,e_1,133,157,224,7,0,0,0,3,0,0,24,67,91
p_268,10,0,e_1,150,168,224,9,1,0,5,5,0,1,18,56,74
p_263,12,0,e_1,163,176,224,22,2,2,9,5,1,1,13,48,61
p_261,12,0,e_1,170,176,224,19,2,2,10,5,1,1,6,48,54
p_260,13,0,e_1,171,181,224,18,1,1,11,5,1,1,10,43,53
p_257,12,0,e_1,179,186,224,12,0,0,13,5,1,1,7,38,45
p_271,11,0,e_0,127,163,228,11,0,0,0,3,0,0,36,65,101
p_266,15,0,e_0,155,177,228,13,2,0,9,5,0,1,22,51,73
p_256,8,0,e_0,191,200,228,8,0,0,11,4,1,0,9,28,37
p_254,3,0,e_0,199,217,228,15,1,1,8,1,1,0,18,11,29
p_252,2,0,e_2,212,221,229,22,2,2,0,3,0,0,9,8,17
p_251,4,0,e_0,228,243,277,15,2,1,0,3,0,0,15,34,49
p_250,7,0,e_0,236,254,277,10,2,1,2,5,0,1,18,23,41
p_249,7,0,e_0,238,254,277,9,2,1,3,5,0,2,16,23,39
p_248,7,0,e_0,246,254,277,7,1,0,5,5,1,1,8,23,31
p_255,10,0,e_3,192,225,293,10,0,0,0,3,0,0,33,68,101
p_253,15,0,e_3,208,242,293,10,1,0,5,5,0,1,34,51,85
p_247,12,0,e_3,248,253,293,1,1,0,13,4,1,0,5,40,45
p_244,2,0,e_3,271,285,293,4,1,0,6,4,1,0,14,8,22
p_243,8,0,e_2,285,296,332,24,1,1,5,5,0,1,11,36,47
p_245,9,0,e_2,269,301,332,28,1,1,0,3,0,0,32,31,63
p_233,2,0,e_2,319,324,332,12,1,1,3,4,1,0,5,8,13
p_246,12,0,e_1,257,296,336,29,1,1,0,3,0,0,39,40,79
p_237,5,0,e_1,313,319,336,5,1,0,7,4,1,0,6,17,23
p_221,4,0,e_2,341,356,374,14,4,3,0,3,0,0,15,18,33
p_214,4,0,e_2,346,356,374,13,3,2,1,5,0,2,10,18,28
p_210,4,0,e_2,353,356,374,14,4,3,3,5,0,3,3,18,21
p_209,2,0,e_2,354,364,374,16,4,3,4,5,0,3,10,10,20
p_216,1,0,e_2,346,369,374,16,3,2,1,5,0,1,23,5,28
p_205,1,0,e_2,362,369,374,15,3,2,2,4,1,3,7,5,12
p_242,4,0,e_0,287,302,394,28,1,1,0,3,0,0,15,92,107
p_241,13,0,e_0,300,331,394,13,0,0,4,5,0,1,31,63,94
p_239,13,0,e_0,305,331,394,13,0,0,5,5,1,2,26,63,89
p_240,14,0,e_0,301,336,394,14,0,0,4,3,0,1,35,58,93
p_234,14,0,e_0,314,336,394,14,2,0,8,5,1,2,22,58,80
p_224,13,0,e_0,335,341,394,7,4,0,14,2,1,3,6,53,59
p_226,12,0,e_0,331,346,394,7,4,0,13,5,1,3,15,48,63
p_228,11,0,e_0,325,351,394,8,5,0,11,5,1,3,26,43,69
p_219,11,0,e_0,342,351,394,7,4,1,13,4,1,4,9,43,52
p_220,9,0,e_0,342,359,394,9,4,2,13,4,1,3,17,35,52
p_218,9,0,e_0,343,359,394,9,4,2,13,4,1,4,16,35,51
p_212,9,0,e_0,348,359,394,8,4,3,12,4,1,3,11,35,46
p_206,6,0,e_0,362,370,394,10,3,2,8,4,1,1,8,24,32
p_230,5,0,e_0,323,375,394,12,4,2,11,5,1,2,52,19,71
p_199,2,0,e_0,368,386,394,13,3,1,6,4,1,2,18,8,26
p_222,3,0,e_1,339,351,396,10,4,3,0,3,0,0,12,45,57
p_217,8,0,e_1,345,368,396,9,4,2,1,5,0,1,23,28,51
p_204,8,0,e_1,364,368,396,7,2,1,7,5,1,1,4,28,32
p_196,5,0,e_1,376,379,396,9,3,2,6,4,1,0,3,17,20
p_238,2,0,e_3,311,320,436,2,0,0,0,3,0,0,9,116,125
p_232,5,0,e_3,320,331,436,9,2,1,2,5,1,1,11,105,116
p_236,8,0,e_3,313,342,436,8,1,0,0,5,0,1,29,94,123
p_235,8,0,e_3,314,342,436,8,2,0,0,5,0,2,28,94,122
p_229,9,0,e_3,323,347,436,8,4,1,3,5,1,3,24,89,113
p_227,9,0,e_3,326,347,436,7,5,1,4,5,1,4,21,89,110
p_231,10,0,e_3,320,352,436,8,3,0,2,5,1,2,32,84,116
p_225,10,0,e_3,333,352,436,5,4,0,5,5,1,3,19,84,103
p_213,12,0,e_3,347,360,436,5,3,1,9,5,1,2,13,76,89
p_207,12,0,e_3,355,360,436,5,4,2,11,5,1,3,5,76,81
p_223,13,0,e_3,339,365,436,6,4,0,7,5,1,3,26,71,97
p_208,13,0,e_3,355,365,436,4,4,1,11,5,1,3,10,71,81
p_202,13,0,e_3,365,367,436,2,3,1,13,5,1,2,2,69,71
p_201,13,0,e_3,366,367,436,2,3,1,13,2,1,2,1,69,70
p_211,14,0,e_3,348,374,436,5,4,0,9,5,1,3,26,62,88
p_184,5,0,e_0,393,411,484,4,9,2,0,3,1,0,18,73,91
p_182,5,0,e_0,394,411,484,4,8,2,0,5,0,1,17,73,90
p_178,5,0,e_0,398,411,484,3,8,1,1,5,0,2,13,73,86
p_179,6,0,e_0,397,416,484,3,8,2,1,5,0,1,19,68,87
p_176,6,0,e_0,398,416,484,2,8,1,1,5,0,2,18,68,86
p_177,9,0,e_0,398,427,484,29,9,9,1,5,0,2,29,57,86
p_173,10,0,e_0,405,432,484,27,9,9,3,5,0,3,27,52,79
p_170,10,0,e_0,408,432,484,26,10,10,4,5,0,4,24,52,76
p_160,10,0,e_0,421,432,484,23,9,9,7,5,1,4,11,52,63
p_159,11,0,e_0,424,437,484,21,10,10,8,5,1,4,13,47,60
p_152,10,0,e_0,439,442,484,13,9,2,11,4,1,5,3,42,45
p_153,8,0,e_0,438,450,484,16,9,3,11,4,1,4,12,34,46
p_154,7,0,e_0,438,455,484,17,9,4,11,4,1,3,17,29,46
p_147,7,0,e_0,450,455,484,20,8,5,8,4,1,4,5,29,34
p_166,5,0,e_0,415,463,484,30,9,9,6,2,1,2,48,21,69
p_215,6,0,e_2,346,394,488,11,3,2,1,5,0,2,48,94,142
p_197,8,0,e_2,375,402,488,6,3,2,0,5,0,1,27,86,113
p_183,12,0,e_2,393,416,488,27,9,9,6,2,0,2,23,72,95
p_190,14,0,e_2,382,424,488,28,5,5,2,5,0,2,42,64,106
p_180,14,0,e_2,396,424,488,25,8,8,6,5,1,3,28,64,92
p_172,14,0,e_2,405,424,488,23,9,9,9,5,1,2,19,64,83
p_165,14,0,e_2,416,424,488,20,10,10,12,5,1,2,8,64,72
p_162,14,0,e_2,417,424,488,20,10,10,12,5,1,2,7,64,71
p_168,15,0,e_2,412,429,488,20,9,9,11,5,1,2,17,59,76
p_158,14,0,e_2,426,434,488,18,9,9,14,5,1,1,8,54,62
p_157,12,0,e_2,427,442,488,20,9,9,15,5,1,2,15,46,61
p_138,7,0,e_2,456,459,488,19,9,6,8,4,1,3,3,29,32
p_144,4,0,e_2,451,470,488,23,8,7,9,4,1,2,19,18,37
p_150,3,0,e_2,444,475,488,25,10,7,12,4,1,0,31,13,44
p_148,3,0,e_2,447,475,488,25,9,7,11,4,1,1,28,13,41
p_167,7,0,e_1,412,419,494,28,9,9,5,5,0,1,7,75,82
p_181,11,0,e_1,395,433,494,28,8,8,0,3,1,0,38,61,99
p_169,11,0,e_1,410,433,494,25,10,10,4,5,0,1,23,61,84
p_164,12,0,e_1,416,438,494,22,10,10,6,5,0,2,22,56,78
p_161,13,0,e_1,418,443,494,21,10,10,7,2,0,2,25,51,76
p_146,10,0,e_1,451,454,494,17,8,3,11,4,1,0,3,40,43
p_135,7,0,e_1,461,465,494,18,8,6,8,4,1,1,4,29,33
p_129,5,0,e_1,470,473,494,17,7,5,6,4,1,1,3,21,24
p_125,4,0,e_1,474,478,494,18,8,6,5,4,1,1,4,16,20
p_136,2,0,e_1,460,486,494,23,8,7,8,4,1,0,26,8,34
p_143,2,0,e_2,451,496,572,25,8,7,9,4,1,1,45,76,121
p_118,4,0,e_2,488,504,572,15,9,4,0,5,0,1,16,68,84
p_114,9,0,e_2,494,521,572,9,9,3,2,5,0,2,27,51,78
p_115,10,0,e_2,494,526,572,8,9,3,2,5,0,3,32,46,78
p_100,10,0,e_2,522,526,572,2,9,1,9,5,1,6,4,46,50
p_104,7,0,e_2,516,537,572,7,9,5,8,5,1,5,21,35,56
p_93,7,0,e_2,529,537,572,4,9,2,9,4,1,6,8,35,43
p_98,6,0,e_2,524,542,572,6,9,3,10,5,1,6,18,30,48
p_95,6,0,e_2,527,542,572,5,9,2,10,4,1,6,15,30,45
p_94,6,0,e_2,528,542,572,5,9,2,10,4,1,6,14,30,44
p_108,5,0,e_2,509,547,572,10,9,7,5,5,1,3,38,25,63
p_96,5,0,e_2,527,547,572,6,9,3,10,4,1,6,20,25,45
p_106,4,0,e_2,512,552,572,10,9,7,6,5,1,4,40,20,60
p_85,3,0,e_2,542,557,572,5,9,2,6,4,1,4,15,15,30
p_84,3,0,e_2,546,557,572,4,10,2,5,1,1,4,11,15,26
p_186,1,0,e_3,391,441,572,9,7,4,10,4,1,6,50,131,181
p_156,1,0,e_3,428,441,572,1,9,0,2,4,1,8,13,131,144
p_185,2,0,e_3,392,446,572,8,8,4,10,4,1,7,54,126,180
p_175,2,0,e_3,399,446,572,6,8,2,8,1,1,7,47,126,173
p_174,3,0,e_3,402,451,572,5,8,2,8,4,1,7,49,121,170
p_171,3,0,e_3,408,451,572,3,9,1,6,4,1,8,43,121,164
p_192,5,0,e_3,380,459,572,7,4,2,12,4,1,3,79,113,192
p_191,7,0,e_3,382,467,572,5,4,2,12,4,1,3,85,105,190
p_189,7,0,e_3,387,467,572,4,5,1,11,4,1,4,80,105,185
p_187,7,0,e_3,391,467,572,3,8,2,10,4,1,7,76,105,181
p_132,7,0,e_3,463,467,572,17,8,6,6,5,1,7,4,105,109
p_188,8,0,e_3,390,472,572,2,5,1,10,4,1,4,82,100,182
p_198,9,0,e_3,368,477,572,6,3,1,13,2,1,2,109,95,204
p_195,9,0,e_3,376,477,572,5,3,1,14,4,1,2,101,95,196
p_131,9,0,e_3,467,477,572,14,7,4,7,5,1,6,10,95,105
p_155,3,0,e_0,434,495,590,27,10,10,10,5,1,3,61,95,156
p_163,4,0,e_0,417,500,590,30,10,10,6,5,1,3,83,90,173
p_133,4,0,e_0,463,500,590,20,8,7,5,4,1,2,37,90,127
p_119,5,0,e_0,483,505,590,15,9,5,0,3,1,2,22,85,107
p_116,7,0,e_0,490,513,590,12,9,4,2,5,0,3,23,77,100
p_117,12,0,e_0,490,530,590,7,9,3,2,5,0,4,40,60,100
p_103,13,0,e_0,517,535,590,30,9,9,8,5,1,1,18,55,73
p_92,13,0,e_0,533,535,590,27,9,9,13,5,1,1,2,55,57
p_89,7,0,e_0,537,555,590,2,9,0,13,4,1,0,18,35,53
p_86,6,0,e_0,541,560,590,3,9,0,11,4,1,1,19,30,49
p_80,6,0,e_0,548,560,590,30,10,10,9,4,1,3,12,30,42
p_77,6,0,e_0,557,560,590,29,9,9,7,4,1,3,3,30,33
p_83,5,0,e_0,546,565,590,2,10,1,10,4,1,2,19,25,44
p_78,4,0,e_0,555,570,590,1,9,0,7,4,1,2,15,20,35
p_70,3,0,e_0,572,575,590,27,9,9,4,4,1,2,3,15,18
p_113,11,0,e_1,496,532,617,7,9,3,0,3,0,0,36,85,121
p_101,12,0,e_1,521,537,617,1,9,0,8,5,0,3,16,80,96
p_91,13,0,e_1,535,542,617,27,9,9,12,5,1,3,7,75,82
p_88,14,0,e_1,538,547,617,25,9,9,12,5,1,3,9,70,79
p_87,15,0,e_1,539,552,617,24,9,9,12,5,1,4,13,65,78
p_79,14,0,e_1,549,557,617,22,9,9,14,5,1,3,8,60,68
p_67,8,0,e_1,574,577,617,22,9,7,9,4,1,4,3,40,43
p_76,7,0,e_1,559,582,617,27,10,10,14,4,1,2,23,35,58
p_73,6,0,e_1,568,587,617,25,10,10,11,4,1,3,19,30,49
p_59,6,0,e_1,584,587,617,20,9,7,7,4,1,4,3,30,33
p_62,5,0,e_1,582,592,617,22,9,8,7,4,1,3,10,25,35
p_61,5,0,e_1,583,592,617,22,9,8,7,4,1,4,9,25,34
p_105,4,0,e_1,515,597,617,10,9,7,6,5,0,2,82,20,102
p_55,4,0,e_1,590,597,617,21,9,8,5,4,1,4,7,20,27
p_43,3,0,e_1,599,602,617,20,8,7,4,4,1,2,3,15,18
p_107,1,0,e_1,512,622,635,13,9,7,5,5,0,1,110,13,123
p_51,1,0,e_1,591,622,635,24,9,8,5,1,1,3,31,13,44
p_56,2,0,e_1,588,627,635,23,8,8,6,4,1,3,39,8,47
p_48,2,0,e_1,593,627,635,22,8,7,5,4,1,3,34,8,42
p_110,1,0,e_2,501,577,690,16,9,2,3,5,1,3,76,113,189
p_99,1,0,e_2,522,577,690,11,9,5,9,5,1,6,55,113,168
p_102,2,0,e_2,521,582,690,11,9,6,9,5,1,5,61,108,169
p_90,2,0,e_2,536,582,690,8,9,3,7,1,1,5,46,108,154
p_81,2,0,e_2,547,582,690,5,10,2,5,4,1,4,35,108,143
p_82,3,0,e_2,547,587,690,4,10,2,5,4,1,4,40,103,143
p_57,6,0,e_2,587,598,690,19,9,7,3,5,1,6,11,92,103
p_63,8,0,e_2,581,606,690,19,9,7,2,2,1,5,25,84,109
p_60,9,0,e_2,584,611,690,17,9,6,2,5,1,6,27,79,106
p_53,9,0,e_2,590,611,690,16,9,6,4,5,1,7,21,79,100
p_69,10,0,e_2,573,616,690,20,9,5,0,5,0,5,43,74,117
p_58,10,0,e_2,586,616,690,16,9,5,3,2,1,6,30,74,104
p_50,10,0,e_2,592,616,690,14,9,5,4,5,1,7,24,74,98
p_41,10,0,e_2,600,616,690,12,9,5,6,5,1,8,16,74,90
p_74,11,0,e_2,567,621,690,20,10,10,1,4,1,3,54,69,123
p_122,5,0,e_3,477,589,690,16,8,6,9,5,1,7,112,101,213
p_126,6,0,e_3,473,594,690,16,7,6,8,5,1,6,121,96,217
p_130,9,0,e_3,469,605,690,14,7,4,7,5,1,6,136,85,221
p_121,9,0,e_3,480,605,690,11,10,5,10,5,1,9,125,85,210
p_128,10,0,e_3,471,610,690,12,6,4,8,2,1,5,139,80,219
p_120,10,0,e_3,481,610,690,10,9,5,10,2,1,8,129,80,209
p_97,10,0,e_3,526,610,690,2,9,1,12,4,1,8,84,80,164
p_194,11,0,e_3,377,615,690,2,3,1,13,4,1,2,238,75,313
p_203,12,0,e_3,365,620,690,3,2,1,13,5,1,1,255,70,325
p_200,12,0,e_3,367,620,690,3,4,1,13,5,1,3,253,70,323
p_193,12,0,e_3,378,620,690,1,4,0,13,4,1,3,242,70,312
p_145,12,0,e_3,451,620,690,15,8,1,3,5,1,7,169,70,239
p_134,12,0,e_3,462,620,690,12,8,2,6,5,1,7,158,70,228
p_123,12,0,e_3,474,620,690,10,8,2,8,5,1,7,146,70,216
p_140,13,0,e_3,455,625,690,13,8,1,4,5,1,7,170,65,235
p_64,1,0,e_0,579,595,694,27,9,9,2,1,1,1,16,99,115
p_71,2,0,e_0,569,600,694,29,10,10,4,1,1,0,31,94,125
p_49,5,0,e_0,592,611,694,19,9,7,0,5,0,4,19,83,102
p_54,6,0,e_0,590,616,694,19,9,7,0,5,0,3,26,78,104
p_47,6,0,e_0,594,616,694,18,8,7,1,2,0,4,22,78,100
p_72,15,0,e_0,569,645,694,16,10,10,4,1,1,1,76,49,125
p_34,15,0,e_0,643,645,694,28,6,6,15,5,1,1,2,49,51
p_32,5,0,e_0,657,677,694,4,6,1,11,4,1,0,20,17,37
p_31,5,0,e_0,662,677,694,3,6,1,10,4,1,1,15,17,32
p_35,4,0,e_1,640,655,697,10,5,2,0,3,0,0,15,42,57
p_33,8,0,e_1,647,669,697,5,5,0,2,5,0,1,22,28,50
p_30,5,0,e_1,676,680,697,29,5,5,6,4,1,0,4,17,21
p_26,3,0,e_1,698,708,771,25,5,5,0,5,0,1,10,63,73
p_24,5,0,e_1,707,716,771,20,5,4,3,2,0,2,9,55,64
p_23,5,0,e_1,709,716,771,20,5,4,3,5,1,3,7,55,62
p_28,6,0,e_1,679,721,771,27,6,6,5,1,1,0,42,50,92
p_25,7,0,e_1,703,726,771,3,4,4,2,5,0,2,23,45,68
p_22,10,0,e_1,712,737,771,14,5,3,4,5,1,3,25,34,59
p_21,10,0,e_1,732,737,771,8,4,3,9,5,1,1,5,34,39
p_20,9,0,e_1,737,742,771,8,3,2,10,4,1,0,5,29,34
p_40,4,0,e_2,601,704,790,18,9,7,7,5,1,8,103,86,189
p_45,5,0,e_2,597,709,790,18,8,7,6,2,1,7,112,81,193
p_52,11,0,e_2,591,729,790,14,9,4,4,5,1,7,138,61,199
p_36,11,0,e_2,635,729,790,4,5,2,14,2,1,5,94,61,155
p_66,12,0,e_2,577,734,790,17,9,3,1,5,1,5,157,56,213
p_65,12,0,e_2,578,734,790,16,9,3,1,5,1,6,156,56,212
p_46,13,0,e_2,596,739,790,11,8,2,6,5,1,7,143,51,194
p_75,14,0,e_2,563,744,790,19,10,10,2,4,1,2,181,46,227
p_68,14,0,e_2,574,744,790,16,9,1,0,5,0,6,170,46,216
p_19,12,0,e_2,740,752,790,4,2,1,13,5,1,1,12,38,50
p_27,2,0,e_0,693,702,792,27,5,5,0,3,1,1,9,90,99
p_29,15,0,e_0,678,743,792,19,5,5,5,4,1,0,65,49,114
p_18,2,0,e_0,768,784,792,6,2,0,7,4,1,0,16,8,24
p_42,4,0,e_3,600,704,792,18,8,7,8,5,1,7,104,88,192
p_38,4,0,e_3,627,704,792,13,4,2,13,5,1,3,77,88,165
p_37,7,0,e_3,633,715,792,8,4,0,15,5,1,3,82,77,159
p_139,13,0,e_3,456,735,792,13,9,1,4,5,1,8,279,57,336
p_137,13,0,e_3,458,735,792,12,8,1,5,2,1,7,277,57,334
p_124,14,0,e_3,474,740,792,8,8,1,8,5,1,7,266,52,318
p_109,14,0,e_3,506,740,792,2,9,1,14,5,1,8,234,52,286
p_151,15,0,e_3,443,745,792,14,9,0,1,5,1,8,302,47,349
p_149,15,0,e_3,444,745,792,13,10,0,2,5,1,9,301,47,348
p_142,15,0,e_3,452,745,792,12,8,0,3,5,1,7,293,47,340
p_141,15,0,e_3,455,745,792,11,9,0,4,5,1,8,290,47,337
p_127,15,0,e_3,473,745,792,7,8,0,8,5,1,7,272,47,319
p_112,15,0,e_3,497,745,792,2,10,0,13,5,1,9,248,47,295
p_111,15,0,e_3,501,745,792,2,9,0,13,5,1,8,244,47,291
p_44,15,0,e_3,598,745,792,8,8,0,7,5,1,7,147,47,194
p_13,11,0,e_0,794,830,865,19,1,1,0,3,0,0,36,35,71
p_11,11,0,e_0,810,830,865,13,1,1,5,5,0,1,20,35,55
p_16,13,0,e_1,774,814,871,23,2,2,0,5,0,1,40,57,97
p_12,13,0,e_1,796,814,871,16,1,1,7,5,0,2,18,57,75
p_10,14,0,e_1,810,819,871,10,1,1,12,5,0,2,9,52,61
p_17,15,0,e_1,772,824,871,21,2,2,0,3,0,0,52,47,99
p_15,15,0,e_1,782,824,871,18,2,2,3,5,0,2,42,47,89
p_14,15,0,e_1,790,824,871,15,2,2,5,5,0,2,34,47,81
p_4,1,0,e_0,864,870,875,6,2,1,0,3,1,0,6,5,11
p_3,1,0,e_0,876,882,887,3,1,0,0,3,0,0,6,5,11
p_39,15,0,e_3,609,839,888,5,7,0,10,2,1,6,230,49,279
p_5,5,0,e_3,860,871,888,3,1,0,8,4,1,0,11,17,28
p_2,3,0,e_1,878,890,901,30,1,1,0,3,0,0,12,11,23
p_1,2,0,e_0,889,898,906,2,0,0,0,3,0,0,9,8,17
p_8,1,0,e_2,847,851,940,12,1,0,0,5,0,1,4,89,93
p_9,2,0,e_2,845,856,940,11,1,0,0,3,0,0,11,84,95
p_7,12,0,e_2,851,888,940,29,1,1,1,5,1,1,37,52,89
p_6,14,0,e_2,858,896,940,25,1,1,2,5,1,1,38,44,82
p_299,3,0,e_1,7,19,30,3,0,0,0,3,0,0,12,11,23
p_296,1,0,e_3,20,26,31,1,0,0,0,3,0,0,6,5,11
p_298,4,0,e_2,10,25,47,4,0,0,0,3,0,0,15,22,37
p_295,5,0,e_2,22,30,47,5,1,0,3,5,0,1,8,17,25
p_288,1,0,e_2,49,55,98,3,2,2,0,3,0,0,6,43,49
p_285,2,0,e_2,54,60,98,7,3,2,1,2,0,1,6,38,44
p_286,3,0,e_2,51,65,98,7,3,2,0,5,0,1,14,33,47
p_282,6,0,e_2,62,76,98,7,2,1,2,5,1,1,14,22,36
p_279,2,0,e_2,76,90,98,8,1,0,6,4,1,0,14,8,22
p_275,2,0,e_2,84,90,98,5,2,1,4,4,1,2,6,8,14
p_290,4,0,e_3,43,50,108,6,1,1,2,5,0,1,7,58,65
p_291,6,0,e_3,35,58,108,6,0,0,0,3,0,0,23,50,73
p_289,7,0,e_3,47,63,108,4,2,0,3,5,0,2,16,45,61
p_283,10,0,e_3,55,74,108,5,3,0,5,5,1,2,19,34,53
p_281,10,0,e_3,63,74,108,3,2,0,7,5,1,1,11,34,45
p_276,5,0,e_3,82,91,108,3,1,0,8,4,1,0,9,17,26
p_300,8,0,e_0,4,31,109,8,0,0,0,3,0,0,27,78,105
p_297,12,0,e_0,18,45,109,12,0,0,4,5,0,1,27,64,91
p_294,13,0,e_0,23,50,109,13,1,0,6,5,0,2,27,59,86
p_293,15,0,e_0,26,58,109,16,1,1,7,5,0,3,32,51,83
p_284,14,0,e_0,55,63,109,9,4,0,14,5,1,1,8,46,54
p_274,4,0,e_0,84,95,109,3,2,1,7,4,1,1,11,14,25
p_292,11,0,e_1,30,66,109,11,0,0,0,3,0,0,36,43,79
p_287,12,0,e_1,51,71,109,8,3,0,6,5,0,1,20,38,58
p_280,12,0,e_1,65,71,109,5,2,0,11,2,0,1,6,38,44
p_269,4,0,e_3,146,161,177,4,0,0,0,3,0,0,15,16,31
p_267,1,0,e_3,153,172,177,5,1,1,2,5,0,1,19,5,24
p_277,10,0,e_0,81,141,183,28,1,1,8,4,1,0,60,42,102
p_271,11,0,e_0,127,146,183,11,0,0,6,5,0,1,19,37,56
p_264,5,0,e_0,162,166,183,29,3,3,6,4,1,0,4,17,21
p_273,13,0,e_2,95,139,200,21,1,1,1,4,1,1,44,61,105
p_278,15,0,e_2,80,147,200,23,1,1,5,4,1,1,67,53,120
p_272,15,0,e_2,105,147,200,16,1,1,2,5,0,2,42,53,95
p_268,10,0,e_2,150,164,200,9,1,0,14,4,1,0,14,36,50
p_262,6,0,e_2,164,178,200,27,3,3,10,4,1,0,14,22,36
p_259,6,0,e_2,174,178,200,25,2,2,7,4,1,1,4,22,26
p_258,5,0,e_2,175,183,200,25,2,2,7,4,1,1,8,17,25
p_254,3,0,e_2,199,211,224,14,1,1,0,3,1,0,12,13,25
p_252,2,0,e_2,212,216,224,17,2,2,3,4,1,0,4,8,12
p_270,7,0,e_1,133,157,238,7,0,0,0,3,0,0,24,81,105
p_263,12,0,e_1,163,174,238,22,3,3,9,5,1,1,11,64,75
p_261,12,0,e_1,170,174,238,19,3,3,11,5,1,2,4,64,68
p_260,13,0,e_1,171,179,238,18,2,2,11,5,1,2,8,59,67
p_266,15,0,e_1,155,187,238,13,2,0,7,5,0,1,32,51,83
p_257,12,0,e_1,179,198,238,12,1,0,13,5,1,1,19,40,59
p_255,10,0,e_1,192,206,238,9,1,1,14,4,1,1,14,32,46
p_256,8,0,e_0,191,218,246,12,1,1,0,3,0,0,27,28,55
p_251,4,0,e_0,228,232,246,11,1,0,5,4,1,0,4,14,18
p_265,12,0,e_3,157,215,275,9,2,0,3,5,0,2,58,60,118
p_253,15,0,e_3,208,226,275,5,1,0,10,5,0,1,18,49,67
p_250,7,0,e_3,236,252,275,5,1,0,12,4,1,0,16,23,39
p_249,7,0,e_3,238,252,275,4,2,0,11,4,1,1,14,23,37
p_248,7,0,e_3,246,252,275,2,2,0,9,4,1,1,6,23,29
p_244,2,0,e_2,271,280,288,29,1,1,0,3,0,0,9,8,17
p_247,12,0,e_0,248,287,327,26,2,2,0,3,0,0,39,40,79
p_246,12,0,e_0,257,287,327,24,1,1,2,5,0,1,30,40,70
p_243,8,0,e_0,285,301,327,8,0,0,12,5,0,1,16,26,42
p_245,9,0,e_1,269,299,330,23,1,1,0,3,0,0,30,31,61
p_233,2,0,e_1,319,322,330,12,2,2,3,4,1,0,3,8,11
p_222,3,0,e_1,339,351,374,12,5,4,0,3,0,0,12,23,35
p_221,4,0,e_1,341,356,374,14,5,4,0,5,0,1,15,18,33
p_214,4,0,e_1,346,356,374,13,4,3,2,5,0,3,10,18,28
p_210,4,0,e_1,353,356,374,14,4,3,3,5,1,3,3,18,21
p_209,2,0,e_1,354,364,374,16,4,3,4,5,1,3,10,10,20
p_216,1,0,e_1,346,369,374,16,4,3,2,5,0,2,23,5,28
p_205,1,0,e_1,362,369,374,15,3,2,2,4,1,3,7,5,12
p_242,4,0,e_2,287,302,396,4,0,0,0,3,1,0,15,94,109
p_241,13,0,e_2,300,331,396,13,0,0,4,5,0,1,31,65,96
p_239,13,0,e_2,305,331,396,13,0,0,5,5,1,2,26,65,91
p_240,14,0,e_2,301,336,396,14,0,0,4,3,0,1,35,60,95
p_234,14,0,e_2,314,336,396,14,3,0,8,5,1,2,22,60,82
p_224,13,0,e_2,335,341,396,7,5,0,14,2,1,3,6,55,61
p_226,12,0,e_2,331,346,396,7,5,0,13,5,1,2,15,50,65
p_219,11,0,e_2,342,351,396,7,5,1,13,4,1,3,9,45,54
p_225,10,0,e_2,333,356,396,7,5,1,13,5,1,3,23,40,63
p_212,9,0,e_2,348,361,396,8,4,3,12,4,1,3,13,35,48
p_206,6,0,e_2,362,372,396,10,3,2,9,4,1,1,10,24,34
p_230,5,0,e_2,323,377,396,12,4,2,11,5,1,2,54,19,73
p_199,2,0,e_2,368,388,396,12,3,0,7,4,1,2,20,8,28
p_217,8,0,e_0,345,353,427,9,5,3,6,5,0,1,8,74,82
p_227,9,0,e_0,326,358,427,9,6,2,0,3,1,0,32,69,101
p_220,9,0,e_0,342,358,427,9,5,3,5,5,0,1,16,69,85
p_218,9,0,e_0,343,358,427,9,5,3,5,5,0,1,15,69,84
p_213,12,0,e_0,347,369,427,5,4,1,6,5,0,2,22,58,80
p_207,12,0,e_0,355,369,427,5,4,2,8,5,1,2,14,58,72
p_203,12,0,e_0,365,369,427,3,3,1,11,5,1,2,4,58,62
p_200,12,0,e_0,367,369,427,3,3,1,12,5,1,2,2,58,60
p_208,13,0,e_0,355,374,427,4,4,1,8,5,1,2,19,53,72
p_202,13,0,e_0,365,374,427,2,3,1,11,5,1,2,9,53,62
p_201,13,0,e_0,366,374,427,2,3,1,11,5,1,2,8,53,61
p_194,11,0,e_0,377,382,427,1,3,0,12,4,1,1,5,45,50
p_197,8,0,e_0,375,393,427,5,3,1,13,4,1,0,18,34,52
p_188,8,0,e_0,390,393,427,30,3,3,9,4,1,3,3,34,37
p_191,7,0,e_0,382,398,427,3,3,2,11,4,1,2,16,29,45
p_238,2,0,e_3,311,320,428,2,0,0,0,3,0,0,9,108,117
p_237,5,0,e_3,313,331,428,5,1,0,0,5,0,1,18,97,115
p_232,5,0,e_3,320,331,428,9,3,1,2,5,1,2,11,97,108
p_236,8,0,e_3,313,342,428,8,2,0,0,5,0,2,29,86,115
p_235,8,0,e_3,314,342,428,8,3,0,0,5,0,3,28,86,114
p_229,9,0,e_3,323,347,428,8,4,1,3,5,1,3,24,81,105
p_231,10,0,e_3,320,352,428,8,3,0,2,5,1,2,32,76,108
p_228,11,0,e_3,325,357,428,8,5,0,3,5,1,4,32,71,103
p_223,13,0,e_3,339,365,428,6,5,0,7,5,1,4,26,63,89
p_211,14,0,e_3,348,370,428,5,4,0,9,5,1,3,22,58,80
p_198,9,0,e_3,368,387,428,5,3,0,14,5,1,2,19,41,60
p_195,9,0,e_3,376,387,428,3,3,0,12,4,1,2,11,41,52
p_204,8,0,e_3,364,392,428,7,2,1,13,2,1,1,28,36,64
p_189,7,0,e_3,387,397,428,2,2,1,9,4,1,1,10,31,41
p_187,7,0,e_3,391,397,428,1,3,0,8,1,1,2,6,31,37
p_186,1,0,e_3,391,433,474,7,2,1,8,1,1,1,42,41,83
p_185,2,0,e_3,392,438,474,6,3,1,8,4,1,2,46,36,82
p_175,2,0,e_3,399,438,474,5,4,1,7,4,1,3,39,36,75
p_171,3,0,e_3,408,443,474,1,3,0,4,4,1,2,35,31,66
p_155,3,0,e_3,434,443,474,6,4,1,1,5,1,3,9,31,40
p_178,5,0,e_3,398,451,474,2,3,0,7,4,1,2,53,23,76
p_144,4,0,e_3,451,456,474,1,3,0,5,4,1,2,5,18,23
p_150,3,0,e_3,444,461,474,4,2,1,3,5,1,1,17,13,30
p_148,3,0,e_3,447,461,474,3,3,1,4,5,1,2,14,13,27
p_143,2,0,e_3,451,466,474,3,2,1,5,4,1,1,15,8,23
p_136,2,0,e_3,460,466,474,1,2,0,3,1,1,1,6,8,14
p_196,5,0,e_1,376,391,490,7,3,2,0,5,0,1,15,99,114
p_215,6,0,e_1,346,396,490,11,4,3,2,5,0,3,50,94,144
p_193,12,0,e_1,378,416,490,30,3,3,1,5,0,2,38,74,112
p_183,12,0,e_1,393,416,490,26,4,4,5,5,1,3,23,74,97
p_190,14,0,e_1,382,424,490,26,3,3,2,5,0,3,42,66,108
p_180,14,0,e_1,396,424,490,23,3,3,6,5,1,2,28,66,94
p_172,14,0,e_1,405,424,490,21,3,3,9,5,1,2,19,66,85
p_165,14,0,e_1,416,424,490,18,5,5,12,5,1,3,8,66,74
p_162,14,0,e_1,417,424,490,18,4,4,12,5,1,4,7,66,73
p_168,15,0,e_1,412,429,490,18,4,4,11,5,1,3,17,61,78
p_158,14,0,e_1,426,434,490,16,5,5,14,5,1,5,8,56,64
p_157,12,0,e_1,427,442,490,12,4,4,15,5,1,6,15,48,63
p_159,11,0,e_1,424,447,490,20,4,4,14,5,1,4,23,43,66
p_160,10,0,e_1,421,452,490,21,5,5,13,5,1,4,31,38,69
p_167,7,0,e_1,412,463,490,26,4,4,11,5,1,2,51,27,78
p_177,9,0,e_2,398,425,518,28,4,4,0,5,0,1,27,93,120
p_173,10,0,e_2,405,430,518,25,3,3,3,5,0,2,25,88,113
p_170,10,0,e_2,408,430,518,24,5,5,4,5,0,3,22,88,110
p_181,11,0,e_2,395,435,518,26,4,4,0,3,1,0,40,83,123
p_169,11,0,e_2,410,435,518,23,5,5,4,5,0,3,25,83,108
p_164,12,0,e_2,416,440,518,20,5,5,6,5,0,4,24,78,102
p_161,13,0,e_2,418,445,518,19,4,4,7,5,0,5,27,73,100
p_151,15,0,e_2,443,453,518,12,2,0,13,5,1,3,10,65,75
p_149,15,0,e_2,444,453,518,12,3,0,13,2,1,3,9,65,74
p_142,15,0,e_2,452,453,518,20,4,4,15,2,1,3,1,65,66
p_140,13,0,e_2,455,463,518,21,3,3,15,4,1,3,8,55,63
p_139,13,0,e_2,456,463,518,21,3,3,15,4,1,4,7,55,62
p_137,13,0,e_2,458,463,518,21,3,3,14,4,1,4,5,55,60
p_145,12,0,e_2,451,468,518,23,4,4,15,5,1,3,17,50,67
p_134,12,0,e_2,462,468,518,21,2,2,13,1,1,4,6,50,56
p_174,3,0,e_0,402,438,555,3,4,1,6,1,1,1,36,117,153
p_192,5,0,e_0,380,446,555,6,3,2,11,4,1,2,66,109,175
p_184,5,0,e_0,393,446,555,3,4,1,8,4,1,2,53,109,162
p_182,5,0,e_0,394,446,555,3,4,1,8,4,1,2,52,109,161
p_179,6,0,e_0,397,451,555,1,3,0,7,1,1,1,54,104,158
p_176,6,0,e_0,398,451,555,1,4,0,7,4,1,2,53,104,157
p_154,7,0,e_0,438,456,555,5,3,0,3,5,1,2,18,99,117
p_153,8,0,e_0,438,461,555,6,3,0,3,5,1,3,23,94,117
p_146,10,0,e_0,451,469,555,25,4,4,6,5,1,2,18,86,104
p_123,12,0,e_0,474,477,555,12,2,0,11,5,1,1,3,78,81
p_124,14,0,e_0,474,485,555,14,2,0,11,5,1,2,11,70,81
p_141,15,0,e_0,455,490,555,19,3,3,7,2,1,2,35,65,100
p_127,15,0,e_0,473,490,555,15,1,1,11,5,1,1,17,65,82
p_117,12,0,e_0,490,501,555,8,5,0,15,4,1,0,11,54,65
p_113,11,0,e_0,496,506,555,5,4,0,13,4,1,2,10,49,59
p_125,4,0,e_3,474,488,594,8,1,1,0,5,0,1,14,106,120
p_122,5,0,e_3,477,493,594,6,2,1,1,5,0,2,16,101,117
p_126,6,0,e_3,473,498,594,6,0,0,0,3,1,0,25,96,121
p_121,9,0,e_3,480,509,594,7,3,0,2,5,0,3,29,85,114
p_120,10,0,e_3,481,514,594,8,4,0,2,5,0,4,33,80,113
p_115,10,0,e_3,494,514,594,5,4,0,5,5,1,3,20,80,100
p_103,13,0,e_3,517,525,594,6,2,1,11,5,1,1,8,69,77
p_112,15,0,e_3,497,533,594,9,3,0,6,2,1,2,36,61,97
p_111,15,0,e_3,501,533,594,8,4,0,7,5,1,3,32,61,93
p_92,13,0,e_3,533,541,594,2,3,0,15,4,1,2,8,53,61
p_91,13,0,e_3,535,541,594,2,4,0,15,4,1,3,6,53,59
p_93,7,0,e_3,529,561,594,9,3,1,14,5,1,2,32,33,65
p_89,7,0,e_3,537,561,594,7,4,1,14,4,1,3,24,33,57
p_95,6,0,e_3,527,566,594,11,2,1,13,5,1,1,39,28,67
p_94,6,0,e_3,528,566,594,10,3,1,14,5,1,2,38,28,66
p_110,1,0,e_2,501,523,596,22,4,3,4,1,1,4,22,73,95
p_118,4,0,e_2,488,534,596,12,5,4,7,1,1,3,46,62,108
p_166,5,0,e_2,415,539,596,28,4,4,6,5,0,3,124,57,181
p_129,5,0,e_2,470,539,596,26,1,1,12,4,1,4,69,57,126
p_119,5,0,e_2,483,539,596,12,5,3,9,4,1,3,56,57,113
p_135,7,0,e_2,461,547,596,26,2,2,13,4,1,4,86,49,135
p_132,7,0,e_2,463,547,596,26,2,2,13,4,1,4,84,49,133
p_131,9,0,e_2,467,555,596,23,1,1,12,1,1,3,88,41,129
p_130,9,0,e_2,469,555,596,22,1,1,12,4,1,4,86,41,127
p_152,10,0,e_2,439,560,596,8,3,0,12,2,1,2,121,36,157
p_128,10,0,e_2,471,560,596,21,1,1,11,4,1,4,89,36,125
p_100,10,0,e_2,522,560,596,8,3,2,1,2,0,5,38,36,74
p_97,10,0,e_2,526,560,596,7,2,1,2,5,1,5,34,36,70
p_73,6,0,e_2,568,574,596,30,3,3,8,4,1,1,6,22,28
p_78,4,0,e_2,555,582,596,5,5,3,9,5,1,1,27,14,41
p_156,1,0,e_1,428,495,604,9,4,3,15,2,1,6,67,109,176
p_163,4,0,e_1,417,506,604,28,4,4,12,5,1,3,89,98,187
p_133,4,0,e_1,463,506,604,29,2,2,7,4,1,2,43,98,141
p_147,7,0,e_1,450,517,604,6,2,0,10,4,1,4,67,87,154
p_138,7,0,e_1,456,517,604,27,3,3,9,4,1,3,61,87,148
p_116,7,0,e_1,490,517,604,9,5,2,0,5,0,3,27,87,114
p_101,12,0,e_1,521,534,604,6,3,2,8,5,1,1,13,70,83
p_109,14,0,e_1,506,542,604,8,4,1,4,5,1,1,36,62,98
p_88,14,0,e_1,538,542,604,30,4,4,13,5,1,1,4,62,66
p_87,15,0,e_1,539,547,604,28,4,4,13,5,1,1,8,57,65
p_79,14,0,e_1,549,552,604,27,5,5,15,4,1,2,3,52,55
p_76,7,0,e_1,559,575,604,30,5,5,12,4,1,2,16,29,45
p_82,3,0,e_1,547,589,604,8,5,3,15,4,1,1,42,15,57
p_81,2,0,e_1,547,594,604,9,5,4,15,4,1,0,47,10,57
p_56,2,0,e_1,588,594,604,29,5,5,3,1,1,2,6,10,16
p_51,1,0,e_1,591,609,646,30,5,5,3,4,1,2,18,37,55
p_59,6,0,e_1,584,626,646,26,5,5,4,4,1,2,42,20,62
p_64,1,0,e_3,579,599,646,2,4,1,3,4,1,3,20,47,67
p_71,2,0,e_3,569,604,646,3,3,1,5,4,1,2,35,42,77
p_48,2,0,e_3,593,604,646,2,5,5,0,3,1,5,11,42,53
p_85,3,0,e_3,542,609,646,10,3,2,13,4,1,2,67,37,104
p_84,3,0,e_3,546,609,646,9,4,2,12,4,1,3,63,37,100
p_70,3,0,e_3,572,609,646,2,4,0,5,4,1,3,37,37,74
p_43,3,0,e_3,599,609,646,8,5,2,1,5,1,4,10,37,47
p_42,4,0,e_3,600,614,646,7,5,2,1,5,1,4,14,32,46
p_40,4,0,e_3,601,614,646,7,6,2,1,5,1,5,13,32,45
p_83,5,0,e_3,546,619,646,7,4,2,12,4,1,3,73,27,100
p_45,5,0,e_3,597,619,646,6,5,1,1,5,0,5,22,27,49
p_86,6,0,e_3,541,624,646,7,3,1,13,4,1,2,83,22,105
p_80,6,0,e_3,548,624,646,5,5,1,11,4,1,4,76,22,98
p_77,6,0,e_3,557,624,646,2,5,1,8,4,1,4,67,22,89
p_47,6,0,e_3,594,624,646,6,5,0,0,5,0,5,30,22,52
p_62,5,0,e_2,582,613,668,27,6,6,4,4,1,1,31,55,86
p_61,5,0,e_2,583,613,668,27,5,5,4,4,1,2,30,55,85
p_63,8,0,e_2,581,624,668,25,5,5,4,1,1,0,43,44,87
p_41,10,0,e_2,600,632,668,9,6,0,1,5,0,2,32,36,68
p_37,7,0,e_2,633,643,668,27,1,1,10,4,1,0,10,25,35
p_35,4,0,e_2,640,654,668,28,2,2,8,4,1,1,14,14,28
p_38,4,0,e_3,627,660,682,1,1,0,5,4,1,0,33,22,55
p_32,5,0,e_3,657,665,682,2,1,0,3,5,0,1,8,17,25
p_31,5,0,e_3,662,665,682,1,2,0,4,5,1,1,3,17,20
p_107,1,0,e_0,512,560,693,19,3,1,9,4,1,2,48,133,181
p_99,1,0,e_0,522,560,693,17,3,2,7,4,1,5,38,133,171
p_102,2,0,e_0,521,565,693,16,3,2,7,1,1,4,44,128,172
p_90,2,0,e_0,536,565,693,12,4,3,4,1,1,6,29,128,157
p_106,4,0,e_0,512,573,693,16,3,1,9,4,1,3,61,120,181
p_105,4,0,e_0,515,573,693,16,2,1,9,4,1,3,58,120,178
p_108,5,0,e_0,509,578,693,16,3,2,10,4,1,1,69,115,184
p_96,5,0,e_0,527,578,693,12,2,1,6,4,1,6,51,115,166
p_98,6,0,e_0,524,583,693,11,2,1,7,4,1,5,59,110,169
p_104,7,0,e_0,516,588,693,13,2,1,9,4,1,3,72,105,177
p_67,8,0,e_0,574,593,693,26,5,5,4,5,1,8,19,100,119
p_114,9,0,e_0,494,598,693,6,4,1,14,4,1,1,104,95,199
p_60,9,0,e_0,584,598,693,23,5,5,6,5,1,8,14,95,109
p_53,9,0,e_0,590,598,693,22,5,5,7,5,1,9,8,95,103
p_69,10,0,e_0,573,603,693,25,4,4,4,5,1,7,30,90,120
p_27,2,0,e_3,693,702,718,2,0,0,0,3,0,0,9,16,25
p_26,3,0,e_3,698,707,718,2,1,0,1,5,0,1,9,11,20
p_30,5,0,e_2,676,694,719,27,1,1,0,3,0,0,18,25,43
p_28,6,0,e_2,679,699,719,25,1,1,0,5,0,1,20,20,40
p_34,15,0,e_1,643,693,744,16,2,2,1,4,1,0,50,51,101
p_29,15,0,e_1,678,693,744,16,1,1,10,5,0,1,15,51,66
p_25,7,0,e_1,703,719,744,5,2,0,12,4,1,0,16,25,41
p_24,5,0,e_1,707,727,744,28,1,1,11,4,1,1,20,17,37
p_23,5,0,e_1,709,727,744,28,1,1,10,4,1,2,18,17,35
p_20,9,0,e_2,737,748,799,9,0,0,6,5,0,1,11,51,62
p_22,10,0,e_2,712,753,799,22,1,1,2,4,1,0,41,46,87
p_21,10,0,e_2,732,753,799,10,0,0,4,5,0,1,21,46,67
p_19,12,0,e_2,740,761,799,12,0,0,7,5,0,2,21,38,59
p_55,4,0,e_0,590,707,805,27,5,5,7,5,1,8,117,98,215
p_49,5,0,e_0,592,712,805,25,6,6,8,2,1,8,120,93,213
p_57,6,0,e_0,587,717,805,25,6,6,7,2,1,7,130,88,218
p_54,6,0,e_0,590,717,805,25,5,5,7,5,1,9,127,88,215
p_33,8,0,e_0,647,725,805,8,1,0,11,1,1,8,78,80,158
p_58,10,0,e_0,586,733,805,22,5,5,7,5,1,8,147,72,219
p_50,10,0,e_0,592,733,805,20,6,6,8,2,1,9,141,72,213
p_74,11,0,e_0,567,738,805,25,3,3,2,5,1,6,171,67,238
p_52,11,0,e_0,591,738,805,20,5,5,8,5,1,9,147,67,214
p_36,11,0,e_0,635,738,805,22,2,2,14,4,1,8,103,67,170
p_66,12,0,e_0,577,743,805,21,5,5,5,2,1,8,166,62,228
p_65,12,0,e_0,578,743,805,21,4,4,5,5,1,9,165,62,227
p_46,13,0,e_0,596,748,805,13,5,0,9,5,1,9,152,57,209
p_75,14,0,e_0,563,753,805,23,4,4,2,5,1,6,190,52,242
p_68,14,0,e_0,574,753,805,20,5,5,4,5,1,9,179,52,231
p_18,2,0,e_1,768,777,865,2,0,0,0,3,0,0,9,88,97
p_17,15,0,e_1,772,818,865,15,0,0,1,5,0,1,46,47,93
p_15,15,0,e_1,782,818,865,13,1,0,3,5,1,1,36,47,83
p_14,15,0,e_1,790,818,865,10,1,0,6,5,1,1,28,47,75
p_13,11,0,e_3,794,810,869,9,1,1,6,5,0,1,16,59,75
p_11,11,0,e_3,810,812,869,4,2,1,11,5,1,1,2,57,59
p_16,13,0,e_3,774,820,869,13,0,0,0,3,0,0,46,49,95
p_12,13,0,e_3,796,820,869,6,2,0,7,5,0,2,24,49,73
p_10,14,0,e_3,810,825,869,3,3,0,11,5,1,2,15,44,59
p_4,1,0,e_1,864,870,875,30,1,1,0,3,1,0,6,5,11
p_3,1,0,e_1,876,882,887,1,0,0,0,3,0,0,6,5,11
p_72,15,0,e_0,569,852,901,20,5,5,3,5,1,7,283,49,332
p_44,15,0,e_0,598,852,901,14,4,0,9,5,1,9,254,49,303
p_39,15,0,e_0,609,852,901,12,4,0,11,5,1,8,243,49,292
p_5,5,0,e_0,860,884,901,28,1,1,13,4,1,0,24,17,41
p_2,3,0,e_3,878,890,901,3,0,0,0,3,0,0,12,11,23
p_1,2,0,e_1,889,898,906,5,0,0,0,3,0,0,9,8,17
p_8,1,0,e_2,847,851,940,6,1,0,0,5,0,1,4,89,93
p_9,2,0,e_2,845,856,940,6,1,0,0,3,0,0,11,84,95
p_7,12,0,e_2,851,888,940,24,1,1,1,5,1,1,37,52,89
p_6,14,0,e_2,858,896,940,19,1,1,2,5,1,1,38,44,82
p_299,3,0,e_1,7,19,32,3,0,0,0,3,0,0,12,13,25
p_296,1,0,e_1,20,27,32,23,1,1,3,4,1,0,7,5,12
p_298,4,0,e_2,10,25,47,4,0,0,0,3,0,0,15,22,37
p_295,5,0,e_2,22,30,47,18,1,1,3,5,0,1,8,17,25
p_290,4,0,e_1,43,50,80,18,2,2,2,5,0,1,7,30,37
p_291,6,0,e_1,35,58,80,19,2,2,0,3,0,0,23,22,45
p_288,1,0,e_1,49,75,80,19,2,2,4,3,0,1,26,5,31
p_300,8,0,e_0,4,31,101,8,0,0,0,3,0,0,27,70,97
p_292,11,0,e_0,30,42,101,16,2,2,8,2,0,1,12,59,71
p_294,13,0,e_0,23,50,101,12,1,0,6,5,0,1,27,51,78
p_287,12,0,e_0,51,55,101,8,2,1,13,4,1,1,4,46,50
p_283,10,0,e_0,55,63,101,8,2,1,12,4,1,1,8,38,46
p_282,6,0,e_0,62,77,101,11,3,2,10,1,1,1,15,24,39
p_286,3,0,e_0,51,88,101,17,2,2,13,4,1,0,37,13,50
p_279,2,0,e_0,76,93,101,11,2,1,6,1,1,1,17,8,25
p_275,2,0,e_0,84,93,101,9,2,1,4,4,1,2,9,8,17
p_285,2,0,e_2,54,56,120,17,2,2,2,5,0,1,2,64,66
p_289,7,0,e_2,47,73,120,14,2,2,0,3,0,0,26,47,73
p_281,10,0,e_2,63,84,120,6,3,1,4,5,1,1,21,36,57
p_276,5,0,e_2,82,101,120,7,2,1,10,5,1,1,19,19,38
p_274,4,0,e_2,84,106,120,7,2,1,10,4,1,1,22,14,36
p_297,12,0,e_3,18,57,121,12,0,0,0,3,0,0,39,64,103
p_284,14,0,e_3,55,65,121,4,2,1,12,5,0,2,10,56,66
p_293,15,0,e_3,26,70,121,13,1,0,2,5,0,1,44,51,95
p_280,12,0,e_3,65,81,121,4,2,1,14,5,1,1,16,40,56
p_277,10,0,e_3,81,89,121,2,1,0,12,4,1,0,8,32,40
p_273,13,0,e_1,95,122,179,25,1,1,4,5,0,1,27,57,84
p_278,15,0,e_1,80,130,179,27,1,1,0,3,0,0,50,49,99
p_269,4,0,e_1,146,165,179,6,1,1,10,4,1,0,19,14,33
p_272,15,0,e_0,105,153,208,20,1,1,0,3,0,0,48,55,103
p_265,12,0,e_0,157,164,208,5,2,0,14,4,1,1,7,44,51
p_262,6,0,e_0,164,184,208,9,4,2,12,4,1,1,20,24,44
p_259,6,0,e_0,174,184,208,8,4,1,9,4,1,2,10,24,34
p_258,5,0,e_0,175,189,208,9,3,1,9,4,1,2,14,19,33
p_267,1,0,e_0,153,203,208,13,2,2,15,4,1,0,50,5,55
p_270,7,0,e_3,133,157,226,7,0,0,0,3,0,0,24,69,93
p_268,10,0,e_3,150,168,226,5,1,0,5,5,0,1,18,58,76
p_263,12,0,e_3,163,176,226,3,3,0,9,5,1,2,13,50,63
p_260,13,0,e_3,171,181,226,2,3,0,11,5,1,2,10,45,55
p_264,5,0,e_3,162,207,226,7,2,1,8,5,1,1,45,19,64
p_254,3,0,e_3,199,215,226,4,2,1,7,4,1,1,16,11,27
p_252,2,0,e_0,212,221,229,2,2,1,0,3,0,0,9,8,17
p_271,11,0,e_2,127,163,230,11,0,0,0,3,0,0,36,67,103
p_266,15,0,e_2,155,177,230,8,2,0,9,5,0,1,22,53,75
p_261,12,0,e_2,170,188,230,2,3,0,13,5,1,1,18,42,60
p_255,10,0,e_2,192,196,230,30,2,2,11,4,1,1,4,34,38
p_256,8,0,e_2,191,204,230,2,2,0,11,4,1,0,13,26,39
p_251,4,0,e_0,228,243,257,4,0,0,0,3,1,0,15,14,29
p_257,12,0,e_1,179,218,278,1,3,0,0,3,0,0,39,60,99
p_253,15,0,e_1,208,229,278,20,2,2,9,5,0,1,21,49,70
p_248,7,0,e_1,246,255,278,5,1,0,10,4,1,0,9,23,32
p_250,7,0,e_2,236,260,317,7,0,0,0,3,0,0,24,57,81
p_247,12,0,e_2,248,277,317,9,1,0,3,5,0,1,29,40,69
p_243,8,0,e_2,285,291,317,2,1,0,10,4,1,0,6,26,32
p_249,7,0,e_3,238,262,317,7,0,0,0,3,0,0,24,55,79
p_246,12,0,e_3,257,279,317,6,1,0,6,5,0,1,22,38,60
p_244,2,0,e_0,271,278,332,12,2,1,0,5,0,1,7,54,61
p_245,9,0,e_0,269,301,332,6,2,1,0,3,0,0,32,31,63
p_238,2,0,e_0,311,324,332,30,1,1,6,4,1,0,13,8,21
p_233,2,0,e_0,319,324,332,8,1,1,3,4,1,1,5,8,13
p_242,4,0,e_1,287,302,394,6,1,0,0,3,0,0,15,92,107
p_236,8,0,e_1,313,316,394,23,2,2,7,5,1,2,3,78,81
p_241,13,0,e_1,300,333,394,22,1,1,4,5,0,1,33,61,94
p_240,14,0,e_1,301,338,394,21,1,1,4,3,0,1,37,56,93
p_234,14,0,e_1,314,338,394,17,2,2,8,5,1,3,24,56,80
p_223,13,0,e_1,339,343,394,7,4,0,14,4,1,2,4,51,55
p_225,10,0,e_1,333,354,394,7,3,1,13,5,1,1,21,40,61
p_218,9,0,e_1,343,359,394,5,4,2,13,4,1,3,16,35,51
p_215,6,0,e_1,346,370,394,7,5,2,12,4,1,4,24,24,48
p_206,6,0,e_1,362,370,394,10,4,0,8,4,1,3,8,24,32
p_221,4,0,e_1,341,378,394,11,4,3,13,4,1,3,37,16,53
p_222,3,0,e_1,339,383,394,13,4,3,14,4,1,1,44,11,55
p_237,5,0,e_3,313,334,411,26,1,1,1,4,1,0,21,77,98
p_232,5,0,e_3,320,334,411,4,1,0,1,5,0,1,14,77,91
p_230,5,0,e_3,323,334,411,13,2,1,2,5,0,2,11,77,88
p_229,9,0,e_3,323,348,411,9,2,1,2,5,0,2,25,63,88
p_231,10,0,e_3,320,353,411,9,1,0,1,5,0,1,33,58,91
p_228,11,0,e_3,325,358,411,9,3,0,2,5,0,3,33,53,86
p_213,12,0,e_3,347,363,411,3,4,0,9,2,1,3,16,48,64
p_198,9,0,e_3,368,374,411,2,4,0,11,4,1,3,6,37,43
p_196,5,0,e_3,376,388,411,4,4,0,9,4,1,3,12,23,35
p_192,5,0,e_3,380,388,411,2,5,0,7,4,1,4,8,23,31
p_210,4,0,e_3,353,393,411,10,4,2,10,5,1,3,40,18,58
p_209,2,0,e_3,354,401,411,12,5,2,10,5,1,4,47,10,57
p_185,2,0,e_3,392,401,411,2,3,0,4,1,1,2,9,10,19
p_216,1,0,e_3,346,406,411,12,4,2,9,5,1,3,60,5,65
p_205,1,0,e_3,362,406,411,11,4,0,12,2,1,3,44,5,49
p_235,8,0,e_2,314,343,429,23,2,2,1,4,1,1,29,86,115
p_227,9,0,e_2,326,348,429,10,4,2,3,5,0,2,22,81,103
p_220,9,0,e_2,342,348,429,6,4,2,8,2,0,2,6,81,87
p_219,11,0,e_2,342,356,429,4,4,0,8,2,0,2,14,73,87
p_239,13,0,e_2,305,364,429,21,1,1,4,4,1,0,59,65,124
p_211,14,0,e_2,348,369,429,5,5,0,9,5,1,3,21,60,81
p_194,11,0,e_2,377,380,429,27,5,5,12,4,1,3,3,49,52
p_204,8,0,e_2,364,391,429,4,4,0,13,5,1,2,27,38,65
p_191,7,0,e_2,382,396,429,30,5,5,11,4,1,3,14,33,47
p_187,7,0,e_2,391,396,429,27,4,4,8,4,1,3,5,33,38
p_179,6,0,e_2,397,401,429,27,3,3,7,4,1,3,4,28,32
p_182,5,0,e_2,394,406,429,29,3,3,7,4,1,3,12,23,35
p_214,4,0,e_2,346,411,429,9,5,2,9,5,1,3,65,18,83
p_174,3,0,e_2,402,416,429,29,2,2,6,4,1,3,14,13,27
p_171,3,0,e_2,408,416,429,28,3,3,5,4,1,3,8,13,21
p_217,8,0,e_0,345,358,438,6,4,3,4,5,0,2,13,80,93
p_212,9,0,e_0,348,363,438,6,5,3,5,5,0,3,15,75,90
p_226,12,0,e_0,331,374,438,8,4,0,0,3,1,0,43,64,107
p_207,12,0,e_0,355,374,438,2,6,0,7,5,0,4,19,64,83
p_203,12,0,e_0,365,374,438,30,4,4,9,5,1,2,9,64,73
p_200,12,0,e_0,367,374,438,29,4,4,10,5,1,2,7,64,71
p_224,13,0,e_0,335,379,438,8,4,0,1,5,0,1,44,59,103
p_208,13,0,e_0,355,379,438,3,6,0,7,5,0,4,24,59,83
p_202,13,0,e_0,365,379,438,29,4,4,9,5,1,2,14,59,73
p_201,13,0,e_0,366,379,438,28,4,4,10,5,1,2,13,59,72
p_193,12,0,e_0,378,384,438,26,5,5,13,2,1,2,6,54,60
p_195,9,0,e_0,376,395,438,30,5,5,12,5,1,2,19,43,62
p_197,8,0,e_0,375,400,438,1,4,0,12,5,1,1,25,38,63
p_188,8,0,e_0,390,400,438,27,4,4,10,4,1,3,10,38,48
p_189,7,0,e_0,387,405,438,28,4,4,11,4,1,2,18,33,51
p_184,5,0,e_1,393,411,512,29,3,3,0,3,1,1,18,101,119
p_177,9,0,e_1,398,425,512,24,3,3,1,5,0,4,27,87,114
p_181,11,0,e_1,395,433,512,23,3,3,0,5,0,3,38,79,117
p_159,11,0,e_1,424,433,512,14,6,2,9,2,1,4,9,79,88
p_183,12,0,e_1,393,438,512,22,3,3,0,3,1,2,45,74,119
p_157,12,0,e_1,427,438,512,12,6,2,9,5,1,4,11,74,85
p_190,14,0,e_1,382,446,512,23,5,5,3,1,1,0,64,66,130
p_180,14,0,e_1,396,446,512,19,3,3,0,5,0,4,50,66,116
p_158,14,0,e_1,426,446,512,10,6,0,9,5,1,4,20,66,86
p_168,15,0,e_1,412,451,512,15,5,0,5,5,1,4,39,61,100
p_151,15,0,e_1,443,451,512,6,5,0,13,5,1,4,8,61,69
p_149,15,0,e_1,444,451,512,6,5,0,14,5,1,4,7,61,68
p_139,13,0,e_1,456,459,512,5,5,2,14,4,1,4,3,53,56
p_153,8,0,e_1,438,476,512,13,5,4,12,5,1,3,38,36,74
p_147,7,0,e_1,450,481,512,10,4,2,15,2,1,2,31,31,62
p_186,1,0,e_3,391,416,527,3,4,1,4,4,1,3,25,111,136
p_167,7,0,e_3,412,436,527,21,4,3,0,5,0,4,24,91,115
p_173,10,0,e_3,405,447,527,21,1,1,1,1,1,0,42,80,122
p_170,10,0,e_3,408,447,527,21,3,3,1,4,1,2,39,80,119
p_169,11,0,e_3,410,452,527,11,3,3,0,3,1,3,42,75,117
p_161,13,0,e_3,418,460,527,14,5,1,1,5,1,4,42,67,109
p_172,14,0,e_3,405,465,527,17,2,2,1,1,1,1,60,62,122
p_165,14,0,e_3,416,465,527,13,5,0,1,5,1,4,49,62,111
p_162,14,0,e_3,417,465,527,13,5,0,1,5,1,4,48,62,110
p_142,15,0,e_3,452,470,527,4,4,0,11,5,1,3,18,57,75
p_141,15,0,e_3,455,470,527,3,5,0,12,5,1,4,15,57,72
p_134,12,0,e_3,462,481,527,5,4,2,13,5,1,3,19,46,65
p_123,12,0,e_3,474,481,527,2,4,0,14,4,1,3,7,46,53
p_120,10,0,e_3,481,489,527,2,3,0,12,4,1,2,8,38,46
p_130,9,0,e_3,469,494,527,6,3,0,15,2,1,2,25,33,58
p_199,2,0,e_2,368,437,541,9,4,1,14,2,1,2,69,104,173
p_166,5,0,e_2,415,448,541,22,4,4,3,1,1,1,33,93,126
p_160,10,0,e_2,421,465,541,16,6,3,2,4,1,2,44,76,120
p_152,10,0,e_2,439,465,541,10,5,3,2,5,1,3,26,76,102
p_146,10,0,e_2,451,465,541,7,4,2,6,5,1,3,14,76,90
p_164,12,0,e_2,416,473,541,15,5,1,3,4,1,2,57,68,125
p_145,12,0,e_2,451,473,541,5,4,2,6,5,1,3,22,68,90
p_140,13,0,e_2,455,478,541,5,5,2,7,5,1,3,23,63,86
p_124,14,0,e_2,474,483,541,30,4,4,12,5,1,4,9,58,67
p_128,10,0,e_2,471,497,541,5,4,1,12,5,1,3,26,44,70
p_115,10,0,e_2,494,497,541,29,3,3,11,4,1,4,3,44,47
p_114,9,0,e_2,494,502,541,30,3,3,11,4,1,3,8,39,47
p_126,6,0,e_2,473,513,541,8,4,2,12,5,1,3,40,28,68
p_108,5,0,e_2,509,518,541,30,5,5,7,4,1,3,9,23,32
p_148,3,0,e_2,447,526,541,15,4,3,5,2,1,2,79,15,94
p_156,1,0,e_0,428,443,564,22,6,5,2,4,1,3,15,121,136
p_175,2,0,e_0,399,448,564,30,3,3,8,1,1,3,49,116,165
p_163,4,0,e_0,417,456,564,23,5,4,5,4,1,2,39,108,147
p_178,5,0,e_0,398,461,564,28,3,3,8,4,1,2,63,103,166
p_176,6,0,e_0,398,466,564,27,3,3,8,4,1,3,68,98,166
p_154,7,0,e_0,438,471,564,14,5,4,0,5,0,5,33,93,126
p_138,7,0,e_0,456,471,564,11,5,3,4,5,1,3,15,93,108
p_131,9,0,e_0,467,479,564,7,4,1,6,5,1,2,12,85,97
p_137,13,0,e_0,458,493,564,4,5,2,4,5,1,3,35,71,106
p_127,15,0,e_0,473,501,564,29,4,4,7,5,1,3,28,63,91
p_112,15,0,e_0,497,501,564,23,4,4,14,5,1,4,4,63,67
p_117,12,0,e_0,490,512,564,28,4,4,12,5,1,3,22,52,74
p_113,11,0,e_0,496,517,564,28,3,3,14,5,1,3,21,47,68
p_104,7,0,e_0,516,531,564,26,5,5,11,1,1,2,15,33,48
p_98,6,0,e_0,524,536,564,25,5,5,9,4,1,3,12,28,40
p_110,1,0,e_1,501,517,634,6,3,1,3,4,1,3,16,117,133
p_155,3,0,e_1,434,525,634,18,6,4,11,5,1,3,91,109,200
p_150,3,0,e_1,444,525,634,16,5,4,14,5,1,4,81,109,190
p_144,4,0,e_1,451,530,634,13,4,2,15,4,1,3,79,104,183
p_133,4,0,e_1,463,530,634,12,5,1,12,4,1,4,67,104,171
p_125,4,0,e_1,474,530,634,10,4,2,8,4,1,4,56,104,160
p_118,4,0,e_1,488,530,634,6,3,1,5,1,1,3,42,104,146
p_122,5,0,e_1,477,535,634,8,4,2,8,4,1,3,58,99,157
p_119,5,0,e_1,483,535,634,7,4,2,7,4,1,3,52,99,151
p_135,7,0,e_1,461,543,634,10,4,2,13,4,1,4,82,91,173
p_132,7,0,e_1,463,543,634,9,5,1,12,4,1,4,80,91,171
p_93,7,0,e_1,529,543,634,23,5,3,4,3,1,5,14,91,105
p_100,10,0,e_1,522,554,634,21,5,5,2,5,1,6,32,80,112
p_101,12,0,e_1,521,562,634,20,4,4,2,5,1,5,41,72,113
p_103,13,0,e_1,517,567,634,19,5,5,1,5,1,4,50,67,117
p_143,2,0,e_3,451,535,641,15,3,2,11,2,1,2,84,106,190
p_136,2,0,e_3,460,535,641,15,4,2,13,5,1,3,75,106,181
p_116,7,0,e_3,490,552,641,3,3,1,10,4,1,2,62,89,151
p_121,9,0,e_3,480,560,641,3,3,0,12,1,1,2,80,81,161
p_97,10,0,e_3,526,565,641,10,4,4,0,3,1,4,39,76,115
p_111,15,0,e_3,501,582,641,22,3,3,7,1,1,2,81,59,140
p_87,15,0,e_3,539,582,641,12,5,0,3,5,1,4,43,59,102
p_65,12,0,e_3,578,593,641,4,5,1,14,5,1,4,15,48,63
p_69,10,0,e_3,573,601,641,8,4,1,12,5,1,3,28,40,68
p_50,10,0,e_3,592,601,641,2,6,0,12,1,1,5,9,40,49
p_63,8,0,e_3,581,609,641,7,5,0,15,2,1,4,28,32,60
p_76,7,0,e_3,559,614,641,14,4,2,9,2,1,3,55,27,82
p_49,5,0,e_3,592,622,641,7,5,3,12,1,1,4,30,19,49
p_78,4,0,e_3,555,627,641,18,4,3,8,5,1,3,72,14,86
p_42,4,0,e_3,600,627,641,6,5,3,10,1,1,4,27,14,41
p_107,1,0,e_2,512,546,651,3,5,1,6,1,1,3,34,105,139
p_99,1,0,e_2,522,546,651,30,4,4,4,4,1,4,24,105,129
p_102,2,0,e_2,521,551,651,30,4,4,4,4,1,3,30,100,130
p_86,6,0,e_2,541,565,651,20,5,4,0,5,0,4,24,86,110
p_80,6,0,e_2,548,565,651,18,5,4,1,5,1,4,17,86,103
p_77,6,0,e_2,557,565,651,16,5,3,4,5,1,3,8,86,94
p_89,7,0,e_2,537,570,651,21,5,3,1,4,1,2,33,81,114
p_66,12,0,e_2,577,587,651,4,5,1,9,5,1,3,10,64,74
p_109,14,0,e_2,506,595,651,22,5,5,8,4,1,2,89,56,145
p_68,14,0,e_2,574,595,651,3,5,1,8,5,1,3,21,56,77
p_46,13,0,e_2,596,600,651,28,6,6,14,4,1,4,4,51,55
p_58,10,0,e_2,586,611,651,4,6,1,12,2,1,3,25,40,65
p_41,10,0,e_2,600,611,651,30,5,5,13,4,1,4,11,40,51
p_54,6,0,e_2,590,625,651,7,6,4,13,5,1,4,35,26,61
p_47,6,0,e_2,594,625,651,6,6,3,14,2,1,4,31,26,57
p_90,2,0,e_0,536,572,684,26,5,4,6,4,1,2,36,112,148
p_81,2,0,e_0,547,572,684,22,5,4,4,4,1,4,25,112,137
p_85,3,0,e_0,542,577,684,23,5,4,5,4,1,3,35,107,142
p_84,3,0,e_0,546,577,684,22,5,4,4,4,1,4,31,107,138
p_82,3,0,e_0,547,577,684,21,5,4,4,4,1,4,30,107,137
p_106,4,0,e_0,512,582,684,30,5,5,12,4,1,2,70,102,172
p_105,4,0,e_0,515,582,684,29,5,5,11,4,1,3,67,102,169
p_129,5,0,e_0,470,587,684,10,4,2,7,2,1,2,117,97,214
p_96,5,0,e_0,527,587,684,25,5,4,8,4,1,4,60,97,157
p_62,5,0,e_0,582,587,684,10,6,4,4,5,1,4,5,97,102
p_61,5,0,e_0,583,587,684,10,6,4,4,5,1,4,4,97,101
p_95,6,0,e_0,527,592,684,24,5,4,8,4,1,4,65,92,157
p_94,6,0,e_0,528,592,684,24,5,4,8,4,1,4,64,92,156
p_73,6,0,e_0,568,592,684,13,4,1,1,5,0,5,24,92,116
p_59,6,0,e_0,584,592,684,9,6,4,4,5,1,4,8,92,100
p_71,2,0,e_2,569,659,691,17,4,1,7,2,1,1,90,32,122
p_56,2,0,e_2,588,659,691,11,6,5,12,5,1,4,71,32,103
p_48,2,0,e_2,593,659,691,10,6,5,14,5,1,5,66,32,98
p_70,3,0,e_2,572,664,691,15,4,1,7,5,1,2,92,27,119
p_43,3,0,e_2,599,664,691,7,6,4,13,1,1,4,65,27,92
p_38,4,0,e_2,627,669,691,30,1,1,6,4,1,2,42,22,64
p_32,5,0,e_2,657,674,691,21,4,3,2,5,0,3,17,17,34
p_31,5,0,e_2,662,674,691,19,4,3,3,5,1,3,12,17,29
p_27,2,0,e_2,693,702,718,13,3,0,0,3,0,0,9,16,25
p_26,3,0,e_2,698,707,718,11,3,2,1,5,0,1,9,11,20
p_83,5,0,e_1,546,651,742,20,5,4,8,5,1,4,105,91,196
p_45,5,0,e_1,597,651,742,6,6,3,11,4,1,5,54,91,145
p_57,6,0,e_1,587,656,742,8,6,4,13,4,1,4,69,86,155
p_74,11,0,e_1,567,673,742,9,4,1,13,5,1,2,106,69,175
p_92,13,0,e_1,533,681,742,15,5,1,5,5,1,5,148,61,209
p_91,13,0,e_1,535,681,742,15,5,1,5,5,1,4,146,61,207
p_88,14,0,e_1,538,686,742,13,5,1,6,5,1,4,148,56,204
p_79,14,0,e_1,549,686,742,10,5,1,9,5,1,5,137,56,193
p_75,14,0,e_1,563,686,742,6,5,1,12,5,1,3,123,56,179
p_72,15,0,e_1,569,691,742,4,4,0,13,5,1,3,122,51,173
p_25,7,0,e_1,703,717,742,5,3,0,11,4,1,0,14,25,39
p_24,5,0,e_1,707,725,742,6,3,1,10,4,1,1,18,17,35
p_23,5,0,e_1,709,725,742,5,3,1,9,4,1,2,16,17,33
p_40,4,0,e_3,601,655,745,6,5,3,10,4,1,4,54,90,144
p_35,4,0,e_3,640,655,745,4,2,2,0,3,1,2,15,90,105
p_37,7,0,e_3,633,666,745,25,2,2,2,4,1,1,33,79,112
p_33,8,0,e_3,647,671,745,20,3,1,2,5,0,3,24,74,98
p_34,15,0,e_3,643,694,745,15,2,0,0,5,0,2,51,51,102
p_29,15,0,e_3,678,694,745,5,3,0,10,5,1,2,16,51,67
p_28,6,0,e_3,679,723,745,14,3,1,10,5,1,2,44,22,66
p_30,5,0,e_3,676,728,745,16,2,1,9,5,1,1,52,17,69
p_64,1,0,e_0,579,689,788,15,6,1,3,5,1,4,110,99,209
p_51,1,0,e_0,591,689,788,11,6,4,6,2,1,4,98,99,197
p_55,4,0,e_0,590,700,788,9,6,4,6,5,1,4,110,88,198
p_67,8,0,e_0,574,714,788,9,5,1,2,5,1,4,140,74,214
p_60,9,0,e_0,584,719,788,6,6,2,4,5,1,4,135,69,204
p_53,9,0,e_0,590,719,788,4,6,2,6,5,1,5,129,69,198
p_52,11,0,e_0,591,727,788,1,6,0,6,2,1,4,136,61,197
p_36,11,0,e_0,635,727,788,21,3,3,13,4,1,6,92,61,153
p_44,15,0,e_0,598,741,788,26,6,6,8,5,1,5,143,47,190
p_39,15,0,e_0,609,741,788,23,4,4,10,5,1,6,132,47,179
p_20,9,0,e_2,737,747,798,23,1,1,6,5,0,1,10,51,61
p_22,10,0,e_2,712,752,798,29,3,3,2,4,1,0,40,46,86
p_21,10,0,e_2,732,752,798,24,1,1,4,5,0,1,20,46,66
p_19,12,0,e_2,740,760,798,19,1,1,7,5,0,2,20,38,58
p_18,2,0,e_1,768,777,863,2,0,0,0,3,0,0,9,86,95
p_16,13,0,e_1,774,812,863,17,1,1,1,5,0,1,38,51,89
p_12,13,0,e_1,796,812,863,10,2,1,8,5,1,1,16,51,67
p_10,14,0,e_1,810,817,863,5,2,1,13,5,1,1,7,46,53
p_9,2,0,e_1,845,855,863,6,1,0,5,4,1,0,10,8,18
p_13,11,0,e_3,794,808,871,12,1,1,7,5,0,1,14,63,77
p_17,15,0,e_3,772,822,871,15,0,0,0,3,0,0,50,49,99
p_15,15,0,e_3,782,822,871,12,1,0,3,5,0,1,40,49,89
p_8,1,0,e_3,847,866,871,6,1,0,7,4,1,0,19,5,24
p_11,11,0,e_2,810,846,883,8,2,1,0,3,0,0,36,37,73
p_4,1,0,e_2,864,878,883,30,2,2,5,4,1,1,14,5,19
p_14,15,0,e_0,790,838,887,10,1,0,0,3,0,0,48,49,97
p_5,5,0,e_0,860,870,887,28,2,2,8,4,1,0,10,17,27
p_3,1,0,e_3,876,882,901,1,0,0,0,3,0,0,6,19,25
p_2,3,0,e_3,878,890,901,3,1,0,0,5,0,1,12,11,23
p_1,2,0,e_0,889,898,906,5,1,0,0,3,0,0,9,8,17
p_6,14,0,e_1,858,907,951,19,2,2,1,4,1,0,49,44,93
p_7,12,0,e_2,851,921,959,24,2,2,10,4,1,0,70,38,108
p_299,3,0,e_1,7,19,30,3,0,0,0,3,0,0,12,11,23
p_296,1,0,e_3,20,26,31,1,0,0,0,3,0,0,6,5,11
p_298,4,0,e_2,10,25,47,4,0,0,0,3,0,0,15,22,37
p_295,5,0,e_2,22,30,47,5,1,0,3,5,0,1,8,17,25
p_288,1,0,e_2,49,55,98,3,2,2,0,3,0,0,6,43,49
p_285,2,0,e_2,54,60,98,7,3,2,1,2,0,1,6,38,44
p_286,3,0,e_2,51,65,98,7,3,2,0,5,0,1,14,33,47
p_282,6,0,e_2,62,76,98,7,2,1,2,5,1,1,14,22,36
p_279,2,0,e_2,76,90,98,8,1,0,6,4,1,0,14,8,22
p_275,2,0,e_2,84,90,98,5,1,0,4,4,1,3,6,8,14
p_290,4,0,e_3,43,50,108,6,1,1,2,5,0,1,7,58,65
p_291,6,0,e_3,35,58,108,6,0,0,0,3,0,0,23,50,73
p_289,7,0,e_3,47,63,108,4,2,0,3,5,0,2,16,45,61
p_283,10,0,e_3,55,74,108,5,3,0,5,5,1,2,19,34,53
p_281,10,0,e_3,63,74,108,3,2,0,7,5,1,1,11,34,45
p_274,4,0,e_3,84,94,108,3,1,0,7,4,1,0,10,14,24
p_300,8,0,e_0,4,31,109,8,0,0,0,3,0,0,27,78,105
p_297,12,0,e_0,18,45,109,12,0,0,4,5,0,1,27,64,91
p_294,13,0,e_0,23,50,109,13,1,0,6,5,0,2,27,59,86
p_293,15,0,e_0,26,58,109,16,1,1,7,5,0,3,32,51,83
p_284,14,0,e_0,55,63,109,9,4,0,14,5,1,1,8,46,54
p_276,5,0,e_0,82,92,109,3,1,0,8,4,1,0,10,17,27
p_292,11,0,e_1,30,66,109,11,0,0,0,3,0,0,36,43,79
p_287,12,0,e_1,51,71,109,8,3,0,6,5,0,1,20,38,58
p_280,12,0,e_1,65,71,109,5,2,0,11,2,0,1,6,38,44
p_269,4,0,e_3,146,161,177,4,0,0,0,3,0,0,15,16,31
p_267,1,0,e_3,153,172,177,5,1,1,2,5,0,1,19,5,24
p_277,10,0,e_2,81,130,202,28,1,1,5,4,1,2,49,72,121
p_273,13,0,e_2,95,141,202,21,1,1,1,4,1,2,46,61,107
p_278,15,0,e_2,80,149,202,23,1,1,5,4,1,1,69,53,122
p_272,15,0,e_2,105,149,202,16,1,1,2,5,0,3,44,53,97
p_265,12,0,e_2,157,160,202,9,2,0,13,4,1,0,3,42,45
p_262,6,0,e_2,164,180,202,27,2,2,11,4,1,1,16,22,38
p_259,6,0,e_2,174,180,202,25,1,1,8,4,1,2,6,22,28
p_264,5,0,e_2,162,185,202,29,2,2,12,4,1,0,23,17,40
p_258,5,0,e_2,175,185,202,25,1,1,7,4,1,2,10,17,27
p_270,7,0,e_1,133,157,224,7,0,0,0,3,0,0,24,67,91
p_268,10,0,e_1,150,168,224,9,1,0,5,5,0,1,18,56,74
p_263,12,0,e_1,163,176,224,22,2,2,9,5,1,1,13,48,61
p_261,12,0,e_1,170,176,224,19,2,2,10,5,1,1,6,48,54
p_260,13,0,e_1,171,181,224,18,1,1,11,5,1,1,10,43,53
p_257,12,0,e_1,179,186,224,12,0,0,13,5,1,1,7,38,45
p_271,11,0,e_0,127,163,228,11,0,0,0,3,0,0,36,65,101
p_266,15,0,e_0,155,177,228,13,2,0,9,5,0,1,22,51,73
p_256,8,0,e_0,191,200,228,8,0,0,11,4,1,0,9,28,37
p_254,3,0,e_0,199,217,228,15,1,1,8,1,1,0,18,11,29
p_252,2,0,e_2,212,221,229,22,2,2,0,3,0,0,9,8,17
p_251,4,0,e_0,228,243,277,15,2,1,0,3,0,0,15,34,49
p_250,7,0,e_0,236,254,277,10,2,1,2,5,0,1,18,23,41
p_249,7,0,e_0,238,254,277,9,2,1,3,5,0,2,16,23,39
p_248,7,0,e_0,246,254,277,7,1,0,5,5,1,1,8,23,31
p_255,10,0,e_3,192,225,293,10,0,0,0,3,0,0,33,68,101
p_253,15,0,e_3,208,242,293,10,1,0,5,5,0,1,34,51,85
p_247,12,0,e_3,248,253,293,1,1,0,13,4,1,0,5,40,45
p_244,2,0,e_3,271,285,293,4,1,0,6,4,1,0,14,8,22
p_243,8,0,e_2,285,296,332,24,1,1,5,5,0,1,11,36,47
p_245,9,0,e_2,269,301,332,28,1,1,0,3,0,0,32,31,63
p_238,2,0,e_2,311,324,332,23,1,1,6,4,1,0,13,8,21
p_233,2,0,e_2,319,324,332,20,1,1,3,4,1,1,5,8,13
p_246,12,0,e_1,257,296,336,29,1,1,0,3,0,0,39,40,79
p_237,5,0,e_1,313,319,336,19,1,1,7,4,1,0,6,17,23
p_242,4,0,e_0,287,302,402,28,1,1,0,3,0,0,15,100,115
p_236,8,0,e_0,313,316,402,16,1,1,7,5,1,2,3,86,89
p_235,8,0,e_0,314,316,402,16,1,1,8,5,1,3,2,86,88
p_241,13,0,e_0,300,333,402,13,0,0,4,5,0,1,33,69,102
p_240,14,0,e_0,301,338,402,14,0,0,4,3,0,1,37,64,101
p_234,14,0,e_0,314,338,402,12,1,0,8,5,1,3,24,64,88
p_223,13,0,e_0,339,343,402,3,3,0,14,4,1,4,4,59,63
p_226,12,0,e_0,331,348,402,6,3,1,13,5,1,4,17,54,71
p_219,11,0,e_0,342,353,402,4,3,1,13,1,1,4,11,49,60
p_225,10,0,e_0,333,358,402,7,3,2,13,5,1,4,25,44,69
p_229,9,0,e_0,323,363,402,12,2,2,10,5,1,3,40,39,79
p_227,9,0,e_0,326,363,402,11,3,3,11,5,1,4,37,39,76
p_212,9,0,e_0,348,363,402,5,5,1,12,4,1,4,15,39,54
p_206,6,0,e_0,362,374,402,7,4,2,9,1,1,3,12,28,40
p_232,5,0,e_0,320,379,402,17,1,1,9,5,1,2,59,23,82
p_231,10,0,e_3,320,338,416,12,1,1,4,5,0,1,18,78,96
p_228,11,0,e_3,325,343,416,9,2,1,6,5,0,2,18,73,91
p_239,13,0,e_3,305,351,416,13,0,0,0,3,0,0,46,65,111
p_224,13,0,e_3,335,351,416,4,3,0,9,5,0,3,16,65,81
p_211,14,0,e_3,348,356,416,2,5,0,12,5,1,4,8,60,68
p_208,13,0,e_3,355,361,416,3,4,0,14,2,1,3,6,55,61
p_213,12,0,e_3,347,366,416,2,4,1,12,5,1,3,19,50,69
p_207,12,0,e_3,355,366,416,2,4,0,14,2,1,3,11,50,61
p_220,9,0,e_3,342,377,416,6,2,1,11,2,1,1,35,39,74
p_198,9,0,e_3,368,377,416,3,3,0,12,4,1,2,9,39,48
p_197,8,0,e_3,375,382,416,1,3,0,9,4,1,2,7,34,41
p_191,7,0,e_3,382,387,416,1,3,0,8,4,1,2,5,29,34
p_192,5,0,e_3,380,395,416,3,3,0,8,4,1,2,15,21,36
p_185,2,0,e_3,392,406,416,4,3,1,6,4,1,2,14,10,24
p_175,2,0,e_3,399,406,416,2,3,0,4,4,1,2,7,10,17
p_221,4,0,e_2,341,356,442,11,3,1,0,3,0,0,15,86,101
p_214,4,0,e_2,346,356,442,10,4,1,1,5,0,2,10,86,96
p_215,6,0,e_2,346,364,442,8,4,1,1,5,0,2,18,78,96
p_217,8,0,e_2,345,372,442,7,3,1,1,5,0,1,27,70,97
p_204,8,0,e_2,364,372,442,4,4,1,6,5,1,2,8,70,78
p_200,12,0,e_2,367,386,442,30,3,3,7,5,1,2,19,56,75
p_193,12,0,e_2,378,386,442,27,3,3,10,5,1,3,8,56,64
p_195,9,0,e_2,376,397,442,30,3,3,9,5,1,2,21,45,66
p_188,8,0,e_2,390,402,442,28,3,3,11,4,1,3,12,40,52
p_189,7,0,e_2,387,407,442,30,3,3,12,4,1,2,20,35,55
p_187,7,0,e_2,391,407,442,29,3,3,11,4,1,4,16,35,51
p_179,6,0,e_2,397,412,442,29,3,3,9,4,1,4,15,30,45
p_176,6,0,e_2,398,412,442,28,3,3,9,4,1,5,14,30,44
p_184,5,0,e_2,393,417,442,30,4,4,10,4,1,4,24,25,49
p_178,5,0,e_2,398,417,442,29,3,3,9,4,1,5,19,25,44
p_222,3,0,e_1,339,351,450,13,3,2,0,3,0,0,12,99,111
p_218,9,0,e_1,343,371,450,6,3,1,1,5,0,1,28,79,107
p_194,11,0,e_1,377,379,450,28,3,3,11,5,1,2,2,71,73
p_203,12,0,e_1,365,384,450,30,3,3,7,5,1,1,19,66,85
p_202,13,0,e_1,365,389,450,29,3,3,7,5,1,2,24,61,85
p_201,13,0,e_1,366,389,450,29,3,3,8,5,1,3,23,61,84
p_190,14,0,e_1,382,394,450,24,4,4,12,5,1,2,12,56,68
p_181,11,0,e_1,395,405,450,24,3,3,14,4,1,1,10,45,55
p_173,10,0,e_1,405,410,450,22,2,2,11,4,1,2,5,40,45
p_177,9,0,e_1,398,415,450,25,3,3,13,4,1,2,17,35,52
p_167,7,0,e_1,412,423,450,24,2,2,10,4,1,2,11,27,38
p_182,5,0,e_1,394,431,450,30,3,3,14,4,1,0,37,19,56
p_166,5,0,e_1,415,431,450,5,2,2,9,4,1,2,16,19,35
p_155,3,0,e_1,434,439,450,20,5,4,4,4,1,0,5,11,16
p_156,1,0,e_2,428,447,482,24,5,4,3,4,1,2,19,35,54
p_209,2,0,e_2,354,452,482,12,5,0,4,5,0,3,98,30,128
p_143,2,0,e_2,451,452,482,16,5,4,2,2,1,2,1,30,31
p_174,3,0,e_2,402,459,482,30,3,3,8,4,1,4,57,23,80
p_171,3,0,e_2,408,459,482,29,2,2,7,4,1,4,51,23,74
p_150,3,0,e_2,444,459,482,17,6,5,0,5,0,4,15,23,38
p_148,3,0,e_2,447,459,482,16,6,5,1,5,1,3,12,23,35
p_163,4,0,e_2,417,464,482,24,4,3,5,4,1,2,47,18,65
p_144,4,0,e_2,451,464,482,14,5,4,2,2,1,3,13,18,31
p_133,4,0,e_2,463,464,482,12,3,2,4,3,1,2,1,18,19
p_136,2,0,e_2,460,474,482,14,4,2,3,5,1,2,14,8,22
p_205,1,0,e_0,362,407,524,12,4,2,9,1,1,2,45,117,162
p_186,1,0,e_0,391,407,524,5,3,1,2,1,1,3,16,117,133
p_199,2,0,e_0,368,412,524,10,3,1,8,4,1,4,44,112,156
p_210,4,0,e_0,353,420,524,11,5,1,11,4,1,3,67,104,171
p_230,5,0,e_0,323,425,524,16,2,2,10,5,1,3,102,99,201
p_196,5,0,e_0,376,425,524,4,3,1,6,4,1,4,49,99,148
p_170,10,0,e_0,408,442,524,22,2,2,1,5,1,5,34,82,116
p_160,10,0,e_0,421,442,524,17,5,4,4,5,1,5,21,82,103
p_159,11,0,e_0,424,447,524,15,5,3,5,2,1,4,23,77,100
p_183,12,0,e_0,393,452,524,23,4,4,2,4,1,3,59,72,131
p_145,12,0,e_0,451,452,524,6,5,2,12,2,1,3,1,72,73
p_180,14,0,e_0,396,462,524,21,3,3,1,1,1,4,66,62,128
p_172,14,0,e_0,405,462,524,18,2,2,1,5,0,6,57,62,119
p_168,15,0,e_0,412,467,524,16,2,2,2,5,1,5,55,57,112
p_151,15,0,e_0,443,467,524,8,6,0,10,5,1,5,24,57,81
p_216,1,0,e_3,346,421,528,13,3,1,12,5,1,2,75,107,182
p_154,7,0,e_3,438,441,528,15,5,4,6,5,1,4,3,87,90
p_152,10,0,e_3,439,452,528,11,6,4,7,5,1,5,13,76,89
p_169,11,0,e_3,410,457,528,20,1,1,1,1,1,0,47,71,118
p_164,12,0,e_3,416,462,528,12,2,0,0,5,0,2,46,66,112
p_157,12,0,e_3,427,462,528,13,5,2,3,5,1,4,35,66,101
p_161,13,0,e_3,418,467,528,15,4,1,0,5,0,4,49,61,110
p_140,13,0,e_3,455,467,528,4,5,1,11,5,1,4,12,61,73
p_139,13,0,e_3,456,467,528,4,4,1,11,2,1,3,11,61,72
p_137,13,0,e_3,458,467,528,4,4,1,11,5,1,3,9,61,70
p_165,14,0,e_3,416,472,528,14,3,0,0,5,0,3,56,56,112
p_162,14,0,e_3,417,472,528,14,4,0,0,5,0,4,55,56,111
p_158,14,0,e_3,426,472,528,12,5,0,2,5,1,4,46,56,102
p_123,12,0,e_3,474,480,528,2,3,0,14,4,1,2,6,48,54
p_121,9,0,e_3,480,491,528,3,3,0,12,4,1,2,11,37,48
p_147,7,0,e_1,450,474,575,11,6,4,0,3,0,0,24,101,125
p_131,9,0,e_1,467,482,575,6,2,1,5,5,0,2,15,93,108
p_130,9,0,e_1,469,482,575,6,2,1,6,5,0,3,13,93,106
p_146,10,0,e_1,451,487,575,8,5,4,0,5,0,1,36,88,124
p_128,10,0,e_1,471,487,575,14,2,0,6,5,0,3,16,88,104
p_117,12,0,e_1,490,495,575,27,4,4,11,5,1,2,5,80,85
p_124,14,0,e_1,474,503,575,30,4,4,7,5,1,3,29,72,101
p_127,15,0,e_1,473,508,575,29,3,3,7,2,0,2,35,67,102
p_112,15,0,e_1,497,508,575,22,4,4,12,5,1,3,11,67,78
p_111,15,0,e_1,501,508,575,22,4,4,14,5,1,3,7,67,74
p_109,14,0,e_1,506,513,575,22,4,4,15,5,1,2,7,62,69
p_113,11,0,e_1,496,524,575,27,4,4,12,5,1,2,28,51,79
p_100,10,0,e_1,522,529,575,21,4,4,11,4,1,4,7,46,53
p_97,10,0,e_1,526,529,575,20,5,5,11,4,1,5,3,46,49
p_93,7,0,e_1,529,540,575,7,4,0,10,4,1,5,11,35,46
p_118,4,0,e_2,488,496,590,6,4,3,2,5,0,2,8,94,102
p_119,5,0,e_2,483,501,590,6,4,2,0,5,0,1,18,89,107
p_138,7,0,e_2,456,509,590,10,4,3,2,5,1,2,53,81,134
p_135,7,0,e_2,461,509,590,9,3,2,3,5,1,3,48,81,129
p_132,7,0,e_2,463,509,590,9,3,2,4,3,1,3,46,81,127
p_114,9,0,e_2,494,517,590,29,4,4,4,5,0,3,23,73,96
p_115,10,0,e_2,494,522,590,28,4,4,4,5,0,4,28,68,96
p_101,12,0,e_2,521,530,590,19,5,5,10,2,1,4,9,60,69
p_103,13,0,e_2,517,535,590,20,5,5,9,5,1,4,18,55,73
p_92,13,0,e_2,533,535,590,12,4,0,13,5,1,4,2,55,57
p_104,7,0,e_2,516,555,590,26,5,5,9,2,1,3,39,35,74
p_80,6,0,e_2,548,560,590,17,5,3,9,4,1,3,12,30,42
p_77,6,0,e_2,557,560,590,15,3,2,7,4,1,3,3,30,33
p_108,5,0,e_2,509,565,590,30,4,4,7,5,1,2,56,25,81
p_105,4,0,e_2,515,570,590,29,5,5,9,5,1,3,55,20,75
p_110,1,0,e_3,501,533,640,6,3,2,7,4,1,2,32,107,139
p_107,1,0,e_3,512,533,640,3,4,0,4,4,1,3,21,107,128
p_129,5,0,e_3,470,547,640,9,2,0,14,5,1,1,77,93,170
p_126,6,0,e_3,473,552,640,8,2,0,14,4,1,1,79,88,167
p_116,7,0,e_3,490,557,640,2,3,0,9,1,1,2,67,83,150
p_74,11,0,e_3,567,571,640,7,4,2,10,5,1,3,4,69,73
p_91,13,0,e_3,535,579,640,12,4,0,1,5,1,3,44,61,105
p_88,14,0,e_3,538,584,640,12,5,0,2,5,1,4,46,56,102
p_79,14,0,e_3,549,584,640,9,5,0,5,5,1,4,35,56,91
p_75,14,0,e_3,563,584,640,5,4,0,9,5,1,3,21,56,77
p_68,14,0,e_3,574,584,640,2,5,0,12,5,1,4,10,56,66
p_66,12,0,e_3,577,592,640,3,5,1,13,5,1,4,15,48,63
p_65,12,0,e_3,578,592,640,3,5,1,13,2,1,4,14,48,62
p_50,10,0,e_3,592,600,640,2,5,0,12,4,1,4,8,40,48
p_53,9,0,e_3,590,605,640,3,5,0,12,4,1,4,15,35,50
p_125,4,0,e_0,474,538,642,10,3,2,13,4,1,3,64,104,168
p_122,5,0,e_0,477,543,642,8,4,2,12,1,1,3,66,99,165
p_153,8,0,e_0,438,554,642,14,6,4,9,5,1,5,116,88,204
p_120,10,0,e_0,481,562,642,2,4,0,11,4,1,4,81,80,161
p_134,12,0,e_0,462,570,642,4,3,2,14,5,1,2,108,72,180
p_149,15,0,e_0,444,581,642,7,6,0,10,5,1,5,137,61,198
p_142,15,0,e_0,452,581,642,5,5,0,12,5,1,4,129,61,190
p_141,15,0,e_0,455,581,642,4,5,0,12,5,1,3,126,61,187
p_87,15,0,e_0,539,581,642,12,6,0,4,5,1,5,42,61,103
p_72,15,0,e_0,569,581,642,4,5,0,12,2,1,2,12,61,73
p_52,11,0,e_0,591,595,642,1,5,0,12,4,1,4,4,47,51
p_69,10,0,e_0,573,600,642,7,4,2,13,5,1,2,27,42,69
p_58,10,0,e_0,586,600,642,4,5,1,14,4,1,4,14,42,56
p_60,9,0,e_0,584,605,642,5,5,1,14,4,1,3,21,37,58
p_63,8,0,e_0,581,610,642,7,5,1,15,4,1,2,29,32,61
p_64,1,0,e_2,579,595,670,14,5,1,2,1,1,2,16,75,91
p_71,2,0,e_2,569,600,670,15,5,2,4,1,1,0,31,70,101
p_70,3,0,e_2,572,605,670,14,4,2,4,4,1,1,33,65,98
p_78,4,0,e_2,555,610,670,17,4,2,7,4,1,3,55,60,115
p_55,4,0,e_2,590,610,670,8,5,3,0,5,0,4,20,60,80
p_42,4,0,e_2,600,610,670,6,5,4,2,5,1,4,10,60,70
p_49,5,0,e_2,592,615,670,7,5,3,0,5,0,5,23,55,78
p_45,5,0,e_2,597,615,670,6,6,4,1,5,1,5,18,55,73
p_54,6,0,e_2,590,620,670,6,5,2,0,5,0,4,30,50,80
p_47,6,0,e_2,594,620,670,6,6,4,1,2,0,5,26,50,76
p_41,10,0,e_2,600,634,670,30,5,5,2,5,1,4,34,36,70
p_37,7,0,e_2,633,645,670,25,4,4,10,2,1,1,12,25,37
p_38,4,0,e_2,627,656,670,30,4,4,8,5,1,1,29,14,43
p_35,4,0,e_2,640,656,670,12,3,3,8,4,1,2,16,14,30
p_99,1,0,e_1,522,580,697,30,4,4,11,4,1,3,58,117,175
p_102,2,0,e_1,521,585,697,29,5,5,12,4,1,2,64,112,176
p_90,2,0,e_1,536,585,697,22,5,4,8,4,1,6,49,112,161
p_81,2,0,e_1,547,585,697,21,5,4,6,4,1,6,38,112,150
p_85,3,0,e_1,542,590,697,21,6,5,7,4,1,5,48,107,155
p_84,3,0,e_1,546,590,697,20,5,4,6,4,1,6,44,107,151
p_82,3,0,e_1,547,590,697,20,5,4,6,4,1,6,43,107,150
p_106,4,0,e_1,512,595,697,30,4,4,14,1,1,1,83,102,185
p_96,5,0,e_1,527,600,697,5,4,4,10,4,1,5,73,97,170
p_83,5,0,e_1,546,600,697,18,5,4,6,4,1,6,54,97,151
p_98,6,0,e_1,524,605,697,25,4,4,11,4,1,4,81,92,173
p_95,6,0,e_1,527,605,697,6,4,4,10,4,1,6,78,92,170
p_94,6,0,e_1,528,605,697,8,4,1,10,1,1,5,77,92,169
p_86,6,0,e_1,541,605,697,19,6,3,7,4,1,5,64,92,156
p_59,6,0,e_1,584,605,697,8,5,3,2,2,1,5,21,92,113
p_43,3,0,e_0,599,653,708,7,5,4,10,1,1,3,54,55,109
p_40,4,0,e_0,601,658,708,6,5,4,10,4,1,4,57,50,107
p_32,5,0,e_0,657,663,708,20,4,3,4,3,1,2,6,45,51
p_31,5,0,e_0,662,663,708,19,4,3,5,2,1,2,1,45,46
p_73,6,0,e_0,568,670,708,12,5,3,12,5,1,2,102,38,140
p_33,8,0,e_0,647,678,708,20,4,1,1,5,0,3,31,30,61
p_28,6,0,e_0,679,686,708,13,2,1,8,4,1,1,7,22,29
p_30,5,0,e_0,676,691,708,15,2,1,8,5,1,1,15,17,32
p_27,2,0,e_2,693,702,718,13,1,0,0,3,0,0,9,16,25
p_26,3,0,e_2,698,707,718,11,1,0,1,5,0,1,9,11,20
p_62,5,0,e_3,582,657,742,9,5,0,14,5,1,4,75,85,160
p_61,5,0,e_3,583,657,742,9,5,0,14,2,1,4,74,85,159
p_76,7,0,e_3,559,665,742,14,3,2,7,5,1,2,106,77,183
p_67,8,0,e_3,574,670,742,8,4,2,12,5,1,3,96,72,168
p_34,15,0,e_3,643,693,742,14,3,0,1,5,0,3,50,49,99
p_29,15,0,e_3,678,693,742,5,2,0,10,5,1,1,15,49,64
p_25,7,0,e_3,703,719,742,5,1,0,12,4,1,0,16,23,39
p_24,5,0,e_0,707,725,790,6,2,1,0,3,1,0,18,65,83
p_23,5,0,e_0,709,725,790,5,2,1,0,5,0,1,16,65,81
p_20,9,0,e_0,737,739,790,22,1,1,9,5,1,1,2,51,53
p_22,10,0,e_0,712,744,790,29,2,2,1,5,0,1,32,46,78
p_21,10,0,e_0,732,744,790,23,1,1,7,5,1,1,12,46,58
p_19,12,0,e_0,740,752,790,18,1,1,9,5,1,1,12,38,50
p_51,1,0,e_1,591,702,803,11,5,4,3,5,1,5,111,101,212
p_56,2,0,e_1,588,707,803,11,5,4,3,5,1,5,119,96,215
p_48,2,0,e_1,593,707,803,10,6,5,4,5,1,6,114,96,210
p_57,6,0,e_1,587,721,803,7,5,3,2,5,1,5,134,82,216
p_89,7,0,e_1,537,726,803,17,5,1,8,4,1,6,189,77,266
p_36,11,0,e_1,635,740,803,20,4,4,14,5,1,6,105,63,168
p_46,13,0,e_1,596,748,803,28,6,6,4,5,1,5,152,55,207
p_44,15,0,e_1,598,756,803,25,6,6,5,5,1,6,158,47,205
p_39,15,0,e_1,609,756,803,23,3,3,7,2,1,5,147,47,194
p_8,1,0,e_1,847,853,858,3,1,0,0,3,0,0,6,5,11
p_13,11,0,e_3,794,810,861,9,1,1,6,5,0,1,16,51,67
p_11,11,0,e_3,810,812,861,4,2,1,11,5,1,1,2,49,51
p_16,13,0,e_3,774,820,861,13,0,0,0,3,0,0,46,41,87
p_12,13,0,e_3,796,820,861,6,2,0,7,5,0,2,24,41,65
p_18,2,0,e_2,768,777,867,2,0,0,0,3,0,0,9,90,99
p_10,14,0,e_2,810,815,867,3,3,0,13,5,1,1,5,52,57
p_17,15,0,e_2,772,820,867,15,0,0,1,5,0,1,48,47,95
p_15,15,0,e_2,782,820,867,13,1,0,3,5,1,1,38,47,85
p_14,15,0,e_2,790,820,867,10,1,0,6,5,1,1,30,47,77
p_4,1,0,e_3,864,870,875,1,0,0,0,3,0,0,6,5,11
p_3,1,0,e_2,876,882,887,1,0,0,0,3,0,0,6,5,11
p_5,5,0,e_1,860,878,897,5,0,0,0,3,0,0,18,19,37
p_2,3,0,e_1,878,886,897,3,0,0,5,4,1,0,8,11,19
p_1,2,0,e_2,889,898,906,2,0,0,0,3,0,0,9,8,17
p_9,2,0,e_0,845,854,938,3,1,0,0,3,0,0,9,84,93
p_7,12,0,e_0,851,886,938,21,1,1,1,5,0,1,35,52,87
p_6,14,0,e_0,858,894,938,17,1,1,3,5,1,1,36,44,80
p_299,3,0,e_1,7,19,30,3,0,0,0,3,0,0,12,11,23
p_296,1,0,e_3,20,26,31,1,0,0,0,3,0,0,6,5,11
p_298,4,0,e_2,10,25,47,4,0,0,0,3,0,0,15,22,37
p_295,5,0,e_2,22,30,47,5,1,0,3,5,0,1,8,17,25
p_288,1,0,e_2,49,55,98,3,2,2,0,3,0,0,6,43,49
p_285,2,0,e_2,54,60,98,7,3,2,1,2,0,1,6,38,44
p_286,3,0,e_2,51,65,98,7,3,2,0,5,0,1,14,33,47
p_282,6,0,e_2,62,76,98,7,2,1,2,5,1,1,14,22,36
p_279,2,0,e_2,76,90,98,8,1,0,6,4,1,0,14,8,22
p_275,2,0,e_2,84,90,98,5,2,0,4,4,1,2,6,8,14
p_290,4,0,e_3,43,50,106,6,1,1,2,5,0,1,7,56,63
p_291,6,0,e_3,35,58,106,6,0,0,0,3,0,0,23,48,71
p_289,7,0,e_3,47,63,106,4,2,0,3,5,0,2,16,43,59
p_283,10,0,e_3,55,74,106,5,3,0,5,5,1,2,19,32,51
p_300,8,0,e_0,4,31,111,8,0,0,0,3,0,0,27,80,107
p_297,12,0,e_0,18,45,111,12,0,0,4,5,0,1,27,66,93
p_294,13,0,e_0,23,50,111,13,1,0,6,5,0,2,27,61,88
p_293,15,0,e_0,26,58,111,16,1,1,7,5,0,3,32,53,85
p_284,14,0,e_0,55,63,111,9,4,0,14,5,1,1,8,48,56
p_281,10,0,e_0,63,77,111,3,2,0,14,4,1,0,14,34,48
p_276,5,0,e_0,82,94,111,3,2,0,9,4,1,0,12,17,29
p_292,11,0,e_1,30,66,111,11,0,0,0,3,0,0,36,45,81
p_287,12,0,e_1,51,71,111,8,3,0,6,5,0,1,20,40,60
p_280,12,0,e_1,65,71,111,5,2,0,11,2,0,1,6,40,46
p_274,4,0,e_1,84,97,111,3,2,0,8,4,1,0,13,14,27
p_269,4,0,e_1,146,161,177,6,1,0,0,3,0,0,15,16,31
p_267,1,0,e_1,153,172,177,7,1,0,2,5,0,1,19,5,24
p_277,10,0,e_3,81,138,178,28,1,1,8,4,1,0,57,40,97
p_271,11,0,e_3,127,143,178,4,1,0,7,5,0,1,16,35,51
p_273,13,0,e_2,95,139,200,20,2,2,1,4,1,1,44,61,105
p_278,15,0,e_2,80,147,200,23,1,1,5,4,1,1,67,53,120
p_272,15,0,e_2,105,147,200,15,1,1,2,5,0,2,42,53,95
p_268,10,0,e_2,150,164,200,29,1,1,14,4,1,0,14,36,50
p_262,6,0,e_2,164,178,200,28,1,1,10,4,1,1,14,22,36
p_259,6,0,e_2,174,178,200,25,1,1,7,4,1,2,4,22,26
p_264,5,0,e_2,162,183,200,30,1,1,10,4,1,1,21,17,38
p_258,5,0,e_2,175,183,200,26,1,1,7,4,1,2,8,17,25
p_254,3,0,e_2,199,211,224,11,1,1,0,3,1,0,12,13,25
p_252,2,0,e_2,212,216,224,8,1,1,3,4,1,0,4,8,12
p_270,7,0,e_0,133,157,238,6,2,2,0,3,0,0,24,81,105
p_263,12,0,e_0,163,174,238,23,1,1,9,5,1,1,11,64,75
p_261,12,0,e_0,170,174,238,20,1,1,11,5,1,2,4,64,68
p_260,13,0,e_0,171,179,238,19,1,1,11,5,1,2,8,59,67
p_266,15,0,e_0,155,187,238,22,1,1,7,5,0,1,32,51,83
p_257,12,0,e_0,179,198,238,12,0,0,13,5,1,1,19,40,59
p_255,10,0,e_0,192,206,238,10,1,0,14,4,1,1,14,32,46
p_256,8,0,e_3,191,218,246,8,0,0,0,3,0,0,27,28,55
p_251,4,0,e_3,228,232,246,1,1,0,5,4,1,0,4,14,18
p_265,12,0,e_1,157,215,275,25,1,1,3,5,0,2,58,60,118
p_253,15,0,e_1,208,226,275,10,1,0,10,5,0,1,18,49,67
p_250,7,0,e_1,236,252,275,26,1,1,12,4,1,0,16,23,39
p_249,7,0,e_1,238,252,275,25,1,1,11,4,1,1,14,23,37
p_248,7,0,e_1,246,252,275,7,0,0,9,4,1,1,6,23,29
p_244,2,0,e_3,271,280,288,2,0,0,0,3,0,0,9,8,17
p_247,12,0,e_0,248,287,329,12,0,0,0,3,0,0,39,42,81
p_246,12,0,e_0,257,287,329,12,0,0,2,5,0,1,30,42,72
p_243,8,0,e_0,285,301,329,23,1,1,12,5,0,1,16,28,44
p_238,2,0,e_0,311,321,329,23,1,1,5,4,1,0,10,8,18
p_245,9,0,e_2,269,299,330,9,0,0,0,3,0,0,30,31,61
p_233,2,0,e_2,319,322,330,20,2,2,3,4,1,0,3,8,11
p_242,4,0,e_1,287,302,402,4,0,0,0,3,0,0,15,100,115
p_235,8,0,e_1,314,316,402,16,2,1,8,5,1,3,2,86,88
p_231,10,0,e_1,320,324,402,12,2,1,9,5,1,3,4,78,82
p_241,13,0,e_1,300,335,402,13,0,0,4,5,0,1,35,67,102
p_224,13,0,e_1,335,337,402,4,5,0,13,5,1,3,2,65,67
p_240,14,0,e_1,301,342,402,14,0,0,4,3,0,1,41,60,101
p_234,14,0,e_1,314,342,402,12,2,0,8,5,1,4,28,60,88
p_223,13,0,e_1,339,347,402,4,4,0,13,5,1,3,8,55,63
p_219,11,0,e_1,342,355,402,5,4,2,14,4,1,3,13,47,60
p_229,9,0,e_1,323,363,402,12,2,1,10,2,1,3,40,39,79
p_220,9,0,e_1,342,363,402,7,4,3,14,4,1,3,21,39,60
p_206,6,0,e_1,362,374,402,8,3,2,9,1,1,3,12,28,40
p_237,5,0,e_1,313,379,402,19,1,1,7,5,1,2,66,23,89
p_232,5,0,e_1,320,379,402,17,2,2,9,5,1,3,59,23,82
p_230,5,0,e_1,323,379,402,16,2,2,10,2,1,3,56,23,79
p_222,3,0,e_2,339,351,410,14,4,3,0,3,0,0,12,59,71
p_221,4,0,e_2,341,356,410,12,4,3,0,5,0,1,15,54,69
p_217,8,0,e_2,345,370,410,7,3,2,1,5,0,2,25,40,65
p_204,8,0,e_2,364,370,410,6,3,2,6,5,1,2,6,40,46
p_198,9,0,e_2,368,375,410,3,3,0,8,5,1,3,7,35,42
p_197,8,0,e_2,375,380,410,3,2,1,9,4,1,2,5,30,35
p_199,2,0,e_2,368,400,410,10,3,1,8,5,1,2,32,10,42
p_185,2,0,e_2,392,400,410,4,2,1,4,4,1,2,8,10,18
p_216,1,0,e_2,346,405,410,14,3,2,2,5,0,3,59,5,64
p_205,1,0,e_2,362,405,410,13,3,2,6,5,1,2,43,5,48
p_236,8,0,e_3,313,332,418,16,1,1,2,5,0,1,19,86,105
p_227,9,0,e_3,326,337,418,11,3,2,6,5,0,3,11,81,92
p_228,11,0,e_3,325,345,418,9,2,1,6,5,0,2,20,73,93
p_226,12,0,e_3,331,350,418,6,3,1,8,2,0,3,19,68,87
p_213,12,0,e_3,347,350,418,3,3,1,11,5,1,2,3,68,71
p_239,13,0,e_3,305,355,418,13,0,0,0,3,0,0,50,63,113
p_208,13,0,e_3,355,357,418,2,4,1,13,5,1,3,2,61,63
p_211,14,0,e_3,348,362,418,2,4,0,12,5,1,3,14,56,70
p_207,12,0,e_3,355,370,418,3,3,1,13,5,1,2,15,48,63
p_203,12,0,e_3,365,370,418,1,3,0,13,4,1,2,5,48,53
p_200,12,0,e_3,367,370,418,1,3,0,13,4,1,2,3,48,51
p_212,9,0,e_3,348,381,418,5,3,1,12,5,1,2,33,37,70
p_195,9,0,e_3,376,381,418,1,2,0,10,4,1,1,5,37,42
p_191,7,0,e_3,382,389,418,2,2,0,9,4,1,1,7,29,36
p_192,5,0,e_3,380,397,418,4,1,0,9,1,1,0,17,21,38
p_215,6,0,e_0,346,354,440,9,3,2,4,5,0,2,8,86,94
p_218,9,0,e_0,343,365,440,6,4,2,3,5,0,1,22,75,97
p_225,10,0,e_0,333,370,440,8,5,3,0,3,0,0,37,70,107
p_202,13,0,e_0,365,381,440,30,3,3,9,5,1,2,16,59,75
p_201,13,0,e_0,366,381,440,30,3,3,9,5,1,3,15,59,74
p_193,12,0,e_0,378,386,440,28,2,2,12,5,1,3,8,54,62
p_194,11,0,e_0,377,391,440,29,2,2,12,5,1,2,14,49,63
p_188,8,0,e_0,390,402,440,29,2,2,11,1,1,2,12,38,50
p_189,7,0,e_0,387,407,440,30,3,3,12,4,1,2,20,33,53
p_187,7,0,e_0,391,407,440,30,2,2,11,4,1,3,16,33,49
p_179,6,0,e_0,397,412,440,29,3,3,9,4,1,3,15,28,43
p_176,6,0,e_0,398,412,440,29,3,3,9,4,1,5,14,28,42
p_178,5,0,e_0,398,417,440,30,3,3,9,4,1,4,19,23,42
p_210,4,0,e_0,353,422,440,11,4,1,6,2,0,2,69,18,87
p_163,4,0,e_0,417,422,440,4,5,5,5,4,1,2,5,18,23
p_186,1,0,e_1,391,407,526,6,2,1,2,1,1,3,16,119,135
p_209,2,0,e_1,354,412,526,13,3,1,11,1,1,3,58,114,172
p_214,4,0,e_1,346,420,526,11,3,2,13,1,1,3,74,106,180
p_196,5,0,e_1,376,425,526,5,2,1,6,4,1,3,49,101,150
p_173,10,0,e_1,405,442,526,23,5,5,1,5,0,5,37,84,121
p_170,10,0,e_1,408,442,526,22,6,6,1,5,1,5,34,84,118
p_160,10,0,e_1,421,442,526,17,5,2,4,5,1,4,21,84,105
p_159,11,0,e_1,424,447,526,15,5,1,5,2,1,3,23,79,102
p_157,12,0,e_1,427,452,526,14,5,1,5,5,1,4,25,74,99
p_145,12,0,e_1,451,452,526,8,4,1,12,2,1,3,1,74,75
p_140,13,0,e_1,455,459,526,6,4,1,12,5,1,3,4,67,71
p_137,13,0,e_1,458,459,526,5,5,1,13,2,1,3,1,67,68
p_190,14,0,e_1,382,466,526,25,3,3,4,4,1,3,84,60,144
p_172,14,0,e_1,405,466,526,19,5,5,1,5,0,6,61,60,121
p_168,15,0,e_1,412,471,526,17,5,5,2,5,1,4,59,55,114
p_175,2,0,e_3,399,426,530,3,3,0,5,4,1,2,27,104,131
p_174,3,0,e_3,402,431,530,1,5,0,4,4,1,4,29,99,128
p_184,5,0,e_3,393,439,530,1,2,0,6,4,1,1,46,91,137
p_182,5,0,e_3,394,439,530,1,2,0,6,4,1,1,45,91,136
p_154,7,0,e_3,438,447,530,16,4,2,5,2,1,3,9,83,92
p_181,11,0,e_3,395,461,530,24,2,2,5,4,1,1,66,69,135
p_139,13,0,e_3,456,469,530,5,4,1,10,5,1,3,13,61,74
p_180,14,0,e_3,396,474,530,21,2,2,5,1,1,1,78,56,134
p_123,12,0,e_3,474,482,530,2,3,0,14,4,1,2,8,48,56
p_120,10,0,e_3,481,490,530,2,4,0,12,1,1,3,9,40,49
p_122,5,0,e_3,477,507,530,8,4,1,13,4,1,3,30,23,53
p_125,4,0,e_3,474,512,530,10,2,0,14,4,1,1,38,18,56
p_155,3,0,e_3,434,517,530,21,4,3,4,5,1,3,83,13,96
p_110,1,0,e_3,501,525,530,6,4,3,7,4,1,3,24,5,29
p_107,1,0,e_3,512,525,530,3,4,1,4,4,1,3,13,5,18
p_166,5,0,e_2,415,427,534,26,6,6,1,5,0,4,12,107,119
p_167,7,0,e_2,412,435,534,25,5,5,0,5,0,3,23,99,122
p_153,8,0,e_2,438,440,534,15,5,2,8,5,1,5,2,94,96
p_177,9,0,e_2,398,445,534,26,3,3,2,4,1,3,47,89,136
p_169,11,0,e_2,410,453,534,21,5,5,0,5,0,2,43,81,124
p_183,12,0,e_2,393,458,534,24,2,2,4,4,1,2,65,76,141
p_164,12,0,e_2,416,458,534,18,6,6,2,5,0,5,42,76,118
p_161,13,0,e_2,418,463,534,15,5,1,2,5,0,6,45,71,116
p_165,14,0,e_2,416,468,534,16,6,6,2,5,0,5,52,66,118
p_162,14,0,e_2,417,468,534,14,5,5,2,5,0,6,51,66,117
p_158,14,0,e_2,426,468,534,12,5,0,5,2,0,6,42,66,108
p_142,15,0,e_2,452,473,534,7,4,0,11,2,1,3,21,61,82
p_124,14,0,e_2,474,478,534,30,4,4,15,4,1,2,4,56,60
p_134,12,0,e_2,462,486,534,5,4,2,13,2,1,2,24,48,72
p_128,10,0,e_2,471,494,534,5,3,1,15,5,1,2,23,40,63
p_156,1,0,e_0,428,445,564,25,5,4,3,4,1,0,17,119,136
p_171,3,0,e_0,408,453,564,29,6,6,7,4,1,3,45,111,156
p_150,3,0,e_0,444,453,564,19,5,3,1,2,0,2,9,111,120
p_148,3,0,e_0,447,453,564,18,4,2,1,5,1,2,6,111,117
p_144,4,0,e_0,451,458,564,16,4,2,3,5,1,3,7,106,113
p_147,7,0,e_0,450,469,564,13,4,2,2,5,1,2,19,95,114
p_138,7,0,e_0,456,469,564,11,4,2,4,5,1,3,13,95,108
p_135,7,0,e_0,461,469,564,10,4,2,5,5,1,3,8,95,103
p_132,7,0,e_0,463,469,564,10,4,2,5,5,1,4,6,95,101
p_131,9,0,e_0,467,477,564,6,4,1,7,5,1,4,10,87,97
p_152,10,0,e_0,439,482,564,13,5,2,0,3,1,2,43,82,125
p_146,10,0,e_0,451,482,564,10,4,2,3,5,1,4,31,82,113
p_127,15,0,e_0,473,499,564,23,2,0,8,5,1,5,26,65,91
p_112,15,0,e_0,497,499,564,23,4,4,15,5,1,7,2,65,67
p_117,12,0,e_0,490,510,564,28,4,4,12,5,1,4,20,54,74
p_99,1,0,e_3,522,535,646,1,5,0,2,4,1,4,13,111,124
p_86,6,0,e_3,541,552,646,19,6,5,3,5,1,5,11,94,105
p_93,7,0,e_3,529,557,646,7,5,5,0,3,1,5,28,89,117
p_100,10,0,e_3,522,568,646,22,5,5,2,4,1,4,46,78,124
p_74,11,0,e_3,567,573,646,7,6,3,10,2,1,5,6,73,79
p_101,12,0,e_3,521,578,646,20,4,4,2,4,1,3,57,68,125
p_66,12,0,e_3,577,578,646,4,6,2,12,2,1,5,1,68,69
p_103,13,0,e_3,517,585,646,20,3,3,3,4,1,2,68,61,129
p_91,13,0,e_3,535,585,646,14,6,1,1,5,1,5,50,61,111
p_109,14,0,e_3,506,590,646,21,4,4,5,1,1,3,84,56,140
p_88,14,0,e_3,538,590,646,12,6,0,2,5,1,5,52,56,108
p_79,14,0,e_3,549,590,646,9,7,0,5,5,1,6,41,56,97
p_68,14,0,e_3,574,590,646,3,7,0,11,5,1,6,16,56,72
p_50,10,0,e_3,592,604,646,4,6,0,14,4,1,5,12,42,54
p_60,9,0,e_3,584,609,646,6,6,1,13,2,1,5,25,37,62
p_143,2,0,e_1,451,534,648,18,4,2,12,2,1,2,83,114,197
p_129,5,0,e_1,470,545,648,10,3,1,15,2,1,2,75,103,178
p_80,6,0,e_1,548,550,648,17,7,5,6,5,1,5,2,98,100
p_116,7,0,e_1,490,555,648,3,4,0,9,1,1,3,65,93,158
p_89,7,0,e_1,537,555,648,20,6,4,3,5,1,5,18,93,111
p_130,9,0,e_1,469,563,648,6,3,1,15,5,1,2,94,85,179
p_121,9,0,e_1,480,563,648,3,5,0,12,4,1,4,83,85,168
p_97,10,0,e_1,526,568,648,21,5,5,0,5,0,5,42,80,122
p_75,14,0,e_1,563,582,648,5,7,0,9,5,1,4,19,66,85
p_151,15,0,e_1,443,587,648,9,5,0,10,5,1,4,144,61,205
p_149,15,0,e_1,444,587,648,9,5,0,10,5,1,4,143,61,204
p_141,15,0,e_1,455,587,648,6,4,0,12,5,1,4,132,61,193
p_87,15,0,e_1,539,587,648,13,6,0,3,5,1,5,48,61,109
p_72,15,0,e_1,569,587,648,5,7,0,10,5,1,4,18,61,79
p_52,11,0,e_1,591,601,648,3,6,0,14,4,1,5,10,47,57
p_102,2,0,e_2,521,542,654,30,4,4,3,4,1,3,21,112,133
p_118,4,0,e_2,488,550,654,6,5,1,12,4,1,2,62,104,166
p_106,4,0,e_2,512,550,654,30,4,4,5,1,1,3,38,104,142
p_105,4,0,e_2,515,550,654,29,4,4,5,4,1,3,35,104,139
p_119,5,0,e_2,483,555,654,7,5,1,13,4,1,2,72,99,171
p_108,5,0,e_2,509,555,654,30,5,5,6,4,1,4,46,99,145
p_114,9,0,e_2,494,569,654,30,4,4,10,4,1,2,75,85,160
p_65,12,0,e_2,578,580,654,4,7,2,12,5,1,4,2,74,76
p_92,13,0,e_2,533,585,654,14,6,1,0,3,1,5,52,69,121
p_111,15,0,e_2,501,593,654,22,5,5,9,4,1,2,92,61,153
p_46,13,0,e_2,596,601,654,29,7,7,14,4,1,4,5,53,58
p_73,6,0,e_2,568,624,654,12,7,4,9,2,1,2,56,30,86
p_47,6,0,e_2,594,624,654,7,7,2,15,4,1,4,30,30,60
p_61,5,0,e_2,583,629,654,10,7,1,13,5,1,4,46,25,71
p_49,5,0,e_2,592,629,654,9,6,2,15,2,1,4,37,25,62
p_136,2,0,e_0,460,572,686,15,4,2,4,5,1,2,112,114,226
p_90,2,0,e_0,536,572,686,25,6,5,6,4,1,6,36,114,150
p_81,2,0,e_0,547,572,686,21,7,6,4,4,1,7,25,114,139
p_85,3,0,e_0,542,577,686,22,7,6,5,4,1,6,35,109,144
p_84,3,0,e_0,546,577,686,21,7,6,4,4,1,7,31,109,140
p_82,3,0,e_0,547,577,686,20,7,6,4,4,1,7,30,109,139
p_133,4,0,e_0,463,582,686,13,4,2,5,5,1,3,119,104,223
p_96,5,0,e_0,527,587,686,26,5,5,8,4,1,6,60,99,159
p_126,6,0,e_0,473,592,686,14,2,0,8,5,1,4,119,94,213
p_98,6,0,e_0,524,592,686,25,5,5,9,4,1,6,68,94,162
p_95,6,0,e_0,527,592,686,25,5,5,8,4,1,7,65,94,159
p_94,6,0,e_0,528,592,686,24,6,6,8,4,1,7,64,94,158
p_104,7,0,e_0,516,597,686,26,3,3,11,4,1,4,81,89,170
p_63,8,0,e_0,581,602,686,8,7,2,4,3,1,5,21,84,105
p_115,10,0,e_0,494,610,686,29,4,4,14,5,1,5,116,76,192
p_42,4,0,e_1,600,662,728,7,7,3,11,1,1,5,62,66,128
p_83,5,0,e_1,546,667,728,19,7,6,5,5,1,4,121,61,182
p_62,5,0,e_1,582,667,728,11,7,2,14,5,1,5,85,61,146
p_57,6,0,e_1,587,672,728,9,7,1,15,4,1,4,85,56,141
p_76,7,0,e_1,559,677,728,14,7,4,8,5,1,4,118,51,169
p_67,8,0,e_1,574,682,728,9,7,3,12,5,1,5,108,46,154
p_69,10,0,e_1,573,690,728,7,7,3,11,5,1,4,117,38,155
p_58,10,0,e_1,586,690,728,5,7,1,15,2,1,4,104,38,142
p_41,10,0,e_1,600,690,728,1,7,0,11,1,1,6,90,38,128
p_28,6,0,e_1,679,704,728,16,4,2,7,5,1,2,25,24,49
p_26,3,0,e_1,698,715,728,13,3,1,8,4,1,2,17,13,30
p_27,2,0,e_1,693,720,728,16,3,1,9,4,1,1,27,8,35
p_64,1,0,e_3,579,651,756,15,6,2,12,2,1,5,72,105,177
p_70,3,0,e_3,572,659,756,14,6,3,11,2,1,5,87,97,184
p_78,4,0,e_3,555,664,756,17,6,4,7,5,1,5,109,92,201
p_55,4,0,e_3,590,664,756,10,6,2,14,4,1,5,74,92,166
p_40,4,0,e_3,601,664,756,7,7,3,11,4,1,6,63,92,155
p_77,6,0,e_3,557,672,756,15,6,4,7,5,1,5,115,84,199
p_59,6,0,e_3,584,672,756,9,6,1,13,2,1,5,88,84,172
p_54,6,0,e_3,590,672,756,8,6,1,14,4,1,5,82,84,166
p_53,9,0,e_3,590,683,756,5,6,0,14,4,1,5,93,73,166
p_29,15,0,e_3,678,703,756,7,3,0,8,5,1,2,25,53,78
p_22,10,0,e_3,712,720,756,2,3,0,12,4,1,2,8,36,44
p_25,7,0,e_3,703,731,756,8,2,0,15,4,1,1,28,25,53
p_30,5,0,e_3,676,739,756,6,2,1,7,5,1,1,63,17,80
p_23,5,0,e_3,709,739,756,8,3,1,13,4,1,2,30,17,47
p_51,1,0,e_2,591,659,758,13,6,4,15,5,1,4,68,99,167
p_71,2,0,e_2,569,664,758,16,7,4,9,5,1,3,95,94,189
p_56,2,0,e_2,588,664,758,12,7,0,14,5,1,4,76,94,170
p_48,2,0,e_2,593,664,758,11,7,5,15,4,1,4,71,94,165
p_43,3,0,e_2,599,669,758,8,7,4,13,4,1,5,70,89,159
p_38,4,0,e_2,627,674,758,30,5,5,5,4,1,4,47,84,131
p_34,15,0,e_2,643,709,758,16,5,5,2,1,1,3,66,49,115
p_24,5,0,e_2,707,741,758,9,3,1,15,5,1,1,34,17,51
p_35,4,0,e_0,640,700,794,27,5,5,12,4,1,4,60,94,154
p_45,5,0,e_0,597,705,794,7,7,3,7,5,1,3,108,89,197
p_32,5,0,e_0,657,705,794,10,5,2,7,4,1,5,48,89,137
p_31,5,0,e_0,662,705,794,9,4,2,6,4,1,5,43,89,132
p_37,7,0,e_0,633,713,794,26,5,5,14,4,1,3,80,81,161
p_33,8,0,e_0,647,718,794,10,5,1,10,4,1,5,71,76,147
p_113,11,0,e_0,496,729,794,27,4,4,14,5,1,6,233,65,298
p_36,11,0,e_0,635,729,794,22,5,5,13,4,1,4,94,65,159
p_44,15,0,e_0,598,743,794,27,7,7,7,5,1,4,145,51,196
p_39,15,0,e_0,609,743,794,24,5,5,10,2,1,3,134,51,185
p_19,12,0,e_0,740,754,794,23,1,1,14,5,1,2,14,40,54
p_20,9,0,e_0,737,765,794,26,2,2,13,5,1,1,28,29,57
p_21,10,0,e_1,732,765,797,27,2,2,0,3,0,0,33,32,65
p_18,2,0,e_2,768,777,857,2,0,0,0,3,0,0,9,80,89
p_13,11,0,e_2,794,806,857,12,1,1,7,5,1,1,12,51,63
p_16,13,0,e_2,774,814,857,17,1,1,1,5,0,1,40,43,83
p_12,13,0,e_2,796,814,857,10,1,1,8,5,1,2,18,43,61
p_11,11,0,e_2,810,822,857,7,1,1,12,5,1,1,12,35,47
p_8,1,0,e_1,847,853,858,6,1,0,0,3,0,0,6,5,11
p_10,14,0,e_3,810,817,869,4,1,1,12,5,0,1,7,52,59
p_17,15,0,e_3,772,822,869,15,0,0,0,3,0,0,50,47,97
p_15,15,0,e_3,782,822,869,12,1,0,3,5,0,1,40,47,87
p_14,15,0,e_3,790,822,869,10,1,0,5,5,0,1,32,47,79
p_4,1,0,e_2,864,870,875,30,1,1,0,3,0,0,6,5,11
p_3,1,0,e_2,876,882,887,1,0,0,0,3,0,0,6,5,11
p_5,5,0,e_1,860,878,895,28,1,1,0,3,0,0,18,17,35
p_2,3,0,e_3,878,890,901,3,0,0,0,3,0,0,12,11,23
p_1,2,0,e_2,889,898,906,5,0,0,0,3,0,0,9,8,17
p_9,2,0,e_0,845,854,938,6,1,0,0,3,0,0,9,84,93
p_7,12,0,e_0,851,886,938,24,1,1,1,5,0,1,35,52,87
p_6,14,0,e_0,858,894,938,19,1,1,3,5,1,1,36,44,80
p_299,3,0,e_1,7,19,30,3,0,0,0,3,0,0,12,11,23
p_296,1,0,e_3,20,26,31,1,0,0,0,3,0,0,6,5,11
p_298,4,0,e_2,10,25,47,4,0,0,0,3,0,0,15,22,37
p_295,5,0,e_2,22,30,47,5,1,0,3,5,0,1,8,17,25
p_288,1,0,e_2,49,55,98,3,2,2,0,3,0,0,6,43,49
p_285,2,0,e_2,54,60,98,7,3,2,1,2,0,1,6,38,44
p_286,3,0,e_2,51,65,98,7,3,2,0,5,0,1,14,33,47
p_282,6,0,e_2,62,76,98,7,2,1,2,5,1,1,14,22,36
p_279,2,0,e_2,76,90,98,8,1,0,6,4,1,0,14,8,22
p_275,2,0,e_2,84,90,98,5,1,0,4,4,1,3,6,8,14
p_290,4,0,e_3,43,50,108,6,1,1,2,5,0,1,7,58,65
p_291,6,0,e_3,35,58,108,6,0,0,0,3,0,0,23,50,73
p_289,7,0,e_3,47,63,108,4,2,0,3,5,0,2,16,45,61
p_283,10,0,e_3,55,74,108,5,3,0,5,5,1,2,19,34,53
p_281,10,0,e_3,63,74,108,3,2,0,7,5,1,1,11,34,45
p_274,4,0,e_3,84,94,108,3,1,0,7,4,1,0,10,14,24
p_300,8,0,e_0,4,31,109,8,0,0,0,3,0,0,27,78,105
p_297,12,0,e_0,18,45,109,12,0,0,4,5,0,1,27,64,91
p_294,13,0,e_0,23,50,109,13,1,0,6,5,0,2,27,59,86
p_293,15,0,e_0,26,58,109,16,1,1,7,5,0,3,32,51,83
p_284,14,0,e_0,55,63,109,9,4,0,14,5,1,1,8,46,54
p_276,5,0,e_0,82,92,109,3,1,0,8,4,1,0,10,17,27
p_292,11,0,e_1,30,66,109,11,0,0,0,3,0,0,36,43,79
p_287,12,0,e_1,51,71,109,8,3,0,6,5,0,1,20,38,58
p_280,12,0,e_1,65,71,109,5,2,0,11,2,0,1,6,38,44
p_269,4,0,e_3,146,161,177,4,0,0,0,3,0,0,15,16,31
p_267,1,0,e_3,153,172,177,5,1,1,2,5,0,1,19,5,24
p_277,10,0,e_2,81,130,202,28,1,1,5,4,1,2,49,72,121
p_273,13,0,e_2,95,141,202,21,1,1,1,4,1,2,46,61,107
p_278,15,0,e_2,80,149,202,23,1,1,5,4,1,1,69,53,122
p_272,15,0,e_2,105,149,202,16,1,1,2,5,0,3,44,53,97
p_265,12,0,e_2,157,160,202,9,2,0,13,4,1,0,3,42,45
p_262,6,0,e_2,164,180,202,27,2,2,11,4,1,1,16,22,38
p_259,6,0,e_2,174,180,202,25,1,1,8,4,1,2,6,22,28
p_264,5,0,e_2,162,185,202,29,2,2,12,4,1,0,23,17,40
p_258,5,0,e_2,175,185,202,25,1,1,7,4,1,2,10,17,27
p_270,7,0,e_1,133,157,224,7,0,0,0,3,0,0,24,67,91
p_268,10,0,e_1,150,168,224,9,1,0,5,5,0,1,18,56,74
p_263,12,0,e_1,163,176,224,22,2,2,9,5,1,1,13,48,61
p_261,12,0,e_1,170,176,224,19,2,2,10,5,1,1,6,48,54
p_260,13,0,e_1,171,181,224,18,1,1,11,5,1,1,10,43,53
p_257,12,0,e_1,179,186,224,12,0,0,13,5,1,1,7,38,45
p_271,11,0,e_0,127,163,228,11,0,0,0,3,0,0,36,65,101
p_266,15,0,e_0,155,177,228,13,2,0,9,5,0,1,22,51,73
p_256,8,0,e_0,191,200,228,8,0,0,11,4,1,0,9,28,37
p_254,3,0,e_0,199,217,228,15,1,1,8,1,1,0,18,11,29
p_252,2,0,e_2,212,221,229,22,2,2,0,3,0,0,9,8,17
p_251,4,0,e_0,228,243,277,15,2,1,0,3,0,0,15,34,49
p_250,7,0,e_0,236,254,277,10,2,1,2,5,0,1,18,23,41
p_249,7,0,e_0,238,254,277,9,2,1,3,5,0,2,16,23,39
p_248,7,0,e_0,246,254,277,7,1,0,5,5,1,1,8,23,31
p_255,10,0,e_3,192,225,293,10,0,0,0,3,0,0,33,68,101
p_253,15,0,e_3,208,242,293,10,1,0,5,5,0,1,34,51,85
p_247,12,0,e_3,248,253,293,1,1,0,13,4,1,0,5,40,45
p_244,2,0,e_3,271,285,293,4,1,0,6,4,1,0,14,8,22
p_243,8,0,e_2,285,296,332,24,1,1,5,5,0,1,11,36,47
p_245,9,0,e_2,269,301,332,28,1,1,0,3,0,0,32,31,63
p_233,2,0,e_2,319,324,332,12,1,1,3,4,1,0,5,8,13
p_246,12,0,e_1,257,296,336,29,1,1,0,3,0,0,39,40,79
p_237,5,0,e_1,313,319,336,5,1,0,7,4,1,0,6,17,23
p_221,4,0,e_2,341,356,374,14,5,4,0,3,0,0,15,18,33
p_214,4,0,e_2,346,356,374,13,4,3,1,5,0,2,10,18,28
p_210,4,0,e_2,353,356,374,14,5,4,3,5,0,3,3,18,21
p_209,2,0,e_2,354,364,374,16,5,4,4,5,0,3,10,10,20
p_216,1,0,e_2,346,369,374,16,4,3,1,5,0,1,23,5,28
p_205,1,0,e_2,362,369,374,15,3,2,2,4,1,3,7,5,12
p_242,4,0,e_0,287,302,394,28,1,1,0,3,0,0,15,92,107
p_241,13,0,e_0,300,331,394,13,0,0,4,5,0,1,31,63,94
p_239,13,0,e_0,305,331,394,13,0,0,5,5,1,2,26,63,89
p_240,14,0,e_0,301,336,394,14,0,0,4,3,0,1,35,58,93
p_234,14,0,e_0,314,336,394,14,2,0,8,5,1,2,22,58,80
p_224,13,0,e_0,335,341,394,7,5,0,14,2,1,4,6,53,59
p_226,12,0,e_0,331,346,394,7,5,0,13,5,1,3,15,48,63
p_219,11,0,e_0,342,351,394,7,5,1,13,4,1,4,9,43,52
p_225,10,0,e_0,333,356,394,7,5,1,13,5,1,4,23,38,61
p_227,9,0,e_0,326,361,394,9,6,2,12,5,1,3,35,33,68
p_220,9,0,e_0,342,361,394,9,5,3,13,4,1,4,19,33,52
p_218,9,0,e_0,343,361,394,9,5,3,13,4,1,5,18,33,51
p_212,9,0,e_0,348,361,394,8,5,4,12,4,1,4,13,33,46
p_206,6,0,e_0,362,372,394,10,3,2,9,4,1,1,10,22,32
p_230,5,0,e_0,323,377,394,12,4,2,11,5,1,2,54,17,71
p_222,3,0,e_1,339,351,400,12,5,4,0,3,0,0,12,49,61
p_217,8,0,e_1,345,368,400,9,5,3,1,5,0,1,23,32,55
p_204,8,0,e_1,364,368,400,8,3,2,7,5,1,1,4,32,36
p_196,5,0,e_1,376,379,400,9,3,2,6,4,1,1,3,21,24
p_199,2,0,e_1,368,390,400,13,3,1,8,4,1,0,22,10,32
p_186,1,0,e_1,391,395,400,9,7,4,2,4,1,0,4,5,9
p_238,2,0,e_3,311,320,440,2,0,0,0,3,0,0,9,120,129
p_232,5,0,e_3,320,331,440,9,2,1,2,5,1,1,11,109,120
p_236,8,0,e_3,313,342,440,8,1,0,0,5,0,1,29,98,127
p_235,8,0,e_3,314,342,440,8,2,0,0,5,0,2,28,98,126
p_229,9,0,e_3,323,347,440,8,4,1,3,5,1,3,24,93,117
p_231,10,0,e_3,320,352,440,8,3,0,2,5,1,2,32,88,120
p_228,11,0,e_3,325,357,440,8,5,0,3,5,1,4,32,83,115
p_213,12,0,e_3,347,362,440,5,4,1,9,5,1,3,15,78,93
p_207,12,0,e_3,355,362,440,5,5,2,11,5,1,4,7,78,85
p_223,13,0,e_3,339,367,440,6,5,0,7,5,1,4,28,73,101
p_208,13,0,e_3,355,367,440,4,5,1,11,5,1,4,12,73,85
p_202,13,0,e_3,365,367,440,2,4,1,13,5,1,3,2,73,75
p_201,13,0,e_3,366,367,440,2,3,1,13,2,1,2,1,73,74
p_211,14,0,e_3,348,374,440,5,5,0,9,5,1,4,26,66,92
p_203,12,0,e_3,365,382,440,3,3,1,13,5,1,2,17,58,75
p_175,2,0,e_1,399,408,486,6,8,3,0,3,1,0,9,78,87
p_174,3,0,e_1,402,413,486,5,8,3,0,5,0,1,11,73,84
p_167,7,0,e_1,412,427,486,29,9,9,3,2,1,1,15,59,74
p_173,10,0,e_1,405,438,486,27,8,8,1,5,0,2,33,48,81
p_170,10,0,e_1,408,438,486,26,10,10,2,5,1,2,30,48,78
p_160,10,0,e_1,421,438,486,24,10,10,5,5,1,2,17,48,65
p_159,11,0,e_1,424,443,486,22,10,10,6,5,1,2,19,43,62
p_152,10,0,e_1,439,448,486,10,11,11,10,5,1,3,9,38,47
p_153,8,0,e_1,438,456,486,22,12,12,10,5,1,2,18,30,48
p_154,7,0,e_1,438,461,486,23,12,12,10,5,1,1,23,25,48
p_138,7,0,e_1,456,461,486,20,11,6,8,4,1,2,5,25,30
p_143,2,0,e_1,451,478,486,26,11,10,9,4,1,2,27,8,35
p_136,2,0,e_1,460,478,486,24,10,9,7,1,1,1,18,8,26
p_215,6,0,e_2,346,394,486,11,4,3,1,5,0,2,48,92,140
p_197,8,0,e_2,375,402,486,6,3,2,0,5,0,1,27,84,111
p_183,12,0,e_2,393,416,486,27,8,8,6,2,0,2,23,70,93
p_190,14,0,e_2,382,424,486,28,5,5,2,5,0,2,42,62,104
p_180,14,0,e_2,396,424,486,25,7,7,6,5,1,3,28,62,90
p_172,14,0,e_2,405,424,486,23,8,8,9,5,1,2,19,62,81
p_165,14,0,e_2,416,424,486,21,9,9,12,5,1,2,8,62,70
p_162,14,0,e_2,417,424,486,21,10,10,12,5,1,2,7,62,69
p_168,15,0,e_2,412,429,486,21,9,9,11,5,1,2,17,57,74
p_158,14,0,e_2,426,434,486,19,10,10,14,5,1,1,8,52,60
p_157,12,0,e_2,427,442,486,21,10,10,15,5,1,2,15,44,59
p_147,7,0,e_2,450,459,486,21,11,5,10,4,1,1,9,27,36
p_144,4,0,e_2,451,470,486,24,11,8,9,4,1,2,19,16,35
p_133,4,0,e_2,463,470,486,21,10,8,6,4,1,2,7,16,23
p_155,3,0,e_2,434,475,486,28,11,11,14,4,1,1,41,11,52
p_184,5,0,e_0,393,411,492,4,8,2,0,3,1,0,18,81,99
p_182,5,0,e_0,394,411,492,4,7,2,0,5,0,1,17,81,98
p_177,9,0,e_0,398,425,492,29,9,9,1,5,0,2,27,67,94
p_181,11,0,e_0,395,433,492,28,7,7,0,5,0,1,38,59,97
p_169,11,0,e_0,410,433,492,25,9,9,5,2,0,2,23,59,82
p_164,12,0,e_0,416,438,492,23,9,9,6,5,1,3,22,54,76
p_161,13,0,e_0,418,443,492,21,11,11,7,5,1,4,25,49,74
p_146,10,0,e_0,451,454,492,18,11,3,11,4,1,1,3,38,41
p_135,7,0,e_0,461,465,492,19,10,6,8,4,1,1,4,27,31
p_166,5,0,e_0,415,473,492,30,9,9,6,5,1,2,58,19,77
p_129,5,0,e_0,470,473,492,19,8,7,6,4,1,1,3,19,22
p_125,4,0,e_0,474,478,492,19,9,7,5,4,1,0,4,14,18
p_110,1,0,e_0,501,507,512,17,9,3,0,3,0,0,6,5,11
p_118,4,0,e_1,488,503,573,16,9,5,0,3,0,0,15,70,85
p_114,9,0,e_1,494,520,573,10,9,4,1,5,0,1,26,53,79
p_115,10,0,e_1,494,525,573,9,9,4,1,5,0,2,31,48,79
p_100,10,0,e_1,522,525,573,4,9,3,9,5,1,2,3,48,51
p_113,11,0,e_1,496,530,573,8,9,4,2,5,0,3,34,43,77
p_89,7,0,e_1,537,544,573,4,9,2,9,4,1,2,7,29,36
p_98,6,0,e_1,524,549,573,7,9,4,10,2,1,1,25,24,49
p_94,6,0,e_1,528,549,573,6,9,3,11,5,1,2,21,24,45
p_85,3,0,e_1,542,560,573,7,9,3,7,4,1,3,18,13,31
p_84,3,0,e_1,546,560,573,6,9,2,7,4,1,3,14,13,27
p_82,3,0,e_1,547,560,573,6,9,2,6,4,1,3,13,13,26
p_90,2,0,e_1,536,565,573,9,9,4,9,4,1,1,29,8,37
p_81,2,0,e_1,547,565,573,7,9,2,6,4,1,3,18,8,26
p_150,3,0,e_2,444,497,574,26,11,9,12,4,1,1,53,77,130
p_148,3,0,e_2,447,497,574,26,12,9,11,4,1,1,50,77,127
p_116,7,0,e_2,490,511,574,13,9,5,1,5,0,1,21,63,84
p_117,12,0,e_2,490,528,574,8,9,3,1,5,0,2,38,46,84
p_101,12,0,e_2,521,528,574,2,9,1,10,5,1,1,7,46,53
p_97,10,0,e_2,526,536,574,3,9,2,12,5,1,1,10,38,48
p_95,6,0,e_2,527,550,574,7,9,4,12,2,1,2,23,24,47
p_86,6,0,e_2,541,550,574,4,9,1,9,4,1,2,9,24,33
p_96,5,0,e_2,527,555,574,8,9,5,12,2,1,1,28,19,47
p_83,5,0,e_2,546,555,574,4,9,1,7,4,1,2,9,19,28
p_78,4,0,e_2,555,560,574,2,9,1,5,4,1,0,5,14,19
p_156,1,0,e_3,428,445,580,1,10,0,2,4,1,9,17,135,152
p_185,2,0,e_3,392,450,580,8,7,4,10,4,1,6,58,130,188
p_171,3,0,e_3,408,455,580,3,8,1,6,4,1,7,47,125,172
p_163,4,0,e_3,417,460,580,1,9,0,5,4,1,8,43,120,163
p_192,5,0,e_3,380,465,580,7,4,2,12,4,1,3,85,115,200
p_178,5,0,e_3,398,465,580,3,8,2,8,4,1,7,67,115,182
p_179,6,0,e_3,397,470,580,3,7,2,9,4,1,6,73,110,183
p_176,6,0,e_3,398,470,580,2,8,1,8,4,1,7,72,110,182
p_191,7,0,e_3,382,475,580,5,4,2,12,4,1,3,93,105,198
p_189,7,0,e_3,387,475,580,4,5,1,11,4,1,4,88,105,193
p_187,7,0,e_3,391,475,580,3,7,2,10,4,1,6,84,105,189
p_132,7,0,e_3,463,475,580,18,10,6,5,5,1,9,12,105,117
p_188,8,0,e_3,390,480,580,2,5,1,10,4,1,4,90,100,190
p_198,9,0,e_3,368,485,580,6,3,1,13,2,1,2,117,95,212
p_195,9,0,e_3,376,485,580,5,3,1,14,4,1,2,109,95,204
p_70,3,0,e_1,572,584,629,29,10,10,0,3,1,0,12,45,57
p_62,5,0,e_1,582,592,629,25,10,8,3,5,0,2,10,37,47
p_61,5,0,e_1,583,592,629,24,10,8,3,2,0,2,9,37,46
p_49,5,0,e_1,592,594,629,22,10,8,5,5,1,4,2,35,37
p_59,6,0,e_1,584,599,629,23,10,7,3,5,1,2,15,30,45
p_57,6,0,e_1,587,599,629,22,9,7,4,5,1,3,12,30,42
p_54,6,0,e_1,590,599,629,22,10,7,5,5,1,5,9,30,39
p_47,6,0,e_1,594,599,629,20,10,7,5,5,1,4,5,30,35
p_45,5,0,e_1,597,604,629,20,10,8,6,5,1,4,7,25,32
p_55,4,0,e_1,590,609,629,24,10,9,5,5,1,4,19,20,39
p_42,4,0,e_1,600,609,629,21,9,8,6,4,1,5,9,20,29
p_40,4,0,e_1,601,609,629,21,9,8,6,4,1,5,8,20,28
p_43,3,0,e_1,599,614,629,22,9,8,6,4,1,4,15,15,30
p_56,2,0,e_1,588,619,629,26,10,9,4,5,1,3,31,10,41
p_48,2,0,e_1,593,619,629,25,10,9,5,2,1,4,26,10,36
p_107,1,0,e_0,512,518,635,15,9,1,0,3,0,0,6,117,123
p_102,2,0,e_0,521,523,635,12,9,7,2,5,1,2,2,112,114
p_106,4,0,e_0,512,531,635,12,9,1,0,3,0,1,19,104,123
p_105,4,0,e_0,515,531,635,11,9,8,0,5,0,2,16,104,120
p_104,7,0,e_0,516,542,635,8,9,6,1,5,0,2,26,93,119
p_93,7,0,e_0,529,542,635,5,9,3,4,5,1,3,13,93,106
p_92,13,0,e_0,533,562,635,28,10,10,4,5,1,2,29,73,102
p_91,13,0,e_0,535,562,635,28,9,9,5,5,1,3,27,73,100
p_88,14,0,e_0,538,567,635,26,10,10,6,5,1,3,29,68,97
p_79,14,0,e_0,549,567,635,24,10,10,9,5,1,4,18,68,86
p_75,14,0,e_0,563,567,635,21,9,9,13,5,1,5,4,68,72
p_87,15,0,e_0,539,572,635,25,9,9,6,5,1,4,33,63,96
p_72,15,0,e_0,569,572,635,18,11,11,14,5,1,5,3,63,66
p_68,14,0,e_0,574,577,635,18,10,10,15,4,1,5,3,58,61
p_66,12,0,e_0,577,585,635,19,11,11,14,4,1,5,8,50,58
p_64,1,0,e_1,579,634,639,1,10,10,2,5,0,1,55,5,60
p_51,1,0,e_1,591,634,639,26,10,9,5,2,1,4,43,5,48
p_35,4,0,e_1,640,655,669,12,4,1,0,3,0,0,15,14,29
p_67,8,0,e_2,574,601,687,24,10,10,0,3,0,0,27,86,113
p_63,8,0,e_2,581,601,687,22,10,7,2,5,0,1,20,86,106
p_41,10,0,e_2,600,609,687,15,9,5,8,2,0,3,9,78,87
p_52,11,0,e_2,591,614,687,16,10,4,5,5,0,1,23,73,96
p_46,13,0,e_2,596,622,687,13,10,2,7,5,0,2,26,65,91
p_44,15,0,e_2,598,630,687,10,9,0,7,5,0,3,32,57,89
p_39,15,0,e_2,609,630,687,8,8,0,10,5,1,3,21,57,78
p_36,11,0,e_2,635,644,687,6,4,2,14,4,1,2,9,43,52
p_33,8,0,e_2,647,655,687,7,4,3,10,4,1,2,8,32,40
p_37,7,0,e_2,633,660,687,10,4,2,14,4,1,1,27,27,54
p_32,5,0,e_2,657,668,687,8,4,1,8,4,1,2,11,19,30
p_31,5,0,e_2,662,668,687,7,4,0,7,4,1,2,6,19,25
p_38,4,0,e_2,627,673,687,15,5,4,14,5,1,1,46,14,60
p_71,2,0,e_3,569,588,700,1,10,0,3,4,1,9,19,112,131
p_122,5,0,e_3,477,599,700,18,10,8,7,5,1,9,122,101,223
p_119,5,0,e_3,483,599,700,16,10,6,9,5,1,9,116,101,217
p_108,5,0,e_3,509,599,700,11,9,1,14,2,1,8,90,101,191
p_126,6,0,e_3,473,604,700,17,9,7,7,5,1,8,131,96,227
p_80,6,0,e_3,548,604,700,2,9,0,8,4,1,8,56,96,152
p_131,9,0,e_3,467,615,700,16,9,4,5,5,1,8,148,85,233
p_130,9,0,e_3,469,615,700,15,8,4,6,2,1,7,146,85,231
p_121,9,0,e_3,480,615,700,13,10,6,8,5,1,9,135,85,220
p_128,10,0,e_3,471,620,700,14,8,4,6,5,1,7,149,80,229
p_120,10,0,e_3,481,620,700,12,10,5,8,5,1,9,139,80,219
p_194,11,0,e_3,377,625,700,2,3,1,13,4,1,2,248,75,323
p_200,12,0,e_3,367,630,700,3,4,1,13,5,1,3,263,70,333
p_193,12,0,e_3,378,630,700,1,4,0,13,4,1,3,252,70,322
p_145,12,0,e_3,451,630,700,16,11,1,2,5,1,10,179,70,249
p_28,6,0,e_1,679,700,720,30,6,6,0,3,0,0,21,20,41
p_99,1,0,e_0,522,640,745,13,9,7,2,2,1,2,118,105,223
p_77,6,0,e_0,557,657,745,30,9,9,12,5,1,4,100,88,188
p_73,6,0,e_0,568,657,745,27,10,10,14,5,1,5,89,88,177
p_76,7,0,e_0,559,662,745,28,10,10,12,5,1,5,103,83,186
p_60,9,0,e_0,584,670,745,20,10,6,12,1,1,5,86,75,161
p_53,9,0,e_0,590,670,745,19,10,6,11,4,1,6,80,75,155
p_69,10,0,e_0,573,675,745,22,10,10,15,4,1,4,102,70,172
p_58,10,0,e_0,586,675,745,18,10,5,12,4,1,6,89,70,159
p_50,10,0,e_0,592,675,745,17,10,5,11,4,1,6,83,70,153
p_74,11,0,e_0,567,680,745,22,10,10,14,5,1,4,113,65,178
p_65,12,0,e_0,578,685,745,18,11,11,14,4,1,6,107,60,167
p_29,15,0,e_0,678,696,745,21,6,6,11,5,1,2,18,49,67
p_24,5,0,e_0,707,728,745,23,5,4,12,4,1,0,21,17,38
p_23,5,0,e_0,709,728,745,22,5,4,11,4,1,1,19,17,36
p_27,2,0,e_2,693,702,764,30,6,6,0,3,0,0,9,62,71
p_26,3,0,e_2,698,707,764,27,6,6,1,5,0,1,9,57,66
p_25,7,0,e_2,703,721,764,22,5,4,2,5,1,1,18,43,61
p_22,10,0,e_2,712,732,764,16,5,4,4,5,1,1,20,32,52
p_20,9,0,e_1,737,762,799,10,5,4,1,5,0,1,25,37,62
p_21,10,0,e_1,732,767,799,10,5,4,0,3,0,0,35,32,67
p_30,5,0,e_3,676,717,804,2,5,0,7,4,1,4,41,87,128
p_134,12,0,e_3,462,740,804,14,10,2,4,5,1,9,278,64,342
p_123,12,0,e_3,474,740,804,11,9,2,7,2,1,8,266,64,330
p_19,12,0,e_3,740,742,804,6,4,3,12,5,1,3,2,62,64
p_140,13,0,e_3,455,747,804,14,10,1,3,5,1,9,292,57,349
p_139,13,0,e_3,456,747,804,14,11,1,3,5,1,10,291,57,348
p_137,13,0,e_3,458,747,804,13,11,1,4,5,1,10,289,57,346
p_103,13,0,e_3,517,747,804,2,9,1,15,4,1,8,230,57,287
p_124,14,0,e_3,474,752,804,9,9,1,7,2,1,8,278,52,330
p_109,14,0,e_3,506,752,804,3,9,1,13,5,1,8,246,52,298
p_151,15,0,e_3,443,757,804,14,11,0,1,5,0,11,314,47,361
p_149,15,0,e_3,444,757,804,14,11,0,1,2,0,11,313,47,360
p_142,15,0,e_3,452,757,804,13,11,0,2,5,1,10,305,47,352
p_141,15,0,e_3,455,757,804,12,11,0,3,5,1,10,302,47,349
p_127,15,0,e_3,473,757,804,8,10,0,7,5,1,9,284,47,331
p_8,1,0,e_1,847,851,864,15,1,1,0,5,0,1,4,13,17
p_9,2,0,e_1,845,856,864,15,1,1,0,3,0,0,11,8,19
p_18,2,0,e_0,768,777,865,10,2,0,0,3,0,0,9,88,97
p_17,15,0,e_0,772,818,865,25,2,2,1,5,0,1,46,47,93
p_15,15,0,e_0,782,818,865,22,2,2,3,5,1,1,36,47,83
p_14,15,0,e_0,790,818,865,19,2,2,6,5,1,1,28,47,75
p_13,11,0,e_2,794,810,869,22,2,2,6,5,0,1,16,59,75
p_11,11,0,e_2,810,812,869,17,1,1,11,5,1,1,2,57,59
p_16,13,0,e_2,774,820,869,27,2,2,0,3,0,0,46,49,95
p_12,13,0,e_2,796,820,869,19,2,2,7,5,0,2,24,49,73
p_10,14,0,e_2,810,825,869,14,1,1,11,5,1,2,15,44,59
p_4,1,0,e_1,864,870,875,11,2,1,0,3,0,0,6,5,11
p_3,1,0,e_1,876,882,887,7,2,1,0,3,0,0,6,5,11
p_2,3,0,e_2,878,890,901,4,2,1,0,3,0,0,12,11,23
p_112,15,0,e_3,497,851,902,4,9,0,11,5,1,8,354,51,405
p_111,15,0,e_3,501,851,902,3,9,0,12,5,1,8,350,51,401
p_34,15,0,e_3,643,851,902,0,5,0,15,5,1,4,208,51,259
p_7,12,0,e_3,851,862,902,3,1,0,15,4,1,0,11,40,51
p_5,5,0,e_3,860,885,902,7,2,0,12,4,1,1,25,17,42
p_1,2,0,e_1,889,898,906,2,1,0,0,3,0,0,9,8,17
p_6,14,0,e_0,858,909,953,29,2,2,2,4,1,0,51,44,95
p_299,3,0,e_1,7,19,32,3,0,0,0,3,0,0,12,13,25
p_296,1,0,e_1,20,27,32,23,1,1,3,4,1,0,7,5,12
p_298,4,0,e_2,10,25,47,4,0,0,0,3,0,0,15,22,37
p_295,5,0,e_2,22,30,47,18,1,1,3,5,0,1,8,17,25
p_290,4,0,e_1,43,50,80,18,2,2,2,5,0,1,7,30,37
p_291,6,0,e_1,35,58,80,19,2,2,0,3,0,0,23,22,45
p_288,1,0,e_1,49,75,80,19,2,2,4,3,0,1,26,5,31
p_300,8,0,e_0,4,31,97,8,0,0,0,3,0,0,27,66,93
p_292,11,0,e_0,30,42,97,16,2,2,8,2,0,1,12,55,67
p_294,13,0,e_0,23,50,97,12,1,0,6,5,0,1,27,47,74
p_282,6,0,e_0,62,73,97,11,3,1,9,4,1,2,11,24,35
p_286,3,0,e_0,51,84,97,17,2,2,13,4,1,0,33,13,46
p_285,2,0,e_0,54,89,97,17,2,2,12,4,1,1,35,8,43
p_279,2,0,e_0,76,89,97,11,3,2,5,4,1,2,13,8,21
p_275,2,0,e_0,84,89,97,9,3,2,3,4,1,1,5,8,13
p_297,12,0,e_3,18,57,121,12,0,0,0,3,0,0,39,64,103
p_293,15,0,e_3,26,68,121,13,1,0,2,5,0,1,42,53,95
p_280,12,0,e_3,65,79,121,4,3,1,14,5,1,2,14,42,56
p_283,10,0,e_3,55,87,121,8,2,1,12,5,0,2,32,34,66
p_281,10,0,e_3,63,87,121,6,3,1,14,5,1,2,24,34,58
p_277,10,0,e_3,81,87,121,2,2,0,12,4,1,1,6,34,40
p_276,5,0,e_3,82,104,121,6,2,1,11,4,1,1,22,17,39
p_289,7,0,e_2,47,71,140,14,2,2,0,3,0,0,24,69,93
p_287,12,0,e_2,51,88,140,8,2,1,1,5,0,1,37,52,89
p_284,14,0,e_2,55,96,140,4,3,1,2,5,0,2,41,44,85
p_269,4,0,e_2,146,161,177,12,1,1,0,3,0,0,15,16,31
p_267,1,0,e_2,153,172,177,13,1,1,2,5,0,1,19,5,24
p_274,4,0,e_1,84,95,179,7,3,2,1,5,0,1,11,84,95
p_278,15,0,e_1,80,130,179,27,2,2,0,3,0,0,50,49,99
p_270,7,0,e_1,133,156,179,14,1,1,14,4,1,0,23,23,46
p_273,13,0,e_0,95,138,199,25,2,2,0,4,1,0,43,61,104
p_272,15,0,e_0,105,146,199,20,1,1,2,5,0,1,41,53,94
p_268,10,0,e_0,150,163,199,5,1,1,14,4,1,0,13,36,49
p_262,6,0,e_0,164,177,199,13,3,2,10,4,1,1,13,22,35
p_259,6,0,e_0,174,177,199,10,3,1,7,4,1,2,3,22,25
p_264,5,0,e_0,162,182,199,14,1,1,10,1,1,0,20,17,37
p_258,5,0,e_0,175,182,199,11,3,1,6,4,1,2,7,17,24
p_254,3,0,e_0,199,211,224,6,2,1,0,3,0,0,12,13,25
p_252,2,0,e_0,212,216,224,4,1,0,3,4,1,0,4,8,12
p_271,11,0,e_3,127,163,230,11,0,0,0,3,0,0,36,67,103
p_263,12,0,e_3,163,168,230,7,2,1,11,5,1,1,5,62,67
p_266,15,0,e_3,155,179,230,6,1,0,9,5,0,1,24,51,75
p_261,12,0,e_3,170,190,230,6,2,1,12,5,1,1,20,40,60
p_256,8,0,e_3,191,204,230,4,1,0,12,4,1,0,13,26,39
p_260,13,0,e_1,171,220,261,4,3,1,2,4,1,0,49,41,90
p_251,4,0,e_0,228,243,277,26,1,1,0,3,0,0,15,34,49
p_249,7,0,e_0,238,254,277,7,1,0,3,5,0,1,16,23,39
p_255,10,0,e_2,192,209,277,2,2,0,5,5,0,1,17,68,85
p_265,12,0,e_2,157,217,277,9,2,1,3,5,0,2,60,60,120
p_257,12,0,e_2,179,217,277,3,2,0,0,5,0,1,38,60,98
p_253,15,0,e_2,208,228,277,22,1,1,10,2,0,1,20,49,69
p_248,7,0,e_2,246,254,277,4,1,0,9,4,1,0,8,23,31
p_250,7,0,e_3,236,260,315,7,0,0,0,3,0,0,24,55,79
p_247,12,0,e_3,248,277,315,9,1,0,3,5,0,1,29,38,67
p_246,12,0,e_3,257,277,315,6,2,0,6,5,0,2,20,38,58
p_244,2,0,e_1,271,278,332,12,2,1,0,5,0,1,7,54,61
p_245,9,0,e_1,269,301,332,5,2,1,0,3,0,0,32,31,63
p_238,2,0,e_1,311,324,332,29,1,1,6,4,1,0,13,8,21
p_233,2,0,e_1,319,324,332,25,2,2,3,4,1,1,5,8,13
p_243,8,0,e_0,285,312,386,2,1,0,0,3,0,0,27,74,101
p_241,13,0,e_0,300,329,386,22,1,1,4,5,0,1,29,57,86
p_239,13,0,e_0,305,329,386,20,1,1,6,5,0,2,24,57,81
p_226,12,0,e_0,331,334,386,11,3,1,13,4,1,2,3,52,55
p_229,9,0,e_0,323,345,386,17,3,2,11,5,1,2,22,41,63
p_217,8,0,e_0,345,350,386,11,4,3,9,4,1,2,5,36,41
p_237,5,0,e_0,313,361,386,25,1,1,8,5,1,1,48,25,73
p_210,4,0,e_0,353,366,386,13,4,2,7,4,1,3,13,20,33
p_222,3,0,e_0,339,371,386,17,3,2,11,4,1,2,32,15,47
p_199,2,0,e_0,368,376,386,12,5,3,4,4,1,3,8,10,18
p_216,1,0,e_0,346,381,386,18,4,3,9,4,1,3,35,5,40
p_242,4,0,e_2,287,302,392,5,1,0,0,3,0,0,15,90,105
p_240,14,0,e_2,301,334,392,20,1,1,4,3,0,0,33,58,91
p_224,13,0,e_2,335,339,392,9,3,1,14,4,1,2,4,53,57
p_228,11,0,e_2,325,347,392,14,3,1,11,5,1,2,22,45,67
p_218,9,0,e_2,343,355,392,11,4,3,12,4,1,3,12,37,49
p_215,6,0,e_2,346,366,392,13,4,3,11,1,1,3,20,26,46
p_232,5,0,e_2,320,371,392,22,2,2,10,5,1,1,51,21,72
p_221,4,0,e_2,341,376,392,16,4,3,13,4,1,2,35,16,51
p_214,4,0,e_2,346,376,392,15,4,3,11,1,1,3,30,16,46
p_209,2,0,e_2,354,384,392,15,4,2,9,1,1,3,30,8,38
p_236,8,0,e_3,313,341,429,22,1,1,0,4,1,0,28,88,116
p_235,8,0,e_3,314,341,429,8,1,1,0,3,1,1,27,88,115
p_231,10,0,e_3,320,349,429,17,2,1,1,5,0,2,29,80,109
p_207,12,0,e_3,355,357,429,4,4,2,12,5,1,3,2,72,74
p_223,13,0,e_3,339,362,429,7,3,1,8,5,0,3,23,67,90
p_208,13,0,e_3,355,362,429,3,5,1,12,5,1,4,7,67,74
p_234,14,0,e_3,314,367,429,14,1,1,0,3,1,1,53,62,115
p_211,14,0,e_3,348,367,429,4,4,0,10,2,1,3,19,62,81
p_203,12,0,e_3,365,375,429,2,5,0,14,5,1,4,10,54,64
p_200,12,0,e_3,367,375,429,2,5,0,14,4,1,4,8,54,62
p_212,9,0,e_3,348,386,429,9,3,2,10,2,1,2,38,43,81
p_198,9,0,e_3,368,386,429,5,5,1,14,4,1,4,18,43,61
p_197,8,0,e_3,375,391,429,4,4,1,12,4,1,3,16,38,54
p_189,7,0,e_3,387,396,429,2,4,1,9,4,1,3,9,33,42
p_206,6,0,e_3,362,401,429,9,4,1,13,5,1,3,39,28,67
p_230,5,0,e_1,323,349,442,21,3,3,2,1,1,0,26,93,119
p_227,9,0,e_1,326,363,442,16,3,2,2,4,1,1,37,79,116
p_220,9,0,e_1,342,363,442,11,4,3,3,5,0,3,21,79,100
p_225,10,0,e_1,333,368,442,12,3,1,0,5,0,2,35,74,109
p_219,11,0,e_1,342,373,442,9,4,2,3,5,0,3,31,69,100
p_213,12,0,e_1,347,378,442,6,4,2,5,5,0,4,31,64,95
p_201,13,0,e_1,366,383,442,3,5,0,10,5,1,4,17,59,76
p_194,11,0,e_1,377,391,442,1,5,0,12,2,1,3,14,51,65
p_195,9,0,e_1,376,399,442,3,5,0,12,5,1,3,23,43,66
p_204,8,0,e_1,364,404,442,7,5,1,9,5,1,3,40,38,78
p_188,8,0,e_1,390,404,442,30,4,4,11,1,1,3,14,38,52
p_191,7,0,e_1,382,409,442,3,5,2,13,2,1,3,27,33,60
p_176,6,0,e_1,398,414,442,1,5,0,9,1,1,3,16,28,44
p_184,5,0,e_1,393,419,442,3,5,2,11,4,1,3,26,23,49
p_166,5,0,e_1,415,419,442,28,5,5,6,4,1,2,4,23,27
p_192,5,0,e_0,380,403,498,6,5,3,1,1,1,2,23,95,118
p_182,5,0,e_0,394,403,498,2,5,1,2,5,0,3,9,95,104
p_177,9,0,e_0,398,417,498,28,5,5,4,5,0,4,19,81,100
p_181,11,0,e_0,395,425,498,26,4,4,3,5,0,3,30,73,103
p_193,12,0,e_0,378,430,498,29,5,5,2,4,1,2,52,68,120
p_183,12,0,e_0,393,430,498,26,5,5,2,5,0,3,37,68,105
p_157,12,0,e_0,427,430,498,18,6,6,11,5,1,4,3,68,71
p_202,13,0,e_0,365,435,498,1,6,0,4,1,1,2,70,63,133
p_161,13,0,e_0,418,435,498,19,5,5,9,5,1,4,17,63,80
p_172,14,0,e_0,405,440,498,21,5,5,5,5,1,4,35,58,93
p_165,14,0,e_0,416,440,498,19,5,5,9,2,1,4,24,58,82
p_162,14,0,e_0,417,440,498,18,6,6,9,5,1,4,23,58,81
p_158,14,0,e_0,426,440,498,17,5,5,11,5,1,4,14,58,72
p_160,10,0,e_0,421,454,498,22,5,5,10,5,1,4,33,44,77
p_152,10,0,e_0,439,454,498,8,4,0,14,2,1,3,15,44,59
p_186,1,0,e_2,391,397,514,7,4,2,0,3,1,2,6,117,123
p_196,5,0,e_2,376,411,514,7,5,3,4,4,1,1,35,103,138
p_187,7,0,e_2,391,419,514,1,4,0,0,3,1,3,28,95,123
p_167,7,0,e_2,412,419,514,26,6,6,5,5,1,4,7,95,102
p_173,10,0,e_2,405,430,514,25,5,5,3,5,1,3,25,84,109
p_170,10,0,e_2,408,430,514,25,5,5,4,5,1,4,22,84,106
p_169,11,0,e_2,410,435,514,23,6,6,5,2,1,3,25,79,104
p_190,14,0,e_2,382,446,514,26,5,5,2,4,1,2,64,68,132
p_180,14,0,e_2,396,446,514,23,4,4,1,2,0,3,50,68,118
p_168,15,0,e_2,412,451,514,18,6,6,5,5,1,4,39,63,102
p_149,15,0,e_2,444,451,514,12,4,0,14,5,1,3,7,63,70
p_145,12,0,e_2,451,462,514,13,4,1,15,4,1,3,11,52,63
p_131,9,0,e_2,467,473,514,12,4,3,11,4,1,4,6,41,47
p_154,7,0,e_2,438,481,514,5,4,0,12,5,1,2,43,33,76
p_147,7,0,e_2,450,481,514,18,4,1,15,2,1,2,31,33,64
p_205,1,0,e_3,362,434,555,14,3,1,13,5,1,2,72,121,193
p_185,2,0,e_3,392,439,555,6,4,2,8,4,1,3,47,116,163
p_175,2,0,e_3,399,439,555,4,5,1,6,4,1,4,40,116,156
p_174,3,0,e_3,402,444,555,3,4,1,6,4,1,3,42,111,153
p_178,5,0,e_3,398,452,555,2,4,1,7,4,1,3,54,103,157
p_179,6,0,e_3,397,457,555,1,4,0,7,4,1,3,60,98,158
p_146,10,0,e_3,451,471,555,15,3,1,5,2,1,2,20,84,104
p_128,10,0,e_3,471,473,555,10,4,2,10,5,1,3,2,82,84
p_123,12,0,e_3,474,481,555,8,4,2,10,5,1,3,7,74,81
p_139,13,0,e_3,456,486,555,11,3,1,6,2,1,2,30,69,99
p_137,13,0,e_3,458,486,555,11,4,1,6,5,1,3,28,69,97
p_151,15,0,e_3,443,494,555,12,3,0,3,2,1,2,51,61,112
p_142,15,0,e_3,452,494,555,10,4,0,5,5,1,3,42,61,103
p_141,15,0,e_3,455,494,555,9,4,0,6,5,1,3,39,61,100
p_127,15,0,e_3,473,494,555,5,4,0,10,5,1,3,21,61,82
p_156,1,0,e_1,428,447,568,1,5,5,3,1,1,3,19,121,140
p_171,3,0,e_1,408,455,568,2,5,0,7,1,1,2,47,113,160
p_163,4,0,e_1,417,460,568,28,6,6,5,4,1,3,43,108,151
p_159,11,0,e_1,424,483,568,20,5,5,4,4,1,2,59,85,144
p_164,12,0,e_1,416,488,568,21,5,5,6,4,1,2,72,80,152
p_134,12,0,e_1,462,488,568,11,4,2,4,5,1,3,26,80,106
p_140,13,0,e_1,455,493,568,11,4,1,3,5,1,3,38,75,113
p_124,14,0,e_1,474,498,568,6,5,1,8,5,1,4,24,70,94
p_112,15,0,e_1,497,503,568,29,5,5,14,2,1,3,6,65,71
p_111,15,0,e_1,501,503,568,28,5,5,15,5,1,4,2,65,67
p_109,14,0,e_1,506,508,568,27,5,5,14,4,1,3,2,60,62
p_117,12,0,e_1,490,516,568,4,5,1,12,5,1,3,26,52,78
p_114,9,0,e_1,494,527,568,6,4,1,13,5,1,3,33,41,74
p_104,7,0,e_1,516,535,568,2,6,0,12,4,1,3,19,33,52
p_93,7,0,e_1,529,535,568,29,8,8,9,4,1,5,6,33,39
p_136,2,0,e_0,460,506,628,21,4,3,8,4,1,4,46,122,168
p_155,3,0,e_0,434,511,628,8,5,2,13,2,1,2,77,117,194
p_150,3,0,e_0,444,511,628,24,4,3,13,4,1,3,67,117,184
p_144,4,0,e_0,451,516,628,21,3,2,11,4,1,3,65,112,177
p_105,4,0,e_0,515,516,628,6,6,3,4,3,1,3,1,112,113
p_129,5,0,e_0,470,523,628,15,4,2,6,4,1,4,53,105,158
p_138,7,0,e_0,456,531,628,17,3,2,10,4,1,3,75,97,172
p_132,7,0,e_0,463,531,628,15,4,3,8,4,1,4,68,97,165
p_153,8,0,e_0,438,536,628,6,4,0,14,5,1,3,98,92,190
p_101,12,0,e_0,521,550,628,26,7,7,5,5,1,4,29,78,107
p_103,13,0,e_0,517,555,628,26,6,6,4,3,1,3,38,73,111
p_92,13,0,e_0,533,555,628,23,7,7,7,5,1,4,22,73,95
p_91,13,0,e_0,535,555,628,22,7,7,8,2,1,3,20,73,93
p_79,14,0,e_0,549,560,628,18,8,8,12,2,1,4,11,68,79
p_87,15,0,e_0,539,565,628,19,8,8,9,5,1,4,26,63,89
p_110,1,0,e_2,501,519,642,12,5,4,3,4,1,4,18,123,141
p_143,2,0,e_2,451,524,642,23,3,2,15,4,1,2,73,118,191
p_148,3,0,e_2,447,529,642,23,4,3,14,5,1,2,82,113,195
p_133,4,0,e_2,463,534,642,18,4,3,12,4,1,3,71,108,179
p_125,4,0,e_2,474,534,642,16,4,2,9,4,1,4,60,108,168
p_118,4,0,e_2,488,534,642,13,4,1,5,1,1,4,46,108,154
p_122,5,0,e_2,477,539,642,14,5,3,8,4,1,4,62,103,165
p_119,5,0,e_2,483,539,642,13,5,2,7,4,1,4,56,103,159
p_94,6,0,e_2,528,544,642,1,7,0,3,2,1,4,16,98,114
p_86,6,0,e_2,541,544,642,28,7,7,5,5,1,4,3,98,101
p_135,7,0,e_2,461,549,642,16,4,3,12,1,1,3,88,93,181
p_89,7,0,e_2,537,549,642,28,7,7,5,5,1,4,12,93,105
p_100,10,0,e_2,522,560,642,28,7,7,2,5,1,5,38,82,120
p_97,10,0,e_2,526,560,642,27,6,6,2,5,1,5,34,82,116
p_88,14,0,e_2,538,574,642,21,7,7,5,2,1,3,36,68,104
p_107,1,0,e_1,512,573,660,9,5,3,13,4,1,3,61,87,148
p_102,2,0,e_1,521,578,660,6,6,3,11,4,1,4,57,82,139
p_81,2,0,e_1,547,578,660,30,8,8,5,4,1,4,31,82,113
p_71,2,0,e_1,569,578,660,16,7,6,0,5,0,5,9,82,91
p_85,3,0,e_1,542,583,660,1,7,0,6,4,1,3,41,77,118
p_84,3,0,e_1,546,583,660,30,8,8,5,4,1,4,37,77,114
p_82,3,0,e_1,547,583,660,29,8,8,5,4,1,4,36,77,113
p_70,3,0,e_1,572,583,660,14,7,5,1,2,0,4,11,77,88
p_96,5,0,e_1,527,591,660,2,6,0,9,4,1,4,64,69,133
p_62,5,0,e_1,582,591,660,12,6,4,3,2,1,4,9,69,78
p_61,5,0,e_1,583,591,660,12,5,4,3,5,1,4,8,69,77
p_126,6,0,e_1,473,596,660,14,4,2,8,5,1,3,123,64,187
p_98,6,0,e_1,524,596,660,1,7,0,10,4,1,5,72,64,136
p_73,6,0,e_1,568,596,660,2,6,6,0,5,0,5,28,64,92
p_59,6,0,e_1,584,596,660,11,5,4,3,5,1,4,12,64,76
p_106,4,0,e_3,512,569,677,6,5,3,10,1,1,4,57,108,165
p_108,5,0,e_3,509,574,677,6,4,3,11,4,1,3,65,103,168
p_95,6,0,e_3,527,579,677,1,6,0,7,4,1,5,52,98,150
p_116,7,0,e_3,490,584,677,9,4,1,14,5,1,3,94,93,187
p_130,9,0,e_3,469,592,677,11,4,2,10,5,1,3,123,85,208
p_121,9,0,e_3,480,592,677,9,4,2,12,2,1,3,112,85,197
p_53,9,0,e_3,590,592,677,6,6,3,9,5,1,5,2,85,87
p_120,10,0,e_3,481,597,677,8,4,2,12,5,1,3,116,80,196
p_115,10,0,e_3,494,597,677,5,4,0,15,4,1,3,103,80,183
p_58,10,0,e_3,586,597,677,7,5,2,7,5,1,4,11,80,91
p_113,11,0,e_3,496,602,677,4,4,0,15,4,1,3,106,75,181
p_52,11,0,e_3,591,602,677,4,6,1,9,2,1,5,11,75,86
p_65,12,0,e_3,578,607,677,6,5,0,6,2,1,4,29,70,99
p_46,13,0,e_3,596,612,677,3,6,0,10,2,1,5,16,65,81
p_44,15,0,e_3,598,620,677,5,7,0,10,5,1,6,22,57,79
p_64,1,0,e_1,579,665,742,17,6,5,2,5,1,4,86,77,163
p_56,2,0,e_1,588,670,742,14,6,4,4,5,1,5,82,72,154
p_43,3,0,e_1,599,675,742,17,8,4,7,5,1,6,76,67,143
p_55,4,0,e_1,590,680,742,11,6,3,5,2,1,5,90,62,152
p_42,4,0,e_1,600,680,742,15,8,3,7,5,1,7,80,62,142
p_45,5,0,e_1,597,685,742,11,7,3,6,5,1,5,88,57,145
p_67,8,0,e_1,574,696,742,9,6,3,1,5,1,4,122,46,168
p_60,9,0,e_1,584,701,742,8,5,3,3,5,1,4,117,41,158
p_41,10,0,e_1,600,706,742,9,8,3,7,5,1,7,106,36,142
p_25,7,0,e_1,703,717,742,17,3,1,9,5,1,1,14,25,39
p_24,5,0,e_1,707,725,742,18,2,1,10,4,1,1,18,17,35
p_99,1,0,e_0,522,633,744,7,7,3,5,2,1,4,111,111,222
p_90,2,0,e_0,536,638,744,3,7,1,8,5,1,3,102,106,208
p_48,2,0,e_0,593,638,744,13,7,3,8,1,1,6,45,106,151
p_78,4,0,e_0,555,646,744,18,7,6,13,5,1,4,91,98,189
p_47,6,0,e_0,594,654,744,9,7,3,8,4,1,6,60,90,150
p_63,8,0,e_0,581,662,744,10,6,4,11,4,1,5,81,82,163
p_33,8,0,e_0,647,662,744,29,6,6,4,5,1,6,15,82,97
p_69,10,0,e_0,573,670,744,7,6,1,13,4,1,4,97,74,171
p_74,11,0,e_0,567,675,744,7,7,0,15,4,1,4,108,69,177
p_36,11,0,e_0,635,675,744,29,7,7,1,5,1,7,40,69,109
p_75,14,0,e_0,563,686,744,12,7,0,15,5,1,4,123,58,181
p_34,15,0,e_0,643,691,744,23,7,7,3,5,1,6,48,53,101
p_29,15,0,e_0,678,691,744,15,6,0,12,5,1,3,13,53,66
p_28,6,0,e_0,679,720,744,24,6,2,12,5,1,3,41,24,65
p_32,5,0,e_0,657,725,744,30,6,6,7,5,1,5,68,19,87
p_40,4,0,e_2,601,656,754,15,7,3,10,1,1,6,55,98,153
p_83,5,0,e_2,546,661,754,28,8,8,6,5,1,3,115,93,208
p_80,6,0,e_2,548,666,754,26,8,8,7,2,1,3,118,88,206
p_77,6,0,e_2,557,666,754,16,7,4,9,5,1,4,109,88,197
p_76,7,0,e_2,559,671,754,14,7,3,10,2,1,3,112,83,195
p_50,10,0,e_2,592,682,754,5,7,2,12,4,1,6,90,72,162
p_66,12,0,e_2,577,690,754,6,6,0,14,5,1,4,113,64,177
p_68,14,0,e_2,574,698,754,9,6,0,14,5,1,4,124,56,180
p_72,15,0,e_2,569,703,754,11,7,0,13,5,1,4,134,51,185
p_23,5,0,e_2,709,735,754,18,2,1,13,4,1,1,26,19,45
p_26,3,0,e_2,698,743,754,22,4,3,14,5,1,1,45,11,56
p_27,2,0,e_0,693,752,780,24,5,4,15,4,1,2,59,28,87
p_31,5,0,e_0,662,763,780,29,6,6,8,5,1,5,101,17,118
p_30,5,0,e_0,676,763,780,5,6,6,11,5,1,3,87,17,104
p_51,1,0,e_3,591,682,787,14,5,3,9,2,1,4,91,105,196
p_38,4,0,e_3,627,693,787,9,5,2,13,4,1,4,66,94,160
p_35,4,0,e_3,640,693,787,5,7,3,9,4,1,6,53,94,147
p_49,5,0,e_3,592,698,787,10,6,3,9,5,1,5,106,89,195
p_57,6,0,e_3,587,703,787,10,5,4,8,5,1,4,116,84,200
p_54,6,0,e_3,590,703,787,9,6,3,9,5,1,5,113,84,197
p_37,7,0,e_3,633,708,787,4,6,0,11,4,1,5,75,79,154
p_22,10,0,e_3,712,719,787,12,2,1,8,5,1,1,7,68,75
p_39,15,0,e_3,609,736,787,3,6,0,12,5,1,5,127,51,178
p_21,10,0,e_3,732,753,787,6,2,1,14,5,1,1,21,34,55
p_20,9,0,e_3,737,758,787,6,2,1,15,4,1,1,21,29,50
p_19,12,0,e_1,740,780,842,2,3,0,0,4,1,0,40,62,102
p_17,15,0,e_1,772,791,842,20,1,1,10,5,0,1,19,51,70
p_12,13,0,e_1,796,799,842,16,1,1,14,4,1,1,3,43,46
p_13,11,0,e_1,794,807,842,18,1,1,14,4,1,0,13,35,48
p_18,2,0,e_2,768,777,855,4,1,0,0,3,0,0,9,78,87
p_16,13,0,e_2,774,812,855,21,1,1,1,5,0,1,38,43,81
p_8,1,0,e_2,847,850,855,12,1,0,2,4,1,0,3,5,8
p_11,11,0,e_0,810,818,883,13,1,1,9,5,0,1,8,65,73
p_15,15,0,e_0,782,832,883,16,1,1,0,3,0,0,50,51,101
p_5,5,0,e_0,860,864,883,4,1,0,6,4,1,0,4,19,23
p_4,1,0,e_0,864,878,883,6,1,0,5,4,1,0,14,5,19
p_10,14,0,e_3,810,835,889,10,1,1,6,5,0,1,25,54,79
p_14,15,0,e_3,790,840,889,15,0,0,0,3,0,0,50,49,99
p_3,1,0,e_3,876,884,889,2,1,0,3,4,1,0,8,5,13
p_1,2,0,e_0,889,898,906,2,0,0,0,3,0,0,9,8,17
p_9,2,0,e_1,845,854,924,12,1,0,0,3,0,0,9,70,79
p_7,12,0,e_1,851,886,924,30,1,1,1,5,0,1,35,38,73
p_6,14,0,e_2,858,903,949,25,1,1,0,3,0,0,45,46,91
p_2,3,0,e_2,878,938,949,30,2,2,6,5,0,1,60,11,71
p_299,3,0,e_1,7,19,30,3,0,0,0,3,0,0,12,11,23
p_296,1,0,e_3,20,26,31,1,0,0,0,3,0,0,6,5,11
p_298,4,0,e_2,10,25,47,4,0,0,0,3,0,0,15,22,37
p_295,5,0,e_2,22,30,47,5,1,0,3,5,0,1,8,17,25
p_288,1,0,e_2,49,55,98,3,2,2,0,3,0,0,6,43,49
p_285,2,0,e_2,54,60,98,7,3,2,1,2,0,1,6,38,44
p_286,3,0,e_2,51,65,98,7,3,2,0,5,0,1,14,33,47
p_282,6,0,e_2,62,76,98,7,2,1,2,5,1,1,14,22,36
p_279,2,0,e_2,76,90,98,8,1,0,6,4,1,0,14,8,22
p_275,2,0,e_2,84,90,98,5,2,0,4,4,1,1,6,8,14
p_290,4,0,e_3,43,50,108,6,1,1,2,5,0,1,7,58,65
p_291,6,0,e_3,35,58,108,6,0,0,0,3,0,0,23,50,73
p_289,7,0,e_3,47,63,108,4,2,0,3,5,0,2,16,45,61
p_283,10,0,e_3,55,74,108,5,3,0,5,5,1,2,19,34,53
p_281,10,0,e_3,63,74,108,3,2,0,7,5,1,1,11,34,45
p_274,4,0,e_3,84,94,108,3,2,0,7,4,1,1,10,14,24
p_300,8,0,e_0,4,31,109,8,0,0,0,3,0,0,27,78,105
p_297,12,0,e_0,18,45,109,12,0,0,4,5,0,1,27,64,91
p_294,13,0,e_0,23,50,109,13,1,0,6,5,0,2,27,59,86
p_293,15,0,e_0,26,58,109,16,1,1,7,5,0,3,32,51,83
p_284,14,0,e_0,55,63,109,9,4,0,14,5,1,1,8,46,54
p_276,5,0,e_0,82,92,109,3,2,0,8,4,1,1,10,17,27
p_292,11,0,e_1,30,66,109,11,0,0,0,3,0,0,36,43,79
p_287,12,0,e_1,51,71,109,8,3,0,6,5,0,1,20,38,58
p_280,12,0,e_1,65,71,109,5,2,0,11,2,0,1,6,38,44
p_277,10,0,e_0,81,141,185,28,2,2,8,4,1,0,60,44,104
p_271,11,0,e_0,127,146,185,13,1,1,6,5,0,1,19,39,58
p_264,5,0,e_0,162,166,185,8,2,1,6,4,1,1,4,19,23
p_269,4,0,e_0,146,171,185,14,1,1,11,4,1,0,25,14,39
p_273,13,0,e_2,95,139,198,21,2,2,1,4,1,0,44,59,103
p_272,15,0,e_2,105,147,198,16,2,2,2,5,0,1,42,51,93
p_268,10,0,e_2,150,164,198,6,1,1,14,4,1,0,14,34,48
p_262,6,0,e_2,164,178,198,6,2,0,10,4,1,0,14,20,34
p_259,6,0,e_2,174,178,198,4,1,0,7,4,1,1,4,20,24
p_278,15,0,e_3,80,155,206,23,1,1,8,4,1,0,75,51,126
p_265,12,0,e_3,157,166,206,3,1,0,15,4,1,0,9,40,49
p_263,12,0,e_3,163,166,206,1,2,0,13,4,1,1,3,40,43
p_258,5,0,e_3,175,189,206,4,1,0,9,4,1,0,14,17,31
p_254,3,0,e_2,199,211,224,29,1,1,0,3,0,0,12,13,25
p_252,2,0,e_2,212,216,224,2,0,0,3,4,1,0,4,8,12
p_270,7,0,e_1,133,157,240,15,1,1,0,3,0,0,24,83,107
p_261,12,0,e_1,170,174,240,29,1,1,11,5,1,2,4,66,70
p_260,13,0,e_1,171,179,240,28,1,1,11,5,1,3,8,61,69
p_266,15,0,e_1,155,187,240,30,1,1,7,5,0,2,32,53,85
p_257,12,0,e_1,179,198,240,26,2,2,13,5,1,2,19,42,61
p_255,10,0,e_1,192,206,240,24,1,1,14,4,1,2,14,34,48
p_267,1,0,e_1,153,235,240,14,1,0,6,5,0,1,82,5,87
p_251,4,0,e_2,228,243,277,4,0,0,0,3,0,0,15,34,49
p_250,7,0,e_2,236,254,277,7,0,0,2,5,0,1,18,23,41
p_249,7,0,e_2,238,254,277,7,0,0,3,5,0,2,16,23,39
p_248,7,0,e_2,246,254,277,7,0,0,5,5,1,1,8,23,31
p_256,8,0,e_0,191,218,292,27,1,1,0,3,0,0,27,74,101
p_253,15,0,e_0,208,241,292,15,0,0,5,5,0,1,33,51,84
p_247,12,0,e_0,248,252,292,12,0,0,13,4,1,0,4,40,44
p_244,2,0,e_0,271,284,292,16,1,1,6,4,1,0,13,8,21
p_245,9,0,e_3,269,299,332,9,0,0,0,3,0,0,30,33,63
p_242,4,0,e_3,287,316,332,9,1,1,5,5,0,1,29,16,45
p_233,2,0,e_3,319,324,332,1,1,0,3,4,1,0,5,8,13
p_246,12,0,e_1,257,296,336,12,0,0,0,3,0,0,39,40,79
p_237,5,0,e_1,313,319,336,30,2,2,7,4,1,0,6,17,23
p_243,8,0,e_2,285,312,394,5,1,1,0,3,0,0,27,82,109
p_241,13,0,e_2,300,329,394,26,2,2,4,5,0,1,29,65,94
p_239,13,0,e_2,305,329,394,24,2,2,6,5,0,3,24,65,89
p_240,14,0,e_2,301,334,394,25,2,2,5,5,0,2,33,60,93
p_234,14,0,e_2,314,334,394,20,2,2,8,5,1,2,20,60,80
p_224,13,0,e_2,335,339,394,13,0,0,14,4,1,4,4,55,59
p_226,12,0,e_2,331,344,394,12,0,0,13,5,1,3,13,50,63
p_219,11,0,e_2,342,349,394,11,1,0,12,4,1,4,7,45,52
p_225,10,0,e_2,333,354,394,10,0,0,14,2,1,3,21,40,61
p_227,9,0,e_2,326,359,394,23,1,1,12,5,1,3,33,35,68
p_220,9,0,e_2,342,359,394,9,1,0,12,4,1,4,17,35,52
p_212,9,0,e_2,348,359,394,7,4,0,11,1,1,3,11,35,46
p_206,6,0,e_2,362,370,394,4,4,1,8,4,1,2,8,24,32
p_230,5,0,e_2,323,375,394,27,1,1,11,5,1,2,52,19,71
p_210,4,0,e_2,353,380,394,9,4,2,10,1,1,2,27,14,41
p_221,4,0,e_3,341,356,420,4,0,0,0,3,0,0,15,64,79
p_214,4,0,e_3,346,356,420,11,3,1,1,5,0,3,10,64,74
p_215,6,0,e_3,346,364,420,9,3,1,1,5,0,3,18,56,74
p_217,8,0,e_3,345,372,420,7,1,0,1,5,0,1,27,48,75
p_204,8,0,e_3,364,372,420,2,3,0,6,5,1,2,8,48,56
p_198,9,0,e_3,368,377,420,2,4,0,7,5,1,3,9,43,52
p_195,9,0,e_3,376,377,420,2,5,0,9,2,1,4,1,43,44
p_197,8,0,e_3,375,384,420,1,4,0,9,5,1,3,9,36,45
p_191,7,0,e_3,382,389,420,1,5,0,8,4,1,4,7,31,38
p_196,5,0,e_3,376,397,420,4,4,0,9,2,1,3,21,23,44
p_184,5,0,e_3,393,397,420,1,4,0,6,4,1,3,4,23,27
p_182,5,0,e_3,394,397,420,1,4,0,6,4,1,3,3,23,26
p_174,3,0,e_3,402,405,420,1,3,0,4,4,1,2,3,15,18
p_199,2,0,e_3,368,410,420,7,3,1,7,5,1,2,42,10,52
p_185,2,0,e_3,392,410,420,4,4,1,6,4,1,3,18,10,28
p_238,2,0,e_0,311,320,426,3,2,1,0,3,0,0,9,106,115
p_232,5,0,e_0,320,331,426,28,2,2,2,5,1,1,11,95,106
p_236,8,0,e_0,313,342,426,27,2,2,0,5,0,1,29,84,113
p_235,8,0,e_0,314,342,426,26,2,2,0,5,0,2,28,84,112
p_229,9,0,e_0,323,347,426,23,1,1,3,5,1,3,24,79,103
p_231,10,0,e_0,320,352,426,23,2,2,2,5,1,2,32,74,106
p_228,11,0,e_0,325,357,426,21,1,1,3,5,1,4,32,69,101
p_213,12,0,e_0,347,362,426,11,4,0,9,5,1,3,15,64,79
p_223,13,0,e_0,339,367,426,13,0,0,7,5,1,4,28,59,87
p_208,13,0,e_0,355,367,426,9,3,3,11,5,1,4,12,59,71
p_202,13,0,e_0,365,367,426,7,3,0,13,5,1,2,2,59,61
p_201,13,0,e_0,366,367,426,7,3,0,13,2,1,1,1,59,60
p_211,14,0,e_0,348,374,426,12,4,0,9,5,1,4,26,52,78
p_193,12,0,e_0,378,382,426,27,5,5,13,4,1,1,4,44,48
p_194,11,0,e_0,377,387,426,28,6,6,13,4,1,0,10,39,49
p_222,3,0,e_1,339,351,430,3,0,0,0,3,0,0,12,79,91
p_218,9,0,e_1,343,371,430,9,1,0,1,5,0,1,28,59,87
p_207,12,0,e_1,355,382,430,8,3,3,4,5,1,2,27,48,75
p_203,12,0,e_1,365,382,430,6,3,0,7,5,1,3,17,48,65
p_200,12,0,e_1,367,382,430,5,3,0,8,5,1,3,15,48,63
p_187,7,0,e_1,391,399,430,30,4,4,9,4,1,2,8,31,39
p_179,6,0,e_1,397,404,430,29,3,3,7,4,1,3,7,26,33
p_176,6,0,e_1,398,404,430,29,3,3,7,1,1,3,6,26,32
p_192,5,0,e_1,380,409,430,4,5,1,12,5,1,2,29,21,50
p_178,5,0,e_1,398,409,430,30,3,3,7,1,1,3,11,21,32
p_171,3,0,e_1,408,417,430,29,3,3,5,1,1,1,9,13,22
p_209,2,0,e_1,354,422,430,10,4,2,4,5,1,1,68,8,76
p_155,3,0,e_1,434,441,488,18,5,4,1,5,0,1,7,47,54
p_163,4,0,e_1,417,446,488,27,3,3,3,4,1,1,29,42,71
p_154,7,0,e_1,438,457,488,13,5,3,2,5,0,2,19,31,50
p_147,7,0,e_1,450,457,488,9,4,3,5,5,1,2,7,31,38
p_138,7,0,e_1,456,457,488,13,5,3,7,2,1,3,1,31,32
p_144,4,0,e_1,451,470,488,12,4,3,5,5,1,3,19,18,37
p_133,4,0,e_1,463,470,488,15,3,2,6,4,1,3,7,18,25
p_150,3,0,e_1,444,475,488,15,4,3,4,5,1,2,31,13,44
p_148,3,0,e_1,447,475,488,14,4,3,4,5,1,2,28,13,41
p_143,2,0,e_1,451,480,488,14,4,3,5,5,1,2,29,8,37
p_136,2,0,e_1,460,480,488,18,4,3,7,4,1,3,20,8,28
p_156,1,0,e_0,428,431,502,21,6,4,0,5,0,2,3,71,74
p_189,7,0,e_0,387,451,502,30,5,5,11,4,1,0,64,51,115
p_188,8,0,e_0,390,456,502,29,4,4,10,4,1,1,66,46,112
p_153,8,0,e_0,438,456,502,12,5,3,3,5,1,2,18,46,64
p_152,10,0,e_0,439,464,502,9,5,2,3,5,1,2,25,38,63
p_146,10,0,e_0,451,464,502,6,4,2,7,5,1,2,13,38,51
p_126,6,0,e_0,473,478,502,11,2,1,7,4,1,1,5,24,29
p_129,5,0,e_0,470,483,502,13,2,1,8,4,1,0,13,19,32
p_122,5,0,e_0,477,483,502,11,3,1,6,1,1,2,6,19,25
p_125,4,0,e_0,474,488,502,12,2,1,7,4,1,2,14,14,28
p_167,7,0,e_2,412,417,514,25,2,2,6,5,0,5,5,97,102
p_177,9,0,e_2,398,425,514,26,3,3,1,5,0,3,27,89,116
p_173,10,0,e_2,405,430,514,23,3,3,3,5,0,4,25,84,109
p_170,10,0,e_2,408,430,514,22,3,3,4,5,0,5,22,84,106
p_181,11,0,e_2,395,435,514,24,4,4,0,5,0,2,40,79,119
p_169,11,0,e_2,410,435,514,21,2,2,5,5,0,5,25,79,104
p_183,12,0,e_2,393,440,514,24,4,4,0,3,1,1,47,74,121
p_164,12,0,e_2,416,440,514,19,3,3,7,2,0,6,24,74,98
p_161,13,0,e_2,418,445,514,17,4,4,7,5,1,6,27,69,96
p_190,14,0,e_2,382,450,514,24,6,6,4,4,1,0,68,64,132
p_180,14,0,e_2,396,450,514,21,3,3,0,5,0,3,54,64,118
p_172,14,0,e_2,405,450,514,19,3,3,3,5,0,5,45,64,109
p_165,14,0,e_2,416,450,514,17,3,3,7,2,0,6,34,64,98
p_162,14,0,e_2,417,450,514,17,3,3,7,5,1,6,33,64,97
p_158,14,0,e_2,426,450,514,13,5,0,9,5,1,6,24,64,88
p_216,1,0,e_3,346,425,542,14,2,2,1,5,0,2,79,117,196
p_205,1,0,e_3,362,425,542,9,4,1,6,5,1,3,63,117,180
p_186,1,0,e_3,391,425,542,6,4,2,7,4,1,3,34,117,151
p_175,2,0,e_3,399,430,542,3,3,0,5,4,1,2,31,112,143
p_166,5,0,e_3,415,441,542,26,2,2,1,4,1,1,26,101,127
p_160,10,0,e_3,421,458,542,10,3,0,0,5,0,3,37,84,121
p_159,11,0,e_3,424,463,542,10,3,0,1,2,0,3,39,79,118
p_157,12,0,e_3,427,468,542,11,5,0,1,5,1,4,41,74,115
p_145,12,0,e_3,451,468,542,4,4,0,8,5,1,3,17,74,91
p_124,14,0,e_3,474,476,542,2,3,1,14,5,1,2,2,66,68
p_141,15,0,e_3,455,481,542,6,4,0,9,5,1,3,26,61,87
p_127,15,0,e_3,473,481,542,2,2,0,13,5,1,1,8,61,69
p_123,12,0,e_3,474,492,542,4,2,1,14,5,1,1,18,50,68
p_120,10,0,e_3,481,500,542,5,3,1,15,4,1,2,19,42,61
p_115,10,0,e_3,494,500,542,2,3,0,12,4,1,2,6,42,48
p_118,4,0,e_1,488,503,605,9,4,3,0,3,0,0,15,102,117
p_116,7,0,e_1,490,514,605,5,4,2,0,5,0,1,24,91,115
p_113,11,0,e_1,496,528,605,30,3,3,2,5,0,3,32,77,109
p_117,12,0,e_1,490,533,605,30,4,4,0,5,0,2,43,72,115
p_103,13,0,e_1,517,538,605,22,5,5,8,5,1,3,21,67,88
p_92,13,0,e_1,533,538,605,19,5,5,12,5,1,5,5,67,72
p_91,13,0,e_1,535,538,605,18,6,6,12,5,1,5,3,67,70
p_112,15,0,e_1,497,546,605,26,3,3,2,5,0,4,49,59,108
p_111,15,0,e_1,501,546,605,25,2,2,4,5,0,5,45,59,104
p_87,15,0,e_1,539,546,605,16,5,5,13,5,1,5,7,59,66
p_93,7,0,e_1,529,572,605,26,6,6,11,5,1,5,43,33,76
p_89,7,0,e_1,537,572,605,24,5,5,13,2,1,5,35,33,68
p_76,7,0,e_1,559,572,605,3,3,3,11,4,1,5,13,33,46
p_98,6,0,e_1,524,577,605,28,5,5,10,5,1,4,53,28,81
p_95,6,0,e_1,527,577,605,27,6,6,11,2,1,5,50,28,78
p_110,1,0,e_0,501,507,608,9,2,1,0,3,1,0,6,101,107
p_104,7,0,e_0,516,527,608,29,5,5,4,5,1,1,11,81,92
p_100,10,0,e_0,522,538,608,24,6,6,6,5,1,3,16,70,86
p_97,10,0,e_0,526,538,608,24,5,5,7,2,1,3,12,70,82
p_101,12,0,e_0,521,546,608,23,5,5,5,5,1,2,25,62,87
p_109,14,0,e_0,506,554,608,25,1,1,1,2,0,0,48,54,102
p_88,14,0,e_0,538,554,608,17,5,5,10,5,1,2,16,54,70
p_79,14,0,e_0,549,554,608,13,5,0,13,5,1,4,5,54,59
p_77,6,0,e_0,557,580,608,9,4,1,13,4,1,4,23,28,51
p_73,6,0,e_0,568,580,608,10,3,2,10,4,1,5,12,28,40
p_83,5,0,e_0,546,585,608,12,4,1,12,5,1,2,39,23,62
p_62,5,0,e_0,582,585,608,13,3,2,6,4,1,4,3,23,26
p_78,4,0,e_0,555,590,608,11,4,2,14,4,1,3,35,18,53
p_84,3,0,e_0,546,595,608,14,4,3,12,5,1,1,49,13,62
p_82,3,0,e_0,547,595,608,14,5,3,12,5,1,4,48,13,61
p_119,5,0,e_2,483,531,640,10,4,3,9,4,1,5,48,109,157
p_135,7,0,e_2,461,539,640,12,4,2,13,4,1,2,78,101,179
p_132,7,0,e_2,463,539,640,12,3,2,13,4,1,3,76,101,177
p_131,9,0,e_2,467,547,640,9,2,1,12,1,1,3,80,93,173
p_130,9,0,e_2,469,547,640,9,2,1,12,4,1,4,78,93,171
p_128,10,0,e_2,471,552,640,7,2,1,11,4,1,4,81,88,169
p_134,12,0,e_2,462,560,640,7,3,1,13,1,1,2,98,80,178
p_140,13,0,e_2,455,565,640,4,4,0,15,4,1,0,110,75,185
p_139,13,0,e_2,456,565,640,7,5,1,15,4,1,1,109,75,184
p_137,13,0,e_2,458,565,640,7,4,1,14,4,1,1,107,75,182
p_75,14,0,e_2,563,570,640,9,3,0,13,5,1,2,7,70,77
p_168,15,0,e_2,412,575,640,17,2,2,6,5,0,6,163,65,228
p_151,15,0,e_2,443,575,640,10,4,0,13,5,1,3,132,65,197
p_149,15,0,e_2,444,575,640,9,4,0,13,2,1,2,131,65,196
p_142,15,0,e_2,452,575,640,7,4,0,14,5,1,1,123,65,188
p_107,1,0,e_3,512,547,654,6,3,1,7,4,1,2,35,107,142
p_99,1,0,e_3,522,547,654,3,5,1,4,4,1,4,25,107,132
p_102,2,0,e_3,521,552,654,3,4,1,5,4,1,3,31,102,133
p_106,4,0,e_3,512,560,654,3,4,1,7,4,1,3,48,94,142
p_105,4,0,e_3,515,560,654,2,5,1,6,4,1,4,45,94,139
p_108,5,0,e_3,509,565,654,3,2,0,8,4,1,1,56,89,145
p_121,9,0,e_3,480,579,654,6,2,0,15,2,1,1,99,75,174
p_114,9,0,e_3,494,579,654,3,3,1,12,4,1,2,85,75,160
p_74,11,0,e_3,567,587,654,6,2,0,5,5,1,1,20,67,87
p_68,14,0,e_3,574,598,654,6,3,0,8,5,1,2,24,56,80
p_46,13,0,e_3,596,603,654,1,7,0,14,5,1,6,7,51,58
p_52,11,0,e_3,591,611,654,5,4,1,12,5,1,3,20,43,63
p_50,10,0,e_3,592,616,654,6,6,1,12,5,1,5,24,38,62
p_41,10,0,e_3,600,616,654,4,7,2,14,4,1,6,16,38,54
p_57,6,0,e_3,587,630,654,11,2,1,11,5,1,1,43,24,67
p_55,4,0,e_3,590,668,700,12,3,1,12,5,1,2,78,32,110
p_38,4,0,e_3,627,668,700,3,4,2,7,4,1,3,41,32,73
p_49,5,0,e_3,592,673,700,11,5,1,12,5,1,4,81,27,108
p_45,5,0,e_3,597,673,700,9,7,0,14,2,1,6,76,27,103
p_32,5,0,e_3,657,673,700,6,3,1,1,5,0,3,16,27,43
p_31,5,0,e_3,662,673,700,5,3,1,2,5,0,3,11,27,38
p_54,6,0,e_3,590,678,700,10,4,1,12,5,1,3,88,22,110
p_30,5,0,e_3,676,683,700,1,2,0,6,5,1,1,7,17,24
p_81,2,0,e_0,547,616,712,15,5,3,12,5,1,3,69,96,165
p_48,2,0,e_0,593,616,712,13,7,1,3,4,1,2,23,96,119
p_36,11,0,e_0,635,645,712,24,3,3,8,5,1,2,10,67,77
p_44,15,0,e_0,598,659,712,29,7,7,2,4,1,1,61,53,114
p_34,15,0,e_0,643,659,712,18,4,4,11,5,1,3,16,53,69
p_33,8,0,e_0,647,682,712,24,4,4,11,5,1,2,35,30,65
p_37,7,0,e_0,633,687,712,28,4,4,7,5,1,1,54,25,79
p_27,2,0,e_0,693,704,712,30,1,1,5,4,1,0,11,8,19
p_64,1,0,e_1,579,610,715,18,3,2,6,4,1,3,31,105,136
p_51,1,0,e_1,591,610,715,15,4,1,3,4,1,4,19,105,124
p_90,2,0,e_1,536,615,715,29,5,5,13,5,1,5,79,100,179
p_56,2,0,e_1,588,615,715,15,3,1,3,4,1,5,27,100,127
p_85,3,0,e_1,542,620,715,15,5,3,14,5,1,5,78,95,173
p_70,3,0,e_1,572,620,715,12,3,2,7,4,1,4,48,95,143
p_96,5,0,e_1,527,628,715,28,6,6,11,2,1,4,101,87,188
p_94,6,0,e_1,528,633,715,27,6,6,11,5,1,5,105,82,187
p_86,6,0,e_1,541,633,715,6,5,5,14,5,1,5,92,82,174
p_80,6,0,e_1,548,633,715,11,5,1,15,4,1,5,85,82,167
p_39,15,0,e_1,609,662,715,26,6,6,1,2,0,4,53,53,106
p_28,6,0,e_1,679,691,715,30,2,2,10,4,1,1,12,24,36
p_35,4,0,e_1,640,699,715,30,3,3,8,5,1,1,59,16,75
p_26,3,0,e_1,698,704,715,27,1,1,4,1,1,0,6,11,17
p_25,7,0,e_3,703,727,750,7,0,0,0,3,0,0,24,23,47
p_71,2,0,e_2,569,648,756,14,3,2,14,2,1,1,79,108,187
p_43,3,0,e_2,599,653,756,11,7,6,9,4,1,7,54,103,157
p_42,4,0,e_2,600,658,756,10,7,5,9,4,1,8,58,98,156
p_40,4,0,e_2,601,658,756,9,7,4,9,4,1,9,57,98,155
p_61,5,0,e_2,583,663,756,13,3,2,13,4,1,5,80,93,173
p_59,6,0,e_2,584,668,756,12,3,2,12,4,1,6,84,88,172
p_47,6,0,e_2,594,668,756,9,7,1,10,4,1,7,74,88,162
p_67,8,0,e_2,574,676,756,6,3,2,15,2,1,2,102,80,182
p_63,8,0,e_2,581,676,756,11,3,2,13,4,1,5,95,80,175
p_60,9,0,e_2,584,681,756,9,3,2,12,4,1,7,97,75,172
p_53,9,0,e_2,590,681,756,7,4,1,11,4,1,8,91,75,166
p_69,10,0,e_2,573,686,756,5,3,1,15,5,1,2,113,70,183
p_58,10,0,e_2,586,686,756,7,2,1,12,4,1,7,100,70,170
p_66,12,0,e_2,577,694,756,7,4,1,15,4,1,3,117,62,179
p_65,12,0,e_2,578,694,756,7,3,1,14,4,1,4,116,62,178
p_20,9,0,e_1,737,767,796,25,1,1,0,3,0,0,30,29,59
p_21,10,0,e_0,732,765,811,26,1,1,0,3,0,0,33,46,79
p_19,12,0,e_0,740,773,811,21,1,1,2,5,0,1,33,38,71
p_24,5,0,e_2,707,773,858,8,1,1,15,4,1,0,66,85,151
p_23,5,0,e_2,709,773,858,8,1,1,14,4,1,2,64,85,149
p_22,10,0,e_2,712,790,858,8,1,0,13,4,1,2,78,68,146
p_72,15,0,e_2,569,807,858,9,3,0,14,2,1,2,238,51,289
p_29,15,0,e_2,678,807,858,21,2,2,8,5,1,4,129,51,180
p_17,15,0,e_2,772,807,858,14,1,0,5,2,0,2,35,51,86
p_15,15,0,e_2,782,807,858,12,2,0,8,5,1,2,25,51,76
p_14,15,0,e_2,790,807,858,9,2,0,10,5,1,1,17,51,68
p_13,11,0,e_2,794,821,858,8,2,1,11,5,1,1,27,37,64
p_9,2,0,e_2,845,850,858,4,1,0,3,4,1,0,5,8,13
p_18,2,0,e_3,768,777,863,2,0,0,0,3,0,0,9,86,95
p_16,13,0,e_3,774,812,863,12,1,0,1,5,0,1,38,51,89
p_12,13,0,e_3,796,812,863,5,2,0,8,5,1,1,16,51,67
p_10,14,0,e_3,810,817,863,1,3,0,13,5,1,2,7,46,53
p_11,11,0,e_3,810,828,863,2,2,0,13,5,1,1,18,35,53
p_4,1,0,e_2,864,870,875,1,0,0,0,3,0,0,6,5,11
p_3,1,0,e_2,876,882,887,1,0,0,0,3,0,0,6,5,11
p_5,5,0,e_1,860,878,897,26,1,1,0,3,0,0,18,19,37
p_2,3,0,e_1,878,886,897,3,0,0,5,4,1,0,8,11,19
p_1,2,0,e_2,889,898,906,2,0,0,0,3,0,0,9,8,17
p_8,1,0,e_0,847,853,940,4,1,0,0,3,0,0,6,87,93
p_7,12,0,e_0,851,888,940,22,1,1,1,5,0,1,37,52,89
p_6,14,0,e_0,858,896,940,17,1,1,2,5,1,1,38,44,82
p_299,3,0,e_1,7,19,30,3,0,0,0,3,0,0,12,11,23
p_296,1,0,e_3,20,26,31,1,0,0,0,3,0,0,6,5,11
p_298,4,0,e_2,10,25,47,4,0,0,0,3,0,0,15,22,37
p_295,5,0,e_2,22,30,47,5,1,0,3,5,0,1,8,17,25
p_290,4,0,e_3,43,50,88,6,1,1,2,5,0,1,7,38,45
p_291,6,0,e_3,35,58,88,6,0,0,0,3,0,0,23,30,53
p_289,7,0,e_3,47,63,88,4,2,0,3,5,0,2,16,25,41
p_279,2,0,e_3,76,80,88,1,1,0,3,4,1,0,4,8,12
p_288,1,0,e_2,49,55,98,3,2,2,0,3,0,0,6,43,49
p_285,2,0,e_2,54,60,98,7,3,2,1,2,0,1,6,38,44
p_286,3,0,e_2,51,65,98,7,3,2,0,5,0,1,14,33,47
p_282,6,0,e_2,62,76,98,13,1,0,2,5,1,1,14,22,36
p_275,2,0,e_2,84,90,98,29,3,3,4,4,1,0,6,8,14
p_300,8,0,e_0,4,31,109,8,0,0,0,3,0,0,27,78,105
p_297,12,0,e_0,18,45,109,12,0,0,4,5,0,1,27,64,91
p_294,13,0,e_0,23,50,109,13,1,0,6,5,0,2,27,59,86
p_293,15,0,e_0,26,58,109,16,1,1,7,5,0,3,32,51,83
p_284,14,0,e_0,55,63,109,9,3,0,14,5,1,2,8,46,54
p_287,12,0,e_0,51,71,109,8,3,0,13,5,1,1,20,38,58
p_280,12,0,e_0,65,71,109,25,1,1,14,4,1,1,6,38,44
p_283,10,0,e_1,55,63,109,5,3,0,8,5,0,1,8,46,54
p_281,10,0,e_1,63,65,109,27,1,1,10,5,1,1,2,44,46
p_292,11,0,e_1,30,70,109,11,0,0,0,3,0,0,40,39,79
p_276,5,0,e_1,82,90,109,27,3,3,7,4,1,0,8,19,27
p_274,4,0,e_1,84,95,109,27,3,3,7,4,1,1,11,14,25
p_267,1,0,e_2,153,159,164,10,2,1,0,3,0,0,6,5,11
p_277,10,0,e_3,81,120,194,22,2,2,2,4,1,1,39,74,113
p_273,13,0,e_3,95,131,194,15,2,1,2,5,0,2,36,63,99
p_278,15,0,e_3,80,139,194,17,1,1,2,4,1,0,59,55,114
p_272,15,0,e_3,105,139,194,10,3,0,5,5,0,3,34,55,89
p_271,11,0,e_3,127,153,194,7,3,2,12,5,1,2,26,41,67
p_268,10,0,e_3,150,158,194,2,2,1,12,4,1,1,8,36,44
p_262,6,0,e_3,164,172,194,2,2,0,8,4,1,1,8,22,30
p_264,5,0,e_3,162,177,194,4,1,0,9,4,1,0,15,17,32
p_269,4,0,e_1,146,161,233,9,2,1,0,3,0,0,15,72,87
p_265,12,0,e_1,157,187,233,28,1,1,3,5,0,1,30,46,76
p_263,12,0,e_1,163,187,233,27,2,2,4,5,1,1,24,46,70
p_261,12,0,e_1,170,187,233,24,3,3,7,5,1,1,17,46,63
p_260,13,0,e_1,171,192,233,23,2,2,7,5,1,1,21,41,62
p_258,5,0,e_2,175,192,233,30,2,2,0,5,0,1,17,41,58
p_259,6,0,e_2,174,197,233,30,2,2,0,3,0,0,23,36,59
p_256,8,0,e_2,191,205,233,23,1,1,5,2,0,1,14,28,42
p_252,2,0,e_2,212,225,233,25,2,1,6,4,1,0,13,8,21
p_270,7,0,e_0,133,157,234,10,3,1,0,3,0,0,24,77,101
p_266,15,0,e_0,155,183,234,26,2,2,7,5,0,1,28,51,79
p_257,12,0,e_0,179,194,234,23,1,1,14,5,1,1,15,40,55
p_255,10,0,e_0,192,202,234,20,1,1,12,4,1,1,10,32,42
p_249,7,0,e_1,238,262,285,11,3,1,0,3,0,0,24,23,47
p_244,2,0,e_2,271,280,288,7,2,1,0,3,0,0,9,8,17
p_254,3,0,e_3,199,211,300,3,0,0,0,3,0,0,12,89,101
p_253,15,0,e_3,208,249,300,13,1,0,2,5,0,1,41,51,92
p_246,12,0,e_3,257,260,300,1,2,0,13,4,1,1,3,40,43
p_251,4,0,e_3,228,286,300,18,2,1,8,5,1,1,58,14,72
p_250,7,0,e_0,236,260,319,12,3,1,0,3,0,0,24,59,83
p_248,7,0,e_0,246,260,319,9,3,1,3,5,0,1,14,59,73
p_247,12,0,e_0,248,277,319,19,2,0,3,5,0,1,29,42,71
p_245,9,0,e_0,269,288,319,30,2,2,10,5,1,1,19,31,50
p_243,8,0,e_0,285,293,319,26,1,1,10,4,1,1,8,26,34
p_233,2,0,e_0,319,328,362,13,2,2,0,3,0,0,9,34,43
p_232,5,0,e_0,320,339,362,9,2,1,0,5,0,1,19,23,42
p_230,5,0,e_0,323,339,362,8,2,1,1,5,0,2,16,23,39
p_221,4,0,e_0,341,344,362,6,2,1,5,4,1,1,3,18,21
p_222,3,0,e_0,339,349,362,8,3,2,5,4,1,0,10,13,23
p_216,1,0,e_0,346,357,362,8,2,0,4,4,1,1,11,5,16
p_205,1,0,e_0,362,368,373,5,3,2,0,3,0,0,6,5,11
p_237,5,0,e_3,313,331,384,5,0,0,0,3,0,0,18,53,71
p_235,8,0,e_3,314,342,384,8,1,0,0,5,0,1,28,42,70
p_229,9,0,e_3,323,347,384,6,2,0,3,5,0,2,24,37,61
p_227,9,0,e_3,326,347,384,5,3,0,4,5,0,3,21,37,58
p_220,9,0,e_3,342,347,384,1,2,0,8,5,1,1,5,37,42
p_218,9,0,e_3,343,347,384,1,2,0,8,5,1,1,4,37,41
p_217,8,0,e_3,345,352,384,1,2,0,9,5,1,1,7,32,39
p_215,6,0,e_3,346,360,384,3,3,0,9,2,1,2,14,24,38
p_214,4,0,e_3,346,368,384,5,2,0,9,2,1,1,22,16,38
p_210,4,0,e_3,353,368,384,4,3,1,8,4,1,2,15,16,31
p_209,2,0,e_3,354,376,384,6,3,2,8,4,1,2,22,8,30
p_199,2,0,e_3,368,376,384,2,2,0,4,4,1,1,8,8,16
p_242,4,0,e_1,287,302,390,30,1,1,0,3,0,0,15,88,103
p_241,13,0,e_1,300,331,390,13,0,0,4,5,0,1,31,59,90
p_239,13,0,e_1,305,331,390,13,0,0,5,5,1,2,26,59,85
p_240,14,0,e_1,301,336,390,14,0,0,4,3,0,1,35,54,89
p_234,14,0,e_1,314,336,390,14,2,0,8,5,1,2,22,54,76
p_224,13,0,e_1,335,341,390,7,3,0,14,2,1,2,6,49,55
p_226,12,0,e_1,331,346,390,7,3,0,13,5,1,2,15,44,59
p_228,11,0,e_1,325,351,390,8,3,0,11,5,1,2,26,39,65
p_219,11,0,e_1,342,351,390,3,2,0,13,4,1,2,9,39,48
p_212,9,0,e_1,348,359,390,30,4,4,12,4,1,1,11,31,42
p_206,6,0,e_1,362,370,390,30,3,3,8,4,1,0,8,20,28
p_238,2,0,e_2,311,320,432,2,0,0,0,3,0,0,9,112,121
p_236,8,0,e_2,313,340,432,8,1,1,0,5,0,1,27,92,119
p_231,10,0,e_2,320,348,432,8,2,0,2,5,1,1,28,84,112
p_225,10,0,e_2,333,348,432,5,3,0,6,5,1,2,15,84,99
p_213,12,0,e_2,347,356,432,27,4,4,10,2,1,1,9,76,85
p_207,12,0,e_2,355,356,432,25,4,4,12,2,1,2,1,76,77
p_223,13,0,e_2,339,363,432,6,3,0,8,2,1,1,24,69,93
p_208,13,0,e_2,355,363,432,24,4,4,12,2,1,3,8,69,77
p_211,14,0,e_2,348,368,432,25,4,4,10,5,1,2,20,64,84
p_202,13,0,e_2,365,373,432,22,3,3,13,5,1,3,8,59,67
p_201,13,0,e_2,366,373,432,21,3,3,14,5,1,4,7,59,66
p_203,12,0,e_2,365,378,432,23,3,3,13,5,1,2,13,54,67
p_200,12,0,e_2,367,378,432,22,2,2,14,2,1,3,11,54,65
p_194,11,0,e_2,377,383,432,21,1,1,12,1,1,2,6,49,55
p_198,9,0,e_2,368,391,432,25,2,2,14,4,1,3,23,41,64
p_186,1,0,e_1,391,397,482,1,0,0,0,3,0,0,6,85,91
p_181,11,0,e_1,395,429,482,11,1,0,1,5,0,1,34,53,87
p_169,11,0,e_1,410,429,482,6,3,0,5,5,1,1,19,53,72
p_164,12,0,e_1,416,434,482,5,5,0,7,5,1,1,18,48,66
p_157,12,0,e_1,427,434,482,3,5,0,11,5,1,3,7,48,55
p_161,13,0,e_1,418,439,482,6,5,0,8,5,1,2,21,43,64
p_138,7,0,e_1,456,459,482,29,6,6,8,4,1,0,3,23,26
p_196,5,0,e_0,376,394,485,27,1,1,0,3,0,0,18,91,109
p_193,12,0,e_0,378,417,485,20,1,1,0,5,0,1,39,68,107
p_183,12,0,e_0,393,417,485,12,1,0,5,2,0,2,24,68,92
p_190,14,0,e_0,382,425,485,16,1,1,1,5,0,2,43,60,103
p_180,14,0,e_0,396,425,485,13,1,0,5,5,1,2,29,60,89
p_172,14,0,e_0,405,425,485,11,3,0,8,5,1,2,20,60,80
p_165,14,0,e_0,416,425,485,7,5,0,12,2,1,2,9,60,69
p_162,14,0,e_0,417,425,485,7,5,0,12,5,1,2,8,60,68
p_168,15,0,e_0,412,430,485,10,4,0,11,5,1,2,18,55,73
p_158,14,0,e_0,426,435,485,5,5,0,14,5,1,1,9,50,59
p_152,10,0,e_0,439,449,485,30,7,7,13,4,1,0,10,36,46
p_147,7,0,e_0,450,460,485,30,6,6,10,4,1,0,10,25,35
p_133,4,0,e_0,463,471,485,30,5,5,6,4,1,0,8,14,22
p_185,2,0,e_3,392,401,485,2,0,0,0,3,0,0,9,84,93
p_167,7,0,e_3,412,418,485,8,3,2,5,5,1,2,6,67,73
p_177,9,0,e_3,398,426,485,8,1,0,1,5,0,1,28,59,87
p_173,10,0,e_3,405,431,485,7,2,0,3,5,1,1,26,54,80
p_170,10,0,e_3,408,431,485,6,3,0,4,5,1,2,23,54,77
p_160,10,0,e_3,421,431,485,2,5,0,8,5,1,4,10,54,64
p_159,11,0,e_3,424,436,485,2,5,0,9,5,1,4,12,49,61
p_153,8,0,e_3,438,447,485,3,6,0,11,4,1,5,9,38,47
p_154,7,0,e_3,438,452,485,4,5,0,11,4,1,4,14,33,47
p_166,5,0,e_3,415,460,485,9,4,3,6,5,1,3,45,25,70
p_163,4,0,e_3,417,465,485,9,4,2,7,2,1,3,48,20,68
p_144,4,0,e_3,451,465,485,3,6,1,7,1,1,5,14,20,34
p_155,3,0,e_3,434,470,485,8,5,0,11,5,1,4,36,15,51
p_150,3,0,e_3,444,470,485,6,7,4,9,4,1,6,26,15,41
p_148,3,0,e_3,447,470,485,5,6,3,8,4,1,5,23,15,38
p_110,1,0,e_0,501,507,512,9,3,1,0,3,0,0,6,5,11
p_156,1,0,e_3,428,490,517,12,5,2,9,5,1,4,62,27,89
p_143,2,0,e_3,451,495,517,5,5,3,7,1,1,4,44,22,66
p_136,2,0,e_3,460,495,517,3,5,2,5,4,1,4,35,22,57
p_118,4,0,e_3,488,503,517,3,2,0,1,5,0,2,15,14,29
p_175,2,0,e_2,399,440,570,14,2,1,7,4,1,4,41,130,171
p_174,3,0,e_2,402,445,570,13,2,1,7,4,1,5,43,125,168
p_171,3,0,e_2,408,445,570,13,3,2,6,4,1,6,37,125,162
p_192,5,0,e_2,380,453,570,26,1,1,12,4,1,3,73,117,190
p_184,5,0,e_2,393,453,570,5,1,0,9,4,1,3,60,117,177
p_182,5,0,e_2,394,453,570,5,1,0,8,4,1,3,59,117,176
p_178,5,0,e_2,398,453,570,4,1,0,8,4,1,4,55,117,172
p_179,6,0,e_2,397,458,570,5,1,0,8,4,1,3,61,112,173
p_176,6,0,e_2,398,458,570,5,1,0,8,4,1,4,60,112,172
p_191,7,0,e_2,382,463,570,23,1,1,11,1,1,3,81,107,188
p_189,7,0,e_2,387,463,570,7,0,0,10,4,1,4,76,107,183
p_187,7,0,e_2,391,463,570,7,0,0,9,4,1,3,72,107,179
p_135,7,0,e_2,461,463,570,28,5,5,7,5,1,7,2,107,109
p_132,7,0,e_2,463,465,570,27,5,5,7,5,1,6,2,105,107
p_204,8,0,e_2,364,470,570,27,3,3,13,5,1,1,106,100,206
p_107,1,0,e_0,512,518,573,30,2,2,0,3,0,0,6,55,61
p_102,2,0,e_0,521,523,573,11,1,1,2,5,1,2,2,50,52
p_106,4,0,e_0,512,531,573,27,2,2,0,3,0,1,19,42,61
p_105,4,0,e_0,515,531,573,26,2,2,0,5,0,2,16,42,58
p_104,7,0,e_0,516,542,573,7,1,1,1,5,0,2,26,31,57
p_83,5,0,e_0,546,550,573,18,3,2,6,4,1,3,4,23,27
p_85,3,0,e_0,542,558,573,20,4,2,7,4,1,2,16,15,31
p_84,3,0,e_0,546,558,573,20,3,2,6,4,1,3,12,15,27
p_82,3,0,e_0,547,558,573,19,3,2,6,4,1,4,11,15,26
p_90,2,0,e_0,536,563,573,7,3,2,5,5,1,2,27,10,37
p_81,2,0,e_0,547,563,573,20,3,2,6,4,1,4,16,10,26
p_99,1,0,e_0,522,568,573,12,1,1,2,2,1,2,46,5,51
p_119,5,0,e_1,483,499,592,25,3,3,0,5,0,1,16,93,109
p_114,9,0,e_1,494,513,592,7,3,0,4,5,0,2,19,79,98
p_120,10,0,e_1,481,518,592,21,2,2,0,3,1,0,37,74,111
p_115,10,0,e_1,494,518,592,8,3,0,4,5,0,3,24,74,98
p_101,12,0,e_1,521,526,592,11,1,0,11,5,1,2,5,66,71
p_103,13,0,e_1,517,531,592,13,1,0,10,2,1,1,14,61,75
p_109,14,0,e_1,506,536,592,19,2,2,7,5,1,2,30,56,86
p_92,13,0,e_1,533,541,592,8,2,0,13,5,1,2,8,51,59
p_91,13,0,e_1,535,541,592,8,3,0,14,2,1,2,6,51,57
p_97,10,0,e_1,526,552,592,7,2,0,12,5,1,2,26,40,66
p_76,7,0,e_1,559,563,592,11,3,2,8,4,1,2,4,29,33
p_80,6,0,e_1,548,568,592,16,3,2,11,4,1,1,20,24,44
p_77,6,0,e_1,557,568,592,13,3,2,9,4,1,2,11,24,35
p_78,4,0,e_1,555,576,592,16,3,2,9,4,1,1,21,16,37
p_70,3,0,e_1,572,581,592,12,3,2,5,4,1,1,9,11,20
p_96,5,0,e_3,527,534,635,6,2,2,3,5,0,2,7,101,108
p_98,6,0,e_3,524,539,635,6,1,1,2,5,0,1,15,96,111
p_95,6,0,e_3,527,539,635,5,3,1,3,5,0,3,12,96,108
p_94,6,0,e_3,528,539,635,5,3,1,3,5,0,3,11,96,107
p_116,7,0,e_3,490,544,635,6,3,0,1,5,1,2,54,91,145
p_93,7,0,e_3,529,544,635,3,3,0,4,5,0,3,15,91,106
p_89,7,0,e_3,537,544,635,1,3,0,6,5,1,2,7,91,98
p_88,14,0,e_3,538,567,635,8,2,0,6,2,1,1,29,68,97
p_79,14,0,e_3,549,567,635,8,3,1,8,5,1,2,18,68,86
p_75,14,0,e_3,563,567,635,3,3,1,13,5,1,2,4,68,72
p_87,15,0,e_3,539,572,635,9,3,0,6,5,1,2,33,63,96
p_72,15,0,e_3,569,572,635,1,4,0,14,5,1,3,3,63,66
p_68,14,0,e_3,574,577,635,1,5,0,15,4,1,4,3,58,61
p_66,12,0,e_3,577,585,635,2,5,0,14,4,1,4,8,50,58
p_65,12,0,e_3,578,585,635,2,6,0,14,4,1,5,7,50,57
p_51,1,0,e_1,591,597,668,10,5,4,0,3,1,0,6,71,77
p_48,2,0,e_1,593,602,668,8,5,3,0,5,0,2,9,66,75
p_43,3,0,e_1,599,607,668,6,5,2,1,5,1,2,8,61,69
p_42,4,0,e_1,600,612,668,5,5,2,2,5,1,3,12,56,68
p_49,5,0,e_1,592,617,668,6,5,4,0,5,0,1,25,51,76
p_41,10,0,e_1,600,634,668,29,5,5,2,5,1,4,34,34,68
p_38,4,0,e_1,627,654,668,28,7,7,8,5,1,1,27,14,41
p_35,4,0,e_1,640,654,668,17,6,5,8,4,1,1,14,14,28
p_64,1,0,e_0,579,585,682,13,6,5,0,3,0,0,6,97,103
p_56,2,0,e_0,588,590,682,9,6,4,2,5,1,2,2,92,94
p_55,4,0,e_0,590,598,682,7,5,4,2,5,1,2,8,84,92
p_62,5,0,e_0,582,603,682,8,6,5,0,5,0,1,21,79,100
p_61,5,0,e_0,583,603,682,7,6,4,1,5,0,2,20,79,99
p_45,5,0,e_0,597,603,682,5,5,3,4,3,1,4,6,79,85
p_59,6,0,e_0,584,608,682,6,5,3,1,2,0,1,24,74,98
p_57,6,0,e_0,587,608,682,6,6,4,1,5,1,2,21,74,95
p_54,6,0,e_0,590,608,682,5,5,3,2,5,1,3,18,74,92
p_52,11,0,e_0,591,625,682,30,5,5,2,5,1,3,34,57,91
p_46,13,0,e_0,596,633,682,27,5,5,4,5,1,4,37,49,86
p_36,11,0,e_0,635,641,682,11,6,0,13,4,1,1,6,41,47
p_33,8,0,e_0,647,652,682,18,7,4,9,4,1,1,5,30,35
p_37,7,0,e_0,633,657,682,23,7,7,13,4,1,0,24,25,49
p_32,5,0,e_0,657,665,682,19,6,5,7,4,1,0,8,17,25
p_71,2,0,e_2,569,578,698,14,4,1,0,3,1,11,9,120,129
p_125,4,0,e_2,474,586,698,28,2,2,9,2,1,7,112,112,224
p_129,5,0,e_2,470,591,698,28,3,3,8,5,1,5,121,107,228
p_122,5,0,e_2,477,591,698,27,2,2,9,5,1,9,114,107,221
p_108,5,0,e_2,509,591,698,27,2,2,14,4,1,10,82,107,189
p_126,6,0,e_2,473,596,698,26,3,3,9,5,1,6,123,102,225
p_86,6,0,e_2,541,596,698,18,4,3,7,4,1,10,55,102,157
p_197,8,0,e_2,375,604,698,24,1,1,13,4,1,3,229,94,323
p_188,8,0,e_2,390,604,698,8,0,0,9,1,1,3,214,94,308
p_195,9,0,e_2,376,609,698,23,1,1,12,4,1,3,233,89,322
p_131,9,0,e_2,467,609,698,25,4,4,7,5,1,6,142,89,231
p_130,9,0,e_2,469,609,698,24,3,3,8,2,1,5,140,89,229
p_121,9,0,e_2,480,609,698,22,2,2,10,5,1,9,129,89,218
p_146,10,0,e_2,451,614,698,27,6,6,5,5,1,6,163,84,247
p_128,10,0,e_2,471,614,698,23,3,3,8,5,1,6,143,84,227
p_31,5,0,e_0,662,699,718,18,6,5,6,4,1,1,37,19,56
p_27,2,0,e_0,693,710,718,17,1,0,3,5,0,1,17,8,25
p_28,6,0,e_1,679,700,722,13,2,1,0,3,0,0,21,22,43
p_26,3,0,e_1,698,711,722,11,1,0,6,5,0,1,13,11,24
p_40,4,0,e_3,601,649,745,5,5,2,9,4,1,4,48,96,144
p_73,6,0,e_3,568,657,745,10,3,1,14,5,1,2,89,88,177
p_47,6,0,e_3,594,657,745,4,5,2,10,1,1,4,63,88,151
p_67,8,0,e_3,574,665,745,7,4,2,15,4,1,3,91,80,171
p_63,8,0,e_3,581,665,745,5,6,3,13,4,1,5,84,80,164
p_60,9,0,e_3,584,670,745,3,5,2,12,1,1,4,86,75,161
p_53,9,0,e_3,590,670,745,2,5,1,11,4,1,4,80,75,155
p_69,10,0,e_3,573,675,745,5,3,1,15,4,1,2,102,70,172
p_58,10,0,e_3,586,675,745,2,6,1,12,4,1,5,89,70,159
p_50,10,0,e_3,592,675,745,1,5,0,11,4,1,4,83,70,153
p_74,11,0,e_3,567,680,745,5,2,1,14,5,1,1,113,65,178
p_34,15,0,e_3,643,694,745,13,6,0,2,5,0,6,51,51,102
p_29,15,0,e_3,678,694,745,4,3,0,11,5,1,2,16,51,67
p_25,7,0,e_3,703,720,745,5,1,0,12,4,1,0,17,25,42
p_24,5,0,e_3,707,728,745,6,2,1,11,4,1,1,21,17,38
p_23,5,0,e_3,709,762,781,5,3,1,10,4,1,2,53,19,72
p_18,2,0,e_3,768,773,781,1,1,0,3,4,1,0,5,8,13
p_20,9,0,e_1,737,767,796,23,2,2,0,3,0,0,30,29,59
p_21,10,0,e_0,732,765,797,24,2,2,0,3,0,0,33,32,65
p_30,5,0,e_2,676,715,804,15,3,2,6,4,1,6,39,89,128
p_100,10,0,e_2,522,732,804,9,1,0,11,1,1,10,210,72,282
p_22,10,0,e_2,712,732,804,29,3,3,4,5,0,7,20,72,92
p_113,11,0,e_2,496,737,804,9,3,0,14,5,1,9,241,67,308
p_145,12,0,e_2,451,742,804,25,6,6,5,5,1,7,291,62,353
p_134,12,0,e_2,462,742,804,23,5,5,7,2,1,6,280,62,342
p_123,12,0,e_2,474,742,804,20,2,2,9,2,1,8,268,62,330
p_117,12,0,e_2,490,742,804,11,4,0,12,5,1,9,252,62,314
p_19,12,0,e_2,740,742,804,19,2,2,12,5,1,4,2,62,64
p_140,13,0,e_2,455,747,804,23,6,6,5,5,1,7,292,57,349
p_139,13,0,e_2,456,747,804,23,6,6,6,5,1,8,291,57,348
p_137,13,0,e_2,458,747,804,22,6,6,6,5,1,7,289,57,346
p_124,14,0,e_2,474,752,804,18,2,2,9,2,1,8,278,52,330
p_151,15,0,e_2,443,757,804,24,7,7,3,5,1,6,314,47,361
p_149,15,0,e_2,444,757,804,24,7,7,3,2,1,6,313,47,360
p_8,1,0,e_1,847,853,858,10,1,0,0,3,0,0,6,5,11
p_9,2,0,e_0,845,854,862,10,1,0,0,3,0,0,9,8,17
p_4,1,0,e_0,864,870,875,4,2,0,0,3,0,0,6,5,11
p_13,11,0,e_3,794,816,883,15,2,2,4,5,0,2,22,67,89
p_11,11,0,e_3,810,816,883,10,3,2,9,5,0,3,6,67,73
p_16,13,0,e_3,774,824,883,19,2,2,2,4,1,1,50,59,109
p_12,13,0,e_3,796,824,883,12,3,1,5,5,0,3,28,59,87
p_10,14,0,e_3,810,829,883,7,3,1,9,5,0,3,19,54,73
p_17,15,0,e_3,772,834,883,17,1,1,2,1,1,0,62,49,111
p_15,15,0,e_3,782,834,883,15,2,0,0,5,0,2,52,49,101
p_14,15,0,e_3,790,834,883,12,2,0,3,5,0,2,44,49,93
p_5,5,0,e_3,860,866,883,2,1,0,7,4,1,0,6,17,23
p_3,1,0,e_0,876,882,901,1,1,0,0,3,0,0,6,19,25
p_2,3,0,e_0,878,890,901,28,1,1,0,5,0,1,12,11,23
p_142,15,0,e_2,452,851,902,22,6,6,5,2,1,7,399,51,450
p_141,15,0,e_2,455,851,902,21,6,6,5,5,1,8,396,51,447
p_127,15,0,e_2,473,851,902,17,3,3,9,5,1,8,378,51,429
p_112,15,0,e_2,497,851,902,13,3,0,14,2,1,10,354,51,405
p_111,15,0,e_2,501,851,902,11,3,0,15,5,1,11,350,51,401
p_44,15,0,e_2,598,851,902,24,6,6,6,5,1,8,253,51,304
p_39,15,0,e_2,609,851,902,22,7,7,9,5,1,6,242,51,293
p_7,12,0,e_2,851,862,902,28,1,1,15,4,1,0,11,40,51
p_1,2,0,e_2,889,894,902,2,0,0,3,4,1,0,5,8,13
p_6,14,0,e_1,858,903,947,23,1,1,0,3,0,0,45,44,89
p_299,3,0,e_1,7,19,30,3,0,0,0,3,0,0,12,11,23
p_296,1,0,e_3,20,26,31,1,0,0,0,3,0,0,6,5,11
p_298,4,0,e_2,10,25,47,4,0,0,0,3,0,0,15,22,37
p_295,5,0,e_2,22,30,47,5,1,0,3,5,0,1,8,17,25
p_290,4,0,e_3,43,50,88,6,1,1,2,5,0,1,7,38,45
p_291,6,0,e_3,35,58,88,6,0,0,0,3,0,0,23,30,53
p_289,7,0,e_3,47,63,88,4,2,0,3,5,0,2,16,25,41
p_279,2,0,e_3,76,80,88,1,1,0,3,4,1,0,4,8,12
p_288,1,0,e_2,49,55,98,3,2,2,0,3,0,0,6,43,49
p_285,2,0,e_2,54,60,98,7,3,2,1,2,0,1,6,38,44
p_286,3,0,e_2,51,65,98,7,3,2,0,5,0,1,14,33,47
p_282,6,0,e_2,62,76,98,13,1,0,2,5,1,1,14,22,36
p_275,2,0,e_2,84,90,98,29,3,3,4,4,1,0,6,8,14
p_300,8,0,e_0,4,31,109,8,0,0,0,3,0,0,27,78,105
p_297,12,0,e_0,18,45,109,12,0,0,4,5,0,1,27,64,91
p_294,13,0,e_0,23,50,109,13,1,0,6,5,0,2,27,59,86
p_293,15,0,e_0,26,58,109,16,1,1,7,5,0,3,32,51,83
p_284,14,0,e_0,55,63,109,9,3,0,14,5,1,2,8,46,54
p_287,12,0,e_0,51,71,109,8,3,0,13,5,1,1,20,38,58
p_280,12,0,e_0,65,71,109,25,1,1,14,4,1,1,6,38,44
p_283,10,0,e_1,55,63,109,5,3,0,8,5,0,1,8,46,54
p_281,10,0,e_1,63,65,109,27,1,1,10,5,1,1,2,44,46
p_292,11,0,e_1,30,70,109,11,0,0,0,3,0,0,40,39,79
p_276,5,0,e_1,82,90,109,27,3,3,7,4,1,0,8,19,27
p_274,4,0,e_1,84,95,109,27,3,3,7,4,1,1,11,14,25
p_267,1,0,e_2,153,159,164,10,2,1,0,3,0,0,6,5,11
p_277,10,0,e_3,81,120,194,22,2,2,2,4,1,1,39,74,113
p_273,13,0,e_3,95,131,194,15,2,1,2,5,0,2,36,63,99
p_278,15,0,e_3,80,139,194,17,1,1,2,4,1,0,59,55,114
p_272,15,0,e_3,105,139,194,10,3,0,5,5,0,3,34,55,89
p_271,11,0,e_3,127,153,194,7,3,2,12,5,1,2,26,41,67
p_268,10,0,e_3,150,158,194,2,2,1,12,4,1,1,8,36,44
p_262,6,0,e_3,164,172,194,2,2,0,8,4,1,1,8,22,30
p_264,5,0,e_3,162,177,194,4,1,0,9,4,1,0,15,17,32
p_269,4,0,e_1,146,161,233,9,2,1,0,3,0,0,15,72,87
p_265,12,0,e_1,157,187,233,28,1,1,3,5,0,1,30,46,76
p_263,12,0,e_1,163,187,233,27,2,2,4,5,1,1,24,46,70
p_261,12,0,e_1,170,187,233,24,3,3,7,5,1,1,17,46,63
p_260,13,0,e_1,171,192,233,23,2,2,7,5,1,1,21,41,62
p_258,5,0,e_2,175,192,233,30,2,2,0,5,0,1,17,41,58
p_259,6,0,e_2,174,197,233,30,2,2,0,3,0,0,23,36,59
p_256,8,0,e_2,191,205,233,23,1,1,5,2,0,1,14,28,42
p_252,2,0,e_2,212,225,233,25,2,1,6,4,1,0,13,8,21
p_270,7,0,e_0,133,157,234,10,3,1,0,3,0,0,24,77,101
p_266,15,0,e_0,155,183,234,26,2,2,7,5,0,1,28,51,79
p_257,12,0,e_0,179,194,234,23,1,1,14,5,1,1,15,40,55
p_255,10,0,e_0,192,202,234,20,1,1,12,4,1,1,10,32,42
p_249,7,0,e_1,238,262,285,11,3,1,0,3,0,0,24,23,47
p_244,2,0,e_2,271,280,288,7,2,1,0,3,0,0,9,8,17
p_254,3,0,e_3,199,211,300,3,0,0,0,3,0,0,12,89,101
p_253,15,0,e_3,208,249,300,13,1,0,2,5,0,1,41,51,92
p_246,12,0,e_3,257,260,300,1,2,0,13,4,1,1,3,40,43
p_251,4,0,e_3,228,286,300,18,2,1,8,5,1,1,58,14,72
p_250,7,0,e_0,236,260,319,12,3,1,0,3,0,0,24,59,83
p_248,7,0,e_0,246,260,319,9,3,1,3,5,0,1,14,59,73
p_247,12,0,e_0,248,277,319,19,2,0,3,5,0,1,29,42,71
p_245,9,0,e_0,269,288,319,30,2,2,10,5,1,1,19,31,50
p_243,8,0,e_0,285,293,319,26,1,1,10,4,1,1,8,26,34
p_233,2,0,e_0,319,328,362,13,2,2,0,3,0,0,9,34,43
p_232,5,0,e_0,320,339,362,9,2,1,0,5,0,1,19,23,42
p_230,5,0,e_0,323,339,362,8,2,1,1,5,0,2,16,23,39
p_221,4,0,e_0,341,344,362,6,2,1,5,4,1,1,3,18,21
p_222,3,0,e_0,339,349,362,8,3,2,5,4,1,0,10,13,23
p_216,1,0,e_0,346,357,362,8,2,0,4,4,1,1,11,5,16
p_205,1,0,e_0,362,368,373,5,3,2,0,3,0,0,6,5,11
p_237,5,0,e_3,313,331,384,5,0,0,0,3,0,0,18,53,71
p_235,8,0,e_3,314,342,384,8,1,0,0,5,0,1,28,42,70
p_229,9,0,e_3,323,347,384,6,2,0,3,5,0,2,24,37,61
p_227,9,0,e_3,326,347,384,5,3,0,4,5,0,3,21,37,58
p_220,9,0,e_3,342,347,384,1,2,0,8,5,1,1,5,37,42
p_218,9,0,e_3,343,347,384,1,2,0,8,5,1,1,4,37,41
p_217,8,0,e_3,345,352,384,1,2,0,9,5,1,1,7,32,39
p_215,6,0,e_3,346,360,384,3,3,0,9,2,1,2,14,24,38
p_214,4,0,e_3,346,368,384,5,2,0,9,2,1,1,22,16,38
p_210,4,0,e_3,353,368,384,4,3,1,8,4,1,2,15,16,31
p_209,2,0,e_3,354,376,384,6,3,2,8,4,1,2,22,8,30
p_199,2,0,e_3,368,376,384,2,2,0,4,4,1,1,8,8,16
p_242,4,0,e_1,287,302,390,30,1,1,0,3,0,0,15,88,103
p_241,13,0,e_1,300,331,390,13,0,0,4,5,0,1,31,59,90
p_239,13,0,e_1,305,331,390,13,0,0,5,5,1,2,26,59,85
p_240,14,0,e_1,301,336,390,14,0,0,4,3,0,1,35,54,89
p_234,14,0,e_1,314,336,390,14,2,0,8,5,1,2,22,54,76
p_224,13,0,e_1,335,341,390,7,3,0,14,2,1,2,6,49,55
p_226,12,0,e_1,331,346,390,7,3,0,13,5,1,2,15,44,59
p_228,11,0,e_1,325,351,390,8,3,0,11,5,1,2,26,39,65
p_219,11,0,e_1,342,351,390,3,2,0,13,4,1,2,9,39,48
p_212,9,0,e_1,348,359,390,30,4,4,12,4,1,1,11,31,42
p_206,6,0,e_1,362,370,390,30,3,3,8,4,1,0,8,20,28
p_238,2,0,e_2,311,320,432,2,0,0,0,3,0,0,9,112,121
p_236,8,0,e_2,313,340,432,8,1,1,0,5,0,1,27,92,119
p_231,10,0,e_2,320,348,432,8,2,0,2,5,1,1,28,84,112
p_225,10,0,e_2,333,348,432,5,3,0,6,5,1,2,15,84,99
p_213,12,0,e_2,347,356,432,27,4,4,10,2,1,1,9,76,85
p_207,12,0,e_2,355,356,432,25,4,4,12,2,1,2,1,76,77
p_223,13,0,e_2,339,363,432,6,3,0,8,2,1,1,24,69,93
p_208,13,0,e_2,355,363,432,24,4,4,12,2,1,3,8,69,77
p_211,14,0,e_2,348,368,432,25,4,4,10,5,1,2,20,64,84
p_202,13,0,e_2,365,373,432,22,3,3,13,5,1,3,8,59,67
p_201,13,0,e_2,366,373,432,21,3,3,14,5,1,4,7,59,66
p_203,12,0,e_2,365,378,432,23,3,3,13,5,1,2,13,54,67
p_200,12,0,e_2,367,378,432,22,2,2,14,2,1,3,11,54,65
p_194,11,0,e_2,377,383,432,21,1,1,12,1,1,2,6,49,55
p_198,9,0,e_2,368,391,432,25,2,2,14,4,1,3,23,41,64
p_185,2,0,e_3,392,401,487,2,0,0,0,3,0,0,9,86,95
p_178,5,0,e_3,398,412,487,4,1,0,1,5,0,1,14,75,89
p_167,7,0,e_3,412,420,487,8,3,2,5,5,1,2,8,67,75
p_177,9,0,e_3,398,428,487,8,2,0,1,5,0,2,30,59,89
p_173,10,0,e_3,405,433,487,7,3,0,3,5,1,2,28,54,82
p_170,10,0,e_3,408,433,487,6,4,0,4,5,1,3,25,54,79
p_160,10,0,e_3,421,433,487,3,5,0,7,5,1,4,12,54,66
p_159,11,0,e_3,424,438,487,3,5,0,8,5,1,4,14,49,63
p_157,12,0,e_3,427,443,487,3,5,0,9,2,1,4,16,44,60
p_138,7,0,e_3,456,460,487,1,3,0,8,4,1,2,4,27,31
p_166,5,0,e_3,415,468,487,9,4,3,6,5,1,3,53,19,72
p_163,4,0,e_3,417,473,487,10,5,3,6,5,1,4,56,14,70
p_186,1,0,e_1,391,397,488,1,0,0,0,3,0,0,6,91,97
p_184,5,0,e_1,393,411,488,5,1,0,0,5,0,1,18,77,95
p_181,11,0,e_1,395,431,488,11,1,0,1,5,0,2,36,57,93
p_169,11,0,e_1,410,431,488,6,4,0,5,2,1,1,21,57,78
p_164,12,0,e_1,416,436,488,6,5,0,6,5,1,1,20,52,72
p_161,13,0,e_1,418,441,488,6,6,0,7,5,1,2,23,47,70
p_152,10,0,e_1,439,452,488,3,4,1,13,5,1,1,13,36,49
p_144,4,0,e_1,451,472,488,6,3,1,10,1,1,1,21,16,37
p_143,2,0,e_1,451,480,488,8,3,2,10,1,1,0,29,8,37
p_196,5,0,e_0,376,394,491,27,1,1,0,3,0,0,18,97,115
p_193,12,0,e_0,378,417,491,20,1,1,0,5,0,1,39,74,113
p_183,12,0,e_0,393,417,491,12,1,0,5,2,0,2,24,74,98
p_190,14,0,e_0,382,425,491,16,1,1,1,5,0,2,43,66,109
p_180,14,0,e_0,396,425,491,13,1,0,5,5,1,2,29,66,95
p_172,14,0,e_0,405,425,491,11,4,0,8,5,1,2,20,66,86
p_165,14,0,e_0,416,425,491,8,5,0,12,2,1,2,9,66,75
p_162,14,0,e_0,417,425,491,8,6,0,12,5,1,2,8,66,74
p_168,15,0,e_0,412,430,491,10,4,0,11,5,1,2,18,61,79
p_158,14,0,e_0,426,435,491,5,6,0,14,5,1,1,9,56,65
p_153,8,0,e_0,438,455,491,5,4,1,13,4,1,3,17,36,53
p_154,7,0,e_0,438,460,491,6,4,1,13,4,1,2,22,31,53
p_147,7,0,e_0,450,460,491,3,3,0,9,4,1,4,10,31,41
p_133,4,0,e_0,463,471,491,2,3,1,6,4,1,3,8,20,28
p_155,3,0,e_0,434,476,491,11,5,2,14,1,1,1,42,15,57
p_156,1,0,e_0,428,496,519,14,6,3,15,5,1,2,68,23,91
p_136,2,0,e_0,460,501,519,5,3,2,7,4,1,2,41,18,59
p_150,3,0,e_0,444,506,519,9,3,2,11,4,1,4,62,13,75
p_148,3,0,e_0,447,506,519,8,3,2,10,4,1,4,59,13,72
p_110,1,0,e_0,501,514,519,10,1,1,2,5,1,1,13,5,18
p_175,2,0,e_2,399,440,574,14,3,2,7,4,1,4,41,134,175
p_174,3,0,e_2,402,445,574,13,3,2,7,4,1,5,43,129,172
p_171,3,0,e_2,408,445,574,13,4,3,6,4,1,6,37,129,166
p_192,5,0,e_2,380,453,574,26,1,1,12,4,1,3,73,121,194
p_182,5,0,e_2,394,453,574,5,1,0,8,4,1,3,59,121,180
p_179,6,0,e_2,397,458,574,5,1,0,8,4,1,3,61,116,177
p_176,6,0,e_2,398,458,574,5,2,0,8,4,1,4,60,116,176
p_191,7,0,e_2,382,463,574,23,1,1,11,1,1,3,81,111,192
p_189,7,0,e_2,387,463,574,7,0,0,10,4,1,4,76,111,187
p_187,7,0,e_2,391,463,574,7,0,0,9,4,1,3,72,111,183
p_135,7,0,e_2,461,463,574,30,3,3,7,5,1,7,2,111,113
p_132,7,0,e_2,463,465,574,29,3,3,7,5,1,6,2,109,111
p_204,8,0,e_2,364,470,574,27,3,3,13,5,1,1,106,104,210
p_197,8,0,e_2,375,470,574,24,1,1,13,4,1,3,95,104,199
p_188,8,0,e_2,390,470,574,8,0,0,9,1,1,3,80,104,184
p_118,4,0,e_1,488,503,591,4,0,0,0,3,0,0,15,88,103
p_114,9,0,e_1,494,520,591,8,1,0,1,5,0,1,26,71,97
p_101,12,0,e_1,521,531,591,7,2,1,9,5,1,5,10,60,70
p_103,13,0,e_1,517,536,591,7,2,1,8,5,1,5,19,55,74
p_92,13,0,e_1,533,536,591,2,2,1,12,5,1,6,3,55,58
p_97,10,0,e_1,526,547,591,7,2,1,11,5,1,6,21,44,65
p_104,7,0,e_1,516,558,591,14,2,1,8,5,1,4,42,33,75
p_80,6,0,e_1,548,563,591,5,1,0,10,4,1,4,15,28,43
p_77,6,0,e_1,557,563,591,2,2,0,7,1,1,4,6,28,34
p_108,5,0,e_1,509,568,591,17,2,2,6,5,1,1,59,23,82
p_106,4,0,e_1,512,573,591,17,2,1,7,5,1,3,61,18,79
p_105,4,0,e_1,515,573,591,17,2,1,8,5,1,4,58,18,76
p_70,3,0,e_1,572,578,591,1,2,0,4,1,1,1,6,13,19
p_107,1,0,e_1,512,586,591,20,2,1,7,5,1,2,74,5,79
p_116,7,0,e_3,490,514,591,7,0,0,0,3,0,0,24,77,101
p_109,14,0,e_3,506,537,591,9,1,0,5,5,0,1,31,54,85
p_91,13,0,e_3,535,542,591,1,2,0,14,5,1,1,7,49,56
p_76,7,0,e_3,559,562,591,1,2,0,8,4,1,1,3,29,32
p_78,4,0,e_3,555,573,591,5,1,0,9,4,1,0,18,18,36
p_71,2,0,e_3,569,581,591,3,2,1,5,4,1,1,12,10,22
p_64,1,0,e_3,579,586,591,1,2,0,2,4,1,1,7,5,12
p_99,1,0,e_0,522,527,644,18,2,1,0,5,0,1,5,117,122
p_102,2,0,e_0,521,532,644,17,2,1,0,3,0,0,11,112,123
p_98,6,0,e_0,524,546,644,12,2,1,0,5,0,2,22,98,120
p_88,14,0,e_0,538,572,644,30,2,2,4,5,1,2,34,72,106
p_79,14,0,e_0,549,572,644,27,1,1,7,5,1,3,23,72,95
p_75,14,0,e_0,563,572,644,23,2,2,11,5,1,3,9,72,81
p_87,15,0,e_0,539,577,644,29,2,2,4,5,1,3,38,67,105
p_72,15,0,e_0,569,577,644,20,3,3,13,5,1,5,8,67,75
p_68,14,0,e_0,574,582,644,20,2,2,14,5,1,6,8,62,70
p_66,12,0,e_0,577,590,644,21,2,2,15,4,1,6,13,54,67
p_65,12,0,e_0,578,590,644,21,2,2,15,4,1,7,12,54,66
p_74,11,0,e_0,567,595,644,25,2,2,13,5,1,3,28,49,77
p_52,11,0,e_0,591,595,644,11,1,0,12,4,1,7,4,49,53
p_69,10,0,e_0,573,600,644,24,2,2,14,5,1,4,27,44,71
p_58,10,0,e_0,586,600,644,21,1,1,13,4,1,8,14,44,58
p_51,1,0,e_1,591,596,669,11,1,1,0,5,0,1,5,73,78
p_48,2,0,e_1,593,601,669,10,1,1,0,5,0,3,8,68,76
p_43,3,0,e_1,599,606,669,21,2,2,2,5,1,3,7,63,70
p_55,4,0,e_1,590,611,669,4,0,0,0,3,1,0,21,58,79
p_42,4,0,e_1,600,611,669,19,2,2,2,2,1,3,11,58,69
p_49,5,0,e_1,592,616,669,7,1,1,0,5,0,2,24,53,77
p_45,5,0,e_1,597,616,669,19,2,2,1,5,1,3,19,53,72
p_41,10,0,e_1,600,633,669,13,2,1,2,2,1,3,33,36,69
p_37,7,0,e_1,633,644,669,20,1,0,10,4,1,1,11,25,36
p_38,4,0,e_1,627,655,669,11,2,1,8,5,1,1,28,14,42
p_35,4,0,e_1,640,655,669,7,2,0,8,4,1,2,15,14,29
p_54,6,0,e_3,590,611,681,6,0,0,0,3,1,0,21,70,91
p_47,6,0,e_3,594,611,681,5,1,0,1,5,0,1,17,70,87
p_46,13,0,e_3,596,634,681,12,1,0,1,5,0,1,38,47,85
p_36,11,0,e_3,635,642,681,2,1,0,13,4,1,0,7,39,46
p_33,8,0,e_3,647,653,681,2,1,0,10,4,1,0,6,28,34
p_32,5,0,e_3,657,664,681,2,1,0,7,4,1,0,7,17,24
p_81,2,0,e_2,547,582,710,10,1,0,6,4,1,11,35,128,163
p_85,3,0,e_2,542,587,710,10,1,0,7,4,1,10,45,123,168
p_84,3,0,e_2,546,587,710,9,1,0,6,4,1,11,41,123,164
p_82,3,0,e_2,547,587,710,9,1,0,6,4,1,12,40,123,163
p_125,4,0,e_2,474,592,710,30,1,1,9,2,1,6,118,118,236
p_129,5,0,e_2,470,597,710,30,2,2,8,5,1,5,127,113,240
p_122,5,0,e_2,477,597,710,28,1,1,9,5,1,8,120,113,233
p_119,5,0,e_2,483,597,710,26,1,1,11,5,1,9,114,113,227
p_96,5,0,e_2,527,597,710,12,2,1,10,1,1,9,70,113,183
p_83,5,0,e_2,546,597,710,7,1,0,6,4,1,11,51,113,164
p_126,6,0,e_2,473,602,710,28,1,1,9,5,1,6,129,108,237
p_95,6,0,e_2,527,602,710,11,2,1,10,1,1,9,75,108,183
p_94,6,0,e_2,528,602,710,11,2,1,10,4,1,9,74,108,182
p_86,6,0,e_2,541,602,710,7,1,0,7,4,1,10,61,108,169
p_93,7,0,e_2,529,607,710,9,2,1,10,4,1,9,78,103,181
p_27,2,0,e_3,693,702,710,2,0,0,0,3,0,0,9,8,17
p_30,5,0,e_1,676,694,713,26,1,1,0,3,0,0,18,19,37
p_26,3,0,e_1,698,702,713,2,1,0,4,4,1,0,4,11,15
p_23,5,0,e_3,709,727,744,5,0,0,0,3,1,0,18,17,35
p_90,2,0,e_0,536,652,758,12,2,0,3,5,1,1,116,106,222
p_56,2,0,e_0,588,652,758,29,1,1,12,4,1,8,64,106,170
p_40,4,0,e_0,601,660,758,19,2,2,10,4,1,5,59,98,157
p_62,5,0,e_0,582,665,758,27,2,2,14,4,1,6,83,93,176
p_61,5,0,e_0,583,665,758,27,2,2,14,4,1,7,82,93,175
p_73,6,0,e_0,568,670,758,29,2,2,13,5,1,4,102,88,190
p_59,6,0,e_0,584,670,758,25,2,2,14,4,1,7,86,88,174
p_57,6,0,e_0,587,670,758,25,1,1,13,4,1,8,83,88,171
p_67,8,0,e_0,574,678,758,26,2,2,14,5,1,5,104,80,184
p_63,8,0,e_0,581,678,758,24,2,2,14,1,1,6,97,80,177
p_60,9,0,e_0,584,683,758,22,2,2,14,4,1,7,99,75,174
p_53,9,0,e_0,590,683,758,9,1,1,12,4,1,7,93,75,168
p_50,10,0,e_0,592,688,758,10,1,0,12,4,1,7,96,70,166
p_29,15,0,e_0,678,705,758,16,1,1,8,5,1,2,27,53,80
p_22,10,0,e_0,712,722,758,10,1,0,13,4,1,2,10,36,46
p_18,2,0,e_3,768,777,785,2,0,0,0,3,0,0,9,8,17
p_24,5,0,e_0,707,775,806,26,1,1,15,4,1,1,68,31,99
p_25,7,0,e_0,703,783,806,25,1,1,15,5,1,1,80,23,103
p_20,9,0,e_1,737,762,813,23,1,1,1,5,0,1,25,51,76
p_21,10,0,e_1,732,767,813,24,1,1,0,3,0,0,35,46,81
p_19,12,0,e_1,740,775,813,19,1,1,2,5,0,2,35,38,73
p_31,5,0,e_2,662,727,828,30,2,2,12,4,1,7,65,101,166
p_28,6,0,e_2,679,732,828,24,1,1,8,4,1,9,53,96,149
p_89,7,0,e_2,537,737,828,7,2,1,8,4,1,11,200,91,291
p_195,9,0,e_2,376,745,828,23,1,1,12,4,1,3,369,83,452
p_131,9,0,e_2,467,745,828,26,2,2,7,5,1,6,278,83,361
p_130,9,0,e_2,469,745,828,26,2,2,8,2,1,5,276,83,359
p_121,9,0,e_2,480,745,828,23,1,1,10,5,1,8,265,83,348
p_146,10,0,e_2,451,750,828,30,3,3,5,5,1,6,299,78,377
p_128,10,0,e_2,471,750,828,24,2,2,8,5,1,6,279,78,357
p_120,10,0,e_2,481,750,828,22,1,1,10,5,1,8,269,78,347
p_115,10,0,e_2,494,750,828,9,1,0,13,5,1,8,256,78,334
p_100,10,0,e_2,522,750,828,9,2,1,11,1,1,9,228,78,306
p_113,11,0,e_2,496,755,828,10,1,0,14,5,1,8,259,73,332
p_145,12,0,e_2,451,760,828,28,3,3,5,5,1,7,309,68,377
p_134,12,0,e_2,462,760,828,25,3,3,7,2,1,6,298,68,366
p_11,11,0,e_0,810,846,885,11,3,2,0,3,0,0,36,39,75
p_5,5,0,e_0,860,866,885,3,1,0,7,4,1,0,6,19,25
p_4,1,0,e_0,864,880,885,6,1,0,5,4,1,1,16,5,21
p_3,1,0,e_0,876,880,885,2,1,0,2,4,1,1,4,5,9
p_13,11,0,e_3,794,820,885,16,1,1,3,5,0,1,26,65,91
p_12,13,0,e_3,796,828,885,14,2,1,3,5,0,2,32,57,89
p_10,14,0,e_3,810,833,885,8,3,1,8,5,0,3,23,52,75
p_15,15,0,e_3,782,838,885,16,1,1,1,4,1,0,56,47,103
p_14,15,0,e_3,790,838,885,14,1,0,1,5,0,1,48,47,95
p_1,2,0,e_0,889,898,906,2,0,0,0,3,0,0,9,8,17
p_8,1,0,e_1,847,851,928,11,1,0,0,5,0,1,4,77,81
p_9,2,0,e_1,845,856,928,11,1,0,0,3,0,0,11,72,83
p_7,12,0,e_1,851,888,928,29,1,1,1,5,1,1,37,40,77
p_2,3,0,e_1,878,917,928,29,1,1,9,5,1,1,39,11,50
p_123,12,0,e_2,474,866,928,22,1,1,9,2,1,7,392,62,454
p_117,12,0,e_2,490,866,928,12,1,1,12,5,1,8,376,62,438
p_140,13,0,e_2,455,871,928,25,3,3,5,5,1,7,416,57,473
p_139,13,0,e_2,456,871,928,25,4,4,6,5,1,8,415,57,472
p_137,13,0,e_2,458,871,928,24,4,4,6,5,1,7,413,57,470
p_16,13,0,e_2,774,871,928,12,1,0,15,2,1,3,97,57,154
p_124,14,0,e_2,474,876,928,20,1,1,9,2,1,7,402,52,454
p_6,14,0,e_2,858,876,928,25,1,1,10,5,0,4,18,52,70
p_151,15,0,e_2,443,881,928,27,3,3,3,5,1,6,438,47,485
p_149,15,0,e_2,444,881,928,27,3,3,3,2,1,6,437,47,484
p_142,15,0,e_2,452,881,928,24,3,3,5,2,1,7,429,47,476
p_141,15,0,e_2,455,881,928,23,3,3,5,5,1,8,426,47,473
p_127,15,0,e_2,473,881,928,19,1,1,9,5,1,7,408,47,455
p_112,15,0,e_2,497,881,928,13,1,0,14,2,1,9,384,47,431
p_111,15,0,e_2,501,881,928,12,1,0,15,5,1,10,380,47,427
p_44,15,0,e_2,598,975,1022,13,2,0,5,5,1,9,377,47,424
p_39,15,0,e_2,609,975,1022,9,2,0,7,5,1,7,366,47,413
p_34,15,0,e_2,643,975,1022,26,1,1,15,5,1,8,332,47,379
p_17,15,0,e_2,772,975,1022,14,1,0,14,5,1,3,203,47,250
p_299,3,0,e_1,7,19,30,3,0,0,0,3,0,0,12,11,23
p_296,1,0,e_3,20,26,31,1,0,0,0,3,0,0,6,5,11
p_298,4,0,e_2,10,25,47,4,0,0,0,3,0,0,15,22,37
p_295,5,0,e_2,22,30,47,5,1,0,3,5,0,1,8,17,25
p_288,1,0,e_2,49,55,98,3,2,2,0,3,0,0,6,43,49
p_285,2,0,e_2,54,60,98,7,3,2,1,2,0,1,6,38,44
p_286,3,0,e_2,51,65,98,7,3,2,0,5,0,1,14,33,47
p_282,6,0,e_2,62,76,98,7,2,1,2,5,1,1,14,22,36
p_279,2,0,e_2,76,90,98,8,1,0,6,4,1,0,14,8,22
p_275,2,0,e_2,84,90,98,5,2,1,4,4,1,2,6,8,14
p_290,4,0,e_3,43,50,108,6,1,1,2,5,0,1,7,58,65
p_291,6,0,e_3,35,58,108,6,0,0,0,3,0,0,23,50,73
p_289,7,0,e_3,47,63,108,4,2,0,3,5,0,2,16,45,61
p_283,10,0,e_3,55,74,108,5,3,0,5,5,1,2,19,34,53
p_281,10,0,e_3,63,74,108,3,2,0,7,5,1,1,11,34,45
p_276,5,0,e_3,82,91,108,3,1,0,8,4,1,0,9,17,26
p_300,8,0,e_0,4,31,109,8,0,0,0,3,0,0,27,78,105
p_297,12,0,e_0,18,45,109,12,0,0,4,5,0,1,27,64,91
p_294,13,0,e_0,23,50,109,13,1,0,6,5,0,2,27,59,86
p_293,15,0,e_0,26,58,109,16,1,1,7,5,0,3,32,51,83
p_284,14,0,e_0,55,63,109,9,4,0,14,5,1,1,8,46,54
p_274,4,0,e_0,84,95,109,3,2,1,7,4,1,1,11,14,25
p_292,11,0,e_1,30,66,109,11,0,0,0,3,0,0,36,43,79
p_287,12,0,e_1,51,71,109,8,3,0,6,5,0,1,20,38,58
p_280,12,0,e_1,65,71,109,5,2,0,11,2,0,1,6,38,44
p_269,4,0,e_3,146,161,177,4,0,0,0,3,0,0,15,16,31
p_267,1,0,e_3,153,172,177,5,1,1,2,5,0,1,19,5,24
p_277,10,0,e_0,81,141,183,28,1,1,8,4,1,0,60,42,102
p_271,11,0,e_0,127,146,183,11,0,0,6,5,0,1,19,37,56
p_264,5,0,e_0,162,166,183,29,3,3,6,4,1,0,4,17,21
p_273,13,0,e_2,95,139,200,21,1,1,1,4,1,1,44,61,105
p_278,15,0,e_2,80,147,200,23,1,1,5,4,1,1,67,53,120
p_272,15,0,e_2,105,147,200,16,1,1,2,5,0,2,42,53,95
p_268,10,0,e_2,150,164,200,9,1,0,14,4,1,0,14,36,50
p_262,6,0,e_2,164,178,200,27,3,3,10,4,1,0,14,22,36
p_259,6,0,e_2,174,178,200,25,2,2,7,4,1,1,4,22,26
p_258,5,0,e_2,175,183,200,25,2,2,7,4,1,1,8,17,25
p_254,3,0,e_2,199,211,224,14,1,1,0,3,1,0,12,13,25
p_252,2,0,e_2,212,216,224,17,2,2,3,4,1,0,4,8,12
p_270,7,0,e_1,133,157,238,7,0,0,0,3,0,0,24,81,105
p_263,12,0,e_1,163,174,238,22,3,3,9,5,1,1,11,64,75
p_261,12,0,e_1,170,174,238,19,3,3,11,5,1,2,4,64,68
p_260,13,0,e_1,171,179,238,18,2,2,11,5,1,2,8,59,67
p_266,15,0,e_1,155,187,238,13,2,0,7,5,0,1,32,51,83
p_257,12,0,e_1,179,198,238,12,1,0,13,5,1,1,19,40,59
p_255,10,0,e_1,192,206,238,9,1,1,14,4,1,1,14,32,46
p_256,8,0,e_0,191,218,246,12,1,1,0,3,0,0,27,28,55
p_251,4,0,e_0,228,232,246,11,1,0,5,4,1,0,4,14,18
p_265,12,0,e_3,157,215,275,9,2,0,3,5,0,2,58,60,118
p_253,15,0,e_3,208,226,275,5,1,0,10,5,0,1,18,49,67
p_250,7,0,e_3,236,252,275,5,1,0,12,4,1,0,16,23,39
p_249,7,0,e_3,238,252,275,4,2,0,11,4,1,1,14,23,37
p_248,7,0,e_3,246,252,275,2,2,0,9,4,1,1,6,23,29
p_244,2,0,e_2,271,280,288,29,1,1,0,3,0,0,9,8,17
p_247,12,0,e_0,248,287,329,26,2,2,0,3,0,0,39,42,81
p_246,12,0,e_0,257,287,329,24,1,1,2,5,0,1,30,42,72
p_243,8,0,e_0,285,301,329,8,0,0,12,5,0,1,16,28,44
p_238,2,0,e_0,311,321,329,23,1,1,5,4,1,0,10,8,18
p_245,9,0,e_1,269,299,330,23,1,1,0,3,0,0,30,31,61
p_233,2,0,e_1,319,322,330,20,2,2,3,4,1,0,3,8,11
p_242,4,0,e_2,287,302,402,4,0,0,0,3,1,0,15,100,115
p_236,8,0,e_2,313,316,402,16,2,1,7,5,1,2,3,86,89
p_235,8,0,e_2,314,316,402,16,2,1,8,5,1,3,2,86,88
p_228,11,0,e_2,325,327,402,10,3,1,11,5,1,4,2,75,77
p_241,13,0,e_2,300,335,402,13,0,0,4,5,0,1,35,67,102
p_224,13,0,e_2,335,337,402,4,4,0,13,5,1,3,2,65,67
p_240,14,0,e_2,301,342,402,14,0,0,4,3,0,1,41,60,101
p_234,14,0,e_2,314,342,402,12,2,0,8,5,1,3,28,60,88
p_213,12,0,e_2,347,350,402,2,4,1,13,4,1,4,3,52,55
p_219,11,0,e_2,342,355,402,5,3,2,14,4,1,2,13,47,60
p_229,9,0,e_2,323,363,402,12,3,2,10,5,1,3,40,39,79
p_227,9,0,e_2,326,363,402,11,3,2,11,2,1,4,37,39,76
p_220,9,0,e_2,342,363,402,7,3,2,14,4,1,2,21,39,60
p_204,8,0,e_2,364,368,402,5,3,0,9,4,1,3,4,34,38
p_215,6,0,e_2,346,376,402,8,5,1,13,4,1,3,30,26,56
p_237,5,0,e_3,313,323,422,19,1,1,2,5,0,1,10,99,109
p_231,10,0,e_3,320,340,422,12,2,1,4,5,0,2,20,82,102
p_226,12,0,e_3,331,348,422,7,3,1,7,5,1,2,17,74,91
p_239,13,0,e_3,305,353,422,13,0,0,0,3,0,0,48,69,117
p_223,13,0,e_3,339,353,422,3,3,0,10,2,1,2,14,69,83
p_211,14,0,e_3,348,358,422,2,4,0,12,5,1,3,10,64,74
p_208,13,0,e_3,355,363,422,2,4,1,13,5,1,3,8,59,67
p_203,12,0,e_3,365,368,422,1,3,0,13,4,1,2,3,54,57
p_198,9,0,e_3,368,379,422,3,3,0,12,4,1,2,11,43,54
p_195,9,0,e_3,376,379,422,1,5,0,10,4,1,4,3,43,46
p_197,8,0,e_3,375,384,422,2,4,1,10,4,1,3,9,38,47
p_191,7,0,e_3,382,389,422,1,5,0,8,4,1,4,7,33,40
p_192,5,0,e_3,380,397,422,4,4,1,9,4,1,3,17,25,42
p_184,5,0,e_3,393,397,422,1,5,0,6,4,1,4,4,25,29
p_182,5,0,e_3,394,397,422,1,5,0,6,4,1,4,3,25,28
p_217,8,0,e_0,345,360,438,7,3,2,3,5,0,1,15,78,93
p_225,10,0,e_0,333,368,438,8,4,2,0,3,0,0,35,70,105
p_207,12,0,e_0,355,376,438,3,4,1,7,5,0,3,21,62,83
p_202,13,0,e_0,365,381,438,30,4,4,9,5,1,3,16,57,73
p_201,13,0,e_0,366,381,438,29,4,4,10,5,1,4,15,57,72
p_194,11,0,e_0,377,389,438,28,5,5,12,5,1,2,12,49,61
p_188,8,0,e_0,390,400,438,29,4,4,11,4,1,2,10,38,48
p_189,7,0,e_0,387,405,438,30,5,5,11,4,1,2,18,33,51
p_187,7,0,e_0,391,405,438,30,4,4,11,4,1,3,14,33,47
p_179,6,0,e_0,397,410,438,29,4,4,9,4,1,3,13,28,41
p_176,6,0,e_0,398,410,438,29,4,4,8,4,1,5,12,28,40
p_178,5,0,e_0,398,415,438,30,4,4,8,4,1,4,17,23,40
p_210,4,0,e_0,353,420,438,11,4,1,6,5,0,2,67,18,85
p_163,4,0,e_0,417,420,438,27,4,4,5,4,1,2,3,18,21
p_171,3,0,e_0,408,425,438,30,4,4,6,4,1,3,17,13,30
p_222,3,0,e_1,339,351,452,13,3,2,0,3,0,0,12,101,113
p_221,4,0,e_1,341,356,452,12,3,2,0,5,0,1,15,96,111
p_218,9,0,e_1,343,373,452,6,3,2,1,5,0,2,30,79,109
p_212,9,0,e_1,348,373,452,5,4,1,2,5,0,3,25,79,104
p_200,12,0,e_1,367,384,452,30,3,3,7,5,1,2,17,68,85
p_193,12,0,e_1,378,384,452,27,4,4,10,5,1,2,6,68,74
p_190,14,0,e_1,382,392,452,24,6,6,12,5,1,2,10,60,70
p_183,12,0,e_1,393,400,452,24,5,5,14,4,1,1,7,52,59
p_181,11,0,e_1,395,405,452,24,5,5,13,4,1,2,10,47,57
p_173,10,0,e_1,405,410,452,23,5,5,11,4,1,2,5,42,47
p_177,9,0,e_1,398,415,452,26,4,4,12,4,1,3,17,37,54
p_167,7,0,e_1,412,423,452,25,4,4,10,4,1,2,11,29,40
p_166,5,0,e_1,415,431,452,26,5,5,9,4,1,2,16,21,37
p_155,3,0,e_1,434,439,452,23,6,4,4,4,1,1,5,13,18
p_209,2,0,e_1,354,444,452,13,4,1,4,5,1,2,90,8,98
p_205,1,0,e_2,362,407,528,12,3,1,9,1,1,2,45,121,166
p_186,1,0,e_2,391,407,528,6,4,2,2,1,1,3,16,121,137
p_199,2,0,e_2,368,412,528,10,3,1,8,4,1,3,44,116,160
p_232,5,0,e_2,320,423,528,17,2,1,9,5,1,2,103,105,208
p_230,5,0,e_2,323,423,528,16,3,2,10,5,1,3,100,105,205
p_196,5,0,e_2,376,423,528,5,5,2,6,4,1,3,47,105,152
p_206,6,0,e_2,362,428,528,7,3,0,9,1,1,3,66,100,166
p_170,10,0,e_2,408,442,528,23,4,4,1,5,1,4,34,86,120
p_169,11,0,e_2,410,447,528,21,5,5,2,5,1,5,37,81,118
p_164,12,0,e_2,416,452,528,19,4,4,3,5,1,6,36,76,112
p_157,12,0,e_2,427,452,528,15,7,1,6,2,1,6,25,76,101
p_161,13,0,e_2,418,457,528,18,4,4,4,5,1,7,39,71,110
p_140,13,0,e_2,455,457,528,7,4,1,13,5,1,3,2,71,73
p_139,13,0,e_2,456,457,528,7,4,1,13,2,1,2,1,71,72
p_137,13,0,e_2,458,459,528,6,4,1,13,2,1,2,1,69,70
p_143,2,0,e_1,451,460,538,19,4,3,0,3,1,0,9,78,87
p_136,2,0,e_1,460,462,538,16,4,2,2,5,1,2,2,76,78
p_144,4,0,e_1,451,470,538,17,4,3,0,3,1,1,19,68,87
p_133,4,0,e_1,463,470,538,14,4,3,2,5,1,2,7,68,75
p_138,7,0,e_1,456,481,538,13,4,3,1,5,0,2,25,57,82
p_135,7,0,e_1,461,481,538,11,3,2,2,2,1,2,20,57,77
p_132,7,0,e_1,463,481,538,11,4,3,2,5,1,2,18,57,75
p_131,9,0,e_1,467,489,538,8,3,2,3,5,1,2,22,49,71
p_121,9,0,e_1,480,489,538,7,3,1,7,2,1,2,9,49,58
p_128,10,0,e_1,471,494,538,6,2,1,4,5,1,2,23,44,67
p_120,10,0,e_1,481,494,538,6,3,1,7,5,1,2,13,44,57
p_114,9,0,e_1,494,499,538,3,4,0,10,4,1,2,5,39,44
p_116,7,0,e_1,490,507,538,7,3,0,9,5,1,2,17,31,48
p_108,5,0,e_1,509,515,538,4,4,1,7,4,1,3,6,23,29
p_118,4,0,e_1,488,520,538,10,3,2,9,2,1,1,32,18,50
p_216,1,0,e_3,346,427,542,13,3,1,12,5,1,2,81,115,196
p_185,2,0,e_3,392,432,542,4,4,2,6,4,1,3,40,110,150
p_175,2,0,e_3,399,432,542,3,4,1,5,4,1,3,33,110,143
p_174,3,0,e_3,402,437,542,1,3,0,4,4,1,2,35,105,140
p_214,4,0,e_3,346,442,542,10,4,1,12,5,1,3,96,100,196
p_160,10,0,e_3,421,462,542,10,4,4,0,3,1,4,41,80,121
p_159,11,0,e_3,424,467,542,11,5,0,0,5,0,5,43,75,118
p_134,12,0,e_3,462,472,542,6,3,1,10,5,1,2,10,70,80
p_158,14,0,e_3,426,480,542,13,5,0,1,2,0,5,54,62,116
p_127,15,0,e_3,473,485,542,3,3,0,12,5,1,2,12,57,69
p_117,12,0,e_3,490,496,542,2,3,0,14,4,1,2,6,46,52
p_113,11,0,e_3,496,501,542,1,3,0,12,4,1,2,5,41,46
p_126,6,0,e_3,473,518,542,10,2,1,12,5,1,1,45,24,69
p_119,5,0,e_3,483,523,542,10,3,0,15,5,1,2,40,19,59
p_99,1,0,e_3,522,537,542,4,3,0,5,1,1,2,15,5,20
p_156,1,0,e_0,428,443,544,26,7,6,2,4,1,0,15,101,116
p_150,3,0,e_0,444,451,544,21,4,3,1,5,1,3,7,93,100
p_148,3,0,e_0,447,451,544,20,4,3,2,5,1,4,4,93,97
p_154,7,0,e_0,438,465,544,18,5,3,0,5,0,1,27,79,106
p_147,7,0,e_0,450,465,544,15,4,3,3,2,1,3,15,79,94
p_153,8,0,e_0,438,470,544,17,5,3,0,5,0,2,32,74,106
p_152,10,0,e_0,439,478,544,15,5,2,0,5,0,3,39,66,105
p_146,10,0,e_0,451,478,544,11,4,2,3,5,1,3,27,66,93
p_145,12,0,e_0,451,486,544,9,4,1,3,5,1,3,35,58,93
p_123,12,0,e_0,474,486,544,6,4,2,9,5,1,2,12,58,70
p_124,14,0,e_0,474,494,544,4,4,1,9,5,1,2,20,50,70
p_115,10,0,e_0,494,508,544,2,4,0,14,4,1,0,14,36,50
p_104,7,0,e_0,516,519,544,29,4,4,8,4,1,2,3,25,28
p_106,4,0,e_0,512,530,544,4,4,2,9,4,1,1,18,14,32
p_107,1,0,e_2,512,533,652,7,4,2,4,4,1,4,21,119,140
p_125,4,0,e_2,474,544,652,14,4,2,14,4,1,3,70,108,178
p_129,5,0,e_2,470,549,652,11,3,1,15,2,1,2,79,103,182
p_122,5,0,e_2,477,549,652,12,4,2,14,4,1,4,72,103,175
p_96,5,0,e_2,527,549,652,29,5,5,0,3,1,6,22,103,125
p_95,6,0,e_2,527,554,652,28,5,5,0,3,1,6,27,98,125
p_94,6,0,e_2,528,554,652,28,5,5,0,5,0,7,26,98,124
p_93,7,0,e_2,529,559,652,26,5,5,0,5,0,7,30,93,123
p_130,9,0,e_2,469,567,652,8,3,2,15,5,1,1,98,85,183
p_92,13,0,e_2,533,581,652,19,5,5,1,5,1,7,48,71,119
p_180,14,0,e_2,396,586,652,21,4,4,1,1,1,3,190,66,256
p_172,14,0,e_2,405,586,652,19,5,5,1,5,0,5,181,66,247
p_165,14,0,e_2,416,586,652,17,4,4,3,5,1,7,170,66,236
p_162,14,0,e_2,417,586,652,17,4,4,3,5,1,7,169,66,235
p_168,15,0,e_2,412,591,652,17,4,4,2,5,1,5,179,61,240
p_81,2,0,e_0,547,552,654,27,5,4,1,5,0,3,5,102,107
p_82,3,0,e_0,547,557,654,26,5,3,1,5,0,4,10,97,107
p_100,10,0,e_0,522,580,654,25,4,4,6,4,1,2,58,74,132
p_97,10,0,e_0,526,580,654,24,5,5,5,4,1,3,54,74,128
p_69,10,0,e_0,573,580,654,13,4,2,8,5,1,3,7,74,81
p_91,13,0,e_0,535,591,654,18,5,5,3,4,1,2,56,63,119
p_112,15,0,e_0,497,599,654,27,4,4,13,4,1,1,102,55,157
p_41,10,0,e_0,600,616,654,5,5,0,15,4,1,3,16,38,54
p_47,6,0,e_0,594,630,654,11,4,1,14,5,1,3,36,24,60
p_61,5,0,e_0,583,635,654,15,4,2,11,5,1,3,52,19,71
p_45,5,0,e_0,597,635,654,11,5,1,15,5,1,4,38,19,57
p_64,1,0,e_0,579,649,654,20,4,2,10,2,1,2,70,5,75
p_110,1,0,e_1,501,543,656,10,3,2,9,4,1,2,42,113,155
p_102,2,0,e_1,521,548,656,3,4,0,4,4,1,2,27,108,135
p_85,3,0,e_1,542,553,656,27,4,3,1,2,0,5,11,103,114
p_105,4,0,e_1,515,558,656,3,4,2,5,4,1,3,43,98,141
p_83,5,0,e_1,546,563,656,24,5,3,2,5,1,6,17,93,110
p_77,6,0,e_1,557,568,656,21,5,2,4,3,1,4,11,88,99
p_89,7,0,e_1,537,573,656,24,5,5,0,3,1,5,36,83,119
p_74,11,0,e_1,567,587,656,13,4,2,6,2,1,3,20,69,89
p_101,12,0,e_1,521,592,656,23,4,4,4,4,1,3,71,64,135
p_66,12,0,e_1,577,592,656,10,4,2,8,5,1,3,15,64,79
p_65,12,0,e_1,578,592,656,10,4,2,8,5,1,3,14,64,78
p_109,14,0,e_1,506,600,656,26,4,4,7,1,1,2,94,56,150
p_88,14,0,e_1,538,600,656,17,5,5,0,5,0,6,62,56,118
p_79,14,0,e_1,549,600,656,14,4,1,2,5,1,6,51,56,107
p_75,14,0,e_1,563,600,656,11,5,1,5,5,1,4,37,56,93
p_90,2,0,e_3,536,550,658,29,4,4,1,1,1,3,14,108,122
p_84,3,0,e_3,546,555,658,26,4,3,1,5,0,4,9,103,112
p_78,4,0,e_3,555,560,658,23,4,3,3,5,1,3,5,98,103
p_98,6,0,e_3,524,568,658,29,4,4,5,4,1,3,44,90,134
p_86,6,0,e_3,541,568,658,6,4,4,0,3,1,4,27,90,117
p_80,6,0,e_3,548,568,658,22,5,2,2,5,0,5,20,90,110
p_76,7,0,e_3,559,573,658,3,4,4,4,3,1,3,14,85,99
p_103,13,0,e_3,517,593,658,23,3,3,6,1,1,2,76,65,141
p_111,15,0,e_3,501,601,658,26,3,3,11,4,1,2,100,57,157
p_44,15,0,e_3,598,601,658,1,5,0,14,5,1,4,3,57,60
p_46,13,0,e_3,596,609,658,3,4,1,14,5,1,3,13,49,62
p_49,5,0,e_3,592,635,658,12,3,1,13,2,1,2,43,23,66
p_42,4,0,e_3,600,640,658,11,4,0,15,2,1,3,40,18,58
p_35,4,0,e_3,640,642,658,30,3,3,4,4,1,2,2,16,18
p_70,3,0,e_3,572,647,658,20,3,2,7,2,1,2,75,11,86
p_31,5,0,e_0,662,671,760,24,3,2,2,5,0,2,9,89,98
p_37,7,0,e_0,633,679,760,28,5,5,5,4,1,2,46,81,127
p_36,11,0,e_0,635,693,760,24,4,4,5,4,1,2,58,67,125
p_29,15,0,e_0,678,707,760,9,3,0,7,2,1,2,29,53,82
p_25,7,0,e_0,703,733,760,10,3,1,14,5,1,3,30,27,57
p_28,6,0,e_0,679,738,760,18,3,2,7,5,1,3,59,22,81
p_30,5,0,e_0,676,743,760,20,3,2,6,5,1,2,67,17,84
p_51,1,0,e_1,591,661,760,16,4,1,12,2,1,3,70,99,169
p_48,2,0,e_1,593,666,760,15,4,1,12,5,1,4,73,94,167
p_43,3,0,e_1,599,671,760,12,5,0,14,2,1,4,72,89,161
p_40,4,0,e_1,601,676,760,11,5,2,14,4,1,5,75,84,159
p_38,4,0,e_1,627,676,760,3,5,1,6,1,1,6,49,84,133
p_57,6,0,e_1,587,684,760,13,4,2,11,5,1,3,97,76,173
p_58,10,0,e_1,586,698,760,9,4,2,11,2,1,2,112,62,174
p_50,10,0,e_1,592,698,760,7,4,1,12,5,1,4,106,62,168
p_68,14,0,e_1,574,712,760,9,4,1,7,5,1,3,138,48,186
p_22,10,0,e_1,712,726,760,4,3,0,14,4,1,1,14,34,48
p_26,3,0,e_1,698,749,760,15,3,1,10,5,1,1,51,11,62
p_71,2,0,e_2,569,660,760,22,4,3,9,5,1,4,91,100,191
p_56,2,0,e_2,588,660,760,16,4,2,14,5,1,6,72,100,172
p_55,4,0,e_2,590,668,760,14,4,2,15,2,1,5,78,92,170
p_62,5,0,e_2,582,673,760,15,4,2,13,5,1,5,91,87,178
p_73,6,0,e_2,568,678,760,18,4,3,9,5,1,3,110,82,192
p_59,6,0,e_2,584,678,760,14,4,2,14,5,1,6,94,82,176
p_54,6,0,e_2,590,678,760,12,4,2,15,2,1,6,88,82,170
p_67,8,0,e_2,574,686,760,15,4,2,11,5,1,5,112,74,186
p_63,8,0,e_2,581,686,760,13,4,2,13,5,1,5,105,74,179
p_60,9,0,e_2,584,691,760,11,4,2,14,5,1,6,107,69,176
p_53,9,0,e_2,590,691,760,9,4,2,15,2,1,6,101,69,170
p_52,11,0,e_2,591,699,760,6,4,1,15,4,1,6,108,61,169
p_151,15,0,e_2,443,713,760,11,4,0,10,5,1,5,270,47,317
p_149,15,0,e_2,444,713,760,11,4,0,10,5,1,5,269,47,316
p_142,15,0,e_2,452,713,760,8,4,0,12,5,1,3,261,47,308
p_32,5,0,e_3,657,675,760,5,2,2,0,3,1,2,18,85,103
p_33,8,0,e_3,647,686,760,25,2,2,3,4,1,1,39,74,113
p_39,15,0,e_3,609,709,760,28,4,4,13,4,1,3,100,51,151
p_34,15,0,e_3,643,709,760,19,3,3,4,4,1,2,66,51,117
p_24,5,0,e_3,707,741,760,10,3,0,15,5,1,2,34,19,53
p_23,5,0,e_3,709,741,760,10,3,0,15,4,1,2,32,19,51
p_27,2,0,e_3,693,752,760,18,2,1,10,5,1,1,59,8,67
p_20,9,0,e_0,737,789,820,27,3,3,6,1,1,1,52,31,83
p_18,2,0,e_0,768,812,820,20,1,1,2,5,0,1,44,8,52
p_19,12,0,e_3,740,798,846,23,2,2,5,1,1,1,58,48,106
p_16,13,0,e_3,774,803,846,9,1,0,4,5,0,1,29,43,72
p_12,13,0,e_3,796,803,846,1,3,0,12,5,0,3,7,43,50
p_13,11,0,e_3,794,811,846,4,2,2,11,5,0,2,17,35,52
p_21,10,0,e_1,732,792,858,28,3,3,8,4,1,1,60,66,126
p_17,15,0,e_1,772,809,858,11,1,0,4,5,0,1,37,49,86
p_10,14,0,e_1,810,814,858,27,1,1,15,4,1,0,4,44,48
p_141,15,0,e_2,455,807,858,7,4,0,13,5,1,3,352,51,403
p_87,15,0,e_2,539,807,858,16,5,5,3,5,1,8,268,51,319
p_72,15,0,e_2,569,807,858,9,4,0,9,5,1,5,238,51,289
p_15,15,0,e_2,782,807,858,8,2,0,7,5,0,1,25,51,76
p_14,15,0,e_2,790,807,858,5,2,0,10,5,0,1,17,51,68
p_11,11,0,e_2,810,821,858,30,1,1,14,4,1,0,11,37,48
p_9,2,0,e_2,845,850,858,2,0,0,3,4,1,0,5,8,13
p_4,1,0,e_2,864,870,875,1,0,0,0,3,0,0,6,5,11
p_3,1,0,e_2,876,882,887,1,0,0,0,3,0,0,6,5,11
p_5,5,0,e_1,860,878,897,5,0,0,0,3,0,0,18,19,37
p_2,3,0,e_1,878,886,897,3,0,0,5,4,1,0,8,11,19
p_1,2,0,e_2,889,898,906,2,0,0,0,3,0,0,9,8,17
p_8,1,0,e_0,847,853,940,1,0,0,0,3,0,0,6,87,93
p_7,12,0,e_0,851,888,940,12,0,0,1,5,0,1,37,52,89
p_6,14,0,e_0,858,896,940,14,0,0,2,5,1,1,38,44,82
p_299,3,0,e_1,7,19,30,3,0,0,0,3,0,0,12,11,23
p_296,1,0,e_3,20,26,31,1,0,0,0,3,0,0,6,5,11
p_298,4,0,e_2,10,25,47,4,0,0,0,3,0,0,15,22,37
p_295,5,0,e_2,22,30,47,5,1,0,3,5,0,1,8,17,25
p_288,1,0,e_2,49,55,98,3,2,2,0,3,0,0,6,43,49
p_285,2,0,e_2,54,60,98,7,3,2,1,2,0,1,6,38,44
p_286,3,0,e_2,51,65,98,7,3,2,0,5,0,1,14,33,47
p_282,6,0,e_2,62,76,98,7,2,1,2,5,1,1,14,22,36
p_279,2,0,e_2,76,90,98,8,1,0,6,4,1,0,14,8,22
p_275,2,0,e_2,84,90,98,5,2,0,4,4,1,1,6,8,14
p_290,4,0,e_3,43,50,108,6,1,1,2,5,0,1,7,58,65
p_291,6,0,e_3,35,58,108,6,0,0,0,3,0,0,23,50,73
p_289,7,0,e_3,47,63,108,4,2,0,3,5,0,2,16,45,61
p_283,10,0,e_3,55,74,108,5,3,0,5,5,1,2,19,34,53
p_281,10,0,e_3,63,74,108,3,2,0,7,5,1,1,11,34,45
p_274,4,0,e_3,84,94,108,3,2,0,7,4,1,1,10,14,24
p_300,8,0,e_0,4,31,109,8,0,0,0,3,0,0,27,78,105
p_297,12,0,e_0,18,45,109,12,0,0,4,5,0,1,27,64,91
p_294,13,0,e_0,23,50,109,13,1,0,6,5,0,2,27,59,86
p_293,15,0,e_0,26,58,109,16,1,1,7,5,0,3,32,51,83
p_284,14,0,e_0,55,63,109,9,4,0,14,5,1,1,8,46,54
p_276,5,0,e_0,82,92,109,3,2,0,8,4,1,1,10,17,27
p_292,11,0,e_1,30,66,109,11,0,0,0,3,0,0,36,43,79
p_287,12,0,e_1,51,71,109,8,3,0,6,5,0,1,20,38,58
p_280,12,0,e_1,65,71,109,5,2,0,11,2,0,1,6,38,44
p_277,10,0,e_0,81,141,185,28,2,2,8,4,1,0,60,44,104
p_271,11,0,e_0,127,146,185,13,1,1,6,5,0,1,19,39,58
p_264,5,0,e_0,162,166,185,8,2,1,6,4,1,1,4,19,23
p_269,4,0,e_0,146,171,185,14,1,1,11,4,1,0,25,14,39
p_273,13,0,e_2,95,139,198,21,2,2,1,4,1,0,44,59,103
p_272,15,0,e_2,105,147,198,16,2,2,2,5,0,1,42,51,93
p_268,10,0,e_2,150,164,198,6,1,1,14,4,1,0,14,34,48
p_262,6,0,e_2,164,178,198,6,2,0,10,4,1,0,14,20,34
p_259,6,0,e_2,174,178,198,4,1,0,7,4,1,1,4,20,24
p_278,15,0,e_3,80,155,206,23,1,1,8,4,1,0,75,51,126
p_265,12,0,e_3,157,166,206,3,1,0,15,4,1,0,9,40,49
p_263,12,0,e_3,163,166,206,1,2,0,13,4,1,1,3,40,43
p_258,5,0,e_3,175,189,206,4,1,0,9,4,1,0,14,17,31
p_254,3,0,e_2,199,211,224,29,1,1,0,3,0,0,12,13,25
p_252,2,0,e_2,212,216,224,2,0,0,3,4,1,0,4,8,12
p_270,7,0,e_1,133,157,240,15,1,1,0,3,0,0,24,83,107
p_261,12,0,e_1,170,174,240,29,1,1,11,5,1,2,4,66,70
p_260,13,0,e_1,171,179,240,28,1,1,11,5,1,3,8,61,69
p_266,15,0,e_1,155,187,240,30,1,1,7,5,0,2,32,53,85
p_257,12,0,e_1,179,198,240,26,2,2,13,5,1,2,19,42,61
p_255,10,0,e_1,192,206,240,24,1,1,14,4,1,2,14,34,48
p_267,1,0,e_1,153,235,240,14,1,0,6,5,0,1,82,5,87
p_251,4,0,e_2,228,243,277,4,0,0,0,3,0,0,15,34,49
p_250,7,0,e_2,236,254,277,7,0,0,2,5,0,1,18,23,41
p_249,7,0,e_2,238,254,277,7,0,0,3,5,0,2,16,23,39
p_248,7,0,e_2,246,254,277,7,0,0,5,5,1,1,8,23,31
p_256,8,0,e_0,191,218,292,27,1,1,0,3,0,0,27,74,101
p_253,15,0,e_0,208,241,292,15,0,0,5,5,0,1,33,51,84
p_247,12,0,e_0,248,252,292,12,0,0,13,4,1,0,4,40,44
p_244,2,0,e_0,271,284,292,16,1,1,6,4,1,0,13,8,21
p_245,9,0,e_3,269,299,332,9,0,0,0,3,0,0,30,33,63
p_242,4,0,e_3,287,316,332,9,1,1,5,5,0,1,29,16,45
p_233,2,0,e_3,319,324,332,1,1,0,3,4,1,0,5,8,13
p_246,12,0,e_1,257,296,338,12,0,0,0,3,0,0,39,42,81
p_237,5,0,e_1,313,319,338,30,2,2,7,4,1,1,6,19,25
p_238,2,0,e_1,311,330,338,3,2,1,7,4,1,0,19,8,27
p_243,8,0,e_2,285,312,396,5,1,1,0,3,0,0,27,84,111
p_241,13,0,e_2,300,329,396,26,2,2,4,5,0,1,29,67,96
p_240,14,0,e_2,301,334,396,25,2,2,5,5,0,2,33,62,95
p_234,14,0,e_2,314,334,396,20,2,2,8,5,1,3,20,62,82
p_224,13,0,e_2,335,339,396,13,0,0,14,4,1,5,4,57,61
p_226,12,0,e_2,331,344,396,12,0,0,13,5,1,4,13,52,65
p_219,11,0,e_2,342,349,396,11,1,0,12,4,1,5,7,47,54
p_225,10,0,e_2,333,354,396,10,0,0,14,2,1,4,21,42,63
p_229,9,0,e_2,323,359,396,23,1,1,11,5,1,4,36,37,73
p_227,9,0,e_2,326,359,396,23,1,1,12,5,1,5,33,37,70
p_235,8,0,e_2,314,364,396,26,2,2,8,5,1,2,50,32,82
p_206,6,0,e_2,362,372,396,4,3,1,8,4,1,3,10,24,34
p_232,5,0,e_2,320,377,396,28,2,2,10,5,1,3,57,19,76
p_230,5,0,e_2,323,377,396,27,1,1,11,5,1,4,54,19,73
p_205,1,0,e_2,362,391,396,9,3,1,8,4,1,2,29,5,34
p_236,8,0,e_0,313,332,422,27,2,2,2,5,0,1,19,90,109
p_231,10,0,e_0,320,340,422,23,2,2,4,5,0,2,20,82,102
p_228,11,0,e_0,325,345,422,21,1,1,6,5,0,3,20,77,97
p_213,12,0,e_0,347,350,422,11,3,0,11,5,1,2,3,72,75
p_239,13,0,e_0,305,355,422,24,2,2,0,3,0,0,50,67,117
p_223,13,0,e_0,339,355,422,13,0,0,10,2,1,2,16,67,83
p_208,13,0,e_0,355,357,422,9,2,2,13,5,1,3,2,65,67
p_211,14,0,e_0,348,362,422,12,3,0,12,5,1,3,14,60,74
p_207,12,0,e_0,355,370,422,8,2,2,13,5,1,2,15,52,67
p_203,12,0,e_0,365,370,422,6,2,0,13,4,1,2,5,52,57
p_200,12,0,e_0,367,370,422,7,3,1,13,4,1,2,3,52,55
p_198,9,0,e_0,368,381,422,10,3,1,12,4,1,3,13,41,54
p_195,9,0,e_0,376,381,422,8,2,1,10,4,1,5,5,41,46
p_197,8,0,e_0,375,386,422,9,2,1,11,4,1,3,11,36,47
p_191,7,0,e_0,382,391,422,8,3,2,9,4,1,4,9,31,40
p_221,4,0,e_3,341,356,446,4,0,0,0,3,0,0,15,90,105
p_214,4,0,e_3,346,356,446,11,2,1,1,5,0,2,10,90,100
p_215,6,0,e_3,346,364,446,9,2,1,1,5,0,2,18,82,100
p_217,8,0,e_3,345,372,446,7,1,0,1,5,0,1,27,74,101
p_204,8,0,e_3,364,372,446,2,2,0,6,5,1,1,8,74,82
p_193,12,0,e_3,378,386,446,4,2,1,10,5,1,1,8,60,68
p_201,13,0,e_3,366,391,446,7,2,0,6,5,1,1,25,55,80
p_183,12,0,e_3,393,396,446,1,3,0,13,4,1,2,3,50,53
p_181,11,0,e_3,395,401,446,1,3,0,12,1,1,2,6,45,51
p_187,7,0,e_3,391,415,446,6,2,0,13,4,1,1,24,31,55
p_167,7,0,e_3,412,415,446,1,5,0,8,4,1,4,3,31,34
p_178,5,0,e_3,398,423,446,7,4,2,12,4,1,3,25,23,48
p_166,5,0,e_3,415,423,446,2,4,0,7,4,1,3,8,23,31
p_163,4,0,e_3,417,428,446,3,4,1,7,4,1,3,11,18,29
p_171,3,0,e_3,408,433,446,6,4,2,9,4,1,3,25,13,38
p_222,3,0,e_1,339,351,450,3,0,0,0,3,0,0,12,99,111
p_210,4,0,e_1,353,356,450,9,3,2,3,5,1,1,3,94,97
p_220,9,0,e_1,342,373,450,9,1,0,0,5,0,1,31,77,108
p_218,9,0,e_1,343,373,450,9,1,0,1,5,0,2,30,77,107
p_212,9,0,e_1,348,373,450,7,3,0,2,5,0,2,25,77,102
p_194,11,0,e_1,377,381,450,6,2,1,10,5,1,2,4,69,73
p_202,13,0,e_1,365,389,450,7,2,0,7,5,1,2,24,61,85
p_190,14,0,e_1,382,394,450,3,3,0,11,5,1,2,12,56,68
p_173,10,0,e_1,405,408,450,30,4,4,11,4,1,4,3,42,45
p_177,9,0,e_1,398,413,450,3,5,1,13,4,1,3,15,37,52
p_188,8,0,e_1,390,418,450,21,1,0,13,5,1,2,28,32,60
p_179,6,0,e_1,397,426,450,6,4,2,13,4,1,2,29,24,53
p_176,6,0,e_1,398,426,450,6,5,2,13,4,1,3,28,24,52
p_155,3,0,e_1,434,437,450,30,2,2,4,4,1,1,3,13,16
p_209,2,0,e_1,354,442,450,10,3,2,4,5,1,2,88,8,96
p_170,10,0,e_2,408,429,519,29,5,5,3,5,0,1,21,90,111
p_169,11,0,e_2,410,434,519,27,5,5,4,5,0,2,24,85,109
p_164,12,0,e_2,416,439,519,25,4,4,6,5,0,4,23,80,103
p_161,13,0,e_2,418,444,519,23,5,5,7,5,0,5,26,75,101
p_180,14,0,e_2,396,449,519,28,4,4,0,3,0,0,53,70,123
p_172,14,0,e_2,405,449,519,26,4,4,2,5,0,1,44,70,114
p_165,14,0,e_2,416,449,519,23,4,4,6,5,0,5,33,70,103
p_162,14,0,e_2,417,449,519,23,5,5,6,5,0,5,32,70,102
p_158,14,0,e_2,426,449,519,20,4,4,9,5,0,6,23,70,93
p_168,15,0,e_2,412,454,519,23,5,5,5,5,0,3,42,65,107
p_151,15,0,e_2,443,454,519,16,1,1,13,2,1,5,11,65,76
p_149,15,0,e_2,444,454,519,15,2,2,13,5,1,6,10,65,75
p_142,15,0,e_2,452,454,519,14,4,0,15,5,1,5,2,65,67
p_140,13,0,e_2,455,462,519,11,4,0,15,4,1,4,7,57,64
p_139,13,0,e_2,456,462,519,11,4,0,15,4,1,5,6,57,63
p_143,2,0,e_1,451,460,536,11,3,2,0,3,0,0,9,76,85
p_136,2,0,e_1,460,462,536,15,3,2,2,5,1,2,2,74,76
p_144,4,0,e_1,451,470,536,9,3,1,0,3,0,1,19,66,85
p_133,4,0,e_1,463,470,536,12,3,2,2,5,1,2,7,66,73
p_129,5,0,e_1,470,475,536,9,4,3,4,5,1,2,5,61,66
p_138,7,0,e_1,456,483,536,11,4,1,1,5,0,2,27,53,80
p_135,7,0,e_1,461,483,536,10,3,1,2,2,1,2,22,53,75
p_132,7,0,e_1,463,483,536,9,3,1,2,5,1,2,20,53,73
p_131,9,0,e_1,467,491,536,6,3,1,3,5,1,2,24,45,69
p_121,9,0,e_1,480,491,536,6,3,2,6,5,1,4,11,45,56
p_120,10,0,e_1,481,496,536,5,3,1,7,5,1,4,15,40,55
p_115,10,0,e_1,494,496,536,2,2,0,10,5,1,3,2,40,42
p_122,5,0,e_1,477,513,536,11,4,3,5,5,1,3,36,23,59
p_108,5,0,e_1,509,513,536,4,3,0,6,4,1,3,4,23,27
p_125,4,0,e_1,474,518,536,9,3,2,5,2,1,2,44,18,62
p_186,1,0,e_3,391,451,536,12,1,0,13,4,1,0,60,85,145
p_156,1,0,e_3,428,451,536,3,3,1,4,4,1,2,23,85,108
p_148,3,0,e_3,447,459,536,3,1,0,0,5,0,1,12,77,89
p_147,7,0,e_3,450,473,536,6,1,0,1,2,0,1,23,63,86
p_130,9,0,e_3,469,481,536,5,3,1,6,5,1,2,12,55,67
p_146,10,0,e_3,451,486,536,9,3,0,1,5,1,2,35,50,85
p_128,10,0,e_3,471,486,536,3,4,0,7,5,1,3,15,50,65
p_123,12,0,e_3,474,494,536,5,3,0,7,5,1,2,20,42,62
p_117,12,0,e_3,490,494,536,1,2,0,11,5,1,1,4,42,46
p_113,11,0,e_3,496,499,536,1,2,0,12,4,1,1,3,37,40
p_114,9,0,e_3,494,507,536,3,1,0,12,4,1,0,13,29,42
p_216,1,0,e_0,346,427,540,14,2,2,11,5,1,1,81,113,194
p_199,2,0,e_0,368,432,540,17,3,2,12,4,1,2,64,108,172
p_185,2,0,e_0,392,432,540,11,3,1,7,4,1,3,40,108,148
p_175,2,0,e_0,399,432,540,9,5,2,5,4,1,3,33,108,141
p_174,3,0,e_0,402,437,540,8,4,2,4,4,1,3,35,103,138
p_196,5,0,e_0,376,445,540,12,2,1,10,4,1,4,69,95,164
p_192,5,0,e_0,380,445,540,11,3,2,9,1,1,4,65,95,160
p_184,5,0,e_0,393,445,540,8,3,1,7,4,1,3,52,95,147
p_182,5,0,e_0,394,445,540,7,4,1,6,4,1,3,51,95,146
p_189,7,0,e_0,387,453,540,7,2,1,8,4,1,4,66,87,153
p_160,10,0,e_0,421,464,540,25,5,5,0,3,1,5,43,76,119
p_159,11,0,e_0,424,469,540,24,4,4,0,5,0,6,45,71,116
p_157,12,0,e_0,427,474,540,22,3,3,1,5,1,6,47,66,113
p_145,12,0,e_0,451,474,540,11,4,0,7,5,1,4,23,66,89
p_124,14,0,e_0,474,482,540,7,4,0,12,5,1,1,8,58,66
p_96,5,0,e_3,527,553,650,28,4,4,3,4,1,3,26,97,123
p_104,7,0,e_3,516,561,650,29,3,3,6,4,1,2,45,89,134
p_89,7,0,e_3,537,561,650,23,4,2,0,5,0,4,24,89,113
p_109,14,0,e_3,506,584,650,25,2,2,9,1,1,1,78,66,144
p_111,15,0,e_3,501,589,650,26,2,2,11,4,1,1,88,61,149
p_69,10,0,e_3,573,606,650,9,6,2,11,5,1,5,33,44,77
p_50,10,0,e_3,592,606,650,4,7,0,14,4,1,6,14,44,58
p_41,10,0,e_3,600,606,650,2,7,0,12,4,1,6,6,44,50
p_53,9,0,e_3,590,611,650,6,6,1,15,4,1,5,21,39,60
p_73,6,0,e_3,568,622,650,15,5,2,9,5,1,4,54,28,82
p_57,6,0,e_3,587,622,650,9,7,0,15,5,1,6,35,28,63
p_54,6,0,e_3,590,622,650,9,6,1,15,4,1,5,32,28,60
p_61,5,0,e_3,583,627,650,11,6,1,14,2,1,5,44,23,67
p_38,4,0,e_3,627,632,650,1,4,0,5,4,1,3,5,18,23
p_82,3,0,e_3,547,637,650,24,5,4,3,5,0,5,90,13,103
p_110,1,0,e_2,501,524,651,10,2,1,4,4,1,7,23,127,150
p_150,3,0,e_2,444,532,651,27,2,2,13,5,1,5,88,119,207
p_119,5,0,e_2,483,540,651,10,3,2,8,4,1,6,57,111,168
p_126,6,0,e_2,473,545,651,7,3,2,10,4,1,6,72,106,178
p_98,6,0,e_2,524,545,651,28,4,4,1,5,1,8,21,106,127
p_95,6,0,e_2,527,545,651,27,5,5,2,5,1,8,18,106,124
p_94,6,0,e_2,528,545,651,26,5,5,2,5,1,8,17,106,123
p_154,7,0,e_2,438,550,651,25,2,2,12,2,1,3,112,101,213
p_93,7,0,e_2,529,550,651,25,5,5,2,5,1,8,21,101,122
p_153,8,0,e_2,438,555,651,24,2,2,12,2,1,4,117,96,213
p_152,10,0,e_2,439,563,651,21,2,2,12,5,1,5,124,88,212
p_100,10,0,e_2,522,563,651,24,4,4,1,5,0,9,41,88,129
p_97,10,0,e_2,526,563,651,23,4,4,1,5,1,8,37,88,125
p_134,12,0,e_2,462,571,651,8,3,0,13,4,1,4,109,80,189
p_101,12,0,e_2,521,571,651,23,4,4,0,5,0,9,50,80,130
p_107,1,0,e_1,512,541,654,7,3,0,5,1,1,2,29,113,142
p_102,2,0,e_1,521,546,654,3,4,0,3,4,1,3,25,108,133
p_90,2,0,e_1,536,546,654,28,4,4,0,5,0,5,10,108,118
p_106,4,0,e_1,512,554,654,4,3,0,5,1,1,3,42,100,142
p_105,4,0,e_1,515,554,654,3,3,0,5,4,1,3,39,100,139
p_86,6,0,e_1,541,562,654,23,4,3,1,5,1,4,21,92,113
p_80,6,0,e_1,548,562,654,20,6,3,2,5,1,4,14,92,106
p_103,13,0,e_1,517,585,654,23,4,4,4,1,1,2,68,69,137
p_112,15,0,e_1,497,593,654,26,3,3,10,4,1,2,96,61,157
p_46,13,0,e_1,596,601,654,30,7,7,14,4,1,6,5,53,58
p_52,11,0,e_1,591,609,654,4,7,0,15,5,1,5,18,45,63
p_58,10,0,e_1,586,614,654,6,7,1,13,5,1,3,28,40,68
p_49,5,0,e_1,592,631,654,9,7,3,15,2,1,5,39,23,62
p_78,4,0,e_1,555,636,654,21,6,3,4,5,1,3,81,18,99
p_55,4,0,e_1,590,636,654,11,6,3,14,5,1,4,46,18,64
p_99,1,0,e_0,522,545,660,3,4,0,4,4,1,3,23,115,138
p_85,3,0,e_0,542,553,660,25,4,4,0,5,0,4,11,107,118
p_84,3,0,e_0,546,553,660,24,4,4,1,5,1,4,7,107,114
p_118,4,0,e_0,488,558,660,10,2,1,15,4,1,0,70,102,172
p_83,5,0,e_0,546,563,660,22,4,3,1,5,1,4,17,97,114
p_77,6,0,e_0,557,568,660,18,6,3,4,3,1,3,11,92,103
p_116,7,0,e_0,490,573,660,6,2,1,14,4,1,1,83,87,170
p_76,7,0,e_0,559,573,660,16,6,2,4,5,1,4,14,87,101
p_74,11,0,e_0,567,587,660,10,5,2,6,2,1,2,20,73,93
p_65,12,0,e_0,578,592,660,6,7,2,8,5,1,2,14,68,82
p_141,15,0,e_0,455,603,660,13,4,0,7,5,1,3,148,57,205
p_127,15,0,e_0,473,603,660,8,3,0,12,2,1,1,130,57,187
p_44,15,0,e_0,598,603,660,27,7,7,14,5,1,4,5,57,62
p_47,6,0,e_0,594,632,660,8,7,2,12,5,1,2,38,28,66
p_45,5,0,e_0,597,637,660,8,7,3,13,5,1,3,40,23,63
p_48,2,0,e_0,593,668,726,12,7,5,12,5,1,1,75,58,133
p_43,3,0,e_0,599,673,726,9,7,4,14,5,1,4,74,53,127
p_42,4,0,e_0,600,678,726,8,7,4,14,5,1,5,78,48,126
p_40,4,0,e_0,601,678,726,7,7,4,15,5,1,6,77,48,125
p_31,5,0,e_0,662,683,726,22,3,2,0,5,0,4,21,43,64
p_30,5,0,e_0,676,683,726,18,2,1,4,5,1,3,7,43,50
p_28,6,0,e_0,679,688,726,16,2,1,4,5,1,2,9,38,47
p_33,8,0,e_0,647,696,726,23,4,4,3,4,1,2,49,30,79
p_26,3,0,e_0,698,713,726,13,2,1,8,4,1,1,15,13,28
p_27,2,0,e_0,693,718,726,15,2,1,7,5,1,1,25,8,33
p_51,1,0,e_1,591,659,736,14,7,6,15,5,1,4,68,77,145
p_70,3,0,e_1,572,667,736,17,6,2,9,5,1,3,95,69,164
p_35,4,0,e_1,640,672,736,28,4,4,3,1,1,2,32,64,96
p_32,5,0,e_1,657,677,736,23,2,2,1,5,0,4,20,59,79
p_36,11,0,e_1,635,697,736,22,5,5,4,1,1,2,62,39,101
p_25,7,0,e_1,703,711,736,8,1,0,9,4,1,0,8,25,33
p_24,5,0,e_1,707,719,736,8,1,0,8,4,1,1,12,17,29
p_23,5,0,e_1,709,719,736,8,1,0,7,4,1,2,10,17,27
p_81,2,0,e_3,547,658,750,25,4,4,3,5,0,4,111,92,203
p_56,2,0,e_3,588,658,750,13,6,0,15,2,1,5,70,92,162
p_37,7,0,e_3,633,675,750,27,4,4,4,4,1,3,42,75,117
p_39,15,0,e_3,609,701,750,24,6,6,9,4,1,5,92,49,141
p_34,15,0,e_3,643,701,750,17,3,3,2,4,1,2,58,49,107
p_29,15,0,e_3,678,701,750,7,2,0,8,5,1,1,23,49,72
p_22,10,0,e_3,712,718,750,2,1,0,12,4,1,0,6,32,38
p_64,1,0,e_2,579,656,763,16,7,2,14,5,1,5,77,107,184
p_71,2,0,e_2,569,661,763,19,6,2,12,5,1,4,92,102,194
p_62,5,0,e_2,582,672,763,11,7,1,14,5,1,6,90,91,181
p_59,6,0,e_2,584,677,763,10,7,1,15,5,1,7,93,86,179
p_67,8,0,e_2,574,685,763,11,7,2,13,5,1,4,111,78,189
p_63,8,0,e_2,581,685,763,9,7,2,14,5,1,6,104,78,182
p_60,9,0,e_2,584,690,763,7,7,1,15,5,1,8,106,73,179
p_66,12,0,e_2,577,701,763,6,7,2,13,5,1,4,124,62,186
p_137,13,0,e_2,458,706,763,10,3,0,14,4,1,5,248,57,305
p_92,13,0,e_2,533,706,763,18,5,5,3,5,1,7,173,57,230
p_91,13,0,e_2,535,706,763,13,4,4,4,5,1,7,171,57,228
p_88,14,0,e_2,538,711,763,16,4,1,5,5,1,7,173,52,225
p_79,14,0,e_2,549,711,763,12,6,1,7,2,1,6,162,52,214
p_75,14,0,e_2,563,711,763,9,5,1,10,5,1,4,148,52,200
p_68,14,0,e_2,574,711,763,5,7,1,13,5,1,5,137,52,189
p_20,9,0,e_1,737,767,796,25,1,1,0,3,0,0,30,29,59
p_21,10,0,e_0,732,765,811,26,1,1,0,3,0,0,33,46,79
p_19,12,0,e_0,740,773,811,21,1,1,2,5,0,1,33,38,71
p_18,2,0,e_3,768,777,857,2,0,0,0,3,0,0,9,80,89
p_13,11,0,e_3,794,806,857,8,2,1,7,5,1,1,12,51,63
p_16,13,0,e_3,774,814,857,12,1,0,1,5,0,1,40,43,83
p_12,13,0,e_3,796,814,857,5,3,0,8,5,1,2,18,43,61
p_9,2,0,e_3,845,849,857,1,1,0,3,4,1,0,4,8,12
p_87,15,0,e_2,539,810,861,14,4,0,5,2,1,7,271,51,322
p_72,15,0,e_2,569,810,861,6,6,0,12,5,1,5,241,51,292
p_17,15,0,e_2,772,810,861,14,1,0,3,5,0,1,38,51,89
p_15,15,0,e_2,782,810,861,12,2,0,6,5,0,1,28,51,79
p_14,15,0,e_2,790,810,861,9,2,0,9,5,0,1,20,51,71
p_10,14,0,e_2,810,815,861,2,2,0,15,4,1,1,5,46,51
p_11,11,0,e_2,810,826,861,3,2,1,15,4,1,0,16,35,51
p_4,1,0,e_2,864,870,875,1,0,0,0,3,0,0,6,5,11
p_3,1,0,e_2,876,882,887,1,0,0,0,3,0,0,6,5,11
p_5,5,0,e_1,860,878,897,5,0,0,0,3,0,0,18,19,37
p_2,3,0,e_1,878,886,897,3,0,0,5,4,1,0,8,11,19
p_1,2,0,e_2,889,898,906,2,0,0,0,3,0,0,9,8,17
p_8,1,0,e_0,847,853,940,1,2,0,0,3,0,0,6,87,93
p_7,12,0,e_0,851,888,940,20,1,1,1,5,0,1,37,52,89
p_6,14,0,e_0,858,896,940,14,0,0,2,5,1,1,38,44,82
p_299,3,0,e_1,7,19,30,3,0,0,0,3,0,0,12,11,23
p_296,1,0,e_3,20,26,31,1,0,0,0,3,0,0,6,5,11
p_290,4,0,e_3,43,50,90,6,1,1,2,5,0,1,7,40,47
p_291,6,0,e_3,35,58,90,6,0,0,0,3,0,0,23,32,55
p_289,7,0,e_3,47,63,90,4,2,0,3,5,0,2,16,27,43
p_279,2,0,e_3,76,80,90,1,2,0,3,4,1,1,4,10,14
p_288,1,0,e_3,49,85,90,3,2,2,4,3,0,2,36,5,41
p_300,8,0,e_0,4,31,101,8,0,0,0,3,0,0,27,70,97
p_297,12,0,e_0,18,45,101,12,0,0,4,5,0,1,27,56,83
p_294,13,0,e_0,23,50,101,13,1,0,6,5,0,2,27,51,78
p_287,12,0,e_0,51,55,101,8,4,0,13,4,1,1,4,46,50
p_283,10,0,e_0,55,63,101,5,4,0,12,4,1,1,8,38,46
p_282,6,0,e_0,62,77,101,11,2,0,10,1,1,1,15,24,39
p_286,3,0,e_0,51,88,101,7,4,2,13,4,1,0,37,13,50
p_275,2,0,e_0,84,93,101,29,2,2,4,4,1,1,9,8,17
p_292,11,0,e_1,30,66,107,11,0,0,0,3,0,0,36,41,77
p_281,10,0,e_1,63,71,107,27,2,2,10,5,0,2,8,36,44
p_274,4,0,e_1,84,91,107,27,2,2,6,4,1,1,7,16,23
p_285,2,0,e_1,54,99,107,7,4,2,7,5,0,1,45,8,53
p_298,4,0,e_2,10,25,117,4,0,0,0,3,0,0,15,92,107
p_295,5,0,e_2,22,30,117,5,1,0,3,5,0,1,8,87,95
p_284,14,0,e_2,55,59,117,9,4,0,13,5,1,1,4,58,62
p_293,15,0,e_2,26,64,117,16,1,1,4,5,1,1,38,53,91
p_280,12,0,e_2,65,75,117,25,2,2,15,4,1,0,10,42,52
p_277,10,0,e_2,81,83,117,22,3,3,10,4,1,0,2,34,36
p_276,5,0,e_2,82,100,117,27,3,3,10,1,1,0,18,17,35
p_269,4,0,e_2,146,148,184,9,1,0,4,5,0,1,2,36,38
p_270,7,0,e_2,133,159,184,10,2,1,0,3,0,0,26,25,51
p_267,1,0,e_2,153,179,184,10,2,1,5,5,1,1,26,5,31
p_273,13,0,e_3,95,131,192,16,1,1,1,5,0,1,36,61,97
p_278,15,0,e_3,80,139,192,17,2,2,2,4,1,1,59,53,112
p_268,10,0,e_3,150,156,192,2,1,0,12,4,1,0,6,36,42
p_262,6,0,e_3,164,170,192,2,2,0,8,4,1,1,6,22,28
p_264,5,0,e_3,162,175,192,3,1,0,8,4,1,0,13,17,30
p_272,15,0,e_0,105,153,206,10,2,0,0,3,0,0,48,53,101
p_265,12,0,e_0,157,164,206,28,1,1,14,4,1,0,7,42,49
p_259,6,0,e_0,174,184,206,29,1,1,9,4,1,0,10,22,32
p_258,5,0,e_0,175,189,206,30,1,1,9,4,1,1,14,17,31
p_254,3,0,e_2,199,211,222,3,0,0,0,3,0,0,12,11,23
p_252,2,0,e_3,212,221,229,2,0,0,0,3,0,0,9,8,17
p_271,11,0,e_1,127,163,234,7,2,2,0,3,0,0,36,71,107
p_263,12,0,e_1,163,168,234,26,2,2,11,5,1,1,5,66,71
p_260,13,0,e_1,171,173,234,23,2,2,13,5,1,2,2,61,63
p_266,15,0,e_1,155,181,234,25,1,1,9,5,0,1,26,53,79
p_261,12,0,e_1,170,192,234,24,2,2,12,5,1,1,22,42,64
p_257,12,0,e_1,179,192,234,22,1,1,15,5,1,2,13,42,55
p_255,10,0,e_1,192,200,234,10,0,0,12,4,1,1,8,34,42
p_256,8,0,e_1,191,208,234,8,0,0,12,1,1,0,17,26,43
p_251,4,0,e_2,228,243,257,4,0,0,0,3,0,0,15,14,29
p_249,7,0,e_3,238,262,285,7,0,0,0,3,0,0,24,23,47
p_244,2,0,e_2,271,280,288,2,1,0,0,3,0,0,9,8,17
p_253,15,0,e_0,208,256,307,15,0,0,0,3,0,0,48,51,99
p_247,12,0,e_0,248,267,307,9,1,0,13,5,0,1,19,40,59
p_245,9,0,e_0,269,278,307,26,1,1,12,4,1,0,9,29,38
p_250,7,0,e_1,236,260,317,7,0,0,0,3,0,0,24,57,81
p_248,7,0,e_1,246,260,317,5,1,0,3,5,0,1,14,57,71
p_246,12,0,e_1,257,277,317,6,1,0,6,5,0,1,20,40,60
p_243,8,0,e_1,285,291,317,8,0,0,10,4,1,0,6,26,32
p_242,4,0,e_2,287,302,386,4,0,0,0,3,1,0,15,84,99
p_235,8,0,e_2,314,316,386,16,1,1,8,5,1,1,2,70,72
p_231,10,0,e_2,320,324,386,12,1,1,9,5,1,1,4,62,66
p_228,11,0,e_2,325,329,386,10,1,1,10,5,1,1,4,57,61
p_226,12,0,e_2,331,334,386,7,2,1,11,5,1,1,3,52,55
p_241,13,0,e_2,300,339,386,13,0,0,4,5,0,1,39,47,86
p_239,13,0,e_2,305,339,386,14,1,1,5,5,1,1,34,47,81
p_224,13,0,e_2,335,339,386,5,2,1,12,5,1,1,4,47,51
p_215,6,0,e_2,346,362,386,9,3,1,11,4,1,2,16,24,40
p_221,4,0,e_2,341,370,386,12,3,2,13,4,1,1,29,16,45
p_214,4,0,e_2,346,370,386,11,3,1,11,4,1,2,24,16,40
p_222,3,0,e_2,339,375,386,14,2,1,13,4,1,0,36,11,47
p_233,2,0,e_1,319,328,388,21,1,1,0,3,0,0,9,60,69
p_232,5,0,e_1,320,339,388,17,1,1,0,5,0,1,19,49,68
p_230,5,0,e_1,323,339,388,16,1,1,1,5,0,2,16,49,65
p_217,8,0,e_1,345,350,388,7,2,1,7,5,1,1,5,38,43
p_229,9,0,e_1,323,355,388,12,1,1,1,5,0,2,32,33,65
p_220,9,0,e_1,342,355,388,7,3,2,6,5,1,1,13,33,46
p_218,9,0,e_1,343,355,388,6,3,1,6,5,1,1,12,33,45
p_212,9,0,e_1,348,355,388,5,3,0,8,5,1,2,7,33,40
p_210,4,0,e_1,353,372,388,9,2,0,9,5,1,1,19,16,35
p_209,2,0,e_1,354,380,388,11,2,0,9,2,1,1,26,8,34
p_227,9,0,e_3,326,331,402,11,1,1,8,5,0,1,5,71,76
p_223,13,0,e_3,339,345,402,4,2,1,11,5,1,1,6,57,63
p_240,14,0,e_3,301,350,402,14,0,0,0,3,0,0,49,52,101
p_234,14,0,e_3,314,350,402,10,1,0,4,5,0,1,36,52,88
p_211,14,0,e_3,348,350,402,0,3,0,14,5,1,2,2,52,54
p_204,8,0,e_3,364,370,402,2,3,0,10,4,1,2,6,32,38
p_206,6,0,e_3,362,378,402,4,2,0,10,4,1,1,16,24,40
p_196,5,0,e_3,376,383,402,1,3,0,6,4,1,2,7,19,26
p_192,5,0,e_3,380,383,402,1,3,0,6,4,1,2,3,19,22
p_216,1,0,e_3,346,397,402,14,2,1,13,5,1,1,51,5,56
p_205,1,0,e_3,362,397,402,9,2,0,10,4,1,1,35,5,40
p_186,1,0,e_3,391,397,402,2,3,0,3,4,1,2,6,5,11
p_238,2,0,e_0,311,320,420,23,1,1,0,3,0,0,9,100,109
p_237,5,0,e_0,313,331,420,20,1,1,0,5,0,1,18,89,107
p_236,8,0,e_0,313,342,420,17,1,1,0,5,0,2,29,78,107
p_225,10,0,e_0,333,350,420,9,2,1,5,5,1,1,17,70,87
p_219,11,0,e_0,342,355,420,5,3,2,8,5,1,1,13,65,78
p_213,12,0,e_0,347,360,420,3,3,1,9,5,1,2,13,60,73
p_207,12,0,e_0,355,360,420,1,2,0,11,5,1,1,5,60,65
p_208,13,0,e_0,355,365,420,30,2,2,11,5,1,1,10,55,65
p_203,12,0,e_0,365,370,420,27,4,4,13,4,1,0,5,50,55
p_200,12,0,e_0,367,370,420,27,4,4,13,4,1,1,3,50,53
p_198,9,0,e_0,368,381,420,29,4,4,12,4,1,2,13,39,52
p_195,9,0,e_0,376,381,420,27,4,4,10,4,1,3,5,39,44
p_197,8,0,e_0,375,386,420,29,3,3,11,4,1,2,11,34,45
p_191,7,0,e_0,382,391,420,28,2,2,9,4,1,2,9,29,38
p_189,7,0,e_0,387,391,420,27,3,3,8,4,1,2,4,29,33
p_178,5,0,e_1,398,405,492,26,3,3,3,5,0,4,7,87,94
p_187,7,0,e_1,391,413,492,26,3,3,1,5,0,2,22,79,101
p_167,7,0,e_1,412,413,492,18,4,3,7,2,1,4,1,79,80
p_177,9,0,e_1,398,423,492,22,3,3,3,5,0,5,25,69,94
p_181,11,0,e_1,395,431,492,20,3,3,2,5,0,3,36,61,97
p_193,12,0,e_1,378,436,492,24,3,3,2,4,1,2,58,56,114
p_164,12,0,e_1,416,436,492,12,5,1,7,5,1,5,20,56,76
p_201,13,0,e_1,366,441,492,26,4,4,6,4,1,2,75,51,126
p_153,8,0,e_1,438,458,492,10,4,3,12,5,1,4,20,34,54
p_147,7,0,e_1,450,463,492,10,3,2,10,4,1,4,13,29,42
p_138,7,0,e_1,456,463,492,9,4,1,8,4,1,5,7,29,36
p_166,5,0,e_1,415,471,492,20,5,4,7,5,1,4,56,21,77
p_163,4,0,e_1,417,476,492,20,5,4,7,5,1,5,59,16,75
p_133,4,0,e_1,463,476,492,11,4,2,7,4,1,3,13,16,29
p_155,3,0,e_1,434,481,492,16,5,4,12,5,1,4,47,11,58
p_188,8,0,e_2,390,412,506,25,3,3,1,5,0,2,22,94,116
p_194,11,0,e_2,377,423,506,25,3,3,3,4,1,1,46,83,129
p_183,12,0,e_2,393,428,506,20,3,3,2,5,0,3,35,78,113
p_157,12,0,e_2,427,428,506,9,5,2,12,2,1,3,1,78,79
p_202,13,0,e_2,365,435,506,26,4,4,5,4,1,2,70,71,141
p_180,14,0,e_2,396,440,506,17,2,2,3,5,0,4,44,66,110
p_158,14,0,e_2,426,440,506,8,5,0,12,5,1,4,14,66,80
p_168,15,0,e_2,412,445,506,12,4,0,8,5,1,4,33,61,94
p_145,12,0,e_2,451,456,506,5,4,2,13,4,1,4,5,50,55
p_152,10,0,e_2,439,464,506,8,4,3,14,2,1,3,25,42,67
p_146,10,0,e_2,451,464,506,7,4,2,13,4,1,4,13,42,55
p_154,7,0,e_2,438,475,506,11,4,3,14,5,1,3,37,31,68
p_132,7,0,e_2,463,475,506,8,4,1,10,1,1,3,12,31,43
p_126,6,0,e_2,473,480,506,6,5,2,7,4,1,3,7,26,33
p_125,4,0,e_2,474,488,506,8,5,2,7,1,1,3,14,18,32
p_171,3,0,e_3,408,413,516,23,3,3,2,5,0,3,5,103,108
p_179,6,0,e_3,397,424,516,25,2,2,1,4,1,1,27,92,119
p_173,10,0,e_3,405,438,516,17,2,1,1,5,0,2,33,78,111
p_170,10,0,e_3,408,438,516,16,4,1,2,5,0,4,30,78,108
p_169,11,0,e_3,410,443,516,15,4,1,2,5,0,4,33,73,106
p_161,13,0,e_3,418,451,516,11,5,1,4,5,1,4,33,65,98
p_190,14,0,e_3,382,456,516,21,2,2,5,1,1,1,74,60,134
p_172,14,0,e_3,405,456,516,13,3,0,1,5,0,3,51,60,111
p_165,14,0,e_3,416,456,516,10,5,0,4,5,1,4,40,60,100
p_162,14,0,e_3,417,456,516,10,5,0,4,5,1,4,39,60,99
p_151,15,0,e_3,443,461,516,4,3,0,11,5,1,2,18,55,73
p_149,15,0,e_3,444,461,516,4,4,0,11,5,1,3,17,55,72
p_142,15,0,e_3,452,461,516,2,4,0,13,5,1,3,9,55,64
p_141,15,0,e_3,455,461,516,1,4,0,14,2,1,3,6,55,61
p_140,13,0,e_3,455,469,516,3,3,1,14,2,1,2,14,47,61
p_199,2,0,e_0,368,428,520,6,4,1,12,4,1,1,60,92,152
p_185,2,0,e_0,392,428,520,30,3,3,7,4,1,1,36,92,128
p_175,2,0,e_0,399,428,520,29,3,3,5,4,1,2,29,92,121
p_174,3,0,e_0,402,433,520,25,2,2,4,4,1,2,31,87,118
p_184,5,0,e_0,393,441,520,27,3,3,7,4,1,1,48,79,127
p_182,5,0,e_0,394,441,520,27,3,3,6,4,1,2,47,79,126
p_176,6,0,e_0,398,446,520,25,3,3,5,1,1,1,48,74,122
p_160,10,0,e_0,421,460,520,13,6,3,0,5,0,4,39,60,99
p_159,11,0,e_0,424,465,520,11,5,2,1,5,0,5,41,55,96
p_134,12,0,e_0,462,470,520,3,4,1,10,5,1,3,8,50,58
p_128,10,0,e_0,471,478,520,3,4,0,12,4,1,3,7,42,49
p_121,9,0,e_0,480,483,520,1,5,0,10,4,1,3,3,37,40
p_129,5,0,e_0,470,497,520,8,4,2,12,4,1,2,27,23,50
p_122,5,0,e_0,477,497,520,6,5,2,10,1,1,3,20,23,43
p_119,5,0,e_0,483,497,520,4,4,1,9,4,1,3,14,23,37
p_114,9,0,e_1,494,521,610,27,5,5,0,5,0,4,27,89,116
p_120,10,0,e_1,481,526,610,29,5,5,3,4,1,3,45,84,129
p_115,10,0,e_1,494,526,610,26,5,5,0,5,0,5,32,84,116
p_97,10,0,e_1,526,528,610,14,6,1,10,5,1,4,2,82,84
p_123,12,0,e_1,474,536,610,30,5,5,4,4,1,3,62,74,136
p_124,14,0,e_1,474,544,610,28,5,5,4,4,1,4,70,66,136
p_127,15,0,e_1,473,549,610,27,5,5,5,4,1,2,76,61,137
p_112,15,0,e_1,497,549,610,20,5,5,1,5,0,5,52,61,113
p_111,15,0,e_1,501,549,610,19,5,5,3,5,0,5,48,61,109
p_87,15,0,e_1,539,549,610,9,5,0,13,5,1,5,10,61,71
p_79,14,0,e_1,549,554,610,5,5,0,15,4,1,4,5,56,61
p_94,6,0,e_1,528,580,610,17,6,4,10,5,1,5,52,30,82
p_80,6,0,e_1,548,580,610,12,5,3,15,2,1,4,32,30,62
p_77,6,0,e_1,557,580,610,10,4,1,13,4,1,4,23,30,53
p_96,5,0,e_1,527,585,610,18,6,4,10,2,1,4,58,25,83
p_110,1,0,e_0,501,525,624,3,5,1,4,1,1,2,24,99,123
p_107,1,0,e_0,512,525,624,30,5,5,2,4,1,4,13,99,112
p_102,2,0,e_0,521,530,624,23,5,4,0,5,0,4,9,94,103
p_148,3,0,e_0,447,535,624,15,4,3,6,5,1,2,88,89,177
p_144,4,0,e_0,451,540,624,13,4,2,7,5,1,3,89,84,173
p_118,4,0,e_0,488,540,624,4,5,1,8,4,1,3,52,84,136
p_98,6,0,e_0,524,548,624,18,6,4,1,2,0,5,24,76,100
p_93,7,0,e_0,529,553,624,16,6,3,2,2,1,5,24,71,95
p_113,11,0,e_0,496,567,624,25,5,5,5,1,1,2,71,57,128
p_74,11,0,e_0,567,569,624,4,4,1,11,5,1,2,2,55,57
p_101,12,0,e_0,521,574,624,13,5,1,0,5,0,5,53,50,103
p_67,8,0,e_0,574,588,624,8,4,1,12,4,1,3,14,36,50
p_73,6,0,e_0,568,596,624,9,4,1,11,2,1,2,28,28,56
p_57,6,0,e_0,587,596,624,7,7,3,8,1,1,4,9,28,37
p_61,5,0,e_0,583,601,624,9,4,2,9,4,1,4,18,23,41
p_156,1,0,e_2,428,511,626,20,5,4,12,5,1,4,83,115,198
p_150,3,0,e_2,444,519,626,16,4,3,15,2,1,3,75,107,182
p_108,5,0,e_2,509,527,626,27,4,4,1,5,0,5,18,99,117
p_95,6,0,e_2,527,532,626,17,6,4,5,5,1,4,5,94,99
p_116,7,0,e_2,490,537,626,30,4,4,4,4,1,2,47,89,136
p_89,7,0,e_2,537,539,626,14,5,3,7,5,1,4,2,87,89
p_117,12,0,e_2,490,556,626,25,4,4,4,4,1,3,66,70,136
p_109,14,0,e_2,506,564,626,18,5,5,0,5,0,4,58,62,120
p_88,14,0,e_2,538,564,626,8,5,0,7,2,1,4,26,62,88
p_69,10,0,e_2,573,578,626,6,4,1,11,4,1,3,5,48,53
p_63,8,0,e_2,581,586,626,6,4,1,9,4,1,3,5,40,45
p_76,7,0,e_2,559,591,626,8,4,1,13,5,1,3,32,35,67
p_59,6,0,e_2,584,596,626,8,4,1,8,4,1,4,12,30,42
p_54,6,0,e_2,590,596,626,6,6,2,7,1,1,4,6,30,36
p_45,5,0,e_2,597,601,626,6,7,3,6,4,1,3,4,25,29
p_143,2,0,e_3,451,524,638,15,3,2,13,5,1,2,73,114,187
p_136,2,0,e_3,460,524,638,13,3,0,15,2,1,2,64,114,178
p_105,4,0,e_3,515,532,638,4,4,4,0,3,1,4,17,106,123
p_135,7,0,e_3,461,543,638,8,3,1,15,4,1,2,82,95,177
p_104,7,0,e_3,516,543,638,19,5,2,0,5,0,5,27,95,122
p_131,9,0,e_3,467,551,638,4,4,0,13,4,1,3,84,87,171
p_130,9,0,e_3,469,551,638,4,4,0,13,4,1,3,82,87,169
p_100,10,0,e_3,522,556,638,14,5,1,2,5,0,5,34,82,116
p_139,13,0,e_3,456,567,638,3,4,1,14,5,1,3,111,71,182
p_137,13,0,e_3,458,567,638,3,4,1,14,5,1,3,109,71,180
p_103,13,0,e_3,517,567,638,13,5,0,0,5,0,5,50,71,121
p_92,13,0,e_3,533,567,638,9,5,0,4,5,1,4,34,71,105
p_91,13,0,e_3,535,567,638,8,5,0,5,5,1,4,32,71,103
p_75,14,0,e_3,563,572,638,2,4,0,12,5,1,3,9,66,75
p_72,15,0,e_3,569,577,638,2,4,0,13,5,1,3,8,61,69
p_64,1,0,e_1,579,615,726,14,5,4,6,1,1,3,36,111,147
p_51,1,0,e_1,591,615,726,11,6,4,4,4,1,4,24,111,135
p_56,2,0,e_1,588,620,726,10,7,4,4,4,1,3,32,106,138
p_48,2,0,e_1,593,620,726,9,7,4,3,4,1,4,27,106,133
p_85,3,0,e_1,542,625,726,16,5,3,14,5,1,5,83,101,184
p_84,3,0,e_1,546,625,726,15,5,3,14,5,1,5,79,101,180
p_82,3,0,e_1,547,625,726,15,5,3,15,5,1,5,78,101,179
p_106,4,0,e_1,512,630,726,27,5,5,6,5,0,5,118,96,214
p_38,4,0,e_1,627,630,726,29,8,8,3,5,1,3,3,96,99
p_83,5,0,e_1,546,635,726,13,5,3,14,5,1,5,89,91,180
p_62,5,0,e_1,582,635,726,9,4,2,6,4,1,4,53,91,144
p_37,7,0,e_1,633,643,726,24,8,8,5,5,1,2,10,83,93
p_41,10,0,e_1,600,654,726,30,7,7,2,4,1,4,54,72,126
p_36,11,0,e_1,635,659,726,20,8,8,5,5,1,2,24,67,91
p_34,15,0,e_1,643,673,726,14,7,0,7,5,1,3,30,53,83
p_81,2,0,e_0,547,632,732,16,5,3,6,2,1,3,85,100,185
p_71,2,0,e_0,569,632,732,13,4,1,11,5,1,3,63,100,163
p_70,3,0,e_0,572,637,732,13,4,1,12,5,1,3,65,95,160
p_42,4,0,e_0,600,642,732,6,7,2,5,1,1,4,42,90,132
p_49,5,0,e_0,592,647,732,7,7,4,7,4,1,4,55,85,140
p_46,13,0,e_0,596,673,732,28,7,7,6,4,1,3,77,59,136
p_44,15,0,e_0,598,681,732,25,8,8,6,4,1,4,83,51,134
p_29,15,0,e_0,678,681,732,5,4,0,14,5,1,2,3,51,54
p_30,5,0,e_0,676,713,732,13,4,3,14,5,1,1,37,19,56
p_27,2,0,e_0,693,724,732,16,1,0,11,4,1,1,31,8,39
p_99,1,0,e_2,522,631,734,23,5,4,4,5,1,4,109,103,212
p_90,2,0,e_2,536,636,734,19,5,4,7,2,1,3,100,98,198
p_43,3,0,e_2,599,641,734,7,7,3,5,4,1,4,42,93,135
p_55,4,0,e_2,590,646,734,8,6,3,7,1,1,3,56,88,144
p_40,4,0,e_2,601,646,734,6,7,2,5,4,1,4,45,88,133
p_33,8,0,e_2,647,660,734,17,7,5,4,5,1,1,13,74,87
p_39,15,0,e_2,609,683,734,23,8,8,3,4,1,4,74,51,125
p_25,7,0,e_2,703,709,734,4,2,0,9,4,1,1,6,25,31
p_31,5,0,e_2,662,717,734,17,6,5,8,5,1,1,55,17,72
p_23,5,0,e_2,709,717,734,4,3,0,7,4,1,1,8,17,25
p_78,4,0,e_3,555,652,742,12,3,1,10,2,1,2,97,90,187
p_86,6,0,e_3,541,660,742,13,5,3,7,5,1,4,119,82,201
p_47,6,0,e_3,594,660,742,5,7,2,11,1,1,6,66,82,148
p_60,9,0,e_3,584,671,742,5,4,1,14,4,1,3,87,71,158
p_53,9,0,e_3,590,671,742,3,6,1,12,4,1,5,81,71,152
p_58,10,0,e_3,586,676,742,3,6,1,13,4,1,5,90,66,156
p_50,10,0,e_3,592,676,742,2,7,1,12,4,1,6,84,66,150
p_52,11,0,e_3,591,681,742,1,6,0,12,4,1,5,90,61,151
p_66,12,0,e_3,577,686,742,3,4,1,15,4,1,3,109,56,165
p_65,12,0,e_3,578,686,742,3,5,1,15,4,1,4,108,56,164
p_68,14,0,e_3,574,694,742,2,4,1,14,5,1,3,120,48,168
p_24,5,0,e_3,707,723,742,5,2,0,10,4,1,1,16,19,35
p_26,3,0,e_3,698,731,742,10,1,0,13,4,1,0,33,11,44
p_35,4,0,e_1,640,740,770,24,7,6,6,5,1,3,100,30,130
p_32,5,0,e_1,657,745,770,18,7,6,11,5,1,3,88,25,113
p_28,6,0,e_1,679,750,770,11,4,2,13,4,1,2,71,20,91
p_20,9,0,e_2,737,767,796,22,1,1,0,3,0,0,30,29,59
p_22,10,0,e_0,712,764,810,28,3,3,5,1,1,1,52,46,98
p_21,10,0,e_0,732,764,810,23,1,1,0,5,0,1,32,46,78
p_19,12,0,e_0,740,772,810,18,1,1,2,5,0,1,32,38,70
p_18,2,0,e_3,768,777,859,2,0,0,0,3,0,0,9,82,91
p_13,11,0,e_3,794,806,859,8,2,1,7,5,1,1,12,53,65
p_16,13,0,e_3,774,814,859,12,1,0,1,5,0,1,40,45,85
p_9,2,0,e_3,845,849,859,1,1,0,3,4,1,0,4,10,14
p_8,1,0,e_3,847,854,859,1,2,0,2,4,1,1,7,5,12
p_10,14,0,e_1,810,817,869,2,2,0,12,5,0,1,7,52,59
p_17,15,0,e_1,772,822,869,14,1,0,0,3,0,0,50,47,97
p_15,15,0,e_1,782,822,869,12,2,0,3,5,0,1,40,47,87
p_14,15,0,e_1,790,822,869,9,2,0,5,5,0,1,32,47,79
p_12,13,0,e_2,796,838,881,5,3,0,0,3,0,0,42,43,85
p_5,5,0,e_2,860,864,881,23,1,1,6,4,1,0,4,17,21
p_11,11,0,e_0,810,846,883,3,2,1,0,3,0,0,36,37,73
p_4,1,0,e_0,864,878,883,26,1,1,5,4,1,0,14,5,19
p_1,2,0,e_0,889,898,906,16,2,1,0,3,0,0,9,8,17
p_7,12,0,e_1,851,907,947,20,2,2,6,4,1,0,56,40,96
p_3,1,0,e_1,876,942,947,22,1,1,2,5,0,1,66,5,71
p_6,14,0,e_3,858,903,949,14,0,0,0,3,1,0,45,46,91
p_2,3,0,e_3,878,938,949,19,1,1,6,5,0,1,60,11,71
p_299,3,0,e_1,7,19,30,3,0,0,0,3,0,0,12,11,23
p_296,1,0,e_3,20,26,31,1,0,0,0,3,0,0,6,5,11
p_298,4,0,e_2,10,25,47,4,0,0,0,3,0,0,15,22,37
p_295,5,0,e_2,22,30,47,5,1,0,3,5,0,1,8,17,25
p_290,4,0,e_3,43,50,88,6,1,1,2,5,0,1,7,38,45
p_291,6,0,e_3,35,58,88,6,0,0,0,3,0,0,23,30,53
p_289,7,0,e_3,47,63,88,4,2,0,3,5,0,2,16,25,41
p_279,2,0,e_3,76,80,88,1,1,0,3,4,1,0,4,8,12
p_288,1,0,e_2,49,55,98,3,2,2,0,3,0,0,6,43,49
p_285,2,0,e_2,54,60,98,7,3,2,1,2,0,1,6,38,44
p_286,3,0,e_2,51,65,98,7,3,2,0,5,0,1,14,33,47
p_282,6,0,e_2,62,76,98,13,1,0,2,5,1,1,14,22,36
p_275,2,0,e_2,84,90,98,29,3,3,4,4,1,0,6,8,14
p_300,8,0,e_0,4,31,109,8,0,0,0,3,0,0,27,78,105
p_297,12,0,e_0,18,45,109,12,0,0,4,5,0,1,27,64,91
p_294,13,0,e_0,23,50,109,13,1,0,6,5,0,2,27,59,86
p_293,15,0,e_0,26,58,109,16,1,1,7,5,0,3,32,51,83
p_284,14,0,e_0,55,63,109,9,3,0,14,5,1,2,8,46,54
p_287,12,0,e_0,51,71,109,8,3,0,13,5,1,1,20,38,58
p_280,12,0,e_0,65,71,109,25,1,1,14,4,1,1,6,38,44
p_283,10,0,e_1,55,63,109,5,3,0,8,5,0,1,8,46,54
p_281,10,0,e_1,63,65,109,27,1,1,10,5,1,1,2,44,46
p_292,11,0,e_1,30,70,109,11,0,0,0,3,0,0,40,39,79
p_276,5,0,e_1,82,90,109,27,3,3,7,4,1,0,8,19,27
p_274,4,0,e_1,84,95,109,27,3,3,7,4,1,1,11,14,25
p_267,1,0,e_2,153,159,164,10,2,1,0,3,0,0,6,5,11
p_277,10,0,e_3,81,120,194,22,2,2,2,4,1,1,39,74,113
p_273,13,0,e_3,95,131,194,15,2,1,2,5,0,2,36,63,99
p_278,15,0,e_3,80,139,194,17,1,1,2,4,1,0,59,55,114
p_272,15,0,e_3,105,139,194,10,3,0,5,5,0,3,34,55,89
p_271,11,0,e_3,127,153,194,7,3,2,12,5,1,2,26,41,67
p_268,10,0,e_3,150,158,194,2,2,1,12,4,1,1,8,36,44
p_262,6,0,e_3,164,172,194,2,2,0,8,4,1,1,8,22,30
p_264,5,0,e_3,162,177,194,4,1,0,9,4,1,0,15,17,32
p_269,4,0,e_1,146,161,233,9,2,1,0,3,0,0,15,72,87
p_265,12,0,e_1,157,187,233,28,1,1,3,5,0,1,30,46,76
p_263,12,0,e_1,163,187,233,27,2,2,4,5,1,1,24,46,70
p_261,12,0,e_1,170,187,233,24,3,3,7,5,1,1,17,46,63
p_260,13,0,e_1,171,192,233,23,2,2,7,5,1,1,21,41,62
p_258,5,0,e_2,175,192,233,30,2,2,0,5,0,1,17,41,58
p_259,6,0,e_2,174,197,233,30,2,2,0,3,0,0,23,36,59
p_256,8,0,e_2,191,205,233,23,1,1,5,2,0,1,14,28,42
p_252,2,0,e_2,212,225,233,25,2,1,6,4,1,0,13,8,21
p_270,7,0,e_0,133,157,234,10,3,1,0,3,0,0,24,77,101
p_266,15,0,e_0,155,183,234,26,2,2,7,5,0,1,28,51,79
p_257,12,0,e_0,179,194,234,23,1,1,14,5,1,1,15,40,55
p_255,10,0,e_0,192,202,234,20,1,1,12,4,1,1,10,32,42
p_249,7,0,e_1,238,262,285,11,3,1,0,3,0,0,24,23,47
p_244,2,0,e_2,271,280,288,7,2,1,0,3,0,0,9,8,17
p_254,3,0,e_3,199,211,300,3,0,0,0,3,0,0,12,89,101
p_253,15,0,e_3,208,249,300,13,1,0,2,5,0,1,41,51,92
p_246,12,0,e_3,257,260,300,1,2,0,13,4,1,1,3,40,43
p_251,4,0,e_3,228,286,300,18,2,1,8,5,1,1,58,14,72
p_250,7,0,e_0,236,260,319,12,3,1,0,3,0,0,24,59,83
p_248,7,0,e_0,246,260,319,9,3,1,3,5,0,1,14,59,73
p_247,12,0,e_0,248,277,319,19,2,0,3,5,0,1,29,42,71
p_245,9,0,e_0,269,288,319,30,2,2,10,5,1,1,19,31,50
p_243,8,0,e_0,285,293,319,26,1,1,10,4,1,1,8,26,34
p_233,2,0,e_0,319,328,362,13,2,2,0,3,0,0,9,34,43
p_232,5,0,e_0,320,339,362,9,2,1,0,5,0,1,19,23,42
p_230,5,0,e_0,323,339,362,8,2,1,1,5,0,2,16,23,39
p_221,4,0,e_0,341,344,362,6,2,1,5,4,1,1,3,18,21
p_222,3,0,e_0,339,349,362,8,3,2,5,4,1,0,10,13,23
p_216,1,0,e_0,346,357,362,8,2,0,4,4,1,1,11,5,16
p_205,1,0,e_0,362,368,373,5,3,2,0,3,0,0,6,5,11
p_237,5,0,e_3,313,331,384,5,0,0,0,3,0,0,18,53,71
p_235,8,0,e_3,314,342,384,8,1,0,0,5,0,1,28,42,70
p_229,9,0,e_3,323,347,384,6,2,0,3,5,0,2,24,37,61
p_227,9,0,e_3,326,347,384,5,3,0,4,5,0,3,21,37,58
p_220,9,0,e_3,342,347,384,1,2,0,8,5,1,1,5,37,42
p_218,9,0,e_3,343,347,384,1,2,0,8,5,1,1,4,37,41
p_217,8,0,e_3,345,352,384,1,2,0,9,5,1,1,7,32,39
p_215,6,0,e_3,346,360,384,3,3,0,9,2,1,2,14,24,38
p_214,4,0,e_3,346,368,384,5,2,0,9,2,1,1,22,16,38
p_210,4,0,e_3,353,368,384,4,3,1,8,4,1,2,15,16,31
p_209,2,0,e_3,354,376,384,6,3,2,8,4,1,2,22,8,30
p_199,2,0,e_3,368,376,384,2,2,0,4,4,1,1,8,8,16
p_242,4,0,e_1,287,302,390,30,1,1,0,3,0,0,15,88,103
p_241,13,0,e_1,300,331,390,13,0,0,4,5,0,1,31,59,90
p_239,13,0,e_1,305,331,390,13,0,0,5,5,1,2,26,59,85
p_240,14,0,e_1,301,336,390,14,0,0,4,3,0,1,35,54,89
p_234,14,0,e_1,314,336,390,14,2,0,8,5,1,2,22,54,76
p_224,13,0,e_1,335,341,390,7,3,0,14,2,1,2,6,49,55
p_226,12,0,e_1,331,346,390,7,3,0,13,5,1,2,15,44,59
p_228,11,0,e_1,325,351,390,8,3,0,11,5,1,2,26,39,65
p_219,11,0,e_1,342,351,390,3,2,0,13,4,1,2,9,39,48
p_212,9,0,e_1,348,359,390,30,4,4,12,4,1,1,11,31,42
p_206,6,0,e_1,362,370,390,30,3,3,8,4,1,0,8,20,28
p_238,2,0,e_2,311,320,432,2,0,0,0,3,0,0,9,112,121
p_236,8,0,e_2,313,340,432,8,1,1,0,5,0,1,27,92,119
p_231,10,0,e_2,320,348,432,8,2,0,2,5,1,1,28,84,112
p_225,10,0,e_2,333,348,432,5,3,0,6,5,1,2,15,84,99
p_213,12,0,e_2,347,356,432,27,4,4,10,2,1,1,9,76,85
p_207,12,0,e_2,355,356,432,25,4,4,12,2,1,2,1,76,77
p_223,13,0,e_2,339,363,432,6,3,0,8,2,1,1,24,69,93
p_208,13,0,e_2,355,363,432,24,4,4,12,2,1,3,8,69,77
p_211,14,0,e_2,348,368,432,25,4,4,10,5,1,2,20,64,84
p_202,13,0,e_2,365,373,432,22,3,3,13,5,1,3,8,59,67
p_201,13,0,e_2,366,373,432,21,3,3,14,5,1,4,7,59,66
p_203,12,0,e_2,365,378,432,23,3,3,13,5,1,2,13,54,67
p_200,12,0,e_2,367,378,432,22,2,2,14,2,1,3,11,54,65
p_194,11,0,e_2,377,383,432,21,1,1,12,1,1,2,6,49,55
p_198,9,0,e_2,368,391,432,25,2,2,14,4,1,3,23,41,64
p_185,2,0,e_3,392,401,483,2,0,0,0,3,0,0,9,82,91
p_178,5,0,e_3,398,412,483,4,1,0,1,5,0,1,14,71,85
p_167,7,0,e_3,412,420,483,8,3,2,5,5,1,2,8,63,71
p_177,9,0,e_3,398,428,483,8,2,0,1,5,0,2,30,55,85
p_173,10,0,e_3,405,433,483,7,3,0,3,5,1,2,28,50,78
p_170,10,0,e_3,408,433,483,6,4,0,4,5,1,3,25,50,75
p_160,10,0,e_3,421,433,483,3,5,0,7,5,1,4,12,50,62
p_159,11,0,e_3,424,438,483,3,5,0,8,5,1,4,14,45,59
p_153,8,0,e_3,438,449,483,3,4,0,11,4,1,3,11,34,45
p_154,7,0,e_3,438,454,483,4,3,0,11,4,1,2,16,29,45
p_166,5,0,e_3,415,462,483,9,4,3,6,5,1,3,47,21,68
p_163,4,0,e_3,417,467,483,10,5,3,6,5,1,4,50,16,66
p_133,4,0,e_3,463,467,483,1,3,0,5,4,1,2,4,16,20
p_136,2,0,e_3,460,475,483,3,3,1,5,4,1,2,15,8,23
p_186,1,0,e_1,391,397,484,1,0,0,0,3,0,0,6,87,93
p_184,5,0,e_1,393,411,484,5,1,0,0,5,0,1,18,73,91
p_181,11,0,e_1,395,431,484,11,1,0,1,5,0,2,36,53,89
p_169,11,0,e_1,410,431,484,6,4,0,5,2,1,1,21,53,74
p_164,12,0,e_1,416,436,484,6,5,0,6,5,1,1,20,48,68
p_157,12,0,e_1,427,436,484,3,5,0,10,5,1,2,9,48,57
p_152,10,0,e_1,439,444,484,1,5,0,11,4,1,2,5,40,45
p_147,7,0,e_1,450,455,484,1,4,0,8,4,1,2,5,29,34
p_144,4,0,e_1,451,466,484,4,4,2,8,4,1,3,15,18,33
p_155,3,0,e_1,434,471,484,9,4,1,12,5,1,2,37,13,50
p_150,3,0,e_1,444,471,484,6,5,4,10,4,1,2,27,13,40
p_148,3,0,e_1,447,471,484,5,5,3,9,4,1,2,24,13,37
p_156,1,0,e_1,428,479,484,12,5,2,10,5,1,2,51,5,56
p_196,5,0,e_0,376,394,485,27,1,1,0,3,0,0,18,91,109
p_193,12,0,e_0,378,417,485,20,1,1,0,5,0,1,39,68,107
p_183,12,0,e_0,393,417,485,12,1,0,5,2,0,2,24,68,92
p_161,13,0,e_0,418,422,485,6,6,0,12,5,1,2,4,63,67
p_190,14,0,e_0,382,427,485,16,1,1,1,5,0,2,45,58,103
p_180,14,0,e_0,396,427,485,13,1,0,5,5,1,2,31,58,89
p_172,14,0,e_0,405,427,485,11,4,0,8,5,1,2,22,58,80
p_165,14,0,e_0,416,427,485,8,5,0,12,2,1,2,11,58,69
p_162,14,0,e_0,417,427,485,8,6,0,12,5,1,2,10,58,68
p_158,14,0,e_0,426,427,485,5,6,0,14,2,1,1,1,58,59
p_168,15,0,e_0,412,434,485,10,4,0,11,5,1,2,22,51,73
p_138,7,0,e_0,456,460,485,30,3,3,8,4,1,1,4,25,29
p_143,2,0,e_0,451,477,485,6,4,3,10,4,1,0,26,8,34
p_118,4,0,e_0,488,503,563,4,0,0,0,3,0,0,15,60,75
p_114,9,0,e_0,494,520,563,9,0,0,1,5,0,1,26,43,69
p_104,7,0,e_0,516,528,563,6,1,1,8,5,1,4,12,35,47
p_98,6,0,e_0,524,533,563,11,2,2,8,4,1,5,9,30,39
p_95,6,0,e_0,527,533,563,10,3,1,7,1,1,5,6,30,36
p_94,6,0,e_0,528,533,563,10,2,1,7,4,1,5,5,30,35
p_108,5,0,e_0,509,538,563,11,1,1,6,5,1,2,29,25,54
p_96,5,0,e_0,527,538,563,11,3,1,7,1,1,5,11,25,36
p_106,4,0,e_0,512,543,563,11,1,1,7,5,1,3,31,20,51
p_105,4,0,e_0,515,543,563,10,1,1,8,5,1,4,28,20,48
p_85,3,0,e_0,542,548,563,14,3,2,4,1,1,2,6,15,21
p_102,2,0,e_0,521,553,563,16,2,2,9,4,1,4,32,10,42
p_90,2,0,e_0,536,553,563,12,2,1,5,4,1,4,17,10,27
p_81,2,0,e_0,547,553,563,14,2,1,3,1,1,2,6,10,16
p_110,1,0,e_0,501,558,563,17,1,1,4,5,0,2,57,5,62
p_175,2,0,e_2,399,440,572,14,3,2,7,4,1,4,41,132,173
p_174,3,0,e_2,402,445,572,13,3,2,7,4,1,5,43,127,170
p_171,3,0,e_2,408,445,572,13,4,3,6,4,1,6,37,127,164
p_192,5,0,e_2,380,453,572,26,1,1,12,4,1,3,73,119,192
p_182,5,0,e_2,394,453,572,5,1,0,8,4,1,3,59,119,178
p_179,6,0,e_2,397,458,572,5,1,0,8,4,1,3,61,114,175
p_176,6,0,e_2,398,458,572,5,2,0,8,4,1,4,60,114,174
p_191,7,0,e_2,382,463,572,23,1,1,11,1,1,3,81,109,190
p_189,7,0,e_2,387,463,572,7,0,0,10,4,1,4,76,109,185
p_187,7,0,e_2,391,463,572,7,0,0,9,4,1,3,72,109,181
p_135,7,0,e_2,461,463,572,28,3,3,7,5,1,7,2,109,111
p_132,7,0,e_2,463,465,572,28,3,3,7,5,1,6,2,107,109
p_204,8,0,e_2,364,470,572,27,3,3,13,5,1,1,106,102,208
p_197,8,0,e_2,375,470,572,24,1,1,13,4,1,3,95,102,197
p_188,8,0,e_2,390,470,572,8,0,0,9,1,1,3,80,102,182
p_119,5,0,e_1,483,501,592,5,0,0,0,3,1,0,18,91,109
p_116,7,0,e_1,490,509,592,7,0,0,2,5,0,1,19,83,102
p_117,12,0,e_1,490,526,592,12,0,0,2,5,0,2,36,66,102
p_101,12,0,e_1,521,526,592,6,2,1,11,5,1,2,5,66,71
p_109,14,0,e_1,506,534,592,11,1,0,6,5,1,2,28,58,86
p_91,13,0,e_1,535,539,592,1,2,0,14,4,1,0,4,53,57
p_89,7,0,e_1,537,559,592,7,2,1,13,4,1,1,22,33,55
p_80,6,0,e_1,548,564,592,9,2,0,10,4,1,2,16,28,44
p_77,6,0,e_1,557,564,592,7,1,0,7,4,1,4,7,28,35
p_78,4,0,e_1,555,572,592,10,1,0,8,4,1,3,17,20,37
p_82,3,0,e_1,547,577,592,13,2,1,11,4,1,1,30,15,45
p_70,3,0,e_1,572,577,592,5,3,2,4,4,1,2,5,15,20
p_71,2,0,e_1,569,582,592,7,3,2,5,4,1,2,13,10,23
p_64,1,0,e_1,579,587,592,5,2,0,3,4,1,1,8,5,13
p_115,10,0,e_3,494,527,605,10,0,0,0,3,0,0,33,78,111
p_97,10,0,e_3,526,527,605,6,1,1,10,2,0,1,1,78,79
p_103,13,0,e_3,517,540,605,6,1,0,7,5,0,1,23,65,88
p_92,13,0,e_3,533,540,605,2,2,0,11,5,1,1,7,65,72
p_88,14,0,e_3,538,545,605,1,2,0,13,5,1,1,7,60,67
p_87,15,0,e_3,539,550,605,2,2,0,13,2,1,1,11,55,66
p_76,7,0,e_3,559,576,605,5,1,0,12,4,1,0,17,29,46
p_73,6,0,e_3,568,581,605,3,2,1,9,4,1,1,13,24,37
p_62,5,0,e_3,582,586,605,1,1,0,6,4,1,0,4,19,23
p_61,5,0,e_3,583,586,605,1,2,0,6,4,1,1,3,19,22
p_56,2,0,e_3,588,597,605,3,1,0,5,4,1,0,9,8,17
p_48,2,0,e_3,593,597,605,1,2,0,3,4,1,1,4,8,12
p_38,4,0,e_3,627,642,656,4,0,0,0,3,0,0,15,14,29
p_35,4,0,e_3,640,642,656,0,1,0,4,5,0,1,2,14,16
p_107,1,0,e_0,512,568,677,14,1,1,7,5,1,3,56,109,165
p_99,1,0,e_0,522,568,677,16,2,2,9,4,1,5,46,109,155
p_67,8,0,e_0,574,591,677,29,3,3,3,5,1,4,17,86,103
p_63,8,0,e_0,581,591,677,28,1,1,5,5,1,6,10,86,96
p_60,9,0,e_0,584,596,677,26,2,2,6,5,1,7,12,81,93
p_53,9,0,e_0,590,596,677,25,2,2,8,2,1,8,6,81,87
p_69,10,0,e_0,573,601,677,28,3,3,2,5,1,3,28,76,104
p_58,10,0,e_0,586,601,677,25,1,1,7,5,1,8,15,76,91
p_74,11,0,e_0,567,606,677,29,2,2,1,2,0,1,39,71,110
p_66,12,0,e_0,577,611,677,25,2,2,4,5,1,5,34,66,100
p_65,12,0,e_0,578,611,677,25,2,2,4,5,1,6,33,66,99
p_46,13,0,e_0,596,616,677,19,1,1,9,5,1,7,20,61,81
p_79,14,0,e_0,549,621,677,29,1,0,3,4,1,2,72,56,128
p_75,14,0,e_0,563,621,677,27,2,2,0,5,0,2,58,56,114
p_68,14,0,e_0,574,621,677,23,3,3,3,5,1,5,47,56,103
p_51,1,0,e_1,591,597,680,3,2,1,0,3,1,0,6,83,89
p_43,3,0,e_1,599,605,680,29,1,1,1,5,1,4,6,75,81
p_42,4,0,e_1,600,610,680,27,1,1,2,5,1,5,10,70,80
p_40,4,0,e_1,601,610,680,27,1,1,2,5,1,6,9,70,79
p_49,5,0,e_1,592,615,680,28,2,2,0,5,0,2,23,65,88
p_45,5,0,e_1,597,615,680,27,1,1,1,5,1,4,18,65,83
p_47,6,0,e_1,594,620,680,27,2,2,0,5,0,4,26,60,86
p_50,10,0,e_1,592,634,680,23,2,2,0,5,0,3,42,46,88
p_41,10,0,e_1,600,634,680,21,1,1,2,5,1,6,34,46,80
p_52,11,0,e_1,591,639,680,23,2,2,0,3,1,1,48,41,89
p_36,11,0,e_1,635,639,680,9,1,0,10,5,1,2,4,41,45
p_33,8,0,e_1,647,650,680,25,2,2,9,4,1,1,3,30,33
p_37,7,0,e_1,633,655,680,6,1,0,10,2,1,1,22,25,47
p_32,5,0,e_1,657,663,680,25,1,1,7,4,1,0,6,17,23
p_84,3,0,e_2,546,583,700,13,2,1,6,4,1,10,37,117,154
p_125,4,0,e_2,474,588,700,28,1,1,9,2,1,6,114,112,226
p_129,5,0,e_2,470,593,700,28,2,2,8,5,1,5,123,107,230
p_122,5,0,e_2,477,593,700,27,1,1,9,5,1,8,116,107,223
p_83,5,0,e_2,546,593,700,11,2,1,6,4,1,11,47,107,154
p_126,6,0,e_2,473,598,700,26,2,2,9,5,1,6,125,102,227
p_86,6,0,e_2,541,598,700,11,3,2,7,4,1,10,57,102,159
p_57,6,0,e_2,587,598,700,29,1,1,4,3,1,10,11,102,113
p_93,7,0,e_2,529,603,700,9,2,1,10,4,1,9,74,97,171
p_195,9,0,e_2,376,611,700,23,1,1,12,4,1,3,235,89,324
p_131,9,0,e_2,467,611,700,25,2,2,7,5,1,6,144,89,233
p_130,9,0,e_2,469,611,700,25,2,2,8,2,1,5,142,89,231
p_121,9,0,e_2,480,611,700,22,1,1,10,5,1,8,131,89,220
p_146,10,0,e_2,451,616,700,28,4,4,5,5,1,6,165,84,249
p_128,10,0,e_2,471,616,700,23,2,2,8,5,1,6,145,84,229
p_28,6,0,e_1,679,700,724,17,1,1,0,3,1,0,21,24,45
p_26,3,0,e_1,698,711,724,13,1,1,6,5,0,2,13,13,26
p_27,2,0,e_1,693,716,724,16,1,1,4,5,0,1,23,8,31
p_34,15,0,e_3,643,703,756,19,1,1,4,4,1,0,60,53,113
p_29,15,0,e_3,678,703,756,8,1,0,7,5,0,1,25,53,78
p_22,10,0,e_3,712,720,756,2,3,0,12,4,1,2,8,36,44
p_25,7,0,e_3,703,731,756,8,1,0,15,4,1,0,28,25,53
p_24,5,0,e_3,707,739,756,9,2,1,14,4,1,1,32,17,49
p_23,5,0,e_3,709,739,756,8,3,1,13,4,1,2,30,17,47
p_55,4,0,e_0,590,691,781,30,2,2,8,2,1,7,101,90,191
p_59,6,0,e_0,584,699,781,29,2,2,6,5,1,6,115,82,197
p_54,6,0,e_0,590,699,781,28,2,2,8,2,1,8,109,82,191
p_72,15,0,e_0,569,728,781,24,3,3,1,5,1,2,159,53,212
p_44,15,0,e_0,598,728,781,17,1,1,9,5,1,8,130,53,183
p_39,15,0,e_0,609,728,781,15,0,0,12,5,1,6,119,53,172
p_21,10,0,e_0,732,745,781,27,2,2,14,4,1,0,13,36,49
p_20,9,0,e_0,737,750,781,26,2,2,12,4,1,1,13,31,44
p_18,2,0,e_0,768,773,781,2,0,0,3,4,1,0,5,8,13
p_31,5,0,e_2,662,717,806,23,1,1,11,4,1,5,55,89,144
p_30,5,0,e_2,676,717,806,19,1,1,7,4,1,7,41,89,130
p_120,10,0,e_2,481,734,806,20,1,1,10,5,1,8,253,72,325
p_100,10,0,e_2,522,734,806,7,2,1,11,1,1,9,212,72,284
p_113,11,0,e_2,496,739,806,11,1,0,14,5,1,8,243,67,310
p_145,12,0,e_2,451,744,806,26,4,4,5,5,1,7,293,62,355
p_134,12,0,e_2,462,744,806,23,3,3,7,2,1,6,282,62,344
p_123,12,0,e_2,474,744,806,20,1,1,9,2,1,7,270,62,332
p_19,12,0,e_2,740,744,806,23,1,1,11,5,1,4,4,62,66
p_140,13,0,e_2,455,749,806,24,3,3,5,5,1,7,294,57,351
p_139,13,0,e_2,456,749,806,24,3,3,6,5,1,8,293,57,350
p_137,13,0,e_2,458,749,806,23,3,3,6,5,1,7,291,57,348
p_124,14,0,e_2,474,754,806,18,1,1,9,2,1,7,280,52,332
p_151,15,0,e_2,443,759,806,25,5,5,3,5,1,6,316,47,363
p_149,15,0,e_2,444,759,806,24,5,5,3,2,1,6,315,47,362
p_8,1,0,e_0,847,851,864,6,1,0,0,5,0,1,4,13,17
p_9,2,0,e_0,845,856,864,6,1,0,0,3,0,0,11,8,19
p_17,15,0,e_1,772,820,867,15,0,0,0,3,0,0,48,47,95
p_15,15,0,e_1,782,820,867,13,1,0,3,5,0,1,38,47,85
p_14,15,0,e_1,790,820,867,10,1,0,5,5,0,1,30,47,77
p_13,11,0,e_3,794,810,869,9,1,1,6,5,0,1,16,59,75
p_11,11,0,e_3,810,812,869,4,2,1,11,5,1,1,2,57,59
p_16,13,0,e_3,774,820,869,13,0,0,0,3,0,0,46,49,95
p_12,13,0,e_3,796,820,869,6,2,0,7,5,0,2,24,49,73
p_10,14,0,e_3,810,825,869,3,3,0,11,5,1,2,15,44,59
p_3,1,0,e_1,876,882,887,1,0,0,0,3,0,0,6,5,11
p_2,3,0,e_3,878,890,901,3,0,0,0,3,0,0,12,11,23
p_1,2,0,e_1,889,898,906,5,0,0,0,3,0,0,9,8,17
p_142,15,0,e_2,452,853,906,22,4,4,5,2,1,7,401,53,454
p_141,15,0,e_2,455,853,906,22,3,3,5,5,1,8,398,53,451
p_127,15,0,e_2,473,853,906,17,2,2,9,5,1,7,380,53,433
p_112,15,0,e_2,497,853,906,15,1,0,14,2,1,9,356,53,409
p_111,15,0,e_2,501,853,906,13,1,0,15,5,1,10,352,53,405
p_7,12,0,e_2,851,864,906,24,1,1,15,5,0,1,13,42,55
p_5,5,0,e_2,860,887,906,28,1,1,13,4,1,1,27,19,46
p_4,1,0,e_2,864,901,906,30,1,1,12,4,1,1,37,5,42
p_6,14,0,e_0,858,908,952,19,1,1,2,4,1,0,50,44,94
p_299,3,0,e_1,7,19,30,3,0,0,0,3,0,0,12,11,23
p_296,1,0,e_3,20,26,31,1,0,0,0,3,0,0,6,5,11
p_298,4,0,e_2,10,25,47,4,0,0,0,3,0,0,15,22,37
p_295,5,0,e_2,22,30,47,5,1,0,3,5,0,1,8,17,25
p_290,4,0,e_3,43,50,88,6,1,1,2,5,0,1,7,38,45
p_291,6,0,e_3,35,58,88,6,0,0,0,3,0,0,23,30,53
p_289,7,0,e_3,47,63,88,4,2,0,3,5,0,2,16,25,41
p_279,2,0,e_3,76,80,88,1,1,0,3,4,1,0,4,8,12
p_288,1,0,e_2,49,55,98,3,2,2,0,3,0,0,6,43,49
p_285,2,0,e_2,54,60,98,7,3,2,1,2,0,1,6,38,44
p_286,3,0,e_2,51,65,98,7,3,2,0,5,0,1,14,33,47
p_282,6,0,e_2,62,76,98,13,1,0,2,5,1,1,14,22,36
p_275,2,0,e_2,84,90,98,29,3,3,4,4,1,0,6,8,14
p_300,8,0,e_0,4,31,109,8,0,0,0,3,0,0,27,78,105
p_297,12,0,e_0,18,45,109,12,0,0,4,5,0,1,27,64,91
p_294,13,0,e_0,23,50,109,13,1,0,6,5,0,2,27,59,86
p_293,15,0,e_0,26,58,109,16,1,1,7,5,0,3,32,51,83
p_284,14,0,e_0,55,63,109,9,3,0,14,5,1,2,8,46,54
p_287,12,0,e_0,51,71,109,8,3,0,13,5,1,1,20,38,58
p_280,12,0,e_0,65,71,109,25,1,1,14,4,1,1,6,38,44
p_283,10,0,e_1,55,63,109,5,3,0,8,5,0,1,8,46,54
p_281,10,0,e_1,63,65,109,27,1,1,10,5,1,1,2,44,46
p_292,11,0,e_1,30,70,109,11,0,0,0,3,0,0,40,39,79
p_276,5,0,e_1,82,90,109,27,3,3,7,4,1,0,8,19,27
p_274,4,0,e_1,84,95,109,27,3,3,7,4,1,1,11,14,25
p_267,1,0,e_2,153,159,164,10,2,1,0,3,0,0,6,5,11
p_277,10,0,e_3,81,120,194,22,2,2,2,4,1,1,39,74,113
p_273,13,0,e_3,95,131,194,15,2,1,2,5,0,2,36,63,99
p_278,15,0,e_3,80,139,194,17,1,1,2,4,1,0,59,55,114
p_272,15,0,e_3,105,139,194,10,3,0,5,5,0,3,34,55,89
p_271,11,0,e_3,127,153,194,7,3,2,12,5,1,2,26,41,67
p_268,10,0,e_3,150,158,194,2,2,1,12,4,1,1,8,36,44
p_262,6,0,e_3,164,172,194,2,2,0,8,4,1,1,8,22,30
p_264,5,0,e_3,162,177,194,4,1,0,9,4,1,0,15,17,32
p_269,4,0,e_1,146,161,233,9,2,1,0,3,0,0,15,72,87
p_265,12,0,e_1,157,187,233,28,1,1,3,5,0,1,30,46,76
p_263,12,0,e_1,163,187,233,27,2,2,4,5,1,1,24,46,70
p_261,12,0,e_1,170,187,233,24,3,3,7,5,1,1,17,46,63
p_260,13,0,e_1,171,192,233,23,2,2,7,5,1,1,21,41,62
p_258,5,0,e_2,175,192,233,30,2,2,0,5,0,1,17,41,58
p_259,6,0,e_2,174,197,233,30,2,2,0,3,0,0,23,36,59
p_256,8,0,e_2,191,205,233,23,1,1,5,2,0,1,14,28,42
p_252,2,0,e_2,212,225,233,25,2,1,6,4,1,0,13,8,21
p_270,7,0,e_0,133,157,234,10,3,1,0,3,0,0,24,77,101
p_266,15,0,e_0,155,183,234,26,2,2,7,5,0,1,28,51,79
p_257,12,0,e_0,179,194,234,23,1,1,14,5,1,1,15,40,55
p_255,10,0,e_0,192,202,234,20,1,1,12,4,1,1,10,32,42
p_249,7,0,e_1,238,262,285,11,3,1,0,3,0,0,24,23,47
p_244,2,0,e_2,271,280,288,7,2,1,0,3,0,0,9,8,17
p_254,3,0,e_3,199,211,300,3,0,0,0,3,0,0,12,89,101
p_253,15,0,e_3,208,249,300,13,1,0,2,5,0,1,41,51,92
p_246,12,0,e_3,257,260,300,1,2,0,13,4,1,1,3,40,43
p_251,4,0,e_3,228,286,300,18,2,1,8,5,1,1,58,14,72
p_250,7,0,e_0,236,260,319,12,3,1,0,3,0,0,24,59,83
p_248,7,0,e_0,246,260,319,9,3,1,3,5,0,1,14,59,73
p_247,12,0,e_0,248,277,319,19,2,0,3,5,0,1,29,42,71
p_245,9,0,e_0,269,288,319,30,2,2,10,5,1,1,19,31,50
p_243,8,0,e_0,285,293,319,26,1,1,10,4,1,1,8,26,34
p_233,2,0,e_0,319,328,362,13,2,2,0,3,0,0,9,34,43
p_232,5,0,e_0,320,339,362,9,2,1,0,5,0,1,19,23,42
p_230,5,0,e_0,323,339,362,8,2,1,1,5,0,2,16,23,39
p_221,4,0,e_0,341,344,362,6,2,1,5,4,1,1,3,18,21
p_222,3,0,e_0,339,349,362,8,3,2,5,4,1,0,10,13,23
p_216,1,0,e_0,346,357,362,8,2,0,4,4,1,1,11,5,16
p_205,1,0,e_0,362,368,373,5,3,2,0,3,0,0,6,5,11
p_237,5,0,e_3,313,331,384,5,0,0,0,3,0,0,18,53,71
p_235,8,0,e_3,314,342,384,8,1,0,0,5,0,1,28,42,70
p_229,9,0,e_3,323,347,384,6,2,0,3,5,0,2,24,37,61
p_227,9,0,e_3,326,347,384,5,3,0,4,5,0,3,21,37,58
p_220,9,0,e_3,342,347,384,1,2,0,8,5,1,1,5,37,42
p_218,9,0,e_3,343,347,384,1,2,0,8,5,1,1,4,37,41
p_217,8,0,e_3,345,352,384,1,2,0,9,5,1,1,7,32,39
p_215,6,0,e_3,346,360,384,3,3,0,9,2,1,2,14,24,38
p_214,4,0,e_3,346,368,384,5,2,0,9,2,1,1,22,16,38
p_210,4,0,e_3,353,368,384,4,3,1,8,4,1,2,15,16,31
p_209,2,0,e_3,354,376,384,6,3,2,8,4,1,2,22,8,30
p_199,2,0,e_3,368,376,384,2,2,0,4,4,1,1,8,8,16
p_242,4,0,e_1,287,302,390,30,1,1,0,3,0,0,15,88,103
p_241,13,0,e_1,300,331,390,13,0,0,4,5,0,1,31,59,90
p_239,13,0,e_1,305,331,390,13,0,0,5,5,1,2,26,59,85
p_240,14,0,e_1,301,336,390,14,0,0,4,3,0,1,35,54,89
p_234,14,0,e_1,314,336,390,14,2,0,8,5,1,2,22,54,76
p_224,13,0,e_1,335,341,390,7,3,0,14,2,1,2,6,49,55
p_226,12,0,e_1,331,346,390,7,3,0,13,5,1,2,15,44,59
p_228,11,0,e_1,325,351,390,8,3,0,11,5,1,2,26,39,65
p_219,11,0,e_1,342,351,390,3,2,0,13,4,1,2,9,39,48
p_212,9,0,e_1,348,359,390,30,4,4,12,4,1,1,11,31,42
p_206,6,0,e_1,362,370,390,30,3,3,8,4,1,0,8,20,28
p_238,2,0,e_2,311,320,432,2,0,0,0,3,0,0,9,112,121
p_236,8,0,e_2,313,340,432,8,1,1,0,5,0,1,27,92,119
p_231,10,0,e_2,320,348,432,8,2,0,2,5,1,1,28,84,112
p_225,10,0,e_2,333,348,432,5,3,0,6,5,1,2,15,84,99
p_213,12,0,e_2,347,356,432,27,4,4,10,2,1,1,9,76,85
p_207,12,0,e_2,355,356,432,25,4,4,12,2,1,2,1,76,77
p_223,13,0,e_2,339,363,432,6,3,0,8,2,1,1,24,69,93
p_208,13,0,e_2,355,363,432,24,4,4,12,2,1,3,8,69,77
p_211,14,0,e_2,348,368,432,25,4,4,10,5,1,2,20,64,84
p_202,13,0,e_2,365,373,432,22,3,3,13,5,1,3,8,59,67
p_201,13,0,e_2,366,373,432,21,3,3,14,5,1,4,7,59,66
p_203,12,0,e_2,365,378,432,23,3,3,13,5,1,2,13,54,67
p_200,12,0,e_2,367,378,432,22,2,2,14,2,1,3,11,54,65
p_194,11,0,e_2,377,383,432,21,1,1,12,1,1,2,6,49,55
p_198,9,0,e_2,368,391,432,25,2,2,14,4,1,3,23,41,64
p_196,5,0,e_0,376,394,483,27,1,1,0,3,0,0,18,89,107
p_193,12,0,e_0,378,417,483,20,1,1,0,5,0,1,39,66,105
p_183,12,0,e_0,393,417,483,12,1,0,5,2,0,2,24,66,90
p_161,13,0,e_0,418,422,483,6,6,0,12,5,1,2,4,61,65
p_190,14,0,e_0,382,427,483,16,1,1,1,5,0,2,45,56,101
p_180,14,0,e_0,396,427,483,13,1,0,5,5,1,2,31,56,87
p_172,14,0,e_0,405,427,483,11,4,0,8,5,1,2,22,56,78
p_165,14,0,e_0,416,427,483,8,5,0,12,2,1,2,11,56,67
p_162,14,0,e_0,417,427,483,8,6,0,12,5,1,2,10,56,66
p_158,14,0,e_0,426,427,483,5,6,0,14,2,1,1,1,56,57
p_168,15,0,e_0,412,434,483,10,4,0,11,5,1,2,22,49,71
p_138,7,0,e_0,456,460,483,29,5,5,8,4,1,0,4,23,27
p_185,2,0,e_3,392,401,483,2,0,0,0,3,0,0,9,82,91
p_178,5,0,e_3,398,412,483,4,1,0,1,5,0,1,14,71,85
p_167,7,0,e_3,412,420,483,8,3,2,5,5,1,2,8,63,71
p_177,9,0,e_3,398,428,483,8,2,0,1,5,0,2,30,55,85
p_173,10,0,e_3,405,433,483,7,3,0,3,5,1,2,28,50,78
p_170,10,0,e_3,408,433,483,6,4,0,4,5,1,3,25,50,75
p_160,10,0,e_3,421,433,483,3,5,0,7,5,1,4,12,50,62
p_159,11,0,e_3,424,438,483,3,5,0,8,5,1,4,14,45,59
p_154,7,0,e_3,438,452,483,4,4,0,11,4,1,3,14,31,45
p_166,5,0,e_3,415,460,483,9,4,3,6,5,1,3,45,23,68
p_163,4,0,e_3,417,465,483,10,5,3,6,5,1,4,48,18,66
p_144,4,0,e_3,451,465,483,3,5,1,7,1,1,4,14,18,32
p_143,2,0,e_3,451,473,483,5,4,2,7,1,1,3,22,10,32
p_136,2,0,e_3,460,473,483,3,4,1,5,4,1,3,13,10,23
p_156,1,0,e_3,428,478,483,12,5,2,9,5,1,4,50,5,55
p_186,1,0,e_1,391,397,484,1,0,0,0,3,0,0,6,87,93
p_184,5,0,e_1,393,411,484,5,1,0,0,5,0,1,18,73,91
p_181,11,0,e_1,395,431,484,11,1,0,1,5,0,2,36,53,89
p_169,11,0,e_1,410,431,484,6,4,0,5,2,1,1,21,53,74
p_164,12,0,e_1,416,436,484,6,5,0,6,5,1,1,20,48,68
p_157,12,0,e_1,427,436,484,3,5,0,10,5,1,2,9,48,57
p_152,10,0,e_1,439,444,484,1,5,0,11,4,1,2,5,40,45
p_153,8,0,e_1,438,452,484,3,5,0,12,4,1,1,14,32,46
p_147,7,0,e_1,450,457,484,30,5,5,8,4,1,2,7,27,34
p_133,4,0,e_1,463,468,484,30,4,4,5,4,1,1,5,16,21
p_155,3,0,e_1,434,473,484,9,5,1,12,5,1,1,39,11,50
p_150,3,0,e_1,444,473,484,6,5,3,10,4,1,2,29,11,40
p_148,3,0,e_1,447,473,484,5,5,3,9,4,1,2,26,11,37
p_110,1,0,e_3,501,507,512,1,0,0,0,3,0,0,6,5,11
p_118,4,0,e_1,488,503,517,4,0,0,0,3,0,0,15,14,29
p_175,2,0,e_2,399,440,572,14,3,2,7,4,1,4,41,132,173
p_174,3,0,e_2,402,445,572,13,3,2,7,4,1,5,43,127,170
p_171,3,0,e_2,408,445,572,13,4,3,6,4,1,6,37,127,164
p_192,5,0,e_2,380,453,572,26,1,1,12,4,1,3,73,119,192
p_182,5,0,e_2,394,453,572,5,1,0,8,4,1,3,59,119,178
p_179,6,0,e_2,397,458,572,5,1,0,8,4,1,3,61,114,175
p_176,6,0,e_2,398,458,572,5,2,0,8,4,1,4,60,114,174
p_191,7,0,e_2,382,463,572,23,1,1,11,1,1,3,81,109,190
p_189,7,0,e_2,387,463,572,7,0,0,10,4,1,4,76,109,185
p_187,7,0,e_2,391,463,572,7,0,0,9,4,1,3,72,109,181
p_135,7,0,e_2,461,463,572,28,4,4,7,5,1,7,2,109,111
p_132,7,0,e_2,463,465,572,27,4,4,7,5,1,6,2,107,109
p_204,8,0,e_2,364,470,572,27,3,3,13,5,1,1,106,102,208
p_197,8,0,e_2,375,470,572,24,1,1,13,4,1,3,95,102,197
p_188,8,0,e_2,390,470,572,8,0,0,9,1,1,3,80,102,182
p_99,1,0,e_1,522,527,588,11,3,2,0,5,0,1,5,61,66
p_102,2,0,e_1,521,532,588,10,3,2,0,3,0,0,11,56,67
p_96,5,0,e_1,527,543,588,11,5,3,1,5,1,1,16,45,61
p_95,6,0,e_1,527,548,588,10,5,2,1,5,1,2,21,40,61
p_80,6,0,e_1,548,550,588,5,2,1,6,5,1,4,2,38,40
p_89,7,0,e_1,537,555,588,7,3,1,3,5,1,3,18,33,51
p_77,6,0,e_1,557,560,588,3,1,0,7,4,1,4,3,28,31
p_83,5,0,e_1,546,565,588,7,2,1,6,5,1,4,19,23,42
p_78,4,0,e_1,555,570,588,6,1,0,7,4,1,3,15,18,33
p_84,3,0,e_1,546,575,588,9,2,1,6,5,1,3,29,13,42
p_70,3,0,e_1,572,575,588,2,3,0,4,4,1,3,3,13,16
p_90,2,0,e_1,536,580,588,12,3,2,3,5,1,2,44,8,52
p_71,2,0,e_1,569,580,588,4,3,0,4,1,1,2,11,8,19
p_107,1,0,e_3,512,518,589,1,0,0,0,3,0,0,6,71,77
p_106,4,0,e_3,512,529,589,4,1,1,0,3,0,1,17,60,77
p_105,4,0,e_3,515,529,589,4,2,0,0,5,0,2,14,60,74
p_98,6,0,e_3,524,537,589,5,3,1,3,5,1,2,13,52,65
p_94,6,0,e_3,528,537,589,2,4,4,4,3,1,3,9,52,61
p_104,7,0,e_3,516,542,589,6,2,0,1,5,0,2,26,47,73
p_97,10,0,e_3,526,553,589,7,4,0,3,5,1,3,27,36,63
p_76,7,0,e_3,559,564,589,1,1,0,8,4,1,0,5,25,30
p_64,1,0,e_3,579,584,589,1,3,0,2,4,1,2,5,5,10
p_119,5,0,e_0,483,501,602,5,0,0,0,3,0,0,18,101,119
p_116,7,0,e_0,490,509,602,7,0,0,2,5,0,1,19,93,112
p_114,9,0,e_0,494,517,602,9,0,0,3,5,0,2,23,85,108
p_115,10,0,e_0,494,522,602,10,0,0,3,5,0,3,28,80,108
p_113,11,0,e_0,496,527,602,11,0,0,4,5,0,4,31,75,106
p_101,12,0,e_0,521,532,602,10,3,0,10,2,1,3,11,70,81
p_103,13,0,e_0,517,537,602,12,2,0,9,5,1,3,20,65,85
p_92,13,0,e_0,533,537,602,8,4,0,12,5,1,2,4,65,69
p_91,13,0,e_0,535,537,602,7,4,0,13,5,1,2,2,65,67
p_109,14,0,e_0,506,542,602,15,0,0,6,5,1,4,36,60,96
p_88,14,0,e_0,538,542,602,8,3,0,13,5,1,1,4,60,64
p_87,15,0,e_0,539,547,602,9,3,0,13,5,1,1,8,55,63
p_79,14,0,e_0,549,552,602,5,2,0,15,4,1,0,3,50,53
p_73,6,0,e_0,568,578,602,30,3,3,9,4,1,0,10,24,34
p_56,2,0,e_0,588,592,602,2,3,3,3,4,1,0,4,10,14
p_51,1,0,e_0,591,607,612,27,6,6,2,1,1,0,16,5,21
p_38,4,0,e_0,627,642,686,14,5,3,0,3,0,0,15,44,59
p_35,4,0,e_0,640,642,686,11,4,1,4,5,0,2,2,44,46
p_37,7,0,e_0,633,653,686,10,3,2,1,5,0,1,20,33,53
p_33,8,0,e_0,647,658,686,6,2,1,5,5,1,1,11,28,39
p_31,5,0,e_0,662,669,686,5,2,0,7,4,1,0,7,17,24
p_55,4,0,e_3,590,603,695,24,3,3,0,5,0,3,13,92,105
p_62,5,0,e_3,582,608,695,26,4,4,1,4,1,3,26,87,113
p_49,5,0,e_3,592,608,695,22,6,4,1,5,0,6,16,87,103
p_54,6,0,e_3,590,613,695,22,4,2,0,5,0,4,23,82,105
p_47,6,0,e_3,594,613,695,21,7,4,1,5,0,7,19,82,101
p_53,9,0,e_3,590,624,695,19,5,2,0,5,0,5,34,71,105
p_50,10,0,e_3,592,629,695,17,6,2,1,5,0,6,37,66,103
p_74,11,0,e_3,567,634,695,25,2,2,6,4,1,1,67,61,128
p_52,11,0,e_3,591,634,695,17,6,1,0,5,0,6,43,61,104
p_46,13,0,e_3,596,642,695,13,7,1,2,5,0,7,46,53,99
p_75,14,0,e_3,563,647,695,23,1,1,7,1,1,0,84,48,132
p_36,11,0,e_3,635,658,695,6,3,2,11,5,1,2,23,37,60
p_32,5,0,e_3,657,678,695,6,1,0,11,1,1,0,21,17,38
p_42,4,0,e_1,600,602,696,21,8,7,4,5,0,5,2,94,96
p_40,4,0,e_1,601,602,696,20,8,7,4,3,0,5,1,94,95
p_61,5,0,e_1,583,609,696,26,4,4,1,4,1,3,26,87,113
p_45,5,0,e_1,597,609,696,21,8,6,3,5,0,5,12,87,99
p_57,6,0,e_1,587,614,696,24,4,4,0,3,1,4,27,82,109
p_67,8,0,e_1,574,622,696,26,3,3,3,1,1,3,48,74,122
p_69,10,0,e_1,573,630,696,24,3,3,3,4,1,3,57,66,123
p_41,10,0,e_1,600,630,696,15,8,3,4,5,0,6,30,66,96
p_72,15,0,e_1,569,647,696,21,3,3,4,1,1,2,78,49,127
p_34,15,0,e_1,643,647,696,2,3,0,14,5,1,1,4,49,53
p_30,5,0,e_1,676,679,696,30,2,2,6,4,1,0,3,17,20
p_81,2,0,e_2,547,580,706,10,2,1,5,4,1,10,33,126,159
p_85,3,0,e_2,542,585,706,10,2,1,6,4,1,9,43,121,164
p_82,3,0,e_2,547,585,706,9,2,1,5,4,1,11,38,121,159
p_125,4,0,e_2,474,590,706,28,2,2,9,2,1,6,116,116,232
p_129,5,0,e_2,470,595,706,28,3,3,8,5,1,5,125,111,236
p_122,5,0,e_2,477,595,706,26,1,1,9,5,1,8,118,111,229
p_108,5,0,e_2,509,595,706,26,1,1,14,4,1,8,86,111,197
p_126,6,0,e_2,473,600,706,26,2,2,9,5,1,6,127,106,233
p_86,6,0,e_2,541,600,706,7,2,1,7,4,1,9,59,106,165
p_59,6,0,e_2,584,600,706,25,4,4,3,2,1,11,16,106,122
p_93,7,0,e_2,529,605,706,9,4,1,9,4,1,8,76,101,177
p_63,8,0,e_2,581,610,706,24,4,4,2,5,1,11,29,96,125
p_195,9,0,e_2,376,615,706,23,1,1,12,4,1,3,239,91,330
p_131,9,0,e_2,467,615,706,25,3,3,7,5,1,6,148,91,239
p_130,9,0,e_2,469,615,706,24,3,3,8,2,1,5,146,91,237
p_24,5,0,e_3,707,725,742,5,0,0,0,3,0,0,18,17,35
p_23,5,0,e_3,709,725,742,5,1,0,0,5,0,1,16,17,33
p_26,3,0,e_1,698,710,769,3,0,0,0,3,0,0,12,59,71
p_25,7,0,e_1,703,724,769,7,0,0,1,5,0,1,21,45,66
p_22,10,0,e_1,712,735,769,9,1,0,3,5,1,1,23,34,57
p_21,10,0,e_1,732,735,769,23,1,1,9,5,1,1,3,34,37
p_20,9,0,e_1,737,740,769,22,1,1,10,4,1,0,3,29,32
p_29,15,0,e_0,678,733,782,20,1,1,2,4,1,0,55,49,104
p_19,12,0,e_0,740,744,782,18,1,1,13,4,1,0,4,38,42
p_48,2,0,e_2,593,714,822,25,7,7,5,5,1,10,121,108,229
p_27,2,0,e_2,693,714,822,28,1,1,3,4,1,8,21,108,129
p_43,3,0,e_2,599,719,822,22,8,8,6,2,1,9,120,103,223
p_28,6,0,e_2,679,730,822,29,1,1,7,4,1,8,51,92,143
p_121,9,0,e_2,480,741,822,22,1,1,10,5,1,8,261,81,342
p_60,9,0,e_2,584,741,822,22,4,4,3,2,1,11,157,81,238
p_146,10,0,e_2,451,746,822,27,5,5,5,5,1,6,295,76,371
p_128,10,0,e_2,471,746,822,22,3,3,8,5,1,6,275,76,351
p_120,10,0,e_2,481,746,822,20,1,1,10,5,1,8,265,76,341
p_100,10,0,e_2,522,746,822,8,3,0,11,4,1,9,224,76,300
p_58,10,0,e_2,586,746,822,21,4,4,3,5,1,11,160,76,236
p_145,12,0,e_2,451,754,822,25,5,5,5,5,1,7,303,68,371
p_134,12,0,e_2,462,754,822,23,4,4,7,2,1,6,292,68,360
p_123,12,0,e_2,474,754,822,20,2,2,9,2,1,7,280,68,348
p_117,12,0,e_2,490,754,822,12,0,0,12,5,1,8,264,68,332
p_8,1,0,e_3,847,851,864,3,1,1,0,5,0,1,4,13,17
p_9,2,0,e_3,845,856,864,2,0,0,0,3,0,0,11,8,19
p_13,11,0,e_0,794,830,865,11,0,0,0,3,0,0,36,35,71
p_11,11,0,e_0,810,830,865,11,0,0,5,5,0,1,20,35,55
p_18,2,0,e_1,768,777,869,2,0,0,0,3,1,0,9,92,101
p_12,13,0,e_1,796,812,869,13,0,0,8,5,1,1,16,57,73
p_10,14,0,e_1,810,817,869,14,0,0,13,5,1,2,7,52,59
p_17,15,0,e_1,772,822,869,15,0,0,1,5,0,1,50,47,97
p_15,15,0,e_1,782,822,869,15,0,0,3,5,1,1,40,47,87
p_14,15,0,e_1,790,822,869,15,0,0,6,5,1,1,32,47,79
p_4,1,0,e_0,864,870,875,1,0,0,0,3,1,0,6,5,11
p_3,1,0,e_0,876,882,887,1,0,0,0,3,0,0,6,5,11
p_2,3,0,e_1,878,890,901,3,0,0,0,3,0,0,12,11,23
p_1,2,0,e_0,889,898,906,2,0,0,0,3,0,0,9,8,17
p_66,12,0,e_2,577,860,924,21,3,3,1,5,0,12,283,64,347
p_65,12,0,e_2,578,860,924,21,3,3,2,5,0,12,282,64,346
p_7,12,0,e_2,851,860,924,11,2,0,9,5,0,4,9,64,73
p_140,13,0,e_2,455,865,924,23,5,5,5,5,1,7,410,59,469
p_139,13,0,e_2,456,865,924,23,5,5,6,5,1,8,409,59,468
p_137,13,0,e_2,458,865,924,22,5,5,6,5,1,7,407,59,466
p_16,13,0,e_2,774,865,924,13,0,0,14,4,1,3,91,59,150
p_124,14,0,e_2,474,870,924,18,2,2,9,2,1,7,396,54,450
p_68,14,0,e_2,574,870,924,20,3,3,0,5,0,12,296,54,350
p_6,14,0,e_2,858,870,924,18,1,1,12,5,0,4,12,54,66
p_151,15,0,e_2,443,875,924,25,5,5,3,5,1,6,432,49,481
p_149,15,0,e_2,444,875,924,24,5,5,3,2,1,6,431,49,480
p_142,15,0,e_2,452,875,924,22,5,5,5,2,1,7,423,49,472
p_141,15,0,e_2,455,875,924,21,5,5,5,5,1,8,420,49,469
p_127,15,0,e_2,473,875,924,17,2,2,9,5,1,7,402,49,451
p_5,5,0,e_2,860,941,1020,26,1,1,12,5,1,3,81,79,160
p_112,15,0,e_2,497,973,1020,15,0,0,14,2,1,8,476,47,523
p_111,15,0,e_2,501,973,1020,15,1,1,15,5,1,9,472,47,519
p_44,15,0,e_2,598,973,1020,12,8,0,6,5,1,10,375,47,422
p_39,15,0,e_2,609,973,1020,10,7,0,8,2,1,8,364,47,411
p_299,3,0,e_1,7,19,30,3,0,0,0,3,0,0,12,11,23
p_296,1,0,e_3,20,26,31,1,0,0,0,3,0,0,6,5,11
p_298,4,0,e_2,10,25,47,4,0,0,0,3,0,0,15,22,37
p_295,5,0,e_2,22,30,47,5,1,0,3,5,0,1,8,17,25
p_288,1,0,e_2,49,55,98,3,2,2,0,3,0,0,6,43,49
p_285,2,0,e_2,54,60,98,7,3,2,1,2,0,1,6,38,44
p_286,3,0,e_2,51,65,98,7,3,2,0,5,0,1,14,33,47
p_282,6,0,e_2,62,76,98,7,2,1,2,5,1,1,14,22,36
p_279,2,0,e_2,76,90,98,8,1,0,6,4,1,0,14,8,22
p_275,2,0,e_2,84,90,98,5,2,0,4,4,1,2,6,8,14
p_290,4,0,e_3,43,50,106,6,1,1,2,5,0,1,7,56,63
p_291,6,0,e_3,35,58,106,6,0,0,0,3,0,0,23,48,71
p_289,7,0,e_3,47,63,106,4,2,0,3,5,0,2,16,43,59
p_283,10,0,e_3,55,74,106,5,3,0,5,5,1,2,19,32,51
p_300,8,0,e_0,4,31,111,8,0,0,0,3,0,0,27,80,107
p_297,12,0,e_0,18,45,111,12,0,0,4,5,0,1,27,66,93
p_294,13,0,e_0,23,50,111,13,1,0,6,5,0,2,27,61,88
p_293,15,0,e_0,26,58,111,16,1,1,7,5,0,3,32,53,85
p_284,14,0,e_0,55,63,111,9,4,0,14,5,1,1,8,48,56
p_281,10,0,e_0,63,77,111,3,2,0,14,4,1,0,14,34,48
p_276,5,0,e_0,82,94,111,3,2,0,9,4,1,0,12,17,29
p_292,11,0,e_1,30,66,111,11,0,0,0,3,0,0,36,45,81
p_287,12,0,e_1,51,71,111,8,3,0,6,5,0,1,20,40,60
p_280,12,0,e_1,65,71,111,5,2,0,11,2,0,1,6,40,46
p_274,4,0,e_1,84,97,111,3,2,0,8,4,1,0,13,14,27
p_269,4,0,e_1,146,161,177,6,1,0,0,3,0,0,15,16,31
p_267,1,0,e_1,153,172,177,7,1,0,2,5,0,1,19,5,24
p_277,10,0,e_3,81,138,178,28,1,1,8,4,1,0,57,40,97
p_271,11,0,e_3,127,143,178,4,1,0,7,5,0,1,16,35,51
p_273,13,0,e_2,95,139,200,20,2,2,1,4,1,1,44,61,105
p_278,15,0,e_2,80,147,200,23,1,1,5,4,1,1,67,53,120
p_272,15,0,e_2,105,147,200,15,1,1,2,5,0,2,42,53,95
p_268,10,0,e_2,150,164,200,29,1,1,14,4,1,0,14,36,50
p_262,6,0,e_2,164,178,200,28,1,1,10,4,1,1,14,22,36
p_259,6,0,e_2,174,178,200,25,1,1,7,4,1,2,4,22,26
p_264,5,0,e_2,162,183,200,30,1,1,10,4,1,1,21,17,38
p_258,5,0,e_2,175,183,200,26,1,1,7,4,1,2,8,17,25
p_254,3,0,e_2,199,211,224,11,1,1,0,3,1,0,12,13,25
p_252,2,0,e_2,212,216,224,8,1,1,3,4,1,0,4,8,12
p_270,7,0,e_0,133,157,238,6,2,2,0,3,0,0,24,81,105
p_263,12,0,e_0,163,174,238,23,1,1,9,5,1,1,11,64,75
p_261,12,0,e_0,170,174,238,20,1,1,11,5,1,2,4,64,68
p_260,13,0,e_0,171,179,238,19,1,1,11,5,1,2,8,59,67
p_266,15,0,e_0,155,187,238,22,1,1,7,5,0,1,32,51,83
p_257,12,0,e_0,179,198,238,12,0,0,13,5,1,1,19,40,59
p_255,10,0,e_0,192,206,238,10,1,0,14,4,1,1,14,32,46
p_256,8,0,e_3,191,218,246,8,0,0,0,3,0,0,27,28,55
p_251,4,0,e_3,228,232,246,1,1,0,5,4,1,0,4,14,18
p_265,12,0,e_1,157,215,275,25,1,1,3,5,0,2,58,60,118
p_253,15,0,e_1,208,226,275,10,1,0,10,5,0,1,18,49,67
p_250,7,0,e_1,236,252,275,26,1,1,12,4,1,0,16,23,39
p_249,7,0,e_1,238,252,275,25,1,1,11,4,1,1,14,23,37
p_248,7,0,e_1,246,252,275,7,0,0,9,4,1,1,6,23,29
p_244,2,0,e_3,271,280,288,2,0,0,0,3,0,0,9,8,17
p_247,12,0,e_0,248,287,329,12,0,0,0,3,0,0,39,42,81
p_246,12,0,e_0,257,287,329,12,0,0,2,5,0,1,30,42,72
p_243,8,0,e_0,285,301,329,23,1,1,12,5,0,1,16,28,44
p_238,2,0,e_0,311,321,329,23,1,1,5,4,1,0,10,8,18
p_245,9,0,e_2,269,299,330,9,0,0,0,3,0,0,30,31,61
p_233,2,0,e_2,319,322,330,20,3,3,3,4,1,0,3,8,11
p_242,4,0,e_1,287,302,404,4,0,0,0,3,0,0,15,102,117
p_236,8,0,e_1,313,316,404,16,2,1,7,5,1,2,3,88,91
p_231,10,0,e_1,320,324,404,12,3,1,9,5,1,3,4,80,84
p_241,13,0,e_1,300,335,404,13,0,0,4,5,0,1,35,69,104
p_224,13,0,e_1,335,337,404,5,3,0,13,5,1,3,2,67,69
p_240,14,0,e_1,301,342,404,14,0,0,4,3,0,1,41,62,103
p_234,14,0,e_1,314,342,404,12,3,0,8,5,1,3,28,62,90
p_213,12,0,e_1,347,350,404,3,5,1,13,4,1,4,3,54,57
p_219,11,0,e_1,342,355,404,5,3,1,14,4,1,3,13,49,62
p_229,9,0,e_1,323,363,404,12,3,1,10,2,1,3,40,41,81
p_227,9,0,e_1,326,363,404,11,4,2,10,5,1,4,37,41,78
p_220,9,0,e_1,342,363,404,7,3,2,14,4,1,3,21,41,62
p_212,9,0,e_1,348,363,404,5,5,1,12,4,1,5,15,41,56
p_204,8,0,e_1,364,368,404,4,4,1,9,4,1,4,4,36,40
p_206,6,0,e_1,362,376,404,7,4,2,9,1,1,3,14,28,42
p_237,5,0,e_3,313,323,416,19,1,1,2,5,0,1,10,93,103
p_235,8,0,e_3,314,334,416,16,2,1,2,5,0,2,20,82,102
p_228,11,0,e_3,325,345,416,10,3,1,5,5,1,2,20,71,91
p_239,13,0,e_3,305,353,416,13,0,0,0,3,0,0,48,63,111
p_223,13,0,e_3,339,353,416,4,3,0,9,5,1,2,14,63,77
p_211,14,0,e_3,348,358,416,2,5,0,12,5,1,4,10,58,68
p_218,9,0,e_3,343,375,416,6,3,1,11,5,1,2,32,41,73
p_198,9,0,e_3,368,375,416,2,4,0,11,4,1,3,7,41,48
p_217,8,0,e_3,345,380,416,7,3,1,11,5,1,2,35,36,71
p_197,8,0,e_3,375,380,416,1,3,0,9,4,1,2,5,36,41
p_191,7,0,e_3,382,385,416,1,4,0,8,4,1,3,3,31,34
p_192,5,0,e_3,380,393,416,3,3,0,8,4,1,2,13,23,36
p_214,4,0,e_3,346,398,416,11,4,1,11,5,1,3,52,18,70
p_185,2,0,e_3,392,406,416,3,4,1,5,1,1,3,14,10,24
p_175,2,0,e_3,399,406,416,2,5,0,4,4,1,4,7,10,17
p_226,12,0,e_0,331,370,428,7,4,1,0,3,0,0,39,58,97
p_207,12,0,e_0,355,370,428,3,5,1,7,5,0,2,15,58,73
p_200,12,0,e_0,367,370,428,29,4,4,11,5,0,3,3,58,61
p_208,13,0,e_0,355,375,428,2,5,1,7,5,0,2,20,53,73
p_202,13,0,e_0,365,375,428,29,4,4,11,5,0,3,10,53,63
p_201,13,0,e_0,366,375,428,29,4,4,11,5,0,3,9,53,62
p_194,11,0,e_0,377,383,428,28,3,3,13,4,1,2,6,45,51
p_195,9,0,e_0,376,391,428,30,3,3,13,4,1,1,15,37,52
p_188,8,0,e_0,390,396,428,28,4,4,9,1,1,1,6,32,38
p_176,6,0,e_0,398,404,428,28,5,5,8,4,1,3,6,24,30
p_182,5,0,e_0,394,409,428,30,5,5,8,4,1,2,15,19,34
p_210,4,0,e_0,353,414,428,11,5,1,7,5,0,1,61,14,75
p_222,3,0,e_2,339,345,428,14,3,2,1,5,0,1,6,83,89
p_215,6,0,e_2,346,356,428,9,5,1,3,5,1,2,10,72,82
p_225,10,0,e_2,333,370,428,8,3,2,0,3,0,0,37,58,95
p_203,12,0,e_2,365,378,428,30,4,4,9,5,1,3,13,50,63
p_189,7,0,e_2,387,395,428,30,4,4,9,4,1,2,8,33,41
p_187,7,0,e_2,391,395,428,28,5,5,8,4,1,3,4,33,37
p_179,6,0,e_2,397,400,428,28,5,5,7,4,1,3,3,28,31
p_184,5,0,e_2,393,405,428,30,5,5,7,4,1,3,12,23,35
p_178,5,0,e_2,398,405,428,29,5,5,6,4,1,4,7,23,30
p_174,3,0,e_2,402,413,428,30,5,5,6,4,1,3,11,15,26
p_171,3,0,e_2,408,413,428,29,4,4,4,4,1,3,5,15,20
p_209,2,0,e_2,354,418,428,13,5,1,6,5,1,3,64,10,74
p_216,1,0,e_2,346,423,428,14,4,1,3,5,1,1,77,5,82
p_205,1,0,e_1,362,409,520,12,4,3,9,1,1,2,47,111,158
p_199,2,0,e_1,368,414,520,9,4,3,8,4,1,4,46,106,152
p_221,4,0,e_1,341,422,520,12,3,2,14,2,1,2,81,98,179
p_232,5,0,e_1,320,427,520,17,3,2,9,5,1,2,107,93,200
p_230,5,0,e_1,323,427,520,16,3,2,10,2,1,3,104,93,197
p_196,5,0,e_1,376,427,520,4,3,1,6,4,1,4,51,93,144
p_177,9,0,e_1,398,441,520,25,5,5,1,1,1,5,43,79,122
p_173,10,0,e_1,405,446,520,22,4,4,0,5,0,7,41,74,115
p_170,10,0,e_1,408,446,520,22,4,4,1,2,0,7,38,74,112
p_160,10,0,e_1,421,446,520,17,6,4,4,3,1,6,25,74,99
p_183,12,0,e_1,393,454,520,23,5,5,2,1,1,4,61,66,127
p_190,14,0,e_1,382,462,520,24,5,5,5,4,1,3,80,58,138
p_172,14,0,e_1,405,462,520,18,4,4,0,5,0,8,57,58,115
p_168,15,0,e_1,412,467,520,16,4,4,2,5,1,7,55,53,108
p_151,15,0,e_1,443,467,520,8,5,0,9,5,1,4,24,53,77
p_163,4,0,e_0,417,442,522,24,5,4,3,4,1,1,25,80,105
p_147,7,0,e_0,450,453,522,11,5,4,6,5,1,3,3,69,72
p_181,11,0,e_0,395,467,522,24,5,5,8,1,1,2,72,55,127
p_157,12,0,e_0,427,472,522,13,6,2,0,3,1,2,45,50,95
p_121,9,0,e_0,480,483,522,3,4,1,10,4,1,4,3,39,42
p_129,5,0,e_0,470,497,522,9,3,1,12,5,1,4,27,25,52
p_122,5,0,e_0,477,497,522,7,4,2,11,4,1,4,20,25,45
p_119,5,0,e_0,483,497,522,6,4,2,9,4,1,4,14,25,39
p_144,4,0,e_0,451,502,522,14,5,4,7,5,1,5,51,20,71
p_125,4,0,e_0,474,502,522,9,4,2,12,4,1,4,28,20,48
p_150,3,0,e_0,444,507,522,17,5,4,4,5,1,2,63,15,78
p_148,3,0,e_0,447,507,522,16,5,4,5,5,1,3,60,15,75
p_143,2,0,e_0,451,512,522,16,5,4,7,5,1,4,61,10,71
p_110,1,0,e_0,501,517,522,5,5,1,4,1,1,2,16,5,21
p_107,1,0,e_0,512,517,522,2,5,0,2,4,1,3,5,5,10
p_186,1,0,e_3,391,421,522,4,4,1,5,4,1,3,30,101,131
p_166,5,0,e_3,415,435,522,5,4,4,0,3,1,4,20,87,107
p_169,11,0,e_3,410,455,522,20,3,3,1,1,1,2,45,67,112
p_193,12,0,e_3,378,460,522,26,3,3,8,4,1,2,82,62,144
p_164,12,0,e_3,416,460,522,16,5,1,0,5,0,5,44,62,106
p_161,13,0,e_3,418,465,522,15,5,1,0,5,0,5,47,57,104
p_140,13,0,e_3,455,465,522,4,4,1,11,5,1,3,10,57,67
p_139,13,0,e_3,456,465,522,4,4,1,11,5,1,3,9,57,66
p_137,13,0,e_3,458,465,522,3,4,1,12,5,1,3,7,57,64
p_180,14,0,e_3,396,470,522,20,5,5,4,4,1,4,74,52,126
p_165,14,0,e_3,416,470,522,14,5,0,0,5,0,5,54,52,106
p_162,14,0,e_3,417,470,522,14,5,0,0,5,0,5,53,52,105
p_158,14,0,e_3,426,470,522,12,6,0,2,5,1,5,44,52,96
p_123,12,0,e_3,474,478,522,1,4,0,13,4,1,3,4,44,48
p_128,10,0,e_3,471,486,522,4,3,0,14,4,1,2,15,36,51
p_156,1,0,e_2,428,433,560,24,6,5,0,5,0,2,5,127,132
p_155,3,0,e_2,434,441,560,20,5,4,1,5,1,2,7,119,126
p_167,7,0,e_2,412,455,560,24,4,4,3,1,1,2,43,105,148
p_154,7,0,e_2,438,455,560,15,5,4,2,5,1,3,17,105,122
p_153,8,0,e_2,438,460,560,14,5,4,2,5,1,3,22,100,122
p_152,10,0,e_2,439,468,560,12,5,4,3,5,1,4,29,92,121
p_146,10,0,e_2,451,468,560,8,5,4,6,5,1,4,17,92,109
p_159,11,0,e_2,424,473,560,15,6,3,1,4,1,1,49,87,136
p_145,12,0,e_2,451,478,560,6,5,2,6,5,1,4,27,82,109
p_134,12,0,e_2,462,478,560,4,3,2,8,5,1,3,16,82,98
p_124,14,0,e_2,474,486,560,29,5,5,11,5,1,3,12,74,86
p_127,15,0,e_2,473,491,560,28,4,4,11,5,1,2,18,69,87
p_117,12,0,e_2,490,502,560,27,4,4,15,2,1,1,12,58,70
p_113,11,0,e_2,496,507,560,26,3,3,14,4,1,4,11,53,64
p_115,10,0,e_2,494,512,560,28,4,4,14,4,1,3,18,48,66
p_102,2,0,e_0,521,530,636,2,4,4,0,3,1,3,9,106,115
p_86,6,0,e_0,541,544,636,19,6,4,5,5,1,4,3,92,95
p_101,12,0,e_0,521,564,636,12,4,4,0,3,1,4,43,72,115
p_103,13,0,e_0,517,569,636,18,5,5,1,4,1,2,52,67,119
p_109,14,0,e_0,506,574,636,20,5,5,3,1,1,3,68,62,130
p_88,14,0,e_0,538,574,636,12,6,1,4,5,1,4,36,62,98
p_75,14,0,e_0,563,574,636,5,7,1,12,2,1,4,11,62,73
p_68,14,0,e_0,574,576,636,2,6,1,14,5,1,5,2,60,62
p_111,15,0,e_0,501,581,636,21,5,5,4,1,1,3,80,55,135
p_87,15,0,e_0,539,581,636,10,6,0,5,5,1,4,42,55,97
p_72,15,0,e_0,569,581,636,2,7,0,13,5,1,5,12,55,67
p_74,11,0,e_0,567,595,636,7,7,2,13,5,1,4,28,41,69
p_52,11,0,e_0,591,595,636,30,7,7,12,4,1,4,4,41,45
p_73,6,0,e_0,568,612,636,12,7,2,13,2,1,4,44,24,68
p_59,6,0,e_0,584,612,636,8,6,2,14,4,1,4,28,24,52
p_136,2,0,e_1,460,528,638,14,3,2,14,5,1,3,68,110,178
p_138,7,0,e_1,456,545,638,10,4,3,12,5,1,2,89,93,182
p_135,7,0,e_1,461,545,638,9,3,2,14,2,1,3,84,93,177
p_116,7,0,e_1,490,545,638,2,4,0,8,4,1,3,55,93,148
p_131,9,0,e_1,467,553,638,6,4,1,15,4,1,2,86,85,171
p_130,9,0,e_1,469,553,638,9,3,0,15,4,1,3,84,85,169
p_100,10,0,e_1,522,558,638,20,4,1,0,5,0,4,36,80,116
p_92,13,0,e_1,533,569,638,14,5,1,3,5,1,4,36,69,105
p_79,14,0,e_1,549,574,638,9,6,1,8,5,1,5,25,64,89
p_149,15,0,e_1,444,579,638,7,5,0,10,5,1,4,135,59,194
p_142,15,0,e_1,452,579,638,5,5,0,12,5,1,3,127,59,186
p_141,15,0,e_1,455,579,638,4,4,0,12,5,1,2,124,59,183
p_66,12,0,e_1,577,590,638,3,6,0,15,5,1,5,13,48,61
p_65,12,0,e_1,578,590,638,13,5,0,15,2,1,5,12,48,60
p_69,10,0,e_1,573,598,638,7,6,1,14,2,1,4,25,40,65
p_133,4,0,e_3,463,536,638,11,3,1,13,5,1,2,73,102,175
p_118,4,0,e_3,488,536,638,6,3,1,10,4,1,2,48,102,150
p_94,6,0,e_3,528,544,638,22,4,3,2,5,0,4,16,94,110
p_132,7,0,e_3,463,549,638,8,4,1,13,5,1,3,86,89,175
p_93,7,0,e_3,529,549,638,21,5,2,2,5,0,5,20,89,109
p_89,7,0,e_3,537,549,638,19,6,3,4,5,1,5,12,89,101
p_120,10,0,e_3,481,560,638,1,4,0,11,4,1,3,79,78,157
p_97,10,0,e_3,526,560,638,19,4,1,1,5,0,4,34,78,112
p_91,13,0,e_3,535,571,638,9,4,4,4,3,0,4,36,67,103
p_112,15,0,e_3,497,579,638,22,3,3,7,4,1,2,82,59,141
p_58,10,0,e_3,586,596,638,3,6,0,13,4,1,5,10,42,52
p_63,8,0,e_3,581,604,638,7,5,0,15,4,1,4,23,34,57
p_76,7,0,e_3,559,609,638,13,6,2,10,2,1,5,50,29,79
p_80,6,0,e_3,548,614,638,17,5,3,7,2,1,4,66,24,90
p_78,4,0,e_3,555,622,638,17,6,3,9,5,1,5,67,16,83
p_99,1,0,e_2,522,565,692,29,4,4,8,4,1,5,43,127,170
p_90,2,0,e_2,536,570,692,24,6,5,5,4,1,5,34,122,156
p_81,2,0,e_2,547,570,692,21,5,3,3,4,1,7,23,122,145
p_85,3,0,e_2,542,575,692,21,6,4,4,4,1,6,33,117,150
p_106,4,0,e_2,512,580,692,29,5,5,10,4,1,3,68,112,180
p_105,4,0,e_2,515,580,692,28,5,5,9,4,1,4,65,112,177
p_108,5,0,e_2,509,585,692,29,4,4,11,4,1,3,76,107,183
p_96,5,0,e_2,527,585,692,24,4,3,7,4,1,5,58,107,165
p_126,6,0,e_2,473,590,692,7,4,2,11,5,1,1,117,102,219
p_98,6,0,e_2,524,590,692,24,4,3,7,1,1,5,66,102,168
p_95,6,0,e_2,527,590,692,23,4,3,7,4,1,5,63,102,165
p_104,7,0,e_2,516,595,692,25,5,5,9,1,1,3,79,97,176
p_67,8,0,e_2,574,600,692,8,6,1,3,2,1,5,26,92,118
p_114,9,0,e_2,494,605,692,29,4,4,14,4,1,2,111,87,198
p_60,9,0,e_2,584,605,692,5,6,0,5,2,1,5,21,87,108
p_70,3,0,e_0,572,647,696,14,6,1,14,5,1,5,75,49,124
p_43,3,0,e_0,599,647,696,6,6,4,10,4,1,3,48,49,97
p_83,5,0,e_0,546,655,696,19,5,4,6,5,1,4,109,41,150
p_62,5,0,e_0,582,655,696,9,6,3,15,4,1,4,73,41,114
p_61,5,0,e_0,583,655,696,9,6,3,15,4,1,4,72,41,113
p_49,5,0,e_0,592,655,696,6,7,4,12,4,1,4,63,41,104
p_45,5,0,e_0,597,655,696,5,6,3,11,4,1,3,58,41,99
p_57,6,0,e_0,587,660,696,7,7,3,13,4,1,4,73,36,109
p_54,6,0,e_0,590,660,696,6,7,3,12,4,1,4,70,36,106
p_47,6,0,e_0,594,660,696,4,7,2,11,1,1,3,66,36,102
p_33,8,0,e_0,647,668,696,19,3,1,3,5,1,2,21,28,49
p_32,5,0,e_0,657,679,696,20,2,1,5,5,1,2,22,17,39
p_31,5,0,e_0,662,679,696,19,2,1,6,5,1,2,17,17,34
p_30,5,0,e_0,676,679,696,14,2,1,6,4,1,1,3,17,20
p_71,2,0,e_1,569,646,714,15,7,1,13,5,1,4,77,68,145
p_56,2,0,e_1,588,646,714,10,7,6,12,4,1,5,58,68,126
p_84,3,0,e_1,546,651,714,21,5,4,7,5,1,4,105,63,168
p_55,4,0,e_1,590,656,714,8,7,4,12,4,1,4,66,58,124
p_42,4,0,e_1,600,656,714,5,6,3,10,4,1,4,56,58,114
p_40,4,0,e_1,601,656,714,5,6,3,9,4,1,4,55,58,113
p_77,6,0,e_1,557,664,714,15,7,3,10,2,1,4,107,50,157
p_50,10,0,e_1,592,678,714,1,7,0,12,4,1,5,86,36,122
p_28,6,0,e_1,679,692,714,12,2,1,10,4,1,0,13,22,35
p_27,2,0,e_1,693,706,714,12,1,0,6,4,1,0,13,8,21
p_82,3,0,e_3,547,649,738,20,5,3,7,5,1,4,102,89,191
p_35,4,0,e_3,640,654,738,4,1,0,0,5,0,1,14,84,98
p_34,15,0,e_3,643,689,738,14,2,0,1,5,0,2,46,49,95
p_29,15,0,e_3,678,689,738,3,2,0,12,5,1,1,11,49,60
p_25,7,0,e_3,703,715,738,4,1,0,11,4,1,0,12,23,35
p_26,3,0,e_0,698,710,769,9,1,0,0,3,0,0,12,59,71
p_24,5,0,e_0,707,718,769,4,2,1,2,5,0,1,11,51,62
p_23,5,0,e_0,709,718,769,4,2,1,3,2,0,1,9,51,60
p_22,10,0,e_0,712,735,769,28,2,2,3,5,1,1,23,34,57
p_21,10,0,e_0,732,735,769,22,1,1,9,5,1,1,3,34,37
p_20,9,0,e_0,737,740,769,9,0,0,10,4,1,0,3,29,32
p_18,2,0,e_0,768,777,785,2,0,0,0,3,1,0,9,8,17
p_64,1,0,e_2,579,697,802,14,5,4,4,3,1,5,118,105,223
p_51,1,0,e_2,591,697,802,10,7,6,6,5,1,4,106,105,211
p_48,2,0,e_2,593,702,802,9,7,6,7,5,1,4,109,100,209
p_38,4,0,e_2,627,710,802,29,1,1,15,5,1,6,83,92,175
p_37,7,0,e_2,633,721,802,24,2,2,14,4,1,7,88,81,169
p_53,9,0,e_2,590,729,802,3,7,1,6,5,1,4,139,73,212
p_41,10,0,e_2,600,734,802,29,6,6,8,5,1,5,134,68,202
p_36,11,0,e_2,635,739,802,20,2,2,13,4,1,8,104,63,167
p_46,13,0,e_2,596,747,802,27,6,6,7,5,1,4,151,55,206
p_44,15,0,e_2,598,755,802,25,6,6,8,5,1,5,157,47,204
p_39,15,0,e_2,609,755,802,22,4,4,10,2,1,5,146,47,193
p_19,12,0,e_1,740,779,843,12,0,0,0,3,0,0,39,64,103
p_16,13,0,e_1,774,784,843,13,0,0,11,5,0,2,10,59,69
p_17,15,0,e_1,772,792,843,15,0,0,10,5,0,1,20,51,71
p_15,15,0,e_1,782,792,843,15,0,0,13,5,1,2,10,51,61
p_14,15,0,e_1,790,792,843,15,0,0,15,5,1,1,2,51,53
p_12,13,0,e_1,796,800,843,13,0,0,14,4,1,1,4,43,47
p_13,11,0,e_1,794,808,843,11,0,0,15,4,1,0,14,35,49
p_8,1,0,e_3,847,853,858,1,0,0,0,3,0,0,6,5,11
p_9,2,0,e_1,845,854,862,2,0,0,0,3,0,0,9,8,17
p_4,1,0,e_1,864,870,875,26,1,1,0,3,0,0,6,5,11
p_11,11,0,e_0,810,846,883,11,0,0,0,3,0,0,36,37,73
p_5,5,0,e_0,860,866,883,23,1,1,7,4,1,0,6,17,23
p_3,1,0,e_1,876,882,901,22,1,1,0,3,0,0,6,19,25
p_2,3,0,e_1,878,890,901,19,1,1,0,5,0,1,12,11,23
p_10,14,0,e_2,810,855,901,14,0,0,0,3,0,0,45,46,91
p_7,12,0,e_2,851,863,901,11,1,0,13,5,0,1,12,38,50
p_1,2,0,e_0,889,898,906,16,1,1,0,3,0,0,9,8,17
p_6,14,0,e_3,858,903,947,14,0,0,0,3,0,0,45,44,89
p_299,3,0,e_1,7,19,30,3,0,0,0,3,0,0,12,11,23
p_296,1,0,e_3,20,26,31,1,0,0,0,3,0,0,6,5,11
p_298,4,0,e_2,10,25,47,4,0,0,0,3,0,0,15,22,37
p_295,5,0,e_2,22,30,47,5,1,0,3,5,0,1,8,17,25
p_290,4,0,e_3,43,50,82,6,1,1,2,5,0,1,7,32,39
p_291,6,0,e_3,35,58,82,6,0,0,0,3,0,0,23,24,47
p_286,3,0,e_3,51,69,82,5,3,1,4,5,1,2,18,13,31
p_288,1,0,e_3,49,77,82,3,1,1,4,3,0,1,28,5,33
p_292,11,0,e_1,30,66,113,11,0,0,0,3,0,0,36,47,83
p_287,12,0,e_1,51,71,113,8,4,0,6,5,0,1,20,42,62
p_280,12,0,e_1,65,71,113,22,3,3,11,2,0,1,6,42,48
p_276,5,0,e_1,82,94,113,15,1,1,9,4,1,1,12,19,31
p_279,2,0,e_1,76,105,113,29,1,1,11,4,1,0,29,8,37
p_300,8,0,e_0,4,31,115,8,0,0,0,3,0,0,27,84,111
p_297,12,0,e_0,18,45,115,12,0,0,4,5,0,1,27,70,97
p_294,13,0,e_0,23,50,115,13,1,0,6,5,0,2,27,65,92
p_293,15,0,e_0,26,58,115,16,1,1,7,5,0,3,32,57,89
p_284,14,0,e_0,55,63,115,9,4,0,14,5,1,1,8,52,60
p_281,10,0,e_0,63,77,115,25,3,3,14,4,1,1,14,38,52
p_282,6,0,e_0,62,91,115,29,3,3,14,1,1,0,29,24,53
p_274,4,0,e_0,84,99,115,16,1,1,8,4,1,2,15,16,31
p_275,2,0,e_0,84,107,115,18,1,1,8,4,1,1,23,8,31
p_285,2,0,e_2,54,56,150,5,4,1,2,5,0,1,2,94,96
p_289,7,0,e_2,47,73,150,4,2,0,0,3,0,0,26,77,103
p_283,10,0,e_2,55,84,150,5,4,0,2,2,0,1,29,66,95
p_278,15,0,e_2,80,101,150,15,1,1,9,5,1,1,21,49,70
p_273,13,0,e_2,95,109,150,9,1,0,13,5,1,1,14,41,55
p_267,1,0,e_2,153,159,164,7,2,1,0,3,0,0,6,5,11
p_277,10,0,e_3,81,114,180,10,0,0,0,3,1,0,33,66,99
p_272,15,0,e_3,105,131,180,8,1,0,7,5,0,1,26,49,75
p_269,4,0,e_3,146,166,180,6,1,0,10,4,1,0,20,14,34
p_258,5,0,e_2,175,182,207,26,1,1,3,5,0,1,7,25,32
p_262,6,0,e_2,164,187,207,28,2,2,0,3,0,0,23,20,43
p_259,6,0,e_2,174,187,207,26,1,1,3,5,0,1,13,20,33
p_271,11,0,e_0,127,163,226,5,2,1,0,3,0,0,36,63,99
p_266,15,0,e_0,155,177,226,22,2,2,9,5,0,1,22,49,71
p_264,5,0,e_0,162,209,226,30,2,2,11,2,0,1,47,17,64
p_270,7,0,e_1,133,157,228,8,1,0,0,3,0,0,24,71,95
p_268,10,0,e_1,150,168,228,29,2,2,5,5,0,1,18,60,78
p_265,12,0,e_1,157,176,228,25,2,2,7,5,1,1,19,52,71
p_263,12,0,e_1,163,176,228,23,2,2,9,5,1,2,13,52,65
p_261,12,0,e_1,170,176,228,21,1,1,10,5,1,1,6,52,58
p_260,13,0,e_1,171,181,228,20,1,1,11,5,1,1,10,47,57
p_257,12,0,e_1,179,186,228,12,0,0,13,5,1,1,7,42,49
p_256,8,0,e_1,191,200,228,8,0,0,11,4,1,0,9,28,37
p_254,3,0,e_1,199,217,228,15,1,1,8,1,1,0,18,11,29
p_252,2,0,e_2,212,221,229,22,2,2,0,3,0,0,9,8,17
p_251,4,0,e_0,228,243,277,15,2,1,0,3,0,0,15,34,49
p_249,7,0,e_0,238,254,277,9,2,1,3,5,0,1,16,23,39
p_255,10,0,e_3,192,225,293,10,0,0,0,3,0,0,33,68,101
p_253,15,0,e_3,208,242,293,10,1,0,5,5,0,1,34,51,85
p_247,12,0,e_3,248,253,293,1,1,0,13,4,1,0,5,40,45
p_244,2,0,e_3,271,285,293,4,1,0,6,4,1,0,14,8,22
p_250,7,0,e_1,236,260,317,10,2,1,0,3,0,0,24,57,81
p_248,7,0,e_1,246,260,317,7,1,0,3,5,0,1,14,57,71
p_246,12,0,e_1,257,277,317,29,1,1,6,5,0,1,20,40,60
p_243,8,0,e_1,285,291,317,24,1,1,10,4,1,0,6,26,32
p_245,9,0,e_2,269,299,330,28,1,1,0,3,0,0,30,31,61
p_238,2,0,e_2,311,322,330,23,1,1,5,4,1,0,11,8,19
p_242,4,0,e_0,287,302,388,28,1,1,0,3,0,0,15,86,101
p_236,8,0,e_0,313,316,388,17,1,1,7,5,1,2,3,72,75
p_228,11,0,e_0,325,327,388,10,2,1,11,5,1,3,2,61,63
p_241,13,0,e_0,300,335,388,13,0,0,4,5,0,1,35,53,88
p_239,13,0,e_0,305,335,388,14,1,1,5,5,1,1,30,53,83
p_225,10,0,e_0,333,346,388,9,2,1,13,5,1,3,13,42,55
p_229,9,0,e_0,323,351,388,12,2,1,10,5,1,2,28,37,65
p_227,9,0,e_0,326,351,388,11,2,1,11,2,1,3,25,37,62
p_220,9,0,e_0,342,351,388,7,3,2,11,4,1,3,9,37,46
p_218,9,0,e_0,343,351,388,6,3,1,11,4,1,3,8,37,45
p_212,9,0,e_0,348,351,388,5,4,0,10,4,1,4,3,37,40
p_217,8,0,e_0,345,356,388,7,2,1,10,1,1,2,11,32,43
p_215,6,0,e_0,346,364,388,9,4,1,10,4,1,3,18,24,42
p_237,5,0,e_0,313,369,388,20,1,1,7,5,1,1,56,19,75
p_230,5,0,e_0,323,369,388,16,2,2,10,5,1,2,46,19,65
p_235,8,0,e_3,314,328,402,16,1,1,4,5,0,1,14,74,88
p_224,13,0,e_3,335,345,402,5,2,1,10,5,1,1,10,57,67
p_223,13,0,e_3,339,345,402,4,3,1,11,5,1,2,6,57,63
p_240,14,0,e_3,301,350,402,14,0,0,0,3,0,0,49,52,101
p_234,14,0,e_3,314,350,402,10,2,0,4,5,0,2,36,52,88
p_211,14,0,e_3,348,350,402,0,4,0,14,5,1,3,2,52,54
p_206,6,0,e_3,362,376,402,4,3,0,10,4,1,2,14,26,40
p_196,5,0,e_3,376,381,402,1,3,0,6,4,1,2,5,21,26
p_214,4,0,e_3,346,386,402,11,3,1,13,5,1,2,40,16,56
p_210,4,0,e_3,353,386,402,9,3,0,13,4,1,2,33,16,49
p_216,1,0,e_3,346,397,402,14,2,1,13,5,1,1,51,5,56
p_205,1,0,e_3,362,397,402,9,3,1,10,4,1,2,35,5,40
p_233,2,0,e_1,319,328,408,21,2,2,0,3,0,0,9,80,89
p_232,5,0,e_1,320,339,408,17,2,2,0,5,0,1,19,69,88
p_231,10,0,e_1,320,356,408,12,2,1,0,5,0,2,36,52,88
p_219,11,0,e_1,342,361,408,5,3,2,6,5,1,3,19,47,66
p_204,8,0,e_1,364,372,408,2,4,0,10,4,1,2,8,36,44
p_192,5,0,e_1,380,383,408,30,3,3,6,4,1,2,3,25,28
p_221,4,0,e_1,341,388,408,12,3,2,5,5,1,2,47,20,67
p_222,3,0,e_1,339,393,408,14,3,2,5,5,1,1,54,15,69
p_185,2,0,e_1,392,398,408,30,2,2,3,1,1,1,6,10,16
p_186,1,0,e_1,391,403,408,2,2,0,3,4,1,1,12,5,17
p_226,12,0,e_2,331,370,432,7,2,1,0,3,0,0,39,62,101
p_213,12,0,e_2,347,370,432,3,4,1,5,5,0,1,23,62,85
p_207,12,0,e_2,355,370,432,1,3,0,7,5,0,1,15,62,77
p_203,12,0,e_2,365,370,432,27,4,4,11,5,0,2,5,62,67
p_200,12,0,e_2,367,370,432,27,4,4,11,5,0,2,3,62,65
p_208,13,0,e_2,355,375,432,30,3,3,7,5,0,1,20,57,77
p_202,13,0,e_2,365,375,432,26,4,4,11,5,0,2,10,57,67
p_201,13,0,e_2,366,375,432,26,4,4,11,5,0,2,9,57,66
p_194,11,0,e_2,377,383,432,25,4,4,13,4,1,2,6,49,55
p_198,9,0,e_2,368,391,432,29,4,4,12,5,0,2,23,41,64
p_195,9,0,e_2,376,391,432,27,4,4,13,4,1,2,15,41,56
p_197,8,0,e_2,375,396,432,28,3,3,13,4,1,1,21,36,57
p_188,8,0,e_2,390,396,432,25,2,2,9,1,1,2,6,36,42
p_191,7,0,e_2,382,401,432,28,3,3,11,1,1,2,19,31,50
p_189,7,0,e_2,387,401,432,27,2,2,10,4,1,3,14,31,45
p_175,2,0,e_2,399,440,500,29,2,2,7,4,1,3,41,60,101
p_174,3,0,e_2,402,445,500,15,1,1,7,4,1,3,43,55,98
p_184,5,0,e_2,393,453,500,27,2,2,9,4,1,2,60,47,107
p_182,5,0,e_2,394,453,500,27,2,2,8,4,1,3,59,47,106
p_178,5,0,e_2,398,453,500,26,1,1,8,4,1,3,55,47,102
p_179,6,0,e_2,397,458,500,25,1,1,8,4,1,2,61,42,103
p_176,6,0,e_2,398,458,500,25,1,1,8,4,1,3,60,42,102
p_187,7,0,e_2,391,463,500,26,2,2,9,4,1,2,72,37,109
p_154,7,0,e_2,438,463,500,11,4,2,2,5,0,5,25,37,62
p_153,8,0,e_2,438,468,500,10,4,2,2,5,0,5,30,32,62
p_129,5,0,e_2,470,479,500,7,3,1,8,4,1,2,9,21,30
p_133,4,0,e_2,463,484,500,9,4,1,7,5,1,2,21,16,37
p_136,2,0,e_2,460,492,500,12,3,2,6,5,1,2,32,8,40
p_209,2,0,e_0,354,396,504,11,3,1,8,4,1,3,42,108,150
p_199,2,0,e_0,368,396,504,6,4,2,5,1,1,1,28,108,136
p_181,11,0,e_0,395,425,504,20,2,2,2,2,0,2,30,79,109
p_159,11,0,e_0,424,425,504,10,5,2,11,2,1,3,1,79,80
p_193,12,0,e_0,378,432,504,24,4,4,2,4,1,1,54,72,126
p_183,12,0,e_0,393,432,504,20,2,2,1,5,0,3,39,72,111
p_190,14,0,e_0,382,440,504,21,3,3,2,4,1,1,58,64,122
p_180,14,0,e_0,396,440,504,17,1,1,2,5,1,3,44,64,108
p_158,14,0,e_0,426,440,504,6,5,0,11,2,1,3,14,64,78
p_168,15,0,e_0,412,445,504,12,3,0,7,5,1,3,33,59,92
p_151,15,0,e_0,443,445,504,3,4,0,15,5,1,4,2,59,61
p_145,12,0,e_0,451,456,504,4,3,1,13,4,1,4,5,48,53
p_152,10,0,e_0,439,464,504,7,4,2,14,2,1,3,25,40,65
p_146,10,0,e_0,451,464,504,6,3,1,13,4,1,4,13,40,53
p_132,7,0,e_0,463,475,504,6,4,1,10,1,1,3,12,29,41
p_171,3,0,e_1,408,420,505,23,3,3,0,3,0,0,12,85,97
p_166,5,0,e_1,415,428,505,19,3,3,2,5,0,4,13,77,90
p_167,7,0,e_1,412,436,505,18,3,3,1,5,0,3,24,69,93
p_170,10,0,e_1,408,447,505,16,3,1,0,3,0,1,39,58,97
p_169,11,0,e_1,410,452,505,15,3,1,0,5,0,2,42,53,95
p_164,12,0,e_1,416,457,505,12,3,1,2,5,0,5,41,48,89
p_157,12,0,e_1,427,457,505,8,5,2,5,2,1,4,30,48,78
p_147,7,0,e_1,450,474,505,9,4,1,11,5,1,3,24,31,55
p_138,7,0,e_1,456,474,505,8,3,0,12,2,1,3,18,31,49
p_135,7,0,e_1,461,474,505,7,3,1,11,4,1,3,13,31,44
p_126,6,0,e_1,473,479,505,5,4,2,7,1,1,2,6,26,32
p_122,5,0,e_1,477,484,505,5,3,1,6,4,1,4,7,21,28
p_148,3,0,e_1,447,492,505,14,4,2,10,5,1,2,45,13,58
p_143,2,0,e_1,451,497,505,14,3,1,11,2,1,3,46,8,54
p_177,9,0,e_3,398,431,518,22,1,1,1,4,1,0,33,87,120
p_173,10,0,e_3,405,436,518,9,1,0,1,5,0,1,31,82,113
p_160,10,0,e_3,421,436,518,12,5,2,6,5,0,5,15,82,97
p_161,13,0,e_3,418,447,518,10,4,1,5,5,0,4,29,71,100
p_172,14,0,e_3,405,452,518,13,2,0,1,5,0,2,47,66,113
p_165,14,0,e_3,416,452,518,10,3,0,4,5,0,3,36,66,102
p_162,14,0,e_3,417,452,518,9,4,0,5,5,0,4,35,66,101
p_149,15,0,e_3,444,457,518,3,4,0,12,5,1,3,13,61,74
p_142,15,0,e_3,452,457,518,1,3,0,14,5,1,2,5,61,66
p_141,15,0,e_3,455,457,518,0,4,0,15,5,1,3,2,61,63
p_140,13,0,e_3,455,465,518,2,3,0,15,5,1,2,10,53,63
p_139,13,0,e_3,456,465,518,2,3,0,15,2,1,2,9,53,62
p_137,13,0,e_3,458,465,518,2,3,0,15,4,1,2,7,53,60
p_134,12,0,e_3,462,470,518,2,3,1,14,4,1,2,8,48,56
p_128,10,0,e_3,471,478,518,2,3,0,12,4,1,2,7,40,47
p_116,7,0,e_2,490,523,614,30,5,5,2,4,1,2,33,91,124
p_114,9,0,e_2,494,531,614,27,5,5,2,4,1,2,37,83,120
p_123,12,0,e_2,474,542,614,29,4,4,6,4,1,3,68,72,140
p_117,12,0,e_2,490,542,614,25,5,5,2,4,1,3,52,72,124
p_103,13,0,e_2,517,547,614,13,5,5,5,5,0,4,30,67,97
p_92,13,0,e_2,533,547,614,9,6,6,9,5,1,4,14,67,81
p_91,13,0,e_2,535,547,614,9,6,0,10,5,1,4,12,67,79
p_112,15,0,e_2,497,555,614,20,4,4,1,4,1,3,58,59,117
p_111,15,0,e_2,501,555,614,19,5,5,0,5,0,4,54,59,113
p_87,15,0,e_2,539,555,614,10,5,0,11,5,1,4,16,59,75
p_93,7,0,e_2,529,581,614,14,7,3,9,5,1,4,52,33,85
p_86,6,0,e_2,541,586,614,13,5,3,12,2,1,3,45,28,73
p_83,5,0,e_2,546,591,614,13,4,3,13,2,1,4,45,23,68
p_62,5,0,e_2,582,591,614,10,6,3,7,4,1,4,9,23,32
p_61,5,0,e_2,583,591,614,10,6,3,7,4,1,4,8,23,31
p_115,10,0,e_1,494,537,617,26,5,5,3,4,1,2,43,80,123
p_113,11,0,e_1,496,542,617,24,4,4,2,1,1,2,46,75,121
p_127,15,0,e_1,473,556,617,26,4,4,7,1,1,3,83,61,144
p_67,8,0,e_1,574,579,617,8,6,1,9,4,1,5,5,38,43
p_95,6,0,e_1,527,587,617,16,6,3,7,5,0,5,60,30,90
p_73,6,0,e_1,568,587,617,10,4,1,11,4,1,5,19,30,49
p_59,6,0,e_1,584,587,617,8,6,2,7,4,1,5,3,30,33
p_96,5,0,e_1,527,592,617,17,6,3,7,5,0,4,65,25,90
p_78,4,0,e_1,555,597,617,11,3,2,15,2,1,4,42,20,62
p_85,3,0,e_1,542,602,617,15,5,3,11,5,1,4,60,15,75
p_43,3,0,e_1,599,602,617,8,8,4,4,4,1,4,3,15,18
p_48,2,0,e_1,593,607,617,10,8,5,5,4,1,3,14,10,24
p_107,1,0,e_1,512,612,617,30,5,5,2,5,0,3,100,5,105
p_99,1,0,e_1,522,612,617,22,5,5,5,5,0,4,90,5,95
p_51,1,0,e_1,591,612,617,11,7,5,5,1,1,3,21,5,26
p_156,1,0,e_0,428,509,624,19,5,4,11,5,1,3,81,115,196
p_155,3,0,e_0,434,517,624,15,5,2,12,5,1,3,83,107,190
p_150,3,0,e_0,444,517,624,13,4,2,15,2,1,3,73,107,180
p_144,4,0,e_0,451,522,624,12,3,1,13,4,1,3,71,102,173
p_125,4,0,e_0,474,522,624,7,4,2,7,1,1,3,48,102,150
p_106,4,0,e_0,512,522,624,27,5,5,2,5,1,4,10,102,112
p_105,4,0,e_0,515,522,624,27,5,5,3,5,1,4,7,102,109
p_108,5,0,e_0,509,527,624,27,6,6,1,5,1,3,18,97,115
p_98,6,0,e_0,524,532,624,17,6,3,4,5,1,4,8,92,100
p_104,7,0,e_0,516,537,624,23,6,6,3,2,1,3,21,87,108
p_89,7,0,e_0,537,539,624,12,6,3,7,5,1,3,2,85,87
p_97,10,0,e_0,526,550,624,12,6,1,5,2,1,4,24,74,98
p_124,14,0,e_0,474,564,624,27,4,4,7,1,1,3,90,60,150
p_109,14,0,e_0,506,564,624,19,6,6,0,5,0,4,58,60,118
p_88,14,0,e_0,538,564,624,9,5,0,7,2,1,3,26,60,86
p_110,1,0,e_3,501,523,644,3,4,0,4,1,1,3,22,121,143
p_163,4,0,e_3,417,534,644,19,3,3,5,5,0,3,117,110,227
p_118,4,0,e_3,488,534,644,4,5,1,8,4,1,4,46,110,156
p_119,5,0,e_3,483,539,644,4,3,0,9,4,1,2,56,105,161
p_94,6,0,e_3,528,544,644,16,6,3,2,5,1,5,16,100,116
p_131,9,0,e_3,467,555,644,4,3,1,13,4,1,2,88,89,177
p_130,9,0,e_3,469,555,644,3,3,0,12,1,1,2,86,89,175
p_121,9,0,e_3,480,555,644,1,3,0,10,4,1,2,75,89,164
p_120,10,0,e_3,481,560,644,29,3,3,9,4,1,2,79,84,163
p_100,10,0,e_3,522,560,644,13,5,1,1,2,0,5,38,84,122
p_101,12,0,e_3,521,568,644,11,5,0,1,5,0,5,47,76,123
p_75,14,0,e_3,563,576,644,3,4,0,11,5,1,3,13,68,81
p_68,14,0,e_3,574,576,644,2,6,1,14,5,1,5,2,68,70
p_72,15,0,e_3,569,581,644,3,5,0,12,5,1,4,12,63,75
p_66,12,0,e_3,577,592,644,4,5,1,14,5,1,4,15,52,67
p_81,2,0,e_2,547,622,714,15,4,3,13,5,1,5,75,92,167
p_56,2,0,e_2,588,622,714,11,8,5,6,4,1,3,34,92,126
p_84,3,0,e_2,546,627,714,15,4,3,13,2,1,3,81,87,168
p_55,4,0,e_2,590,632,714,8,8,4,5,1,1,2,42,82,124
p_41,10,0,e_2,600,652,714,30,8,8,3,1,1,3,52,62,114
p_36,11,0,e_2,635,657,714,21,8,8,5,5,1,2,22,57,79
p_46,13,0,e_2,596,665,714,28,8,8,4,4,1,2,69,49,118
p_28,6,0,e_2,679,688,714,9,5,3,9,4,1,1,9,26,35
p_32,5,0,e_2,657,693,714,16,7,6,11,5,1,1,36,21,57
p_31,5,0,e_2,662,693,714,15,7,6,12,5,1,2,31,21,52
p_30,5,0,e_2,676,693,714,11,5,4,10,4,1,1,17,21,38
p_26,3,0,e_2,698,701,714,9,1,0,4,4,1,1,3,13,16
p_27,2,0,e_2,693,706,714,11,2,1,5,4,1,0,13,8,21
p_38,4,0,e_1,627,631,719,30,9,9,3,5,0,1,4,88,92
p_37,7,0,e_1,633,642,719,25,8,8,4,5,1,1,9,77,86
p_44,15,0,e_1,598,668,719,26,8,8,4,4,1,3,70,51,121
p_39,15,0,e_1,609,668,719,24,8,8,2,4,1,2,59,51,110
p_34,15,0,e_1,643,668,719,15,8,8,7,5,1,2,25,51,76
p_33,8,0,e_1,647,691,719,15,8,4,8,5,1,2,44,28,72
p_35,4,0,e_1,640,705,719,27,8,8,7,5,1,2,65,14,79
p_102,2,0,e_0,521,632,738,17,5,4,4,3,1,3,111,106,217
p_90,2,0,e_0,536,632,738,18,6,5,7,2,1,3,96,106,202
p_82,3,0,e_0,547,637,738,14,4,3,9,5,1,3,90,101,191
p_70,3,0,e_0,572,637,738,14,6,2,12,4,1,5,65,101,166
p_42,4,0,e_0,600,642,738,6,8,3,5,1,1,7,42,96,138
p_40,4,0,e_0,601,642,738,6,8,3,5,4,1,8,41,96,137
p_49,5,0,e_0,592,647,738,7,8,5,7,4,1,7,55,91,146
p_45,5,0,e_0,597,647,738,6,8,4,6,4,1,7,50,91,141
p_80,6,0,e_0,548,652,738,11,4,3,10,5,1,4,104,86,190
p_57,6,0,e_0,587,652,738,7,8,4,8,1,1,6,65,86,151
p_54,6,0,e_0,590,652,738,6,8,3,8,4,1,6,62,86,148
p_63,8,0,e_0,581,660,738,7,6,1,10,4,1,5,79,78,157
p_69,10,0,e_0,573,668,738,7,6,2,11,4,1,5,95,70,165
p_74,11,0,e_0,567,673,738,5,4,1,13,4,1,3,106,65,171
p_79,14,0,e_0,549,684,738,7,4,0,10,2,1,4,135,54,189
p_64,1,0,e_3,579,649,738,14,6,0,15,5,1,5,70,89,159
p_71,2,0,e_3,569,654,738,14,4,1,12,5,1,3,85,84,169
p_77,6,0,e_3,557,668,738,9,3,2,9,5,1,2,111,70,181
p_47,6,0,e_3,594,668,738,6,8,4,12,4,1,7,74,70,144
p_76,7,0,e_3,559,673,738,7,3,1,10,2,1,2,114,65,179
p_60,9,0,e_3,584,681,738,5,6,1,14,4,1,5,97,57,154
p_53,9,0,e_3,590,681,738,3,8,1,12,4,1,7,91,57,148
p_58,10,0,e_3,586,686,738,4,7,1,14,4,1,6,100,52,152
p_50,10,0,e_3,592,686,738,2,8,1,12,4,1,7,94,52,146
p_52,11,0,e_3,591,691,738,1,7,0,12,1,1,6,100,47,147
p_65,12,0,e_3,578,696,738,4,6,1,14,5,1,5,118,42,160
p_25,7,0,e_3,703,713,738,3,1,0,10,4,1,0,10,25,35
p_23,5,0,e_3,709,721,738,3,2,1,8,4,1,1,12,17,29
p_18,2,0,e_1,768,777,785,2,0,0,0,3,0,0,9,8,17
p_20,9,0,e_2,737,743,794,9,0,0,7,5,0,1,6,51,57
p_22,10,0,e_2,712,748,794,27,2,2,0,4,1,0,36,46,82
p_21,10,0,e_2,732,748,794,22,1,1,6,5,0,1,16,46,62
p_19,12,0,e_2,740,756,794,12,0,0,8,5,0,2,16,38,54
p_24,5,0,e_0,707,755,838,4,2,1,9,4,1,1,48,83,131
p_16,13,0,e_0,774,781,838,13,0,0,11,5,1,1,7,57,64
p_29,15,0,e_0,678,789,838,7,5,0,12,5,1,1,111,49,160
p_17,15,0,e_0,772,789,838,15,0,0,10,5,1,1,17,49,66
p_15,15,0,e_0,782,789,838,15,0,0,13,5,1,1,7,49,56
p_13,11,0,e_0,794,803,838,11,0,0,14,4,1,0,9,35,44
p_11,11,0,e_3,810,846,885,11,0,0,0,3,0,0,36,39,75
p_5,5,0,e_3,860,866,885,2,1,0,7,4,1,0,6,19,25
p_3,1,0,e_3,876,880,885,1,1,0,2,4,1,0,4,5,9
p_14,15,0,e_1,790,838,887,15,0,0,0,3,0,0,48,49,97
p_4,1,0,e_1,864,882,887,4,2,0,7,4,1,0,18,5,23
p_12,13,0,e_2,796,838,887,13,0,0,0,3,0,0,42,49,91
p_10,14,0,e_2,810,843,887,14,1,1,4,5,0,1,33,44,77
p_1,2,0,e_1,889,898,906,2,0,0,0,3,0,0,9,8,17
p_8,1,0,e_0,847,851,942,10,1,0,0,5,0,1,4,91,95
p_9,2,0,e_0,845,856,942,13,0,0,0,3,0,0,11,86,97
p_7,12,0,e_0,851,888,942,28,1,1,1,5,1,1,37,54,91
p_6,14,0,e_0,858,896,942,23,1,1,2,5,1,1,38,46,84
p_2,3,0,e_0,878,931,942,28,2,2,9,5,1,2,53,11,64
p_299,3,0,e_1,7,19,30,3,0,0,0,3,0,0,12,11,23
p_296,1,0,e_3,20,26,31,1,0,0,0,3,0,0,6,5,11
p_298,4,0,e_2,10,25,47,4,0,0,0,3,0,0,15,22,37
p_295,5,0,e_2,22,30,47,5,1,0,3,5,0,1,8,17,25
p_290,4,0,e_3,43,50,82,6,1,1,2,5,0,1,7,32,39
p_291,6,0,e_3,35,58,82,6,0,0,0,3,0,0,23,24,47
p_286,3,0,e_3,51,69,82,5,3,1,4,5,1,2,18,13,31
p_288,1,0,e_3,49,77,82,3,1,1,4,3,0,1,28,5,33
p_292,11,0,e_1,30,66,113,11,0,0,0,3,0,0,36,47,83
p_287,12,0,e_1,51,71,113,8,4,0,6,5,0,1,20,42,62
p_280,12,0,e_1,65,71,113,22,3,3,11,2,0,1,6,42,48
p_276,5,0,e_1,82,94,113,15,1,1,9,4,1,1,12,19,31
p_279,2,0,e_1,76,105,113,29,1,1,11,4,1,0,29,8,37
p_300,8,0,e_0,4,31,115,8,0,0,0,3,0,0,27,84,111
p_297,12,0,e_0,18,45,115,12,0,0,4,5,0,1,27,70,97
p_294,13,0,e_0,23,50,115,13,1,0,6,5,0,2,27,65,92
p_293,15,0,e_0,26,58,115,16,1,1,7,5,0,3,32,57,89
p_284,14,0,e_0,55,63,115,9,4,0,14,5,1,1,8,52,60
p_281,10,0,e_0,63,77,115,25,3,3,14,4,1,1,14,38,52
p_282,6,0,e_0,62,91,115,29,3,3,14,1,1,0,29,24,53
p_274,4,0,e_0,84,99,115,16,1,1,8,4,1,2,15,16,31
p_275,2,0,e_0,84,107,115,18,1,1,8,4,1,1,23,8,31
p_285,2,0,e_2,54,56,150,5,4,1,2,5,0,1,2,94,96
p_289,7,0,e_2,47,73,150,4,2,0,0,3,0,0,26,77,103
p_283,10,0,e_2,55,84,150,5,4,0,2,2,0,1,29,66,95
p_278,15,0,e_2,80,101,150,15,1,1,9,5,1,1,21,49,70
p_273,13,0,e_2,95,109,150,9,1,0,13,5,1,1,14,41,55
p_267,1,0,e_2,153,159,164,8,1,0,0,3,0,0,6,5,11
p_277,10,0,e_3,81,114,182,10,0,0,0,3,1,0,33,68,101
p_272,15,0,e_3,105,131,182,8,1,0,7,5,0,1,26,51,77
p_271,11,0,e_3,127,145,182,5,2,1,14,5,1,1,18,37,55
p_264,5,0,e_3,162,165,182,1,1,0,6,4,1,0,3,17,20
p_258,5,0,e_2,175,182,207,27,1,1,3,5,0,1,7,25,32
p_262,6,0,e_2,164,187,207,29,1,1,0,3,0,0,23,20,43
p_259,6,0,e_2,174,187,207,26,1,1,3,5,0,1,13,20,33
p_252,2,0,e_2,212,221,229,22,2,2,0,3,0,0,9,8,17
p_269,4,0,e_1,146,161,235,7,1,0,0,3,0,0,15,74,89
p_265,12,0,e_1,157,187,235,25,1,1,3,5,0,1,30,48,78
p_263,12,0,e_1,163,187,235,23,2,2,4,5,1,1,24,48,72
p_261,12,0,e_1,170,187,235,22,1,1,7,5,1,1,17,48,65
p_260,13,0,e_1,171,192,235,20,1,1,7,5,1,1,21,43,64
p_255,10,0,e_1,192,203,235,10,1,0,13,4,1,0,11,32,43
p_270,7,0,e_0,133,157,236,8,2,1,0,3,0,0,24,79,103
p_268,10,0,e_0,150,168,236,30,1,1,5,5,0,1,18,68,86
p_266,15,0,e_0,155,185,236,23,1,1,7,5,0,2,30,51,81
p_257,12,0,e_0,179,196,236,19,1,1,13,5,1,1,17,40,57
p_254,3,0,e_0,199,225,236,11,1,1,11,4,1,0,26,11,37
p_251,4,0,e_2,228,243,277,15,2,1,0,3,1,0,15,34,49
p_250,7,0,e_2,236,254,277,9,2,1,2,5,0,1,18,23,41
p_248,7,0,e_2,246,254,277,7,1,0,5,5,1,1,8,23,31
p_256,8,0,e_3,191,218,292,8,0,0,0,3,0,0,27,74,101
p_253,15,0,e_3,208,241,292,10,1,0,5,5,0,1,33,51,84
p_247,12,0,e_3,248,252,292,1,1,0,13,4,1,0,4,40,44
p_244,2,0,e_3,271,284,292,4,1,0,6,4,1,0,13,8,21
p_249,7,0,e_0,238,262,319,9,2,1,0,3,0,0,24,57,81
p_246,12,0,e_0,257,279,319,29,1,1,6,5,0,1,22,40,62
p_243,8,0,e_0,285,293,319,24,1,1,10,4,1,0,8,26,34
p_245,9,0,e_1,269,299,330,28,1,1,0,3,0,0,30,31,61
p_238,2,0,e_1,311,322,330,23,1,1,5,4,1,0,11,8,19
p_233,2,0,e_0,319,328,398,20,3,3,0,3,0,0,9,70,79
p_232,5,0,e_0,320,339,398,17,3,2,0,5,0,1,19,59,78
p_229,9,0,e_0,323,353,398,12,3,1,1,5,0,3,30,45,75
p_218,9,0,e_0,343,353,398,7,3,1,6,5,1,3,10,45,55
p_212,9,0,e_0,348,353,398,5,5,1,8,5,1,4,5,45,50
p_231,10,0,e_0,320,358,398,12,3,1,0,5,0,2,38,40,78
p_210,4,0,e_0,353,378,398,11,5,1,9,5,1,3,25,20,45
p_222,3,0,e_0,339,383,398,14,3,2,5,5,1,2,44,15,59
p_209,2,0,e_0,354,388,398,13,5,1,9,5,1,4,34,10,44
p_199,2,0,e_0,368,388,398,9,4,3,7,4,1,4,20,10,30
p_216,1,0,e_0,346,393,398,14,4,1,7,5,1,3,47,5,52
p_242,4,0,e_2,287,302,402,27,1,1,0,3,0,0,15,100,115
p_236,8,0,e_2,313,316,402,16,2,1,7,5,1,2,3,86,89
p_228,11,0,e_2,325,327,402,10,3,1,11,5,1,3,2,75,77
p_241,13,0,e_2,300,335,402,13,0,0,4,5,0,1,35,67,102
p_224,13,0,e_2,335,337,402,5,3,0,13,5,1,3,2,65,67
p_240,14,0,e_2,301,342,402,14,0,0,4,3,0,1,41,60,101
p_234,14,0,e_2,314,342,402,12,3,0,8,5,1,3,28,60,88
p_213,12,0,e_2,347,350,402,3,5,1,13,4,1,4,3,52,55
p_219,11,0,e_2,342,355,402,5,3,1,14,4,1,3,13,47,60
p_227,9,0,e_2,326,363,402,11,3,1,11,2,1,3,37,39,76
p_204,8,0,e_2,364,368,402,4,4,1,9,4,1,4,4,34,38
p_206,6,0,e_2,362,376,402,7,4,2,9,1,1,3,14,26,40
p_230,5,0,e_2,323,381,402,16,3,2,10,5,1,2,58,21,79
p_196,5,0,e_2,376,381,402,4,3,2,6,4,1,3,5,21,26
p_221,4,0,e_2,341,386,402,12,2,1,14,2,1,2,45,16,61
p_237,5,0,e_3,313,323,414,19,1,1,2,5,0,1,10,91,101
p_235,8,0,e_3,314,334,414,16,2,1,2,5,0,2,20,80,100
p_225,10,0,e_3,333,342,414,8,2,1,8,2,1,1,9,72,81
p_239,13,0,e_3,305,353,414,13,0,0,0,3,0,0,48,61,109
p_223,13,0,e_3,339,353,414,4,3,0,9,5,1,2,14,61,75
p_211,14,0,e_3,348,358,414,2,5,0,12,5,1,4,10,56,66
p_220,9,0,e_3,342,375,414,7,2,1,10,5,1,1,33,39,72
p_198,9,0,e_3,368,375,414,2,4,0,11,4,1,3,7,39,46
p_217,8,0,e_3,345,380,414,7,3,1,11,5,1,2,35,34,69
p_197,8,0,e_3,375,380,414,1,3,0,9,4,1,2,5,34,39
p_191,7,0,e_3,382,385,414,1,3,0,8,4,1,2,3,29,32
p_215,6,0,e_3,346,390,414,9,4,1,11,5,1,3,44,24,68
p_192,5,0,e_3,380,395,414,3,2,1,8,4,1,1,15,19,34
p_185,2,0,e_3,392,406,414,4,2,1,6,4,1,1,14,8,22
p_175,2,0,e_3,399,406,414,2,2,0,4,4,1,1,7,8,15
p_226,12,0,e_1,331,370,432,7,3,1,0,3,0,0,39,62,101
p_207,12,0,e_1,355,370,432,3,5,1,7,5,0,2,15,62,77
p_203,12,0,e_1,365,370,432,30,4,4,11,5,0,3,5,62,67
p_200,12,0,e_1,367,370,432,29,4,4,11,5,0,3,3,62,65
p_208,13,0,e_1,355,375,432,2,5,1,7,5,0,2,20,57,77
p_202,13,0,e_1,365,375,432,29,4,4,11,5,0,3,10,57,67
p_201,13,0,e_1,366,375,432,29,4,4,11,5,0,3,9,57,66
p_194,11,0,e_1,377,383,432,28,3,3,13,4,1,2,6,49,55
p_195,9,0,e_1,376,391,432,30,3,3,13,4,1,1,15,41,56
p_188,8,0,e_1,390,396,432,28,2,2,9,1,1,2,6,36,42
p_189,7,0,e_1,387,401,432,30,3,3,10,4,1,2,14,31,45
p_187,7,0,e_1,391,401,432,29,2,2,9,4,1,3,10,31,41
p_179,6,0,e_1,397,406,432,29,2,2,8,4,1,3,9,26,35
p_176,6,0,e_1,398,406,432,28,2,2,8,4,1,4,8,26,34
p_184,5,0,e_1,393,411,432,30,3,3,9,4,1,3,18,21,39
p_177,9,0,e_0,398,427,490,25,2,2,0,5,0,2,29,63,92
p_173,10,0,e_0,405,432,490,22,1,1,2,5,0,3,27,58,85
p_170,10,0,e_0,408,432,490,22,1,1,3,5,0,4,24,58,82
p_160,10,0,e_0,421,432,490,18,1,1,7,5,0,6,11,58,69
p_181,11,0,e_0,395,437,490,24,2,2,1,4,1,1,42,53,95
p_169,11,0,e_0,410,437,490,20,1,1,4,5,0,4,27,53,80
p_159,11,0,e_0,424,437,490,16,1,1,8,5,0,6,13,53,66
p_193,12,0,e_0,378,442,490,26,3,3,4,4,1,3,64,48,112
p_183,12,0,e_0,393,442,490,23,3,3,1,4,1,1,49,48,97
p_164,12,0,e_0,416,442,490,18,1,1,6,5,0,5,26,48,74
p_157,12,0,e_0,427,442,490,14,1,1,9,5,1,5,15,48,63
p_152,10,0,e_0,439,450,490,12,1,1,11,5,1,4,11,40,51
p_153,8,0,e_0,438,458,490,14,1,1,11,5,1,3,20,32,52
p_138,7,0,e_0,456,463,490,9,4,1,8,4,1,3,7,27,34
p_166,5,0,e_0,415,471,490,25,1,1,5,5,0,4,56,19,75
p_174,3,0,e_1,402,443,490,30,2,2,7,4,1,3,41,47,88
p_171,3,0,e_1,408,443,490,29,1,1,6,4,1,3,35,47,82
p_155,3,0,e_1,434,443,490,21,1,1,0,5,0,3,9,47,56
p_214,4,0,e_1,346,448,490,11,4,1,4,5,0,1,102,42,144
p_182,5,0,e_1,394,453,490,30,2,2,8,4,1,4,59,37,96
p_178,5,0,e_1,398,453,490,29,2,2,8,4,1,4,55,37,92
p_154,7,0,e_1,438,461,490,15,1,1,2,5,0,3,23,29,52
p_147,7,0,e_1,450,461,490,11,1,1,4,5,1,3,11,29,40
p_144,4,0,e_1,451,472,490,14,1,1,5,5,1,4,21,18,39
p_150,3,0,e_1,444,477,490,17,1,1,3,5,1,3,33,13,46
p_148,3,0,e_1,447,477,490,16,1,1,4,3,1,3,30,13,43
p_143,2,0,e_1,451,482,490,16,1,1,5,5,1,3,31,8,39
p_136,2,0,e_1,460,482,490,13,3,0,7,2,1,3,22,8,30
p_205,1,0,e_2,362,407,506,12,4,3,9,1,1,2,45,99,144
p_186,1,0,e_2,391,407,506,5,2,1,3,4,1,2,16,99,115
p_167,7,0,e_2,412,427,506,23,1,1,2,5,1,1,15,79,94
p_161,13,0,e_2,418,447,506,16,1,1,4,5,1,2,29,59,88
p_190,14,0,e_2,382,452,506,24,4,4,5,4,1,2,70,54,124
p_180,14,0,e_2,396,452,506,21,2,2,1,1,1,1,56,54,110
p_172,14,0,e_2,405,452,506,18,1,1,1,5,0,2,47,54,101
p_165,14,0,e_2,416,452,506,16,1,1,4,5,1,2,36,54,90
p_162,14,0,e_2,417,452,506,15,1,1,4,5,1,2,35,54,89
p_158,14,0,e_2,426,452,506,12,1,1,7,2,1,2,26,54,80
p_135,7,0,e_2,461,475,506,8,4,3,11,4,1,1,14,31,45
p_132,7,0,e_2,463,475,506,8,4,3,11,4,1,2,12,31,43
p_126,6,0,e_2,473,480,506,6,3,2,7,4,1,3,7,26,33
p_129,5,0,e_2,470,485,506,8,4,3,8,4,1,2,15,21,36
p_122,5,0,e_2,477,485,506,6,3,2,7,4,1,4,8,21,29
p_168,15,0,e_3,412,461,524,15,1,1,0,4,1,0,49,63,112
p_151,15,0,e_3,443,461,524,6,1,0,9,5,0,1,18,63,81
p_149,15,0,e_3,444,461,524,5,1,0,10,5,0,1,17,63,80
p_142,15,0,e_3,452,461,524,3,3,0,12,5,0,3,9,63,72
p_141,15,0,e_3,455,461,524,2,4,0,13,5,0,4,6,63,69
p_140,13,0,e_3,455,469,524,4,3,1,13,5,0,3,14,55,69
p_139,13,0,e_3,456,469,524,3,4,1,14,5,0,4,13,55,68
p_137,13,0,e_3,458,469,524,3,4,1,14,5,0,4,11,55,66
p_145,12,0,e_3,451,474,524,6,2,1,12,5,0,2,23,50,73
p_134,12,0,e_3,462,474,524,3,4,1,15,4,1,3,12,50,62
p_146,10,0,e_3,451,482,524,8,1,1,12,5,0,1,31,42,73
p_128,10,0,e_3,471,482,524,3,4,1,13,4,1,3,11,42,53
p_131,9,0,e_3,467,487,524,4,4,2,13,4,1,3,20,37,57
p_130,9,0,e_3,469,487,524,4,4,2,13,4,1,3,18,37,55
p_121,9,0,e_3,480,487,524,1,3,0,10,4,1,2,7,37,44
p_163,4,0,e_0,417,504,600,25,1,1,6,5,0,5,87,96,183
p_133,4,0,e_0,463,504,600,11,4,3,7,4,1,2,41,96,137
p_123,12,0,e_0,474,530,600,30,3,3,4,4,1,2,56,70,126
p_127,15,0,e_0,473,541,600,27,3,3,5,4,1,1,68,59,127
p_112,15,0,e_0,497,541,600,22,3,3,2,5,0,3,44,59,103
p_111,15,0,e_0,501,541,600,20,5,5,3,5,0,3,40,59,99
p_87,15,0,e_0,539,541,600,11,5,5,15,5,1,6,2,59,61
p_93,7,0,e_0,529,567,600,12,6,1,12,2,1,5,38,33,71
p_76,7,0,e_0,559,567,600,5,5,1,9,4,1,5,8,33,41
p_94,6,0,e_0,528,572,600,13,5,2,12,5,1,5,44,28,72
p_86,6,0,e_0,541,572,600,10,5,2,15,4,1,5,31,28,59
p_80,6,0,e_0,548,572,600,8,6,2,13,4,1,5,24,28,52
p_73,6,0,e_0,568,572,600,12,6,2,7,4,1,4,4,28,32
p_108,5,0,e_0,509,577,600,29,4,4,5,5,1,2,68,23,91
p_106,4,0,e_0,512,582,600,29,5,5,6,5,1,3,70,18,88
p_114,9,0,e_1,494,519,600,28,3,3,1,5,0,3,25,81,106
p_120,10,0,e_1,481,524,600,30,2,2,2,1,1,1,43,76,119
p_115,10,0,e_1,494,524,600,27,3,3,1,5,0,4,30,76,106
p_100,10,0,e_1,522,524,600,20,5,5,10,5,1,5,2,76,78
p_113,11,0,e_1,496,529,600,26,3,3,2,5,0,4,33,71,104
p_117,12,0,e_1,490,534,600,26,4,4,0,5,0,2,44,66,110
p_103,13,0,e_1,517,539,600,18,5,5,9,5,0,5,22,61,83
p_92,13,0,e_1,533,539,600,11,6,0,12,2,1,4,6,61,67
p_91,13,0,e_1,535,539,600,10,6,0,12,5,1,4,4,61,65
p_124,14,0,e_1,474,544,600,28,3,3,4,4,1,2,70,56,126
p_88,14,0,e_1,538,544,600,10,6,0,13,2,1,5,6,56,62
p_89,7,0,e_1,537,567,600,10,6,1,13,5,1,5,30,33,63
p_95,6,0,e_1,527,572,600,13,6,2,11,5,1,5,45,28,73
p_96,5,0,e_1,527,577,600,14,6,3,11,5,1,4,50,23,73
p_85,3,0,e_1,542,585,600,13,5,4,14,5,1,5,43,15,58
p_156,1,0,e_2,428,511,612,25,1,1,7,5,1,2,83,101,184
p_125,4,0,e_2,474,522,612,8,3,2,7,1,1,3,48,90,138
p_105,4,0,e_2,515,522,612,28,5,5,2,5,1,2,7,90,97
p_104,7,0,e_2,516,533,612,25,5,5,2,5,1,2,17,79,96
p_101,12,0,e_2,521,550,612,19,4,4,4,3,1,3,29,62,91
p_109,14,0,e_2,506,558,612,20,5,5,0,5,0,2,52,54,106
p_79,14,0,e_2,549,558,612,8,5,0,12,2,1,3,9,54,63
p_67,8,0,e_2,574,578,612,10,7,2,9,4,1,3,4,34,38
p_77,6,0,e_2,557,586,612,7,5,1,14,2,1,2,29,26,55
p_83,5,0,e_2,546,591,612,10,5,3,11,5,1,3,45,21,66
p_62,5,0,e_2,582,591,612,11,8,1,7,4,1,3,9,21,30
p_61,5,0,e_2,583,591,612,11,8,1,7,4,1,3,8,21,29
p_55,4,0,e_2,590,596,612,10,9,5,5,1,1,1,6,16,22
p_102,2,0,e_2,521,604,612,29,4,4,4,3,1,2,83,8,91
p_56,2,0,e_2,588,604,612,13,9,7,6,4,1,2,16,8,24
p_110,1,0,e_3,501,529,654,4,4,1,5,4,1,3,28,125,153
p_107,1,0,e_3,512,529,654,2,5,0,3,4,1,4,17,125,142
p_118,4,0,e_3,488,540,654,5,2,1,9,4,1,1,52,114,166
p_119,5,0,e_3,483,545,654,5,2,1,10,4,1,1,62,109,171
p_98,6,0,e_3,524,550,654,8,4,1,0,5,0,4,26,104,130
p_116,7,0,e_3,490,555,654,1,3,0,8,4,1,2,65,99,164
p_97,10,0,e_3,526,566,654,10,5,0,0,5,0,5,40,88,128
p_74,11,0,e_3,567,571,654,7,5,1,10,5,1,4,4,83,87
p_75,14,0,e_3,563,582,654,5,5,0,9,5,1,4,19,72,91
p_68,14,0,e_3,574,582,654,4,7,1,12,5,1,6,8,72,80
p_72,15,0,e_3,569,587,654,4,6,0,11,5,1,5,18,67,85
p_66,12,0,e_3,577,598,654,5,7,2,13,5,1,6,21,56,77
p_65,12,0,e_3,578,598,654,5,8,2,13,5,1,7,20,56,76
p_52,11,0,e_3,591,603,654,3,9,1,14,4,1,8,12,51,63
p_69,10,0,e_3,573,608,654,9,6,2,11,5,1,5,35,46,81
p_64,1,0,e_1,579,605,688,16,8,2,5,4,1,2,26,83,109
p_90,2,0,e_1,536,610,688,15,6,5,12,5,1,4,74,78,152
p_82,3,0,e_1,547,615,688,12,6,3,13,4,1,5,68,73,141
p_70,3,0,e_1,572,615,688,16,6,2,6,4,1,3,43,73,116
p_43,3,0,e_1,599,615,688,9,10,7,0,3,1,3,16,73,89
p_42,4,0,e_1,600,620,688,8,10,6,0,5,0,3,20,68,88
p_40,4,0,e_1,601,620,688,7,10,5,0,5,0,5,19,68,87
p_41,10,0,e_1,600,640,688,2,10,1,0,5,0,4,40,48,88
p_36,11,0,e_1,635,645,688,23,8,8,9,5,1,3,10,43,53
p_33,8,0,e_1,647,656,688,24,8,8,11,4,1,2,9,32,41
p_37,7,0,e_1,633,661,688,28,8,8,8,5,1,2,28,27,55
p_32,5,0,e_1,657,669,688,14,8,4,8,4,1,2,12,19,31
p_31,5,0,e_1,662,669,688,13,8,4,7,4,1,2,7,19,26
p_38,4,0,e_1,627,674,688,2,8,1,6,5,1,1,47,14,61
p_35,4,0,e_1,640,674,688,29,8,8,10,5,1,3,34,14,48
p_99,1,0,e_0,522,605,706,29,5,5,10,5,1,4,83,101,184
p_51,1,0,e_0,591,605,706,13,9,8,2,4,1,1,14,101,115
p_71,2,0,e_0,569,610,706,15,6,1,7,4,1,4,41,96,137
p_49,5,0,e_0,592,621,706,9,10,6,2,4,1,1,29,85,114
p_46,13,0,e_0,596,647,706,29,10,10,1,4,1,2,51,59,110
p_39,15,0,e_0,609,655,706,25,8,8,2,2,1,2,46,51,97
p_34,15,0,e_0,643,655,706,18,8,8,12,5,1,2,12,51,63
p_28,6,0,e_0,679,684,706,19,6,4,7,4,1,1,5,22,27
p_30,5,0,e_0,676,689,706,10,5,4,8,4,1,0,13,17,30
p_48,2,0,e_2,593,620,708,11,10,8,5,4,1,2,27,88,115
p_44,15,0,e_2,598,661,708,27,10,10,4,4,1,1,63,47,110
p_24,5,0,e_0,707,725,742,13,2,1,0,3,0,0,18,17,35
p_23,5,0,e_2,709,727,744,12,2,1,0,3,0,0,18,17,35
p_27,2,0,e_1,693,702,764,19,4,2,0,3,0,0,9,62,71
p_26,3,0,e_1,698,707,764,17,3,1,1,5,0,1,9,57,66
p_25,7,0,e_1,703,721,764,12,2,1,2,5,1,1,18,43,61
p_22,10,0,e_1,712,732,764,6,2,1,4,5,1,1,20,32,52
p_81,2,0,e_3,547,662,764,13,5,3,5,5,1,4,115,102,217
p_84,3,0,e_3,546,667,764,12,4,3,5,5,1,3,121,97,218
p_78,4,0,e_3,555,672,764,9,4,1,7,5,1,3,117,92,209
p_45,5,0,e_3,597,677,764,7,9,5,12,1,1,8,80,87,167
p_59,6,0,e_3,584,682,764,10,8,1,14,5,1,7,98,82,180
p_57,6,0,e_3,587,682,764,9,9,4,15,4,1,8,95,82,177
p_54,6,0,e_3,590,682,764,8,9,4,14,4,1,8,92,82,174
p_47,6,0,e_3,594,682,764,7,10,5,13,4,1,9,88,82,170
p_63,8,0,e_3,581,690,764,8,7,1,14,2,1,6,109,74,183
p_60,9,0,e_3,584,695,764,7,9,1,14,5,1,8,111,69,180
p_53,9,0,e_3,590,695,764,5,9,2,14,4,1,8,105,69,174
p_58,10,0,e_3,586,700,764,5,9,0,15,2,1,8,114,64,178
p_50,10,0,e_3,592,700,764,4,10,2,14,4,1,9,108,64,172
p_29,15,0,e_3,678,717,764,10,5,0,5,5,1,4,39,47,86
p_18,2,0,e_1,768,777,785,2,0,0,0,3,0,0,9,8,17
p_20,9,0,e_2,737,773,802,30,1,1,2,4,1,0,36,29,65
p_21,10,0,e_0,732,774,844,30,1,1,3,4,1,0,42,70,112
p_19,12,0,e_0,740,782,844,26,1,1,0,4,1,1,42,62,104
p_17,15,0,e_0,772,793,844,15,0,0,10,5,0,2,21,51,72
p_15,15,0,e_0,782,793,844,13,1,0,12,5,1,1,11,51,62
p_14,15,0,e_0,790,793,844,10,1,0,14,5,1,1,3,51,54
p_12,13,0,e_0,796,801,844,6,1,0,14,4,1,1,5,43,48
p_13,11,0,e_0,794,809,844,9,1,1,15,4,1,0,15,35,50
p_8,1,0,e_1,847,853,858,5,1,0,0,3,0,0,6,5,11
p_9,2,0,e_0,845,854,862,5,1,0,0,3,0,0,9,8,17
p_16,13,0,e_3,774,816,867,13,0,0,0,3,0,0,42,51,93
p_10,14,0,e_3,810,821,867,3,2,0,11,5,0,2,11,46,57
p_11,11,0,e_3,810,832,867,4,1,1,11,5,0,1,22,35,57
p_4,1,0,e_0,864,870,875,30,1,1,0,3,0,0,6,5,11
p_3,1,0,e_0,876,882,887,1,0,0,0,3,0,0,6,5,11
p_5,5,0,e_1,860,878,895,27,1,1,0,3,0,0,18,17,35
p_2,3,0,e_3,878,890,901,3,0,0,0,3,0,0,12,11,23
p_1,2,0,e_0,889,898,906,5,0,0,0,3,0,0,9,8,17
p_7,12,0,e_2,851,890,942,23,1,1,0,3,0,0,39,52,91
p_6,14,0,e_2,858,898,942,19,1,1,2,5,0,1,40,44,84
