p_3,4,0,e_2,25,40,88,4,0,0,0,3,0,0,15,48,63
p_4,5,0,e_2,34,45,88,5,0,0,2,5,0,1,11,43,54
p_5,9,0,e_2,41,59,88,9,0,0,4,5,1,1,18,29,47
p_6,9,0,e_2,45,59,88,9,0,0,5,5,1,1,14,29,43
p_2,11,0,e_1,19,55,90,11,0,0,0,3,0,0,36,35,71
p_1,13,0,e_0,13,55,96,13,0,0,0,3,0,0,42,41,83
p_12,0,8,e_1,86,90,116,21,3,3,1,4,1,0,4,26,30
p_15,5,0,e_0,99,117,134,13,3,2,0,3,0,0,18,17,35
p_11,4,0,e_2,84,102,144,18,4,3,1,4,1,0,18,42,60
p_16,4,0,e_2,101,102,144,13,3,1,4,3,0,1,1,42,43
p_13,8,0,e_2,87,118,144,13,3,2,0,3,1,1,31,26,57
p_19,0,7,e_0,125,134,159,11,1,0,3,4,1,0,9,25,34
p_7,2,0,e_3,55,64,160,2,0,0,0,3,0,0,9,96,105
p_10,9,0,e_3,77,87,160,15,3,2,6,5,1,2,10,73,83
p_9,10,0,e_3,67,92,160,17,2,1,3,5,1,1,25,68,93
p_14,13,0,e_3,87,103,160,8,3,1,9,5,1,2,16,57,73
p_8,15,0,e_3,62,111,160,13,1,0,2,5,0,1,49,49,98
p_20,3,0,e_3,142,149,160,2,1,0,5,4,1,0,7,11,18
p_21,0,10,e_2,142,144,176,5,1,0,0,4,1,0,2,32,34
p_17,10,0,e_1,112,124,188,5,1,0,7,5,1,0,12,64,76
p_18,15,0,e_1,120,141,188,27,1,1,9,5,0,1,21,47,68
p_30,2,0,e_1,200,209,217,16,3,1,0,3,0,0,9,8,17
p_22,6,0,e_0,146,154,236,28,2,2,4,5,1,0,8,82,90
p_23,15,0,e_0,150,185,236,18,1,1,5,5,1,1,35,51,86
p_31,5,0,e_0,203,217,236,12,3,1,9,4,1,0,14,19,33
p_36,1,0,e_0,225,231,236,10,2,1,3,4,1,0,6,5,11
p_24,14,0,e_2,157,190,236,17,1,1,4,5,1,0,33,46,79
p_33,1,0,e_2,213,231,236,13,2,0,7,4,1,0,18,5,23
p_32,0,10,e_1,209,217,249,15,3,3,2,4,1,0,8,32,40
p_35,0,6,e_0,222,236,256,12,3,0,4,4,1,0,14,20,34
p_26,6,0,e_3,169,184,262,11,1,1,1,5,0,1,15,78,93
p_28,7,0,e_3,184,189,262,5,3,1,6,5,1,2,5,73,78
p_25,9,0,e_3,163,197,262,9,0,0,0,3,0,0,34,65,99
p_29,14,0,e_3,192,214,262,6,3,0,8,5,1,2,22,48,70
p_34,11,0,e_3,217,225,262,2,2,0,13,4,1,1,8,37,45
p_27,5,0,e_3,180,245,262,8,2,2,5,5,0,2,65,17,82
p_42,4,0,e_3,269,284,298,4,0,0,0,3,0,0,15,14,29
p_43,4,0,e_3,270,284,298,4,1,0,0,5,0,1,14,14,28
p_44,4,0,e_3,275,284,298,3,1,0,1,5,0,1,9,14,23
p_37,15,0,e_1,228,266,317,25,2,2,3,5,1,0,38,51,89
p_40,15,0,e_1,255,266,317,17,1,1,12,5,0,1,11,51,62
p_41,7,0,e_1,257,292,317,24,1,1,12,5,0,1,35,25,60
p_47,3,0,e_1,293,306,317,28,2,2,7,4,1,0,13,11,24
p_38,12,0,e_2,240,279,319,24,2,2,0,3,0,0,39,40,79
p_49,3,0,e_2,298,308,319,19,2,2,6,4,1,0,10,11,21
p_39,13,0,e_0,247,279,322,22,1,1,3,5,1,0,32,43,75
p_46,8,0,e_0,291,296,322,24,2,2,9,4,1,0,5,26,31
p_51,0,4,e_1,309,317,331,19,2,2,2,4,1,0,8,14,22
p_57,1,0,e_2,327,333,338,18,4,2,0,3,0,0,6,5,11
p_58,0,6,e_2,330,338,358,19,3,3,0,5,0,1,8,20,28
p_53,8,0,e_1,313,345,375,15,4,3,1,4,1,0,32,30,62
p_59,3,0,e_1,335,362,375,14,3,1,5,5,0,1,27,13,40
p_60,2,0,e_1,338,367,375,15,2,1,6,5,0,2,29,8,37
p_63,3,0,e_2,364,369,382,6,1,0,4,4,0,1,5,13,18
p_62,1,0,e_2,345,377,382,14,2,1,2,5,1,0,32,5,37
p_54,7,0,e_3,313,321,392,16,3,3,5,5,0,3,8,71,79
p_48,9,0,e_3,294,329,392,22,2,2,1,4,1,1,35,63,98
p_45,11,0,e_3,290,337,392,21,1,1,2,4,1,0,47,55,102
p_50,11,0,e_3,299,337,392,11,2,0,0,5,0,2,38,55,93
p_52,14,0,e_3,312,348,392,10,2,0,4,5,0,2,36,44,80
p_55,14,0,e_3,314,348,392,9,4,0,5,5,0,4,34,44,78
p_65,0,7,e_1,369,375,398,7,1,0,2,4,1,0,6,23,29
p_56,8,0,e_0,324,351,405,12,4,3,0,3,0,0,27,54,81
p_61,12,0,e_0,341,365,405,4,2,1,5,5,0,1,24,40,64
p_68,2,0,e_0,389,397,405,29,1,1,4,4,1,0,8,8,16
p_64,0,15,e_1,365,375,426,9,1,0,2,4,1,1,10,51,61
p_69,2,0,e_3,391,400,444,2,0,0,0,3,1,0,9,44,53
p_70,3,0,e_3,398,405,444,1,1,0,2,5,0,1,7,39,46
p_71,7,0,e_3,403,419,444,4,2,0,3,5,1,1,16,25,41
p_72,6,0,e_3,417,424,444,1,2,0,7,5,1,1,7,20,27
p_73,3,0,e_0,423,435,446,3,1,0,0,3,0,0,12,11,23
p_66,11,0,e_2,376,417,454,24,1,1,1,1,1,0,41,37,78
p_75,3,0,e_2,438,443,454,29,1,1,4,4,1,0,5,11,16
p_67,12,0,e_1,377,415,477,23,1,1,0,5,2,0,38,62,100
p_74,10,0,e_1,424,443,477,26,1,1,15,5,2,0,19,34,53
p_76,10,0,e_1,440,443,477,21,1,1,11,4,1,1,3,34,37
p_77,4,0,e_1,455,463,477,4,0,0,6,4,1,0,8,14,22
p_81,1,0,e_1,493,499,504,1,0,0,0,3,0,0,6,5,11
p_79,9,0,e_2,457,487,516,9,0,0,0,3,0,0,30,29,59
p_82,0,12,e_3,494,495,535,0,0,0,0,3,0,0,1,40,41
p_78,12,0,e_0,455,494,542,12,0,0,0,3,0,0,39,48,87
p_80,13,0,e_0,474,499,542,13,0,0,6,5,0,1,25,43,68
p_87,3,0,e_0,528,531,542,15,2,2,4,4,1,0,3,11,14
p_83,0,12,e_1,501,504,544,23,1,1,1,4,1,0,3,40,43
p_90,1,0,e_2,538,541,572,14,2,1,0,5,0,1,3,31,34
p_89,5,0,e_2,535,555,572,11,2,1,0,3,0,0,20,17,37
p_97,5,0,e_2,552,555,572,6,1,0,4,5,1,1,3,17,20
p_94,3,0,e_0,546,555,574,10,1,0,0,5,0,1,9,19,28
p_93,4,0,e_0,543,560,574,10,1,0,0,3,0,0,17,14,31
p_88,10,0,e_1,531,536,586,7,2,2,9,5,1,0,5,50,55
p_92,10,0,e_1,540,552,586,5,2,1,11,5,2,0,12,34,46
p_95,10,0,e_1,547,552,586,3,1,0,11,4,1,1,5,34,39
p_96,7,0,e_1,551,563,586,5,1,0,10,1,1,0,12,23,35
p_84,12,0,e_3,504,535,591,10,1,0,2,5,1,0,31,56,87
p_85,14,0,e_3,517,543,591,8,1,0,6,5,1,0,26,48,74
p_86,14,0,e_3,518,543,591,7,2,0,7,5,1,1,25,48,73
p_91,14,0,e_3,539,543,591,1,2,0,13,5,1,1,4,48,52
p_99,9,0,e_3,556,560,591,1,2,0,10,4,1,1,4,31,35
p_98,6,0,e_3,555,571,591,4,1,0,10,4,1,0,16,20,36
p_107,3,0,e_1,584,597,666,29,1,1,0,4,1,0,13,69,82
p_110,12,0,e_1,590,626,666,12,1,1,1,5,0,1,36,40,76
p_113,9,0,e_1,629,637,666,2,2,0,11,4,1,0,8,29,37
p_101,9,0,e_2,566,601,666,28,2,2,2,4,1,0,35,65,100
p_105,12,0,e_2,582,612,666,21,1,1,3,5,0,2,30,54,84
p_102,14,0,e_2,568,620,666,23,2,2,1,4,1,1,52,46,98
p_104,14,0,e_2,581,620,666,19,1,1,3,5,0,2,39,46,85
p_115,9,0,e_2,632,637,666,1,2,0,10,4,1,0,5,29,34
p_109,10,0,e_3,590,623,667,10,0,0,0,3,1,0,33,44,77
p_112,11,0,e_3,613,628,667,4,2,0,7,5,0,2,15,39,54
p_116,7,0,e_3,633,642,667,3,2,0,10,4,1,1,9,25,34
p_111,2,0,e_3,607,659,667,13,1,1,5,5,0,1,52,8,60
p_106,5,0,e_0,583,591,670,27,1,1,3,5,0,2,8,79,87
p_108,7,0,e_0,584,599,670,25,1,1,3,5,0,3,15,71,86
p_100,10,0,e_0,557,610,670,30,3,3,3,5,1,1,53,60,113
p_103,14,0,e_0,577,624,670,20,1,1,1,5,0,1,47,46,93
p_121,3,0,e_0,656,659,670,30,2,2,4,4,1,1,3,11,14
p_117,0,2,e_1,636,666,674,9,3,0,9,1,1,0,30,8,38
p_123,0,2,e_2,661,666,674,2,2,0,1,4,1,1,5,8,13
p_125,2,0,e_3,668,675,717,12,1,1,0,5,0,1,7,42,49
p_122,7,0,e_3,657,692,717,25,2,2,2,4,1,1,35,25,60
p_126,1,0,e_3,681,712,717,9,2,1,4,5,1,1,31,5,36
p_124,7,0,e_2,664,691,722,24,2,2,0,4,1,1,27,31,58
p_119,8,0,e_2,650,696,722,27,2,2,5,4,1,0,46,26,72
p_114,13,0,e_0,632,711,756,27,2,2,12,4,1,0,79,45,124
p_127,7,0,e_0,701,731,756,27,2,2,10,5,0,1,30,25,55
p_129,5,0,e_0,705,739,756,28,2,2,11,5,0,2,34,17,51
p_118,8,0,e_1,649,694,758,27,2,2,5,4,1,0,45,64,109
p_120,13,0,e_1,653,711,758,21,2,2,4,4,1,1,58,47,105
p_130,11,0,e_1,705,719,758,22,2,2,11,5,1,1,14,39,53
p_131,7,0,e_1,722,733,758,22,1,1,10,4,1,0,11,25,36
p_133,6,0,e_1,734,738,758,19,1,1,7,4,1,0,4,20,24
p_128,0,15,e_3,705,717,766,3,2,0,3,4,1,1,12,49,61
p_139,0,15,e_1,758,759,808,17,2,2,0,3,0,0,1,49,50
p_134,14,0,e_3,734,761,817,11,1,1,5,5,1,0,27,56,83
p_136,14,0,e_3,749,761,817,6,2,1,10,5,1,1,12,56,68
p_141,12,0,e_3,770,777,817,2,2,0,14,4,1,1,7,40,47
p_140,5,0,e_3,768,800,817,10,1,0,15,4,1,0,32,17,49
p_132,4,0,e_2,730,745,819,22,1,1,0,3,0,0,15,74,89
p_135,11,0,e_2,739,768,819,12,2,2,2,5,0,1,29,51,80
p_137,13,0,e_2,755,776,819,5,2,2,7,5,1,1,21,43,64
p_142,13,0,e_2,773,776,819,30,3,3,12,5,1,1,3,43,46
p_143,5,0,e_2,780,802,819,6,2,0,12,4,1,0,22,17,39
p_145,1,0,e_2,820,826,831,1,0,0,0,3,0,0,6,5,11
p_138,12,0,e_0,756,795,833,5,2,2,0,3,0,0,39,38,77
p_144,6,0,e_1,815,845,865,24,1,1,15,3,0,0,30,20,50
p_147,6,0,e_2,849,870,894,6,0,0,0,3,0,0,21,24,45
p_149,6,0,e_2,859,870,894,21,1,1,3,5,0,1,11,24,35
p_154,4,0,e_2,874,878,894,18,1,1,5,4,1,1,4,16,20
p_150,3,0,e_2,860,883,894,24,1,1,3,5,0,1,23,11,34
p_152,2,0,e_1,868,877,919,22,1,1,0,3,0,0,9,42,51
p_153,6,0,e_1,872,891,919,17,1,1,1,5,0,1,19,28,47
p_157,7,0,e_1,889,896,919,10,1,1,6,5,1,1,7,23,30
p_158,7,0,e_1,892,896,919,9,1,1,6,5,1,1,4,23,27
p_146,10,0,e_0,846,879,929,10,0,0,0,3,0,0,33,50,83
p_151,12,0,e_0,863,887,929,14,1,1,5,5,0,1,24,42,66
p_156,12,0,e_0,884,887,929,7,1,1,11,5,1,2,3,42,45
p_155,11,0,e_0,884,892,929,8,1,1,11,5,1,1,8,37,45
p_159,8,0,e_0,893,903,929,8,1,1,11,4,1,0,10,26,36
p_148,15,0,e_3,849,897,944,15,0,0,0,3,0,0,48,47,95
p_3,4,0,e_2,25,40,88,4,0,0,0,3,0,0,15,48,63
p_4,5,0,e_2,34,45,88,5,0,0,2,5,0,1,11,43,54
p_5,9,0,e_2,41,59,88,9,0,0,4,5,1,1,18,29,47
p_6,9,0,e_2,45,59,88,9,0,0,5,5,1,1,14,29,43
p_2,11,0,e_1,19,55,90,11,0,0,0,3,0,0,36,35,71
p_1,13,0,e_0,13,55,96,13,0,0,0,3,0,0,42,41,83
p_12,0,8,e_2,86,88,114,21,4,4,0,4,1,0,2,26,28
p_16,4,0,e_1,101,116,130,13,4,1,0,3,0,0,15,14,29
p_15,5,0,e_0,99,117,134,13,4,2,0,3,0,0,18,17,35
p_19,0,7,e_1,125,130,155,11,2,0,1,4,1,0,5,25,30
p_7,2,0,e_3,55,64,160,2,0,0,0,3,0,0,9,96,105
p_10,9,0,e_3,77,87,160,15,3,2,6,5,1,2,10,73,83
p_9,10,0,e_3,67,92,160,17,2,1,3,5,1,1,25,68,93
p_14,13,0,e_3,87,103,160,8,4,1,9,5,1,3,16,57,73
p_8,15,0,e_3,62,111,160,13,1,0,2,5,0,1,49,49,98
p_11,4,0,e_3,84,146,160,18,4,3,8,5,1,3,62,14,76
p_21,0,10,e_0,142,143,179,5,2,0,0,3,0,0,1,36,37
p_13,8,0,e_2,87,114,186,13,4,2,0,3,1,0,27,72,99
p_17,10,0,e_2,112,122,186,5,2,0,8,5,1,0,10,64,74
p_18,15,0,e_2,120,139,186,27,2,2,10,5,1,1,19,47,66
p_20,3,0,e_0,142,156,221,2,2,1,0,3,0,1,14,65,79
p_28,7,0,e_0,184,190,221,5,1,1,9,4,1,2,6,31,37
p_26,6,0,e_0,169,195,221,11,1,1,7,5,2,0,26,26,52
p_27,5,0,e_0,180,200,221,8,1,1,10,4,1,1,20,21,41
p_30,2,0,e_0,200,211,221,5,1,0,5,4,1,0,11,10,21
p_33,1,0,e_0,213,216,221,2,1,0,2,4,1,0,3,5,8
p_25,9,0,e_3,163,193,224,9,0,0,0,3,0,0,30,31,61
p_31,5,0,e_3,203,207,224,1,1,0,6,4,1,0,4,17,21
p_22,6,0,e_1,146,150,230,28,1,1,5,5,1,0,4,80,84
p_24,14,0,e_1,157,178,230,17,1,1,7,5,1,1,21,52,73
p_23,15,0,e_1,150,183,230,18,1,1,6,5,2,0,33,47,80
p_35,0,6,e_3,222,224,246,0,1,0,0,4,1,0,2,22,24
p_32,0,10,e_0,209,221,253,5,1,0,2,4,1,1,12,32,44
p_36,1,0,e_3,225,229,266,11,1,1,0,5,1,0,4,37,41
p_34,11,0,e_2,217,228,297,21,1,1,8,5,0,1,11,69,80
p_29,14,0,e_2,192,239,297,23,0,0,0,3,0,0,47,58,105
p_37,15,0,e_2,228,244,297,14,1,0,11,5,1,1,16,53,69
p_39,13,0,e_2,247,252,297,23,1,1,14,4,1,1,5,45,50
p_38,12,0,e_2,240,257,297,8,2,0,14,5,1,1,17,40,57
p_41,7,0,e_2,257,274,297,26,1,1,12,4,1,0,17,23,40
p_42,4,0,e_1,269,284,298,4,0,0,0,3,0,0,15,14,29
p_44,4,0,e_1,275,284,298,3,1,0,1,5,0,1,9,14,23
p_43,4,0,e_3,270,285,299,4,0,0,0,3,0,0,15,14,29
p_49,3,0,e_3,298,310,321,3,0,0,0,3,1,0,12,11,23
p_40,15,0,e_0,255,273,324,18,1,1,10,3,0,0,18,51,69
p_46,8,0,e_0,291,296,324,24,1,1,9,4,1,0,5,28,33
p_47,3,0,e_0,293,313,324,29,1,1,9,4,1,1,20,11,31
p_51,0,4,e_3,309,321,335,3,0,0,3,2,0,0,12,14,26
p_59,3,0,e_3,335,340,355,1,2,0,4,4,0,2,5,15,20
p_60,2,0,e_3,338,345,355,1,3,0,3,4,0,3,7,10,17
p_57,1,0,e_3,327,350,355,5,1,1,2,5,1,0,23,5,28
p_62,1,0,e_3,345,350,355,1,2,0,2,4,1,1,5,5,10
p_54,7,0,e_1,313,321,372,25,1,1,5,5,0,1,8,51,59
p_53,8,0,e_1,313,326,372,24,1,1,5,5,0,2,13,46,59
p_45,11,0,e_1,290,337,372,22,1,1,2,4,1,0,47,35,82
p_50,11,0,e_1,299,337,372,11,1,0,0,5,0,1,38,35,73
p_58,0,6,e_3,330,355,375,5,2,2,3,5,1,1,25,20,45
p_56,8,0,e_0,324,351,379,7,1,0,0,3,0,0,27,28,55
p_63,3,0,e_0,364,368,379,6,1,1,4,4,1,0,4,11,15
p_48,9,0,e_2,294,326,389,22,1,1,1,4,1,0,32,63,95
p_52,14,0,e_2,312,343,389,19,1,1,5,5,0,1,31,46,77
p_55,14,0,e_2,314,343,389,18,1,1,5,5,0,2,29,46,75
p_61,12,0,e_2,341,351,389,21,3,3,14,5,1,1,10,38,48
p_65,0,7,e_1,369,372,395,8,1,1,1,4,1,0,3,23,26
p_68,2,0,e_0,389,398,406,12,2,2,0,3,0,0,9,8,17
p_69,2,0,e_2,391,400,416,12,2,2,0,3,0,0,9,16,25
p_70,3,0,e_2,398,405,416,15,1,0,2,5,0,1,7,11,18
p_64,0,15,e_1,365,372,421,9,1,1,2,4,1,0,7,49,56
p_66,11,0,e_3,376,394,441,5,0,0,6,3,0,0,18,47,65
p_67,12,0,e_3,377,399,441,6,1,0,6,5,0,1,22,42,64
p_71,7,0,e_3,403,416,441,4,1,0,11,4,1,0,13,25,38
p_72,6,0,e_3,417,421,441,1,1,0,7,4,1,0,4,20,24
p_73,3,0,e_0,423,435,446,3,1,0,0,3,0,0,12,11,23
p_75,3,0,e_2,438,450,461,28,1,1,0,3,0,0,12,11,23
p_74,10,0,e_1,424,442,476,25,1,1,15,3,0,0,18,34,52
p_77,4,0,e_1,455,462,476,12,1,1,6,4,1,0,7,14,21
p_81,1,0,e_1,493,499,504,10,1,0,0,3,0,0,6,5,11
p_79,9,0,e_0,457,487,516,10,2,2,0,3,0,0,30,29,59
p_76,10,0,e_3,440,473,527,10,0,0,0,3,1,0,33,54,87
p_78,12,0,e_3,455,481,527,8,1,0,4,5,0,1,26,46,72
p_80,13,0,e_3,474,486,527,3,2,0,10,5,1,1,12,41,53
p_82,0,12,e_2,494,495,535,11,1,0,0,3,0,0,1,40,41
p_83,0,12,e_1,501,504,544,8,1,0,1,4,1,0,3,40,43
p_87,3,0,e_0,528,540,567,3,0,0,0,3,0,0,12,27,39
p_89,5,0,e_0,535,548,567,5,0,0,2,5,0,1,13,19,32
p_94,3,0,e_0,546,556,567,4,2,1,5,5,1,1,10,11,21
p_90,1,0,e_3,538,544,569,1,0,0,0,3,0,0,6,25,31
p_93,4,0,e_3,543,555,569,5,0,0,1,2,0,0,12,14,26
p_88,10,0,e_1,531,536,586,10,0,0,9,5,1,0,5,50,55
p_92,10,0,e_1,540,552,586,10,1,0,11,5,2,0,12,34,46
p_95,10,0,e_1,547,552,586,8,2,0,11,4,1,1,5,34,39
p_96,7,0,e_1,551,563,586,4,2,0,10,1,1,0,12,23,35
p_84,12,0,e_2,504,535,591,25,1,1,2,5,1,0,31,56,87
p_85,14,0,e_2,517,543,591,19,1,1,6,5,1,0,26,48,74
p_86,14,0,e_2,518,543,591,19,1,1,7,5,1,1,25,48,73
p_91,14,0,e_2,539,543,591,14,1,0,13,5,1,1,4,48,52
p_99,9,0,e_2,556,560,591,25,2,2,10,4,1,1,4,31,35
p_98,6,0,e_2,555,571,591,28,2,2,10,4,1,0,16,20,36
p_101,9,0,e_0,566,596,663,22,2,2,0,3,1,1,30,67,97
p_100,10,0,e_0,557,601,663,24,2,2,3,4,1,0,44,62,106
p_103,14,0,e_0,577,615,663,12,2,0,3,5,0,2,38,48,86
p_113,9,0,e_0,629,632,663,2,2,0,10,4,1,1,3,31,34
p_106,5,0,e_0,583,646,663,19,3,2,5,5,0,3,63,17,80
p_97,5,0,e_3,552,586,665,2,2,0,3,5,1,1,34,79,113
p_108,7,0,e_3,584,594,665,16,4,2,5,5,0,4,10,71,81
p_105,12,0,e_3,582,611,665,12,2,1,4,5,0,2,29,54,83
p_102,14,0,e_3,568,619,665,14,1,1,0,3,1,1,51,46,97
p_104,14,0,e_3,581,619,665,10,2,0,4,5,0,2,38,46,84
p_107,3,0,e_3,584,654,665,20,3,2,5,5,0,3,70,11,81
p_109,10,0,e_1,590,623,667,12,5,2,0,3,0,0,33,44,77
p_112,11,0,e_1,613,628,667,5,3,1,7,5,0,2,15,39,54
p_116,7,0,e_1,633,642,667,3,2,0,10,4,1,1,9,25,34
p_111,2,0,e_1,607,659,667,15,4,2,5,5,0,1,52,8,60
p_123,0,2,e_0,661,663,671,1,3,0,0,4,1,2,2,8,10
p_110,12,0,e_2,590,629,671,10,5,1,0,3,1,0,39,42,81
p_115,9,0,e_2,632,640,671,1,2,0,11,4,1,0,8,31,39
p_121,3,0,e_2,656,660,671,30,3,3,4,4,1,0,4,11,15
p_117,0,2,e_3,636,665,673,9,2,0,9,4,1,1,29,8,37
p_126,1,0,e_2,681,687,692,21,3,3,0,3,0,0,6,5,11
p_125,2,0,e_1,668,675,715,23,4,3,0,5,0,1,7,40,47
p_122,7,0,e_1,657,692,715,25,3,3,2,4,1,1,35,23,58
p_129,5,0,e_2,705,719,752,10,2,1,1,5,0,1,14,33,47
p_127,7,0,e_2,701,727,752,9,2,1,0,3,0,0,26,25,51
p_132,4,0,e_2,730,738,752,3,1,0,6,4,1,0,8,14,22
p_118,8,0,e_0,649,691,753,26,2,2,4,4,1,1,42,62,104
p_114,13,0,e_0,632,708,753,27,2,2,9,4,1,1,76,45,121
p_130,11,0,e_0,705,716,753,4,2,1,12,5,1,1,11,37,48
p_131,7,0,e_0,722,730,753,3,1,0,9,4,1,0,8,23,31
p_124,7,0,e_3,664,690,753,7,2,2,0,3,1,2,26,63,89
p_119,8,0,e_3,650,695,753,26,2,2,4,4,1,1,45,58,103
p_120,13,0,e_3,653,712,753,20,2,2,3,1,1,1,59,41,100
p_128,0,15,e_1,705,715,768,15,2,2,3,4,1,0,10,53,63
p_140,5,0,e_3,768,786,803,5,0,0,0,3,0,0,18,17,35
p_143,5,0,e_3,780,786,803,2,1,0,3,5,0,1,6,17,23
p_139,0,15,e_2,758,759,808,0,0,0,0,3,0,0,1,49,50
p_135,11,0,e_1,739,750,821,23,1,1,8,5,1,2,11,71,82
p_137,13,0,e_1,755,758,821,13,0,0,12,5,2,2,3,63,66
p_134,14,0,e_1,734,763,821,22,1,1,6,5,1,1,29,58,87
p_136,14,0,e_1,749,763,821,17,1,1,11,2,1,2,14,58,72
p_142,13,0,e_1,773,776,821,12,1,0,14,4,1,2,3,45,48
p_141,12,0,e_1,770,781,821,12,1,0,15,4,1,1,11,40,51
p_133,6,0,e_1,734,801,821,30,1,1,6,5,1,0,67,20,87
p_145,1,0,e_1,820,826,831,10,1,1,0,3,1,0,6,5,11
p_138,12,0,e_0,756,795,833,12,0,0,0,3,0,0,39,38,77
p_144,6,0,e_3,815,836,856,6,0,0,0,3,0,0,21,20,41
p_150,3,0,e_3,860,872,885,3,0,0,0,3,0,0,12,13,25
p_152,2,0,e_3,868,877,885,2,1,1,2,5,0,1,9,8,17
p_146,10,0,e_2,846,864,900,23,1,1,15,3,0,0,18,36,54
p_153,6,0,e_2,872,878,900,27,2,2,8,4,1,0,6,22,28
p_154,4,0,e_2,874,886,900,29,2,2,7,4,1,1,12,14,26
p_147,6,0,e_0,849,870,934,26,1,1,0,3,0,0,21,64,85
p_149,6,0,e_0,859,870,934,6,0,0,3,5,0,1,11,64,75
p_155,11,0,e_0,884,887,934,11,0,0,10,5,1,1,3,47,50
p_151,12,0,e_0,863,892,934,12,1,0,4,5,0,1,29,42,71
p_156,12,0,e_0,884,892,934,12,0,0,10,5,1,2,8,42,50
p_159,8,0,e_0,893,906,934,7,1,0,12,4,1,1,13,28,41
p_158,7,0,e_0,892,911,934,7,1,0,12,4,1,0,19,23,42
p_157,7,0,e_3,889,913,936,7,0,0,0,3,0,0,24,23,47
p_148,15,0,e_1,849,897,944,17,1,1,0,3,0,0,48,47,95
p_3,4,0,e_2,25,40,62,4,0,0,0,3,0,0,15,22,37
p_4,5,0,e_2,34,45,62,5,0,0,2,5,0,1,11,17,28
p_5,9,0,e_1,41,49,92,9,0,0,7,5,0,1,8,43,51
p_6,9,0,e_1,45,49,92,9,0,0,8,5,0,2,4,43,47
p_2,11,0,e_1,19,57,92,11,0,0,0,3,0,0,38,35,73
p_1,13,0,e_0,13,55,96,13,0,0,0,3,0,0,42,41,83
p_12,0,8,e_1,86,92,118,21,2,2,2,4,1,0,6,26,32
p_16,4,0,e_0,101,114,136,13,2,1,0,5,0,1,13,22,35
p_15,5,0,e_0,99,119,136,12,2,1,0,3,0,0,20,17,37
p_13,8,0,e_2,87,94,138,13,2,1,6,5,0,3,7,44,51
p_10,9,0,e_2,77,99,138,15,2,1,3,5,0,1,22,39,61
p_9,10,0,e_2,67,104,138,17,2,1,0,3,0,0,37,34,71
p_11,4,0,e_2,84,124,138,18,2,1,5,5,0,2,40,14,54
p_7,2,0,e_3,55,64,156,2,0,0,0,3,0,0,9,92,101
p_14,13,0,e_3,87,99,156,8,2,1,9,5,1,1,12,57,69
p_8,15,0,e_3,62,107,156,13,1,0,2,5,0,1,45,49,94
p_20,3,0,e_3,142,145,156,1,1,0,4,4,1,0,3,11,14
p_19,0,7,e_0,125,136,161,9,1,0,3,4,1,0,11,25,36
p_21,0,10,e_2,142,143,177,4,1,0,0,3,0,0,1,34,35
p_17,10,0,e_1,112,126,192,4,1,0,6,5,1,0,14,66,80
p_18,15,0,e_1,120,143,192,26,1,1,8,5,0,1,23,49,72
p_26,6,0,e_1,169,172,192,11,1,1,7,4,1,0,3,20,23
p_30,2,0,e_1,200,209,217,16,3,1,0,3,0,0,9,8,17
p_24,14,0,e_2,157,191,237,14,0,0,4,5,1,0,34,46,80
p_33,1,0,e_2,213,232,237,13,2,1,7,4,1,0,19,5,24
p_22,6,0,e_0,146,156,238,27,1,1,3,5,1,0,10,82,92
p_23,15,0,e_0,150,187,238,17,1,1,4,5,1,1,37,51,88
p_31,5,0,e_0,203,219,238,12,3,1,10,4,1,0,16,19,35
p_36,1,0,e_0,225,233,238,10,2,1,3,4,1,0,8,5,13
p_32,0,10,e_1,209,217,249,15,3,3,2,4,1,0,8,32,40
p_35,0,6,e_0,222,238,258,11,2,0,4,4,1,0,16,20,36
p_28,7,0,e_3,184,187,260,5,2,1,6,5,0,2,3,73,76
p_25,9,0,e_3,163,195,260,9,0,0,0,3,0,0,32,65,97
p_29,14,0,e_3,192,212,260,6,3,0,8,5,1,2,20,48,68
p_34,11,0,e_3,217,223,260,2,2,0,13,4,1,1,6,37,43
p_27,5,0,e_3,180,243,260,8,1,1,5,5,0,1,63,17,80
p_41,7,0,e_0,257,263,288,24,1,1,6,2,1,0,6,25,31
p_42,4,0,e_0,269,274,288,4,0,0,5,4,1,0,5,14,19
p_43,4,0,e_0,270,274,288,4,0,0,5,4,1,1,4,14,18
p_44,4,0,e_3,275,290,304,4,0,0,0,3,0,0,15,14,29
p_39,13,0,e_1,247,260,317,21,1,1,10,5,1,1,13,57,70
p_37,15,0,e_1,228,268,317,25,2,2,3,5,1,0,40,49,89
p_40,15,0,e_1,255,268,317,16,1,1,12,5,0,2,13,49,62
p_47,3,0,e_1,293,306,317,30,1,1,7,4,1,0,13,11,24
p_38,12,0,e_2,240,279,319,24,2,2,0,3,0,0,39,40,79
p_49,3,0,e_2,298,308,319,29,1,1,6,4,1,0,10,11,21
p_51,0,4,e_3,309,310,326,0,0,0,0,3,0,0,1,16,17
p_57,1,0,e_2,327,333,338,11,2,2,0,3,0,0,6,5,11
p_58,0,6,e_2,330,338,358,11,2,2,0,5,0,1,8,20,28
p_54,7,0,e_3,313,337,372,7,1,0,0,5,1,0,24,35,59
p_53,8,0,e_3,313,342,372,8,2,0,0,5,1,1,29,30,59
p_59,3,0,e_3,335,359,372,6,2,1,7,5,0,2,24,13,37
p_60,2,0,e_3,338,364,372,7,3,1,7,5,1,2,26,8,34
p_56,8,0,e_1,324,351,379,4,3,0,0,3,0,0,27,28,55
p_62,1,0,e_1,345,374,379,6,3,2,6,5,0,1,29,5,34
p_46,8,0,e_0,291,317,387,26,1,1,0,5,0,1,26,70,96
p_48,9,0,e_0,294,322,387,24,1,1,1,5,0,2,28,65,93
p_45,11,0,e_0,290,330,387,23,1,1,0,3,0,0,40,57,97
p_50,11,0,e_0,299,330,387,20,1,1,2,5,0,3,31,57,88
p_52,14,0,e_0,312,341,387,14,1,0,7,5,0,3,29,46,75
p_55,14,0,e_0,314,341,387,14,3,0,7,5,0,4,27,46,73
p_61,12,0,e_0,341,349,387,14,3,0,14,4,1,0,8,38,46
p_63,3,0,e_2,364,376,387,29,1,1,6,3,0,0,12,11,23
p_65,0,7,e_3,369,372,395,1,1,0,1,4,1,0,3,23,26
p_68,2,0,e_0,389,398,406,23,3,3,0,3,0,0,9,8,17
p_64,0,15,e_3,365,372,423,2,1,0,2,4,1,0,7,51,58
p_69,2,0,e_2,391,400,444,22,3,3,0,3,0,0,9,44,53
p_70,3,0,e_2,398,405,444,19,2,2,2,5,0,1,7,39,46
p_71,7,0,e_2,403,419,444,14,2,2,3,5,1,1,16,25,41
p_72,6,0,e_2,417,424,444,11,2,1,7,5,1,1,7,20,27
p_73,3,0,e_0,423,435,446,12,1,0,0,3,0,0,12,11,23
p_67,12,0,e_1,377,417,457,17,3,1,0,4,1,0,40,40,80
p_75,3,0,e_1,438,446,457,7,2,0,5,4,1,0,8,11,19
p_66,11,0,e_3,376,409,474,18,2,1,1,5,2,0,33,65,98
p_74,10,0,e_3,424,440,474,5,1,0,15,4,1,0,16,34,50
p_77,4,0,e_3,455,460,474,1,1,0,5,4,1,0,5,14,19
p_81,1,0,e_1,493,499,504,1,0,0,0,3,0,0,6,5,11
p_79,9,0,e_0,457,487,516,26,2,2,0,3,0,0,30,29,59
p_76,10,0,e_2,440,476,530,30,1,1,1,4,1,0,36,54,90
p_78,12,0,e_2,455,484,530,23,2,2,3,5,0,1,29,46,75
p_80,13,0,e_2,474,489,530,13,0,0,10,5,0,2,15,41,56
p_82,0,12,e_3,494,495,535,0,0,0,0,3,0,0,1,40,41
p_83,0,12,e_1,501,504,544,23,1,1,1,4,1,0,3,40,43
p_87,3,0,e_0,528,540,567,15,2,2,0,3,0,0,12,27,39
p_89,5,0,e_0,535,548,567,11,2,1,2,5,0,1,13,19,32
p_94,3,0,e_0,546,556,567,10,1,0,5,5,1,1,10,11,21
p_90,1,0,e_2,538,544,569,14,2,1,0,3,0,0,6,25,31
p_93,4,0,e_2,543,555,569,10,1,0,1,2,0,0,12,14,26
p_88,10,0,e_1,531,536,586,7,2,2,9,5,1,0,5,50,55
p_92,10,0,e_1,540,552,586,5,2,1,11,5,2,0,12,34,46
p_95,10,0,e_1,547,552,586,3,1,0,11,4,1,1,5,34,39
p_96,7,0,e_1,551,563,586,5,1,0,10,1,1,0,12,23,35
p_84,12,0,e_3,504,535,591,10,1,0,2,5,1,0,31,56,87
p_85,14,0,e_3,517,543,591,8,1,0,6,5,1,0,26,48,74
p_86,14,0,e_3,518,543,591,7,2,0,7,5,1,1,25,48,73
p_91,14,0,e_3,539,543,591,1,2,0,13,5,1,1,4,48,52
p_99,9,0,e_3,556,560,591,1,2,0,10,4,1,1,4,31,35
p_98,6,0,e_3,555,571,591,4,1,0,10,4,1,0,16,20,36
p_101,9,0,e_0,566,596,663,28,2,2,0,3,1,1,30,67,97
p_100,10,0,e_0,557,601,663,30,3,3,3,4,1,0,44,62,106
p_103,14,0,e_0,577,615,663,20,1,1,3,5,0,2,38,48,86
p_113,9,0,e_0,629,632,663,3,1,0,10,4,1,1,3,31,34
p_106,5,0,e_0,583,646,663,27,1,1,5,5,0,3,63,17,80
p_97,5,0,e_2,552,586,665,6,1,0,3,5,1,1,34,79,113
p_108,7,0,e_2,584,594,665,25,1,1,5,5,0,4,10,71,81
p_105,12,0,e_2,582,611,665,21,1,1,4,5,0,2,29,54,83
p_102,14,0,e_2,568,619,665,23,2,2,0,3,1,1,51,46,97
p_104,14,0,e_2,581,619,665,19,1,1,4,5,0,2,38,46,84
p_107,3,0,e_2,584,654,665,29,1,1,5,5,0,3,70,11,81
p_109,10,0,e_1,590,623,667,10,0,0,0,3,0,0,33,44,77
p_112,11,0,e_1,613,628,667,6,1,1,7,5,0,2,15,39,54
p_116,7,0,e_1,633,642,667,4,2,1,10,4,1,1,9,25,34
p_111,2,0,e_1,607,659,667,17,1,1,5,5,0,1,52,8,60
p_123,0,2,e_0,661,663,671,3,1,0,0,4,1,2,2,8,10
p_110,12,0,e_3,590,629,671,12,0,0,0,3,1,0,39,42,81
p_115,9,0,e_3,632,640,671,2,1,0,11,4,1,0,8,31,39
p_121,3,0,e_3,656,660,671,1,1,0,4,4,1,0,4,11,15
p_117,0,2,e_2,636,665,673,10,2,0,9,4,1,1,29,8,37
p_126,1,0,e_3,681,687,692,1,0,0,0,3,0,0,6,5,11
p_125,2,0,e_1,668,675,715,29,1,1,0,5,0,1,7,40,47
p_122,7,0,e_1,657,692,715,27,2,2,2,4,1,1,35,23,58
p_129,5,0,e_3,705,719,752,8,1,1,1,5,0,1,14,33,47
p_127,7,0,e_3,701,727,752,7,0,0,0,3,0,0,26,25,51
p_132,4,0,e_3,730,738,752,2,1,0,6,4,1,0,8,14,22
p_118,8,0,e_0,649,691,753,28,1,1,4,4,1,1,42,62,104
p_114,13,0,e_0,632,708,753,28,2,2,9,4,1,1,76,45,121
p_130,11,0,e_0,705,716,753,10,2,0,12,5,1,1,11,37,48
p_131,7,0,e_0,722,730,753,1,2,0,9,4,1,0,8,23,31
p_124,7,0,e_2,664,690,753,25,1,1,0,3,1,2,26,63,89
p_119,8,0,e_2,650,695,753,28,1,1,4,4,1,1,45,58,103
p_120,13,0,e_2,653,712,753,22,1,1,3,1,1,1,59,41,100
p_128,0,15,e_1,705,715,768,13,1,1,3,4,1,0,10,53,63
p_140,5,0,e_3,768,786,803,5,0,0,0,3,0,0,18,17,35
p_143,5,0,e_3,780,786,803,2,1,0,3,5,0,1,6,17,23
p_139,0,15,e_2,758,759,808,0,0,0,0,3,0,0,1,49,50
p_135,11,0,e_1,739,750,821,23,1,1,8,5,1,2,11,71,82
p_137,13,0,e_1,755,758,821,13,0,0,12,5,2,2,3,63,66
p_134,14,0,e_1,734,763,821,21,2,2,6,5,1,1,29,58,87
p_136,14,0,e_1,749,763,821,17,1,1,11,2,1,2,14,58,72
p_142,13,0,e_1,773,776,821,12,1,0,14,4,1,2,3,45,48
p_141,12,0,e_1,770,781,821,12,1,0,15,4,1,1,11,40,51
p_133,6,0,e_1,734,801,821,29,2,2,6,5,1,0,67,20,87
p_145,1,0,e_1,820,826,831,10,1,1,0,3,1,0,6,5,11
p_138,12,0,e_0,756,795,833,12,0,0,0,3,0,0,39,38,77
p_144,6,0,e_3,815,836,856,6,0,0,0,3,0,0,21,20,41
p_150,3,0,e_3,860,872,885,3,0,0,0,3,0,0,12,13,25
p_152,2,0,e_3,868,877,885,2,1,1,2,5,0,1,9,8,17
p_146,10,0,e_2,846,864,900,23,1,1,15,3,0,0,18,36,54
p_153,6,0,e_2,872,878,900,27,2,2,8,4,1,0,6,22,28
p_154,4,0,e_2,874,886,900,29,2,2,7,4,1,1,12,14,26
p_147,6,0,e_0,849,870,934,26,1,1,0,3,0,0,21,64,85
p_149,6,0,e_0,859,870,934,6,0,0,3,5,0,1,11,64,75
p_155,11,0,e_0,884,887,934,11,0,0,10,5,1,1,3,47,50
p_151,12,0,e_0,863,892,934,12,1,0,4,5,0,1,29,42,71
p_156,12,0,e_0,884,892,934,12,0,0,10,5,1,2,8,42,50
p_159,8,0,e_0,893,906,934,7,1,0,12,4,1,1,13,28,41
p_158,7,0,e_0,892,911,934,7,1,0,12,4,1,0,19,23,42
p_157,7,0,e_3,889,913,936,7,0,0,0,3,0,0,24,23,47
p_148,15,0,e_1,849,897,944,17,1,1,0,3,0,0,48,47,95
p_3,4,0,e_2,25,40,88,4,0,0,0,3,0,0,15,48,63
p_4,5,0,e_2,34,45,88,5,0,0,2,5,0,1,11,43,54
p_5,9,0,e_2,41,59,88,9,0,0,4,5,1,1,18,29,47
p_6,9,0,e_2,45,59,88,9,0,0,5,5,1,1,14,29,43
p_2,11,0,e_1,19,55,90,11,0,0,0,3,0,0,36,35,71
p_1,13,0,e_0,13,55,96,13,0,0,0,3,0,0,42,41,83
p_12,0,8,e_2,86,88,114,21,4,4,0,4,1,0,2,26,28
p_16,4,0,e_1,101,116,130,13,4,1,0,3,0,0,15,14,29
p_15,5,0,e_0,99,117,134,13,4,2,0,3,0,0,18,17,35
p_19,0,7,e_1,125,130,155,11,2,0,1,4,1,0,5,25,30
p_7,2,0,e_3,55,64,162,2,0,0,0,3,0,0,9,98,107
p_10,9,0,e_3,77,87,162,15,3,2,6,5,1,2,10,75,85
p_9,10,0,e_3,67,92,162,17,2,1,3,5,1,1,25,70,95
p_14,13,0,e_3,87,103,162,8,4,1,9,5,1,3,16,59,75
p_8,15,0,e_3,62,111,162,13,1,0,2,5,0,1,49,51,100
p_11,4,0,e_3,84,146,162,18,4,3,8,5,1,3,62,16,78
p_20,3,0,e_3,142,151,162,2,2,1,5,4,1,1,9,11,20
p_21,0,10,e_0,142,143,177,5,2,0,0,3,0,0,1,34,35
p_13,8,0,e_2,87,114,186,13,4,2,0,3,1,0,27,72,99
p_17,10,0,e_2,112,122,186,5,2,0,8,5,1,0,10,64,74
p_18,15,0,e_2,120,139,186,27,2,2,10,5,1,1,19,47,66
p_30,2,0,e_2,200,209,217,16,3,1,0,3,0,0,9,8,17
p_22,6,0,e_1,146,150,232,28,2,2,5,5,1,0,4,82,86
p_23,15,0,e_1,150,181,232,18,1,1,6,5,2,0,31,51,82
p_31,5,0,e_1,203,213,232,12,3,1,8,4,1,0,10,19,29
p_33,1,0,e_1,213,227,232,13,2,0,5,4,1,0,14,5,19
p_24,14,0,e_0,157,191,237,17,1,1,4,5,1,0,34,46,80
p_36,1,0,e_0,225,232,237,10,2,1,3,4,1,0,7,5,12
p_32,0,10,e_2,209,217,249,15,3,3,2,4,1,0,8,32,40
p_35,0,6,e_1,222,232,252,12,3,0,2,4,1,1,10,20,30
p_26,6,0,e_3,169,184,262,11,1,1,1,5,0,1,15,78,93
p_28,7,0,e_3,184,189,262,5,3,1,6,5,1,2,5,73,78
p_25,9,0,e_3,163,197,262,9,0,0,0,3,0,0,34,65,99
p_29,14,0,e_3,192,214,262,6,3,0,8,5,1,2,22,48,70
p_34,11,0,e_3,217,225,262,2,2,0,13,4,1,1,8,37,45
p_27,5,0,e_3,180,245,262,8,2,2,5,5,0,2,65,17,82
p_42,4,0,e_3,269,284,298,4,0,0,0,3,0,0,15,14,29
p_43,4,0,e_3,270,284,298,4,1,0,0,5,0,1,14,14,28
p_44,4,0,e_3,275,284,298,3,1,0,1,5,0,1,9,14,23
p_41,7,0,e_0,257,281,304,24,1,1,0,3,0,0,24,23,47
p_37,15,0,e_2,228,266,315,25,2,2,3,5,1,0,38,49,87
p_40,15,0,e_2,255,266,315,17,1,1,12,5,0,1,11,49,60
p_47,3,0,e_2,293,304,315,28,2,2,6,4,1,0,11,11,22
p_49,3,0,e_2,298,304,315,19,2,2,5,4,1,1,6,11,17
p_38,12,0,e_1,240,272,320,24,2,2,2,5,1,0,32,48,80
p_39,13,0,e_1,247,277,320,22,1,1,5,5,1,1,30,43,73
p_46,8,0,e_1,291,294,320,24,2,2,9,4,1,0,3,26,29
p_51,0,4,e_0,309,310,326,19,2,2,0,3,0,0,1,16,17
p_57,1,0,e_1,327,333,338,18,3,2,0,3,0,0,6,5,11
p_58,0,6,e_2,330,331,353,18,3,3,0,3,0,0,1,22,23
p_60,2,0,e_1,338,347,357,14,2,1,0,3,0,0,9,10,19
p_62,1,0,e_1,345,352,357,13,2,0,2,5,0,1,7,5,12
p_54,7,0,e_0,313,337,370,16,3,3,0,5,1,0,24,33,57
p_53,8,0,e_0,313,342,370,15,3,3,0,5,1,1,29,28,57
p_56,8,0,e_0,324,342,370,12,3,3,4,5,1,2,18,28,46
p_59,3,0,e_0,335,359,370,14,2,1,7,5,0,2,24,11,35
p_63,3,0,e_1,364,376,387,6,1,0,0,3,0,0,12,11,23
p_48,9,0,e_3,294,327,392,22,2,2,1,4,1,1,33,65,98
p_45,11,0,e_3,290,335,392,21,1,1,2,4,1,0,45,57,102
p_50,11,0,e_3,299,335,392,11,2,0,0,5,0,2,36,57,93
p_52,14,0,e_3,312,346,392,10,2,0,4,5,0,2,34,46,80
p_55,14,0,e_3,314,346,392,9,3,0,5,5,0,3,32,46,78
p_61,12,0,e_3,341,354,392,3,2,1,13,5,1,1,13,38,51
p_65,0,7,e_0,369,370,395,7,1,0,0,3,1,0,1,25,26
p_68,2,0,e_1,389,398,406,29,1,1,0,3,0,0,9,8,17
p_69,2,0,e_3,391,400,416,2,0,0,0,3,1,0,9,16,25
p_70,3,0,e_3,398,405,416,1,1,0,2,5,0,1,7,11,18
p_64,0,15,e_0,365,370,421,9,1,0,1,4,1,0,5,51,56
p_66,11,0,e_2,376,394,441,24,1,1,6,3,0,0,18,47,65
p_67,12,0,e_2,377,399,441,23,1,1,6,5,0,1,22,42,64
p_71,7,0,e_2,403,416,441,4,2,0,11,4,1,0,13,25,38
p_72,6,0,e_2,417,421,441,6,0,0,7,4,1,0,4,20,24
p_73,3,0,e_1,423,435,446,3,0,0,0,3,0,0,12,11,23
p_75,3,0,e_3,438,450,461,3,0,0,0,3,0,0,12,11,23
p_74,10,0,e_0,424,442,476,10,0,0,15,3,0,0,18,34,52
p_77,4,0,e_0,455,462,476,28,1,1,6,4,1,0,7,14,21
p_81,1,0,e_0,493,499,504,1,0,0,0,3,0,0,6,5,11
p_79,9,0,e_1,457,487,516,22,1,1,0,3,0,0,30,29,59
p_76,10,0,e_2,440,473,527,10,1,0,0,3,1,0,33,54,87
p_78,12,0,e_2,455,481,527,20,1,1,4,5,0,1,26,46,72
p_80,13,0,e_2,474,486,527,13,0,0,10,5,1,1,12,41,53
p_82,0,12,e_3,494,495,535,0,0,0,0,3,0,0,1,40,41
p_83,0,12,e_0,501,504,544,23,1,1,1,4,1,0,3,40,43
p_90,1,0,e_2,538,544,549,14,2,1,0,3,0,0,6,5,11
p_87,3,0,e_1,528,540,569,15,2,2,0,3,0,0,12,29,41
p_93,4,0,e_1,543,545,569,10,1,0,4,5,1,1,2,24,26
p_89,5,0,e_1,535,550,569,11,2,1,2,5,0,1,15,19,34
p_94,3,0,e_1,546,558,569,10,1,0,4,5,1,1,12,11,23
p_88,10,0,e_0,531,536,586,7,2,2,9,5,1,0,5,50,55
p_92,10,0,e_0,540,552,586,5,2,1,11,5,2,0,12,34,46
p_95,10,0,e_0,547,552,586,3,1,0,11,4,1,1,5,34,39
p_96,7,0,e_0,551,563,586,5,1,0,10,1,1,0,12,23,35
p_84,12,0,e_3,504,535,591,10,1,0,2,5,1,0,31,56,87
p_85,14,0,e_3,517,543,591,8,1,0,6,5,1,0,26,48,74
p_86,14,0,e_3,518,543,591,7,2,0,7,5,1,1,25,48,73
p_91,14,0,e_3,539,543,591,1,2,0,13,5,1,1,4,48,52
p_99,9,0,e_3,556,560,591,1,2,0,10,4,1,1,4,31,35
p_98,6,0,e_3,555,571,591,4,1,0,10,4,1,0,16,20,36
p_111,2,0,e_0,607,616,624,2,0,0,0,3,0,0,9,8,17
p_97,5,0,e_2,552,570,651,6,1,0,0,3,0,0,18,81,99
p_101,9,0,e_2,566,584,651,28,2,2,4,5,0,2,18,67,85
p_100,10,0,e_2,557,589,651,30,3,3,1,5,0,1,32,62,94
p_105,12,0,e_2,582,597,651,21,1,1,9,5,1,3,15,54,69
p_110,12,0,e_2,590,597,651,12,0,0,10,5,1,2,7,54,61
p_102,14,0,e_2,568,605,651,23,2,2,5,5,0,3,37,46,83
p_103,14,0,e_2,577,605,651,20,1,1,7,5,1,3,28,46,74
p_104,14,0,e_2,581,605,651,19,1,1,8,5,1,3,24,46,70
p_112,11,0,e_2,613,616,651,11,0,0,12,4,1,0,3,35,38
p_107,3,0,e_1,584,595,654,29,1,1,0,5,0,1,11,59,70
p_106,5,0,e_1,583,603,654,27,1,1,0,3,0,0,20,51,71
p_108,7,0,e_1,584,611,654,25,1,1,0,5,0,2,27,43,70
p_109,10,0,e_1,590,622,654,10,0,0,2,5,0,3,32,32,64
p_117,0,2,e_2,636,651,659,17,2,2,5,4,1,0,15,8,23
p_123,0,2,e_1,661,662,672,10,2,2,0,3,0,0,1,10,11
p_125,2,0,e_1,668,672,680,7,2,1,1,5,1,0,4,8,12
p_126,1,0,e_1,681,687,692,4,1,0,0,3,0,0,6,5,11
p_116,7,0,e_3,633,656,697,11,1,1,0,5,0,1,23,41,64
p_118,8,0,e_3,649,661,697,5,2,1,5,5,0,2,12,36,48
p_119,8,0,e_3,650,661,697,5,3,1,5,5,0,3,11,36,47
p_115,9,0,e_3,632,666,697,9,0,0,0,3,0,0,34,31,65
p_124,7,0,e_3,664,674,697,2,2,0,9,5,1,1,10,23,33
p_121,3,0,e_2,656,664,701,8,3,2,1,5,1,0,8,37,45
p_122,7,0,e_2,657,678,701,4,3,2,2,5,1,1,21,23,44
p_113,9,0,e_0,629,659,714,9,0,0,0,3,0,0,30,55,85
p_114,13,0,e_0,632,673,714,13,1,1,0,5,0,1,41,41,82
p_120,13,0,e_0,653,673,714,7,3,0,7,5,0,2,20,41,61
p_129,5,0,e_3,705,723,740,5,0,0,0,3,0,0,18,17,35
p_128,0,15,e_2,705,706,757,0,0,0,0,3,0,0,1,51,52
p_127,7,0,e_1,701,725,796,7,0,0,0,3,0,0,24,71,95
p_130,11,0,e_1,705,739,796,11,1,1,1,5,0,1,34,57,91
p_134,14,0,e_1,734,750,796,18,1,1,10,5,1,1,16,46,62
p_140,5,0,e_1,768,779,796,23,1,1,8,4,1,0,11,17,28
p_132,4,0,e_0,730,737,807,29,1,1,2,5,0,1,7,70,77
p_133,6,0,e_0,734,745,807,26,1,1,3,5,0,2,11,62,73
p_131,7,0,e_0,722,750,807,12,0,0,0,3,0,0,28,57,85
p_135,11,0,e_0,739,764,807,11,0,0,4,5,1,2,25,43,68
p_138,12,0,e_0,756,769,807,12,0,0,9,5,1,1,13,38,51
p_136,14,0,e_2,749,752,808,14,0,0,13,5,1,0,3,56,59
p_137,13,0,e_2,755,765,808,13,0,0,15,5,2,0,10,43,53
p_143,5,0,e_2,780,791,808,19,3,3,8,4,1,0,11,17,28
p_139,0,15,e_3,758,759,812,0,0,0,0,3,0,0,1,53,54
p_145,1,0,e_1,820,826,831,12,1,0,0,3,0,0,6,5,11
p_144,6,0,e_0,815,836,856,8,1,0,0,3,0,0,21,20,41
p_141,12,0,e_3,770,799,859,15,1,1,3,5,1,0,29,60,89
p_142,13,0,e_3,773,804,859,13,2,1,4,5,1,1,31,55,86
p_150,3,0,e_0,860,872,883,3,0,0,0,3,0,0,12,11,23
p_152,2,0,e_3,868,877,929,2,0,0,0,3,0,0,9,52,61
p_154,4,0,e_3,874,885,929,7,2,1,1,5,0,2,11,44,55
p_153,6,0,e_3,872,893,929,5,1,0,1,5,0,1,21,36,57
p_157,7,0,e_3,889,898,929,2,2,0,5,5,1,1,9,31,40
p_158,7,0,e_3,892,898,929,1,2,0,6,2,1,1,6,31,37
p_159,8,0,e_3,893,903,929,2,2,0,6,5,1,1,10,26,36
p_147,6,0,e_2,849,870,930,27,1,1,0,3,0,0,21,60,81
p_149,6,0,e_2,859,870,930,6,0,0,3,5,0,1,11,60,71
p_155,11,0,e_2,884,887,930,7,2,2,10,5,1,1,3,43,46
p_151,12,0,e_2,863,892,930,12,0,0,4,5,0,1,29,38,67
p_156,12,0,e_2,884,892,930,8,2,2,10,5,1,2,8,38,46
p_146,10,0,e_1,846,879,943,24,1,1,0,3,0,0,33,64,97
p_148,15,0,e_1,849,896,943,18,1,1,0,5,0,1,47,47,94
p_3,4,0,e_2,25,40,88,4,0,0,0,3,0,0,15,48,63
p_4,5,0,e_2,34,45,88,5,0,0,2,5,0,1,11,43,54
p_5,9,0,e_2,41,59,88,9,0,0,4,5,1,1,18,29,47
p_6,9,0,e_2,45,59,88,9,0,0,5,5,1,1,14,29,43
p_2,11,0,e_1,19,55,90,11,0,0,0,3,0,0,36,35,71
p_1,13,0,e_0,13,55,96,13,0,0,0,3,0,0,42,41,83
p_12,0,8,e_2,86,88,114,21,4,4,0,4,1,0,2,26,28
p_16,4,0,e_1,101,116,130,13,4,1,0,3,0,0,15,14,29
p_15,5,0,e_0,99,117,134,13,4,2,0,3,0,0,18,17,35
p_19,0,7,e_1,125,130,155,11,2,0,1,4,1,0,5,25,30
p_7,2,0,e_3,55,64,160,2,0,0,0,3,0,0,9,96,105
p_10,9,0,e_3,77,87,160,15,3,2,6,5,1,2,10,73,83
p_9,10,0,e_3,67,92,160,17,2,1,3,5,1,1,25,68,93
p_14,13,0,e_3,87,103,160,8,4,1,9,5,1,3,16,57,73
p_8,15,0,e_3,62,111,160,13,1,0,2,5,0,1,49,49,98
p_11,4,0,e_3,84,146,160,18,4,3,8,5,1,3,62,14,76
p_21,0,10,e_0,142,143,179,5,2,0,0,3,0,0,1,36,37
p_13,8,0,e_2,87,114,186,13,4,2,0,3,1,0,27,72,99
p_17,10,0,e_2,112,122,186,5,2,0,8,5,1,0,10,64,74
p_18,15,0,e_2,120,139,186,27,2,2,10,5,1,1,19,47,66
p_20,3,0,e_0,142,156,221,2,2,1,0,3,0,1,14,65,79
p_28,7,0,e_0,184,190,221,5,1,1,9,4,1,2,6,31,37
p_26,6,0,e_0,169,195,221,11,1,1,7,5,2,0,26,26,52
p_27,5,0,e_0,180,200,221,8,1,1,10,4,1,1,20,21,41
p_30,2,0,e_0,200,211,221,5,1,0,5,4,1,0,11,10,21
p_33,1,0,e_0,213,216,221,2,1,0,2,4,1,0,3,5,8
p_25,9,0,e_3,163,193,224,9,0,0,0,3,0,0,30,31,61
p_31,5,0,e_3,203,207,224,1,1,0,6,4,1,0,4,17,21
p_22,6,0,e_1,146,150,230,28,1,1,5,5,1,0,4,80,84
p_24,14,0,e_1,157,178,230,17,1,1,7,5,1,1,21,52,73
p_23,15,0,e_1,150,183,230,18,1,1,6,5,2,0,33,47,80
p_35,0,6,e_3,222,224,246,0,1,0,0,4,1,0,2,22,24
p_32,0,10,e_0,209,221,253,5,1,0,2,4,1,1,12,32,44
p_36,1,0,e_3,225,229,266,11,1,1,0,5,1,0,4,37,41
p_34,11,0,e_2,217,228,297,21,1,1,8,5,0,1,11,69,80
p_29,14,0,e_2,192,239,297,23,0,0,0,3,0,0,47,58,105
p_37,15,0,e_2,228,244,297,14,1,0,11,5,1,1,16,53,69
p_39,13,0,e_2,247,252,297,23,1,1,14,4,1,0,5,45,50
p_41,7,0,e_2,257,272,297,26,1,1,12,4,1,0,15,25,40
p_44,4,0,e_2,275,283,297,3,1,0,6,4,1,0,8,14,22
p_42,4,0,e_1,269,284,298,4,0,0,0,3,0,0,15,14,29
p_43,4,0,e_3,270,285,299,4,0,0,0,3,0,0,15,14,29
p_49,3,0,e_3,298,310,321,3,0,0,0,3,1,0,12,11,23
p_38,12,0,e_0,240,261,323,8,2,0,6,5,1,0,21,62,83
p_40,15,0,e_0,255,272,323,18,1,1,10,5,0,1,17,51,68
p_46,8,0,e_0,291,295,323,24,1,1,9,4,1,0,4,28,32
p_47,3,0,e_0,293,312,323,29,1,1,8,4,1,1,19,11,30
p_51,0,4,e_3,309,321,335,3,0,0,3,2,0,0,12,14,26
p_59,3,0,e_3,335,340,355,1,2,0,4,4,0,2,5,15,20
p_60,2,0,e_3,338,345,355,1,3,0,3,4,0,3,7,10,17
p_57,1,0,e_3,327,350,355,5,1,1,2,5,1,0,23,5,28
p_62,1,0,e_3,345,350,355,1,2,0,2,4,1,1,5,5,10
p_54,7,0,e_1,313,321,372,25,1,1,5,5,0,1,8,51,59
p_53,8,0,e_1,313,326,372,24,1,1,5,5,0,2,13,46,59
p_45,11,0,e_1,290,337,372,22,1,1,2,4,1,0,47,35,82
p_50,11,0,e_1,299,337,372,11,1,0,0,5,0,1,38,35,73
p_58,0,6,e_3,330,355,375,5,2,2,3,5,1,1,25,20,45
p_56,8,0,e_0,324,351,379,7,1,0,0,3,0,0,27,28,55
p_63,3,0,e_0,364,368,379,6,1,1,4,4,1,0,4,11,15
p_48,9,0,e_2,294,326,389,22,1,1,1,4,1,0,32,63,95
p_52,14,0,e_2,312,343,389,19,1,1,5,5,0,1,31,46,77
p_55,14,0,e_2,314,343,389,18,1,1,5,5,0,2,29,46,75
p_61,12,0,e_2,341,351,389,21,3,3,14,5,1,1,10,38,48
p_65,0,7,e_1,369,372,395,8,1,1,1,4,1,0,3,23,26
p_68,2,0,e_0,389,398,406,12,2,2,0,3,0,0,9,8,17
p_69,2,0,e_2,391,400,416,12,2,2,0,3,0,0,9,16,25
p_70,3,0,e_2,398,405,416,15,1,0,2,5,0,1,7,11,18
p_64,0,15,e_1,365,372,421,9,1,1,2,4,1,0,7,49,56
p_66,11,0,e_3,376,394,441,5,0,0,6,3,0,0,18,47,65
p_67,12,0,e_3,377,399,441,6,1,0,6,5,0,1,22,42,64
p_71,7,0,e_3,403,416,441,4,1,0,11,4,1,0,13,25,38
p_72,6,0,e_3,417,421,441,1,1,0,7,4,1,0,4,20,24
p_73,3,0,e_0,423,435,446,3,1,0,0,3,0,0,12,11,23
p_75,3,0,e_2,438,450,461,28,1,1,0,3,0,0,12,11,23
p_74,10,0,e_1,424,442,476,25,1,1,15,3,0,0,18,34,52
p_77,4,0,e_1,455,462,476,12,1,1,6,4,1,0,7,14,21
p_81,1,0,e_1,493,499,504,10,1,0,0,3,0,0,6,5,11
p_79,9,0,e_0,457,487,516,10,2,2,0,3,0,0,30,29,59
p_76,10,0,e_3,440,473,527,10,0,0,0,3,1,0,33,54,87
p_78,12,0,e_3,455,481,527,8,1,0,4,5,0,1,26,46,72
p_80,13,0,e_3,474,486,527,3,2,0,10,5,1,1,12,41,53
p_82,0,12,e_2,494,495,535,11,1,0,0,3,0,0,1,40,41
p_83,0,12,e_1,501,504,544,8,1,0,1,4,1,0,3,40,43
p_87,3,0,e_0,528,540,567,3,0,0,0,3,0,0,12,27,39
p_89,5,0,e_0,535,548,567,5,0,0,2,5,0,1,13,19,32
p_94,3,0,e_0,546,556,567,4,2,1,5,5,1,1,10,11,21
p_90,1,0,e_3,538,544,569,1,0,0,0,3,0,0,6,25,31
p_93,4,0,e_3,543,555,569,5,0,0,1,2,0,0,12,14,26
p_88,10,0,e_1,531,536,586,10,0,0,9,5,1,0,5,50,55
p_92,10,0,e_1,540,552,586,10,1,0,11,5,2,0,12,34,46
p_95,10,0,e_1,547,552,586,8,2,0,11,4,1,1,5,34,39
p_96,7,0,e_1,551,563,586,4,2,0,10,1,1,0,12,23,35
p_84,12,0,e_2,504,535,591,25,1,1,2,5,1,0,31,56,87
p_85,14,0,e_2,517,543,591,19,1,1,6,5,1,0,26,48,74
p_86,14,0,e_2,518,543,591,19,1,1,7,5,1,1,25,48,73
p_91,14,0,e_2,539,543,591,14,1,0,13,5,1,1,4,48,52
p_99,9,0,e_2,556,560,591,25,2,2,10,4,1,1,4,31,35
p_98,6,0,e_2,555,571,591,28,2,2,10,4,1,0,16,20,36
p_101,9,0,e_0,566,596,663,22,2,2,0,3,1,1,30,67,97
p_100,10,0,e_0,557,601,663,24,2,2,3,4,1,0,44,62,106
p_103,14,0,e_0,577,615,663,12,2,0,3,5,0,2,38,48,86
p_113,9,0,e_0,629,632,663,2,2,0,10,4,1,1,3,31,34
p_106,5,0,e_0,583,646,663,19,3,2,5,5,0,3,63,17,80
p_97,5,0,e_3,552,586,665,2,2,0,3,5,1,1,34,79,113
p_108,7,0,e_3,584,594,665,16,4,2,5,5,0,4,10,71,81
p_105,12,0,e_3,582,611,665,12,2,1,4,5,0,2,29,54,83
p_102,14,0,e_3,568,619,665,14,1,1,0,3,1,1,51,46,97
p_104,14,0,e_3,581,619,665,10,2,0,4,5,0,2,38,46,84
p_107,3,0,e_3,584,654,665,20,3,2,5,5,0,3,70,11,81
p_109,10,0,e_1,590,623,667,12,5,2,0,3,0,0,33,44,77
p_112,11,0,e_1,613,628,667,5,3,1,7,5,0,2,15,39,54
p_116,7,0,e_1,633,642,667,3,2,0,10,4,1,1,9,25,34
p_111,2,0,e_1,607,659,667,15,4,2,5,5,0,1,52,8,60
p_110,12,0,e_2,590,629,671,10,5,1,0,3,1,0,39,42,81
p_115,9,0,e_2,632,640,671,1,2,0,11,4,1,0,8,31,39
p_121,3,0,e_2,656,660,671,30,2,2,4,4,1,1,4,11,15
p_117,0,2,e_3,636,665,673,9,2,0,9,4,1,1,29,8,37
p_123,0,2,e_3,661,665,673,1,2,0,1,4,1,1,4,8,12
p_125,2,0,e_1,668,675,717,23,3,2,0,5,0,1,7,42,49
p_122,7,0,e_1,657,692,717,25,2,2,2,4,1,1,35,25,60
p_126,1,0,e_1,681,712,717,21,2,2,4,5,1,1,31,5,36
p_118,8,0,e_2,649,697,725,26,2,2,6,4,1,0,48,28,76
p_129,5,0,e_2,705,708,725,9,2,1,6,4,1,0,3,17,20
p_119,8,0,e_0,650,689,751,26,2,2,4,4,1,1,39,62,101
p_114,13,0,e_0,632,706,751,27,2,2,9,4,1,1,74,45,119
p_127,7,0,e_0,701,726,751,9,2,1,12,5,1,1,25,25,50
p_131,7,0,e_0,722,726,751,3,1,0,8,4,1,1,4,25,29
p_132,4,0,e_0,730,737,751,3,1,0,6,4,1,0,7,14,21
p_124,7,0,e_3,664,690,753,7,1,1,0,3,1,1,26,63,89
p_120,13,0,e_3,653,710,753,20,1,1,3,1,1,0,57,43,100
p_130,11,0,e_3,705,718,753,3,2,1,12,5,1,1,13,35,48
p_128,0,15,e_1,705,717,768,14,2,2,3,4,1,1,12,51,63
p_140,5,0,e_3,768,786,803,5,0,0,0,3,0,0,18,17,35
p_143,5,0,e_3,780,786,803,2,1,0,3,5,0,1,6,17,23
p_139,0,15,e_0,758,759,808,0,0,0,0,3,0,0,1,49,50
p_133,6,0,e_2,734,755,815,30,1,1,0,3,0,0,21,60,81
p_135,11,0,e_2,739,772,815,23,1,1,1,5,0,1,33,43,76
p_138,12,0,e_2,756,777,815,12,0,0,6,5,1,1,21,38,59
p_137,13,0,e_1,755,758,819,13,0,0,12,5,1,1,3,61,64
p_134,14,0,e_1,734,763,819,22,1,1,5,5,1,0,29,56,85
p_136,14,0,e_1,749,763,819,17,1,1,10,5,1,1,14,56,70
p_142,13,0,e_1,773,776,819,12,1,0,14,4,1,1,3,43,46
p_141,12,0,e_1,770,781,819,12,1,0,15,4,1,0,11,38,49
p_145,1,0,e_1,820,826,831,1,0,0,0,3,0,0,6,5,11
p_144,6,0,e_2,815,836,856,6,0,0,0,3,0,0,21,20,41
p_150,3,0,e_2,860,872,885,24,1,1,0,3,0,0,12,13,25
p_152,2,0,e_2,868,877,885,22,1,1,2,5,0,1,9,8,17
p_146,10,0,e_0,846,864,900,10,0,0,15,3,0,0,18,36,54
p_153,6,0,e_0,872,878,900,17,1,1,8,4,1,0,6,22,28
p_154,4,0,e_0,874,886,900,18,1,1,7,4,1,1,12,14,26
p_147,6,0,e_1,849,870,934,6,0,0,0,3,0,0,21,64,85
p_149,6,0,e_1,859,870,934,21,1,1,3,5,0,1,11,64,75
p_155,11,0,e_1,884,887,934,8,1,1,10,5,1,1,3,47,50
p_151,12,0,e_1,863,892,934,14,1,1,4,5,0,1,29,42,71
p_156,12,0,e_1,884,892,934,7,1,1,10,5,1,2,8,42,50
p_159,8,0,e_1,893,906,934,8,1,1,12,4,1,1,13,28,41
p_158,7,0,e_1,892,911,934,9,1,1,12,4,1,0,19,23,42
p_157,7,0,e_2,889,913,936,10,1,1,0,3,0,0,24,23,47
p_148,15,0,e_3,849,897,944,15,0,0,0,3,0,0,48,47,95
p_3,4,0,e_2,25,40,88,4,0,0,0,3,0,0,15,48,63
p_4,5,0,e_2,34,45,88,5,0,0,2,5,0,1,11,43,54
p_5,9,0,e_2,41,59,88,9,0,0,4,5,1,1,18,29,47
p_6,9,0,e_2,45,59,88,9,0,0,5,5,1,1,14,29,43
p_2,11,0,e_1,19,55,90,11,0,0,0,3,0,0,36,35,71
p_1,13,0,e_0,13,55,96,13,0,0,0,3,0,0,42,41,83
p_12,0,8,e_2,86,88,114,21,4,4,0,4,1,0,2,26,28
p_16,4,0,e_1,101,116,130,13,4,1,0,3,0,0,15,14,29
p_15,5,0,e_0,99,117,134,13,4,2,0,3,0,0,18,17,35
p_19,0,7,e_1,125,130,155,11,2,0,1,4,1,0,5,25,30
p_7,2,0,e_3,55,64,162,2,0,0,0,3,0,0,9,98,107
p_10,9,0,e_3,77,87,162,15,3,2,6,5,1,2,10,75,85
p_9,10,0,e_3,67,92,162,17,2,1,3,5,1,1,25,70,95
p_14,13,0,e_3,87,103,162,8,4,1,9,5,1,3,16,59,75
p_8,15,0,e_3,62,111,162,13,1,0,2,5,0,1,49,51,100
p_11,4,0,e_3,84,146,162,18,4,3,8,5,1,3,62,16,78
p_20,3,0,e_3,142,151,162,2,2,1,5,4,1,1,9,11,20
p_21,0,10,e_0,142,143,177,5,2,0,0,3,0,0,1,34,35
p_13,8,0,e_2,87,114,186,13,4,2,0,3,1,0,27,72,99
p_17,10,0,e_2,112,122,186,5,2,0,8,5,1,0,10,64,74
p_18,15,0,e_2,120,139,186,27,2,2,10,5,1,1,19,47,66
p_30,2,0,e_2,200,209,217,16,3,1,0,3,0,0,9,8,17
p_22,6,0,e_1,146,150,232,28,2,2,5,5,1,0,4,82,86
p_23,15,0,e_1,150,181,232,18,1,1,6,5,2,0,31,51,82
p_28,7,0,e_1,184,207,232,5,3,1,14,4,1,0,23,25,48
p_33,1,0,e_1,213,227,232,13,2,1,5,4,1,0,14,5,19
p_24,14,0,e_0,157,191,239,17,1,1,4,5,1,0,34,48,82
p_31,5,0,e_0,203,220,239,12,3,1,10,4,1,0,17,19,36
p_36,1,0,e_0,225,234,239,10,2,1,4,4,1,0,9,5,14
p_32,0,10,e_2,209,217,249,15,3,3,2,4,1,0,8,32,40
p_35,0,6,e_1,222,232,252,11,2,0,2,4,1,1,10,20,30
p_26,6,0,e_3,169,184,260,11,1,1,1,5,0,1,15,76,91
p_25,9,0,e_3,163,195,260,9,0,0,0,3,0,0,32,65,97
p_29,14,0,e_3,192,212,260,6,3,0,8,5,1,2,20,48,68
p_34,11,0,e_3,217,223,260,2,2,0,13,4,1,1,6,37,43
p_27,5,0,e_3,180,243,260,8,2,2,5,5,0,2,63,17,80
p_42,4,0,e_3,269,284,298,4,0,0,0,3,0,0,15,14,29
p_43,4,0,e_3,270,284,298,4,1,0,0,5,0,1,14,14,28
p_44,4,0,e_3,275,284,298,3,1,0,1,5,0,1,9,14,23
p_41,7,0,e_0,257,281,304,24,1,1,0,3,0,0,24,23,47
p_37,15,0,e_2,228,266,315,25,2,2,3,5,1,0,38,49,87
p_40,15,0,e_2,255,266,315,16,1,1,12,5,0,1,11,49,60
p_47,3,0,e_2,293,304,315,28,2,2,6,4,1,0,11,11,22
p_49,3,0,e_2,298,304,315,19,1,1,5,4,1,1,6,11,17
p_38,12,0,e_1,240,272,320,24,2,2,2,5,1,0,32,48,80
p_39,13,0,e_1,247,277,320,21,1,1,5,5,1,1,30,43,73
p_46,8,0,e_1,291,294,320,24,2,2,9,4,1,0,3,26,29
p_51,0,4,e_2,309,315,329,19,1,1,2,4,1,0,6,14,20
p_57,1,0,e_1,327,333,338,18,2,2,0,3,0,0,6,5,11
p_58,0,6,e_1,330,338,358,18,2,2,0,5,0,1,8,20,28
p_54,7,0,e_0,313,327,370,16,2,2,3,5,0,1,14,43,57
p_53,8,0,e_0,313,332,370,15,2,2,3,5,0,2,19,38,57
p_48,9,0,e_0,294,337,370,22,2,2,3,4,1,0,43,33,76
p_59,3,0,e_0,335,357,370,14,2,1,9,5,1,1,22,13,35
p_62,1,0,e_0,345,365,370,13,1,0,7,4,1,1,20,5,25
p_63,3,0,e_1,364,376,387,5,1,0,6,3,0,0,12,11,23
p_45,11,0,e_3,290,333,388,21,1,1,2,4,1,0,43,55,98
p_50,11,0,e_3,299,333,388,11,1,0,0,5,0,1,34,55,89
p_52,14,0,e_3,312,344,388,10,1,0,4,5,0,1,32,44,76
p_55,14,0,e_3,314,344,388,9,2,0,5,5,0,2,30,44,74
p_65,0,7,e_0,369,370,395,6,1,0,0,3,1,0,1,25,26
p_56,8,0,e_2,324,343,397,12,2,2,3,5,1,0,19,54,73
p_61,12,0,e_2,341,357,397,3,2,1,8,5,0,2,16,40,56
p_60,2,0,e_2,338,389,397,14,2,1,7,5,0,1,51,8,59
p_68,2,0,e_1,389,398,406,2,0,0,0,3,0,0,9,8,17
p_64,0,15,e_0,365,370,425,7,1,0,1,4,1,0,5,55,60
p_69,2,0,e_3,391,400,444,2,0,0,0,3,0,0,9,44,53
p_70,3,0,e_3,398,405,444,1,1,0,2,5,0,1,7,39,46
p_71,7,0,e_3,403,419,444,4,2,0,3,5,1,1,16,25,41
p_72,6,0,e_3,417,424,444,1,2,0,7,5,1,1,7,20,27
p_73,3,0,e_1,423,435,446,3,1,0,0,3,0,0,12,11,23
p_66,11,0,e_0,376,409,476,23,1,1,1,5,2,0,33,67,100
p_67,12,0,e_0,377,414,476,21,1,1,1,5,2,1,37,62,99
p_77,4,0,e_0,455,460,476,4,0,0,5,4,1,1,5,16,21
p_75,3,0,e_0,438,465,476,29,1,1,11,4,1,0,27,11,38
p_81,1,0,e_0,493,499,504,1,0,0,0,3,0,0,6,5,11
p_74,10,0,e_2,424,457,505,26,1,1,0,3,0,0,33,48,81
p_76,10,0,e_2,440,457,505,21,1,1,5,5,0,1,17,48,65
p_78,12,0,e_2,455,465,505,12,0,0,10,5,0,1,10,40,50
p_79,9,0,e_2,457,476,505,9,0,0,10,5,1,1,19,29,48
p_82,0,12,e_3,494,495,535,0,0,0,0,3,0,0,1,40,41
p_83,0,12,e_0,501,504,544,23,1,1,1,4,1,0,3,40,43
p_87,3,0,e_2,528,540,553,15,2,2,0,3,0,0,12,13,25
p_90,1,0,e_2,538,548,553,14,1,1,3,5,0,1,10,5,15
p_84,12,0,e_1,504,513,565,10,1,0,9,5,0,1,9,52,61
p_80,13,0,e_1,474,518,565,13,0,0,0,3,0,0,44,47,91
p_89,5,0,e_1,535,544,565,11,1,1,8,4,1,0,9,21,30
p_93,4,0,e_1,543,549,565,10,1,0,5,1,1,0,6,16,22
p_94,3,0,e_1,546,554,565,10,1,0,5,4,1,1,8,11,19
p_88,10,0,e_0,531,536,586,7,2,2,9,5,1,0,5,50,55
p_92,10,0,e_0,540,552,586,5,1,1,11,5,2,0,12,34,46
p_95,10,0,e_0,547,552,586,3,1,0,11,4,1,1,5,34,39
p_96,7,0,e_0,551,563,586,5,1,0,10,1,1,0,12,23,35
p_85,14,0,e_3,517,543,591,8,1,0,6,5,1,0,26,48,74
p_86,14,0,e_3,518,543,591,7,2,0,7,5,1,1,25,48,73
p_91,14,0,e_3,539,543,591,1,1,0,13,5,0,1,4,48,52
p_99,9,0,e_3,556,560,591,1,2,0,10,4,1,1,4,31,35
p_98,6,0,e_3,555,571,591,4,1,0,10,4,1,0,16,20,36
p_111,2,0,e_3,607,616,624,2,0,0,0,3,0,0,9,8,17
p_97,5,0,e_2,552,570,647,6,1,0,0,3,1,0,18,77,95
p_100,10,0,e_2,557,587,647,30,3,3,1,5,0,1,30,60,90
p_102,14,0,e_2,568,601,647,23,2,2,5,5,0,2,33,46,79
p_103,14,0,e_2,577,601,647,20,1,1,7,5,1,2,24,46,70
p_104,14,0,e_2,581,601,647,19,1,1,8,5,1,2,20,46,66
p_108,7,0,e_2,584,624,647,25,1,1,9,5,1,2,40,23,63
p_101,9,0,e_1,566,596,649,28,2,2,0,3,0,0,30,53,83
p_105,12,0,e_1,582,607,649,21,1,1,5,5,0,1,25,42,67
p_110,12,0,e_1,590,607,649,12,0,0,7,5,0,4,17,42,59
p_106,5,0,e_1,583,630,649,27,1,1,5,5,0,2,47,19,66
p_107,3,0,e_1,584,638,649,29,1,1,5,5,0,3,54,11,65
p_117,0,2,e_2,636,647,655,25,1,1,3,4,1,0,11,8,19
p_109,10,0,e_0,590,623,667,10,0,0,0,3,0,0,33,44,77
p_112,11,0,e_0,613,628,667,10,1,0,7,5,0,1,15,39,54
p_113,9,0,e_0,629,636,667,9,0,0,11,4,1,0,7,31,38
p_115,9,0,e_0,632,636,667,9,0,0,10,4,1,1,4,31,35
p_116,7,0,e_0,633,644,667,19,1,1,10,4,1,1,11,23,34
p_123,0,2,e_0,661,667,675,17,1,1,2,4,1,0,6,8,14
p_125,2,0,e_0,668,675,683,13,1,1,0,5,1,0,7,8,15
p_122,7,0,e_2,657,672,703,11,1,1,2,5,0,1,15,31,46
p_124,7,0,e_2,664,672,703,9,1,1,5,5,0,2,8,31,39
p_119,8,0,e_2,650,677,703,13,1,1,1,5,1,0,27,26,53
p_121,3,0,e_1,656,661,706,16,1,1,2,5,0,1,5,45,50
p_118,8,0,e_1,649,678,706,13,1,1,0,3,0,0,29,28,57
p_126,1,0,e_1,681,701,706,10,1,0,7,4,1,0,20,5,25
p_114,13,0,e_3,632,674,715,13,0,0,0,3,0,0,42,41,83
p_120,13,0,e_3,653,674,715,7,1,0,6,5,0,1,21,41,62
p_129,5,0,e_2,705,723,740,28,1,1,0,3,0,0,18,17,35
p_128,0,15,e_1,705,706,757,3,1,0,0,3,1,0,1,51,52
p_127,7,0,e_0,701,725,796,27,1,1,0,3,0,0,24,71,95
p_130,11,0,e_0,705,739,796,22,1,1,1,5,0,1,34,57,91
p_134,14,0,e_0,734,750,796,11,3,0,10,5,1,1,16,46,62
p_140,5,0,e_0,768,779,796,5,1,0,8,4,1,0,11,17,28
p_132,4,0,e_3,730,737,801,8,1,1,2,5,0,1,7,64,71
p_133,6,0,e_3,734,745,801,5,2,1,3,5,0,2,11,56,67
p_131,7,0,e_3,722,750,801,7,0,0,0,3,0,0,28,51,79
p_135,11,0,e_3,739,764,801,7,3,0,4,5,1,2,25,37,62
p_143,5,0,e_3,780,784,801,1,1,0,6,4,1,0,4,17,21
p_136,14,0,e_1,749,752,808,7,2,0,13,5,1,0,3,56,59
p_137,13,0,e_1,755,765,808,5,2,0,15,5,2,0,10,43,53
p_138,12,0,e_1,756,770,808,3,2,0,15,2,2,1,14,38,52
p_139,0,15,e_2,758,759,812,13,2,2,0,3,0,0,1,53,54
p_145,1,0,e_1,820,826,831,1,0,0,0,3,0,0,6,5,11
p_144,6,0,e_0,815,836,856,6,0,0,0,3,0,0,21,20,41
p_141,12,0,e_2,770,799,859,27,1,1,3,5,1,0,29,60,89
p_142,13,0,e_2,773,804,859,25,1,1,4,5,1,1,31,55,86
p_150,3,0,e_0,860,872,883,6,1,1,0,3,0,0,12,11,23
p_152,2,0,e_2,868,877,929,16,2,1,0,3,0,0,9,52,61
p_154,4,0,e_2,874,885,929,13,2,1,1,5,0,2,11,44,55
p_153,6,0,e_2,872,893,929,12,2,1,1,5,0,1,21,36,57
p_157,7,0,e_2,889,898,929,6,2,1,5,5,1,1,9,31,40
p_158,7,0,e_2,892,898,929,5,1,0,6,2,1,1,6,31,37
p_159,8,0,e_2,893,903,929,4,1,0,6,5,1,1,10,26,36
p_147,6,0,e_3,849,870,930,6,0,0,0,3,0,0,21,60,81
p_149,6,0,e_3,859,870,930,3,1,0,3,5,0,1,11,60,71
p_155,11,0,e_3,884,887,930,3,2,1,10,5,1,1,3,43,46
p_151,12,0,e_3,863,892,930,8,1,0,4,5,0,1,29,38,67
p_156,12,0,e_3,884,892,930,2,3,0,10,5,1,2,8,38,46
p_146,10,0,e_1,846,879,943,10,0,0,0,3,0,0,33,64,97
p_148,15,0,e_1,849,896,943,15,1,1,0,5,0,1,47,47,94
p_3,4,0,e_2,25,40,88,4,0,0,0,3,0,0,15,48,63
p_4,5,0,e_2,34,45,88,5,0,0,2,5,0,1,11,43,54
p_5,9,0,e_2,41,59,88,9,0,0,4,5,1,1,18,29,47
p_6,9,0,e_2,45,59,88,9,0,0,5,5,1,1,14,29,43
p_2,11,0,e_1,19,55,90,11,0,0,0,3,0,0,36,35,71
p_1,13,0,e_0,13,55,96,13,0,0,0,3,0,0,42,41,83
p_12,0,8,e_2,86,88,114,21,4,4,0,4,1,0,2,26,28
p_16,4,0,e_1,101,116,130,13,4,1,0,3,0,0,15,14,29
p_15,5,0,e_0,99,117,134,13,4,2,0,3,0,0,18,17,35
p_19,0,7,e_1,125,130,155,11,2,0,1,4,1,0,5,25,30
p_7,2,0,e_3,55,64,162,2,0,0,0,3,0,0,9,98,107
p_10,9,0,e_3,77,87,162,15,3,2,6,5,1,2,10,75,85
p_9,10,0,e_3,67,92,162,17,2,1,3,5,1,1,25,70,95
p_14,13,0,e_3,87,103,162,8,4,1,9,5,1,3,16,59,75
p_8,15,0,e_3,62,111,162,13,1,0,2,5,0,1,49,51,100
p_11,4,0,e_3,84,146,162,18,4,3,8,5,1,3,62,16,78
p_20,3,0,e_3,142,151,162,2,2,1,5,4,1,1,9,11,20
p_21,0,10,e_0,142,143,179,5,2,0,0,3,0,0,1,36,37
p_13,8,0,e_2,87,114,186,13,4,2,0,3,1,0,27,72,99
p_17,10,0,e_2,112,122,186,5,2,0,8,5,1,0,10,64,74
p_18,15,0,e_2,120,139,186,27,2,2,10,5,1,1,19,47,66
p_27,5,0,e_3,180,187,212,4,1,1,3,5,0,1,7,25,32
p_26,6,0,e_3,169,192,212,6,0,0,0,3,0,0,23,20,43
p_25,9,0,e_0,163,174,215,9,0,0,6,5,1,0,11,41,52
p_28,7,0,e_0,184,190,215,3,2,0,9,4,1,0,6,25,31
p_30,2,0,e_0,200,207,215,2,1,0,4,4,1,0,7,8,15
p_22,6,0,e_1,146,150,234,28,2,2,5,5,1,0,4,84,88
p_24,14,0,e_1,157,178,234,17,1,1,7,5,1,1,21,56,77
p_23,15,0,e_1,150,183,234,18,1,1,6,5,2,0,33,51,84
p_31,5,0,e_1,203,215,234,28,1,1,9,4,1,0,12,19,31
p_33,1,0,e_1,213,229,234,19,1,1,5,4,1,1,16,5,21
p_36,1,0,e_1,225,229,234,15,1,1,2,4,1,1,4,5,9
p_32,0,10,e_3,209,212,244,1,1,0,1,4,1,0,3,32,35
p_35,0,6,e_0,222,223,245,17,1,1,0,3,0,0,1,22,23
p_38,12,0,e_3,240,252,294,3,1,0,9,5,1,0,12,42,54
p_41,7,0,e_3,257,269,294,4,1,0,11,4,1,0,12,25,37
p_42,4,0,e_3,269,280,294,3,1,0,7,4,1,0,11,14,25
p_44,4,0,e_3,275,280,294,1,2,0,5,4,1,1,5,14,19
p_34,11,0,e_2,217,228,295,10,1,0,8,5,0,1,11,67,78
p_29,14,0,e_2,192,239,295,22,1,1,0,3,0,0,47,56,103
p_37,15,0,e_2,228,244,295,10,1,0,11,5,1,1,16,51,67
p_39,13,0,e_2,247,252,295,2,1,0,14,4,1,0,5,43,48
p_43,4,0,e_2,270,281,295,3,2,0,7,4,1,0,11,14,25
p_51,0,4,e_2,309,310,326,0,0,0,0,3,0,0,1,16,17
p_40,15,0,e_0,255,285,342,26,1,1,6,3,0,0,30,57,87
p_45,11,0,e_0,290,299,342,20,1,1,14,4,1,0,9,43,52
p_48,9,0,e_0,294,307,342,9,0,0,12,4,1,2,13,35,48
p_46,8,0,e_0,291,312,342,23,1,1,13,4,1,1,21,30,51
p_54,7,0,e_0,313,317,342,7,0,0,8,4,1,0,4,25,29
p_57,1,0,e_0,327,337,342,11,1,1,4,4,1,0,10,5,15
p_58,0,6,e_0,330,342,362,11,1,1,3,4,1,1,12,20,32
p_53,8,0,e_3,313,340,368,8,0,0,0,3,0,0,27,28,55
p_60,2,0,e_3,338,360,368,6,1,0,8,5,0,1,22,8,30
p_56,8,0,e_2,324,340,370,5,1,0,4,5,1,0,16,30,46
p_59,3,0,e_2,335,357,370,6,1,1,7,5,0,1,22,13,35
p_62,1,0,e_2,345,365,370,6,2,1,7,4,1,1,20,5,25
p_47,3,0,e_1,293,305,388,3,0,0,0,3,0,0,12,83,95
p_49,3,0,e_1,298,305,388,3,0,0,1,5,0,1,7,83,90
p_50,11,0,e_1,299,331,388,11,0,0,1,5,0,1,32,57,89
p_52,14,0,e_1,312,342,388,14,0,0,5,5,1,1,30,46,76
p_55,14,0,e_1,314,342,388,14,1,0,6,5,1,2,28,46,74
p_63,3,0,e_1,364,377,388,28,1,1,7,4,1,0,13,11,24
p_65,0,7,e_2,369,370,395,0,0,0,0,3,1,0,1,25,26
p_68,2,0,e_1,389,398,406,2,0,0,0,3,0,0,9,8,17
p_64,0,15,e_2,365,370,421,1,1,0,1,4,1,0,5,51,56
p_66,11,0,e_0,376,379,422,11,0,0,10,5,0,1,3,43,46
p_61,12,0,e_0,341,384,422,26,2,2,0,3,1,0,43,38,81
p_67,12,0,e_0,377,384,422,12,0,0,11,5,0,2,7,38,45
p_69,2,0,e_3,391,400,444,2,0,0,0,3,0,0,9,44,53
p_70,3,0,e_3,398,405,444,1,1,0,2,5,0,1,7,39,46
p_71,7,0,e_3,403,419,444,4,2,0,3,5,1,1,16,25,41
p_72,6,0,e_3,417,424,444,1,2,0,7,5,1,1,7,20,27
p_73,3,0,e_0,423,435,446,3,1,0,0,3,0,0,12,11,23
p_74,10,0,e_2,424,442,476,26,1,1,15,3,0,0,18,34,52
p_77,4,0,e_2,455,462,476,4,0,0,6,4,1,0,7,14,21
p_81,1,0,e_2,493,499,504,1,0,0,0,3,0,0,6,5,11
p_79,9,0,e_0,457,487,516,9,0,0,0,3,0,0,30,29,59
p_75,3,0,e_1,438,450,527,29,1,1,0,3,0,0,12,77,89
p_76,10,0,e_1,440,473,527,21,1,1,0,5,0,1,33,54,87
p_78,12,0,e_1,455,481,527,12,0,0,4,5,1,1,26,46,72
p_80,13,0,e_1,474,486,527,13,0,0,10,5,1,1,12,41,53
p_82,0,12,e_3,494,495,535,0,0,0,0,3,0,0,1,40,41
p_83,0,12,e_2,501,504,544,23,1,1,1,4,1,0,3,40,43
p_90,1,0,e_1,538,544,549,14,2,1,0,3,0,0,6,5,11
p_87,3,0,e_0,528,540,569,15,2,2,0,3,0,0,12,29,41
p_93,4,0,e_0,543,545,569,10,1,0,4,5,1,1,2,24,26
p_89,5,0,e_0,535,550,569,11,2,1,2,5,0,1,15,19,34
p_94,3,0,e_0,546,558,569,10,1,0,4,5,1,1,12,11,23
p_88,10,0,e_2,531,536,588,7,2,2,9,5,1,0,5,52,57
p_92,10,0,e_2,540,552,588,5,2,1,11,5,2,0,12,36,48
p_95,10,0,e_2,547,552,588,3,1,0,11,4,1,1,5,36,41
p_96,7,0,e_2,551,563,588,5,1,0,10,1,1,0,12,25,37
p_98,6,0,e_2,555,568,588,4,1,0,9,4,1,1,13,20,33
p_84,12,0,e_3,504,535,589,10,1,0,2,5,1,0,31,54,85
p_85,14,0,e_3,517,543,589,8,1,0,6,5,1,0,26,46,72
p_86,14,0,e_3,518,543,589,7,2,0,7,5,1,1,25,46,71
p_91,14,0,e_3,539,543,589,1,2,0,13,5,1,1,4,46,50
p_99,9,0,e_3,556,560,589,1,1,0,10,4,1,0,4,29,33
p_111,2,0,e_2,607,616,624,2,0,0,0,3,0,0,9,8,17
p_97,5,0,e_1,552,570,651,6,1,0,0,3,0,0,18,81,99
p_101,9,0,e_1,566,584,651,28,1,1,4,5,0,2,18,67,85
p_100,10,0,e_1,557,589,651,30,2,2,1,5,0,1,32,62,94
p_105,12,0,e_1,582,597,651,20,1,1,9,5,1,3,15,54,69
p_110,12,0,e_1,590,597,651,12,0,0,10,5,1,2,7,54,61
p_102,14,0,e_1,568,605,651,23,1,1,5,5,0,3,37,46,83
p_103,14,0,e_1,577,605,651,20,1,1,7,5,1,3,28,46,74
p_104,14,0,e_1,581,605,651,18,1,1,8,5,1,3,24,46,70
p_112,11,0,e_1,613,616,651,11,0,0,12,4,1,0,3,35,38
p_107,3,0,e_0,584,595,654,28,1,1,0,5,0,1,11,59,70
p_106,5,0,e_0,583,603,654,27,1,1,0,3,0,0,20,51,71
p_108,7,0,e_0,584,611,654,24,1,1,0,5,0,2,27,43,70
p_109,10,0,e_0,590,622,654,10,0,0,2,5,0,3,32,32,64
p_117,0,2,e_1,636,651,659,17,2,2,5,4,1,0,15,8,23
p_123,0,2,e_0,661,662,672,10,3,3,0,3,0,0,1,10,11
p_121,3,0,e_1,656,664,675,8,3,2,1,5,1,0,8,11,19
p_125,2,0,e_0,668,672,680,7,2,1,1,5,1,0,4,8,12
p_126,1,0,e_0,681,687,692,4,1,0,0,3,0,0,6,5,11
p_116,7,0,e_3,633,656,697,11,1,1,0,5,0,1,23,41,64
p_118,8,0,e_3,649,661,697,5,2,1,5,5,0,2,12,36,48
p_119,8,0,e_3,650,661,697,5,3,1,5,5,0,3,11,36,47
p_115,9,0,e_3,632,666,697,9,0,0,0,3,0,0,34,31,65
p_122,7,0,e_3,657,674,697,4,3,2,7,5,1,2,17,23,40
p_124,7,0,e_3,664,674,697,2,3,0,9,5,1,2,10,23,33
p_113,9,0,e_2,629,659,714,9,0,0,0,3,0,0,30,55,85
p_114,13,0,e_2,632,673,714,13,1,1,0,5,0,1,41,41,82
p_120,13,0,e_2,653,673,714,7,3,0,7,5,0,2,20,41,61
p_129,5,0,e_3,705,723,740,5,0,0,0,3,0,0,18,17,35
p_128,0,15,e_1,705,706,755,0,0,0,0,3,0,0,1,49,50
p_132,4,0,e_2,730,737,773,29,1,1,2,5,0,1,7,36,43
p_133,6,0,e_2,734,745,773,26,1,1,3,5,0,2,11,28,39
p_131,7,0,e_2,722,750,773,12,0,0,0,3,0,0,28,23,51
p_127,7,0,e_0,701,725,800,7,0,0,0,3,0,0,24,75,99
p_130,11,0,e_0,705,739,800,11,1,1,1,5,0,1,34,61,95
p_135,11,0,e_0,739,741,800,11,0,0,11,5,1,1,2,59,61
p_134,14,0,e_0,734,752,800,18,1,1,10,5,1,1,18,48,66
p_136,14,0,e_0,749,752,800,14,0,0,13,5,1,1,3,48,51
p_138,12,0,e_0,756,760,800,12,0,0,13,4,1,0,4,40,44
p_140,5,0,e_0,768,783,800,23,1,1,10,4,1,0,15,17,32
p_143,5,0,e_0,780,783,800,19,2,2,6,4,1,1,3,17,20
p_137,13,0,e_1,755,764,805,13,0,0,15,3,0,0,9,41,50
p_139,0,15,e_3,758,759,810,0,0,0,0,3,0,0,1,51,52
p_145,1,0,e_1,820,826,831,11,1,0,0,3,0,0,6,5,11
p_144,6,0,e_0,815,836,856,8,1,0,0,3,0,0,21,20,41
p_142,13,0,e_2,773,815,856,13,2,1,0,3,0,0,42,41,83
p_141,12,0,e_3,770,799,857,15,1,1,3,5,1,0,29,58,87
p_150,3,0,e_2,860,872,883,3,0,0,0,3,0,0,12,11,23
p_152,2,0,e_3,868,877,929,2,0,0,0,3,0,0,9,52,61
p_154,4,0,e_3,874,885,929,7,2,1,1,5,0,2,11,44,55
p_153,6,0,e_3,872,893,929,5,1,0,1,5,0,1,21,36,57
p_157,7,0,e_3,889,898,929,2,2,0,5,5,1,1,9,31,40
p_158,7,0,e_3,892,898,929,1,2,0,6,2,1,1,6,31,37
p_159,8,0,e_3,893,903,929,2,2,0,6,5,1,1,10,26,36
p_149,6,0,e_0,859,880,940,6,0,0,0,3,0,0,21,60,81
p_155,11,0,e_0,884,897,940,7,2,2,7,5,1,1,13,43,56
p_151,12,0,e_0,863,902,940,12,0,0,1,5,0,1,39,38,77
p_156,12,0,e_0,884,902,940,8,2,2,7,5,1,2,18,38,56
p_147,6,0,e_1,849,867,945,26,1,1,0,5,0,1,18,78,96
p_146,10,0,e_1,846,881,945,23,1,1,0,3,0,0,35,64,99
p_148,15,0,e_1,849,898,945,17,1,1,0,5,0,2,49,47,96
p_3,4,0,e_2,25,40,88,4,0,0,0,3,0,0,15,48,63
p_4,5,0,e_2,34,45,88,5,0,0,2,5,0,1,11,43,54
p_5,9,0,e_2,41,59,88,9,0,0,4,5,1,1,18,29,47
p_6,9,0,e_2,45,59,88,9,0,0,5,5,1,1,14,29,43
p_2,11,0,e_1,19,55,90,11,0,0,0,3,0,0,36,35,71
p_1,13,0,e_0,13,55,96,13,0,0,0,3,0,0,42,41,83
p_12,0,8,e_2,86,88,114,21,4,4,0,4,1,0,2,26,28
p_16,4,0,e_1,101,116,130,13,4,1,0,3,0,0,15,14,29
p_15,5,0,e_0,99,117,134,13,4,2,0,3,0,0,18,17,35
p_19,0,7,e_1,125,130,155,11,2,0,1,4,1,0,5,25,30
p_7,2,0,e_3,55,64,162,2,0,0,0,3,0,0,9,98,107
p_10,9,0,e_3,77,87,162,15,3,2,6,5,1,2,10,75,85
p_9,10,0,e_3,67,92,162,17,2,1,3,5,1,1,25,70,95
p_14,13,0,e_3,87,103,162,8,4,1,9,5,1,3,16,59,75
p_8,15,0,e_3,62,111,162,13,1,0,2,5,0,1,49,51,100
p_11,4,0,e_3,84,146,162,18,4,3,8,5,1,3,62,16,78
p_20,3,0,e_3,142,151,162,2,2,1,5,4,1,1,9,11,20
p_21,0,10,e_0,142,143,177,5,2,0,0,3,0,0,1,34,35
p_13,8,0,e_2,87,114,186,13,4,2,0,3,1,0,27,72,99
p_17,10,0,e_2,112,122,186,5,2,0,8,5,1,0,10,64,74
p_18,15,0,e_2,120,139,186,27,2,2,10,5,1,1,19,47,66
p_30,2,0,e_2,200,209,217,16,3,1,0,3,0,0,9,8,17
p_22,6,0,e_1,146,150,234,28,2,2,5,5,1,0,4,84,88
p_23,15,0,e_1,150,181,234,18,1,1,6,5,2,0,31,53,84
p_28,7,0,e_1,184,207,234,5,3,1,14,4,1,0,23,27,50
p_31,5,0,e_1,203,215,234,12,3,1,8,4,1,1,12,19,31
p_33,1,0,e_1,213,229,234,13,2,1,5,4,1,1,16,5,21
p_36,1,0,e_1,225,229,234,10,2,1,2,4,1,1,4,5,9
p_24,14,0,e_0,157,191,235,17,1,1,4,5,1,0,34,44,78
p_32,0,10,e_2,209,217,249,15,3,3,2,4,1,0,8,32,40
p_35,0,6,e_1,222,234,254,11,2,0,3,4,1,1,12,20,32
p_26,6,0,e_3,169,184,260,11,1,1,1,5,0,1,15,76,91
p_25,9,0,e_3,163,195,260,9,0,0,0,3,0,0,32,65,97
p_29,14,0,e_3,192,212,260,6,3,0,8,5,1,2,20,48,68
p_34,11,0,e_3,217,223,260,2,2,0,13,4,1,1,6,37,43
p_27,5,0,e_3,180,243,260,8,2,2,5,5,0,2,63,17,80
p_42,4,0,e_3,269,284,298,4,0,0,0,3,0,0,15,14,29
p_43,4,0,e_3,270,284,298,4,1,0,0,5,0,1,14,14,28
p_44,4,0,e_3,275,284,298,3,1,0,1,5,0,1,9,14,23
p_41,7,0,e_0,257,281,304,24,1,1,0,3,0,0,24,23,47
p_38,12,0,e_1,240,274,314,24,2,2,2,5,1,0,34,40,74
p_47,3,0,e_1,293,303,314,28,3,3,6,4,1,0,10,11,21
p_49,3,0,e_1,298,303,314,19,2,2,4,4,1,1,5,11,16
p_39,13,0,e_2,247,260,315,21,1,1,10,5,1,1,13,55,68
p_37,15,0,e_2,228,268,315,25,2,2,3,5,1,0,40,47,87
p_40,15,0,e_2,255,268,315,16,1,1,12,5,0,2,13,47,60
p_51,0,4,e_1,309,314,328,19,2,2,1,4,1,0,5,14,19
p_57,1,0,e_2,327,333,338,18,3,2,0,3,0,0,6,5,11
p_58,0,6,e_2,330,338,358,18,3,3,0,5,0,1,8,20,28
p_53,8,0,e_0,313,330,368,15,3,2,3,5,0,1,17,38,55
p_48,9,0,e_0,294,335,368,22,3,3,3,4,1,0,41,33,74
p_59,3,0,e_0,335,355,368,14,2,1,9,4,1,0,20,13,33
p_60,2,0,e_0,338,360,368,14,2,1,8,4,1,1,22,8,30
p_54,7,0,e_1,313,339,372,16,3,3,0,3,1,0,26,33,59
p_56,8,0,e_1,324,344,372,12,3,2,3,5,1,1,20,28,48
p_62,1,0,e_1,345,367,372,13,2,0,8,4,1,0,22,5,27
p_63,3,0,e_2,364,376,387,6,1,0,6,3,0,0,12,11,23
p_46,8,0,e_3,291,324,392,24,2,2,2,4,1,1,33,68,101
p_45,11,0,e_3,290,335,392,21,1,1,2,4,1,0,45,57,102
p_50,11,0,e_3,299,335,392,11,2,0,0,5,0,2,36,57,93
p_52,14,0,e_3,312,346,392,10,2,0,4,5,0,2,34,46,80
p_55,14,0,e_3,314,346,392,9,3,0,5,5,0,3,32,46,78
p_61,12,0,e_3,341,354,392,3,2,1,13,5,1,1,13,38,51
p_65,0,7,e_1,369,372,395,7,1,0,1,4,1,0,3,23,26
p_68,2,0,e_2,389,398,406,29,1,1,0,3,0,0,9,8,17
p_64,0,15,e_0,365,368,415,9,1,0,1,4,1,0,3,47,50
p_69,2,0,e_3,391,400,444,2,0,0,0,3,1,0,9,44,53
p_70,3,0,e_3,398,405,444,1,1,0,2,5,0,1,7,39,46
p_71,7,0,e_3,403,419,444,4,2,0,3,5,1,1,16,25,41
p_72,6,0,e_3,417,424,444,1,2,0,7,5,1,1,7,20,27
p_73,3,0,e_2,423,435,446,3,1,0,0,3,0,0,12,11,23
p_66,11,0,e_1,376,409,454,24,1,1,1,5,1,0,33,45,78
p_67,12,0,e_1,377,414,454,23,1,1,1,5,1,1,37,40,77
p_75,3,0,e_1,438,443,454,29,1,1,4,4,1,0,5,11,16
p_74,10,0,e_0,424,442,476,26,1,1,15,3,0,0,18,34,52
p_76,10,0,e_0,440,442,476,21,1,1,10,4,0,1,2,34,36
p_77,4,0,e_0,455,462,476,4,0,0,6,4,1,0,7,14,21
p_81,1,0,e_0,493,499,504,1,0,0,0,3,0,0,6,5,11
p_79,9,0,e_2,457,487,516,9,0,0,0,3,0,0,30,29,59
p_82,0,12,e_3,494,495,535,0,0,0,0,3,0,0,1,40,41
p_78,12,0,e_1,455,494,542,12,0,0,0,3,0,0,39,48,87
p_80,13,0,e_1,474,499,542,13,0,0,6,5,0,1,25,43,68
p_87,3,0,e_1,528,531,542,15,2,2,4,4,1,0,3,11,14
p_83,0,12,e_0,501,504,544,23,1,1,1,4,1,0,3,40,43
p_90,1,0,e_2,538,541,572,14,2,1,0,5,0,1,3,31,34
p_89,5,0,e_2,535,555,572,11,2,1,0,3,0,0,20,17,37
p_97,5,0,e_2,552,555,572,6,1,0,4,5,1,1,3,17,20
p_94,3,0,e_1,546,555,574,10,1,0,0,5,0,1,9,19,28
p_93,4,0,e_1,543,560,574,10,1,0,0,3,0,0,17,14,31
p_88,10,0,e_0,531,536,586,7,2,2,9,5,1,0,5,50,55
p_92,10,0,e_0,540,552,586,5,2,1,11,5,2,0,12,34,46
p_95,10,0,e_0,547,552,586,3,1,0,11,4,1,1,5,34,39
p_96,7,0,e_0,551,563,586,5,1,0,10,1,1,0,12,23,35
p_84,12,0,e_3,504,535,589,10,1,0,2,5,1,0,31,54,85
p_85,14,0,e_3,517,543,589,8,1,0,6,5,1,0,26,46,72
p_86,14,0,e_3,518,543,589,7,2,0,7,5,1,1,25,46,71
p_91,14,0,e_3,539,543,589,1,2,0,13,5,1,1,4,46,50
p_99,9,0,e_3,556,560,589,1,1,0,10,4,1,0,4,29,33
p_109,10,0,e_0,590,623,667,10,0,0,0,3,0,0,33,44,77
p_112,11,0,e_0,613,628,667,6,1,1,7,5,0,2,15,39,54
p_113,9,0,e_0,629,636,667,3,1,0,11,4,1,1,7,31,38
p_111,2,0,e_0,607,659,667,17,1,1,5,5,0,1,52,8,60
p_101,9,0,e_2,566,601,668,28,1,1,2,4,1,0,35,67,102
p_105,12,0,e_2,582,612,668,20,1,1,3,5,0,2,30,56,86
p_102,14,0,e_2,568,620,668,23,1,1,1,4,1,1,52,48,100
p_104,14,0,e_2,581,620,668,18,1,1,3,5,0,2,39,48,87
p_115,9,0,e_2,632,637,668,2,1,0,10,4,1,1,5,31,36
p_107,3,0,e_2,584,657,668,28,1,1,4,5,0,3,73,11,84
p_110,12,0,e_3,590,629,669,12,0,0,0,3,0,0,39,40,79
p_116,7,0,e_3,633,646,669,4,2,0,11,4,1,1,13,23,36
p_106,5,0,e_1,583,591,672,27,1,1,3,5,0,3,8,81,89
p_98,6,0,e_1,555,596,672,4,1,0,3,5,1,1,41,76,117
p_108,7,0,e_1,584,601,672,24,1,1,3,5,0,4,17,71,88
p_100,10,0,e_1,557,612,672,30,2,2,3,5,1,2,55,60,115
p_103,14,0,e_1,577,626,672,20,1,1,1,5,0,2,49,46,95
p_121,3,0,e_1,656,661,672,1,2,0,4,4,1,1,5,11,16
p_117,0,2,e_0,636,667,675,10,3,0,9,4,1,1,31,8,39
p_123,0,2,e_0,661,667,675,2,2,0,2,4,1,1,6,8,14
p_124,7,0,e_0,664,692,725,24,2,2,1,4,1,1,28,33,61
p_118,8,0,e_0,649,697,725,28,2,2,5,4,1,1,48,28,76
p_129,5,0,e_0,705,708,725,10,2,1,6,4,1,0,3,17,20
p_119,8,0,e_1,650,698,726,28,2,2,6,4,1,0,48,28,76
p_126,1,0,e_1,681,721,726,22,2,1,3,5,0,1,40,5,45
p_122,7,0,e_2,657,691,756,27,2,2,3,4,1,1,34,65,99
p_120,13,0,e_2,653,711,756,22,2,2,4,4,1,1,58,45,103
p_127,7,0,e_2,701,731,756,9,2,1,10,5,1,1,30,25,55
p_131,7,0,e_2,722,731,756,4,1,0,10,4,1,1,9,25,34
p_132,4,0,e_2,730,742,756,4,1,0,7,1,1,0,12,14,26
p_125,2,0,e_3,668,677,757,2,1,1,0,3,1,1,9,80,89
p_114,13,0,e_3,632,712,757,28,1,1,11,4,1,0,80,45,125
p_130,11,0,e_3,705,720,757,4,2,1,11,5,1,1,15,37,52
p_133,6,0,e_3,734,737,757,1,1,0,7,4,1,0,3,20,23
p_128,0,15,e_0,705,725,776,15,2,2,6,4,1,0,20,51,71
p_139,0,15,e_3,758,759,808,0,0,0,0,3,0,0,1,49,50
p_137,13,0,e_1,755,776,827,17,1,1,6,5,0,1,21,51,72
p_134,14,0,e_1,734,781,827,23,2,2,0,3,0,0,47,46,93
p_140,5,0,e_1,768,810,827,23,1,1,11,5,0,2,42,17,59
p_143,5,0,e_1,780,810,827,19,1,1,14,2,1,1,30,17,47
p_135,11,0,e_0,739,760,829,25,1,1,4,5,1,0,21,69,90
p_136,14,0,e_0,749,771,829,18,1,1,8,5,1,1,22,58,80
p_142,13,0,e_0,773,784,829,13,1,1,14,5,2,1,11,45,56
p_141,12,0,e_0,770,789,829,15,1,1,14,2,2,0,19,40,59
p_145,1,0,e_0,820,824,829,13,1,1,2,4,1,0,4,5,9
p_138,12,0,e_2,756,795,833,12,0,0,0,3,0,0,39,38,77
p_144,6,0,e_3,815,845,865,9,0,0,15,3,0,0,30,20,50
p_147,6,0,e_1,849,870,894,29,1,1,0,3,0,0,21,24,45
p_149,6,0,e_1,859,870,894,26,1,1,3,5,0,1,11,24,35
p_154,4,0,e_1,874,878,894,7,2,1,5,4,1,1,4,16,20
p_150,3,0,e_1,860,883,894,28,1,1,3,5,0,1,23,11,34
p_146,10,0,e_0,846,879,927,26,1,1,0,3,0,0,33,48,81
p_151,12,0,e_0,863,887,927,18,1,1,5,5,0,1,24,40,64
p_156,12,0,e_0,884,887,927,8,2,0,11,5,1,2,3,40,43
p_155,11,0,e_0,884,892,927,7,2,0,11,5,1,1,8,35,43
p_152,2,0,e_3,868,877,927,2,0,0,0,3,0,0,9,50,59
p_153,6,0,e_3,872,891,927,5,1,0,1,5,0,1,19,36,55
p_157,7,0,e_3,889,896,927,1,2,0,6,5,1,1,7,31,38
p_158,7,0,e_3,892,896,927,1,2,0,6,5,1,1,4,31,35
p_159,8,0,e_3,893,901,927,2,2,0,6,5,1,1,8,26,34
p_148,15,0,e_2,849,897,944,20,1,1,0,3,0,0,48,47,95
p_3,4,0,e_2,25,40,54,4,0,0,0,3,0,0,15,14,29
p_7,2,0,e_2,55,64,72,10,2,1,0,3,0,0,9,8,17
p_6,9,0,e_1,45,49,92,6,2,0,8,5,0,1,4,43,47
p_2,11,0,e_1,19,57,92,11,0,0,0,3,0,0,38,35,73
p_1,13,0,e_0,13,55,96,13,0,0,0,3,0,0,42,41,83
p_12,0,8,e_1,86,92,118,15,2,2,2,4,1,0,6,26,32
p_15,5,0,e_0,99,117,134,7,1,0,0,3,0,0,18,17,35
p_4,5,0,e_3,34,52,137,5,0,0,0,3,0,0,18,85,103
p_5,9,0,e_3,41,66,137,7,1,0,2,5,0,1,25,71,96
p_9,10,0,e_3,67,71,137,11,2,1,9,5,1,1,4,66,70
p_8,15,0,e_3,62,88,137,7,2,0,8,5,1,1,26,49,75
p_16,4,0,e_3,101,123,137,7,1,0,11,4,1,0,22,14,36
p_19,0,7,e_0,125,134,157,4,1,0,3,4,1,0,9,23,32
p_17,10,0,e_1,112,126,160,27,2,2,6,5,1,0,14,34,48
p_20,3,0,e_1,142,149,160,3,1,1,5,4,1,0,7,11,18
p_21,0,10,e_3,142,143,177,0,0,0,0,3,0,0,1,34,35
p_11,4,0,e_2,84,92,182,12,2,1,2,5,0,1,8,90,98
p_13,8,0,e_2,87,106,182,23,1,0,3,5,0,2,19,76,95
p_10,9,0,e_2,77,111,182,9,2,1,0,3,0,0,34,71,105
p_14,13,0,e_2,87,125,182,28,1,0,3,5,0,3,38,57,95
p_18,15,0,e_2,120,133,182,20,2,2,12,5,1,1,13,49,62
p_22,6,0,e_2,146,162,182,14,1,1,11,4,1,0,16,20,36
p_23,15,0,e_0,150,183,234,14,1,0,5,5,1,0,33,51,84
p_27,5,0,e_0,180,215,234,12,1,1,14,5,0,1,35,19,54
p_33,1,0,e_0,213,229,234,6,2,1,5,4,1,1,16,5,21
p_28,7,0,e_2,184,208,235,9,1,1,0,3,0,0,24,27,51
p_30,2,0,e_2,200,225,235,9,1,0,5,5,0,1,25,10,35
p_36,1,0,e_2,225,230,235,3,1,0,2,4,1,0,5,5,10
p_24,14,0,e_3,157,191,237,10,1,0,4,5,1,0,34,46,80
p_31,5,0,e_3,203,220,237,5,1,0,10,4,1,0,17,17,34
p_35,0,6,e_3,222,237,257,5,1,0,5,4,1,0,15,20,35
p_26,6,0,e_1,169,184,258,14,2,2,1,5,0,1,15,74,89
p_25,9,0,e_1,163,195,258,13,2,2,0,3,0,0,32,63,95
p_29,14,0,e_1,192,212,258,30,1,1,8,5,1,1,20,46,66
p_34,11,0,e_1,217,223,258,25,2,2,13,4,1,0,6,35,41
p_32,0,10,e_0,209,234,266,8,2,0,7,4,1,1,25,32,57
p_42,4,0,e_1,269,272,310,12,1,1,3,5,0,1,3,38,41
p_43,4,0,e_1,270,272,310,12,1,1,4,5,0,2,2,38,40
p_41,7,0,e_1,257,283,310,13,1,1,0,3,1,0,26,27,53
p_44,4,0,e_1,275,294,310,10,1,1,5,5,1,1,19,16,35
p_47,3,0,e_1,293,299,310,6,2,1,4,1,1,0,6,11,17
p_38,12,0,e_2,240,279,319,11,1,0,0,3,0,0,39,40,79
p_49,3,0,e_2,298,308,319,5,1,0,6,4,1,0,10,11,21
p_39,13,0,e_3,247,280,323,10,1,0,3,5,1,0,33,43,76
p_46,8,0,e_3,291,297,323,2,1,0,10,4,1,0,6,26,32
p_51,0,4,e_1,309,310,326,4,1,0,0,3,1,1,1,16,17
p_37,15,0,e_0,228,283,336,18,1,1,1,1,1,0,55,53,108
p_40,15,0,e_0,255,283,336,9,2,0,7,5,1,1,28,53,81
p_45,11,0,e_0,290,297,336,29,1,1,13,4,1,0,7,39,46
p_48,9,0,e_0,294,305,336,30,2,2,12,4,1,1,11,31,42
p_57,1,0,e_0,327,331,336,14,1,1,2,4,1,0,4,5,9
p_58,0,6,e_0,330,336,358,14,1,1,1,1,1,0,6,22,28
p_53,8,0,e_3,313,349,377,25,1,1,3,4,1,0,36,28,64
p_60,2,0,e_3,338,369,377,9,1,1,5,5,0,1,31,8,39
p_59,3,0,e_0,335,347,382,9,1,1,0,3,1,0,12,35,47
p_63,3,0,e_0,364,369,382,30,2,2,4,4,1,1,5,13,18
p_62,1,0,e_0,345,377,382,8,2,1,3,5,1,1,32,5,37
p_65,0,7,e_3,369,377,400,2,1,0,2,4,1,0,8,23,31
p_54,7,0,e_2,313,342,401,26,1,1,2,4,1,0,29,59,88
p_56,8,0,e_2,324,347,401,8,1,0,1,5,0,1,23,54,77
p_61,12,0,e_2,341,361,401,6,2,0,7,2,0,1,20,40,60
p_68,2,0,e_2,389,393,401,24,3,3,3,4,1,0,4,8,12
p_50,11,0,e_1,299,349,406,27,1,1,3,4,1,0,50,57,107
p_52,14,0,e_1,312,360,406,19,1,1,0,5,1,1,48,46,94
p_55,14,0,e_1,314,360,406,19,2,2,0,5,1,2,46,46,92
p_69,2,0,e_1,391,398,406,24,3,3,4,4,1,0,7,8,15
p_64,0,15,e_3,365,377,428,3,2,0,3,4,1,1,12,51,63
p_71,7,0,e_2,403,427,452,15,2,2,0,3,0,0,24,25,49
p_73,3,0,e_2,423,441,452,13,2,1,6,5,0,1,18,11,29
p_72,6,0,e_1,417,438,460,12,2,1,0,3,0,0,21,22,43
p_75,3,0,e_1,438,449,460,9,1,0,6,4,1,0,11,11,22
p_67,12,0,e_0,377,420,462,18,3,1,1,4,1,0,43,42,85
p_74,10,0,e_0,424,428,462,6,2,1,11,4,1,1,4,34,38
p_70,3,0,e_0,398,451,462,20,3,2,5,5,0,1,53,11,64
p_66,11,0,e_3,376,414,477,11,0,0,0,3,1,0,38,63,101
p_76,10,0,e_3,440,445,477,1,1,0,11,4,1,0,5,32,37
p_81,1,0,e_1,493,499,504,1,0,0,0,3,0,0,6,5,11
p_82,0,12,e_3,494,495,535,0,0,0,0,3,0,0,1,40,41
p_77,4,0,e_2,455,470,536,3,1,0,0,3,0,0,15,66,81
p_79,9,0,e_2,457,487,536,27,1,1,0,5,0,2,30,49,79
p_78,12,0,e_2,455,498,536,25,1,1,0,3,0,1,43,38,81
p_83,0,12,e_1,501,504,544,23,1,1,1,4,1,0,3,40,43
p_84,12,0,e_0,504,513,563,10,1,0,9,5,0,1,9,50,59
p_80,13,0,e_0,474,518,563,18,1,1,0,3,0,0,44,45,89
p_87,3,0,e_0,528,550,563,15,2,2,10,4,1,0,22,13,35
p_94,3,0,e_0,546,550,563,10,2,1,4,4,1,2,4,13,17
p_90,1,0,e_0,538,558,563,14,1,1,7,4,1,1,20,5,25
p_93,4,0,e_2,543,550,572,10,2,1,2,5,0,1,7,22,29
p_89,5,0,e_2,535,555,572,11,1,1,0,3,1,0,20,17,37
p_97,5,0,e_2,552,555,572,6,2,1,4,5,1,1,3,17,20
p_88,10,0,e_1,531,536,586,7,2,2,9,5,1,0,5,50,55
p_95,10,0,e_1,547,552,586,3,2,0,11,4,1,0,5,34,39
p_96,7,0,e_1,551,563,586,5,2,1,10,1,1,0,12,23,35
p_85,14,0,e_3,517,543,593,8,1,0,6,5,1,0,26,50,76
p_86,14,0,e_3,518,543,593,7,2,0,7,5,1,1,25,50,75
p_91,14,0,e_3,539,543,593,1,1,0,13,5,0,1,4,50,54
p_92,10,0,e_3,540,557,593,5,1,1,13,5,0,1,17,36,53
p_99,9,0,e_3,556,562,593,1,2,0,10,1,1,1,6,31,37
p_98,6,0,e_3,555,573,593,4,2,0,10,4,1,1,18,20,38
p_111,2,0,e_3,607,616,624,2,0,0,0,3,0,0,9,8,17
p_101,9,0,e_0,566,592,661,29,2,2,1,5,0,1,26,69,95
p_100,10,0,e_0,557,597,661,30,3,3,1,1,1,0,40,64,104
p_102,14,0,e_0,568,611,661,23,2,2,1,5,0,2,43,50,93
p_112,11,0,e_0,613,622,661,10,1,0,14,4,1,1,9,39,48
p_116,7,0,e_0,633,636,661,19,1,1,8,4,1,1,3,25,28
p_107,3,0,e_0,584,650,661,30,1,1,7,5,0,3,66,11,77
p_117,0,2,e_0,636,661,669,25,1,1,7,4,1,1,25,8,33
p_106,5,0,e_1,583,603,670,28,1,1,1,4,1,0,20,67,87
p_109,10,0,e_1,590,620,670,21,1,1,1,5,0,1,30,50,80
p_110,12,0,e_1,590,628,670,19,1,1,1,5,0,2,38,42,80
p_113,9,0,e_1,629,639,670,9,0,0,12,4,1,0,10,31,41
p_121,3,0,e_1,656,659,670,16,2,2,4,4,1,0,3,11,14
p_108,7,0,e_2,584,601,672,26,1,1,2,5,0,2,17,71,88
p_105,12,0,e_2,582,618,672,21,1,1,1,5,0,1,36,54,90
p_103,14,0,e_2,577,626,672,21,1,1,0,3,0,0,49,46,95
p_104,14,0,e_2,581,626,672,20,1,1,1,5,0,1,45,46,91
p_115,9,0,e_2,632,643,672,9,0,0,12,4,1,0,11,29,40
p_123,0,2,e_1,661,670,678,18,3,3,3,4,1,0,9,8,17
p_126,1,0,e_1,681,687,692,11,2,1,2,3,0,0,6,5,11
p_125,2,0,e_0,668,669,711,13,3,1,2,2,1,1,1,42,43
p_124,7,0,e_0,664,688,711,10,3,1,1,5,1,0,24,23,47
p_118,8,0,e_3,649,659,719,13,1,1,5,5,0,1,10,60,70
p_119,8,0,e_3,650,659,719,13,2,1,5,5,0,2,9,60,69
p_114,13,0,e_3,632,676,719,13,0,0,0,3,0,0,44,43,87
p_120,13,0,e_3,653,676,719,7,2,0,6,5,0,2,23,43,66
p_122,7,0,e_3,657,696,719,11,2,1,8,5,0,2,39,23,62
p_128,0,15,e_2,705,706,759,4,1,0,0,3,0,0,1,53,54
p_132,4,0,e_3,730,745,773,4,0,0,0,3,0,0,15,28,43
p_133,6,0,e_3,734,753,773,5,1,0,1,5,0,1,19,20,39
p_127,7,0,e_1,701,725,796,29,1,1,0,3,0,0,24,71,95
p_130,11,0,e_1,705,739,796,23,1,1,1,5,0,1,34,57,91
p_134,14,0,e_1,734,750,796,13,2,0,10,5,1,1,16,46,62
p_140,5,0,e_1,768,779,796,26,1,1,8,4,1,0,11,17,28
p_129,5,0,e_2,705,725,810,29,1,1,0,3,0,1,20,85,105
p_136,14,0,e_2,749,754,810,9,2,0,13,5,2,0,5,56,61
p_138,12,0,e_2,756,770,810,23,1,1,14,5,2,0,14,40,54
p_143,5,0,e_2,780,793,810,23,2,2,9,4,1,0,13,17,30
p_131,7,0,e_0,722,746,811,7,0,0,0,3,0,0,24,65,89
p_135,11,0,e_0,739,760,811,9,2,0,5,5,0,1,21,51,72
p_137,13,0,e_0,755,768,811,23,1,1,10,5,1,1,13,43,56
p_141,12,0,e_0,770,773,811,19,1,1,13,4,1,0,3,38,41
p_139,0,15,e_3,758,773,822,5,1,0,5,4,1,0,15,49,64
p_145,1,0,e_1,820,826,831,14,2,0,0,3,0,0,6,5,11
p_144,6,0,e_0,815,836,856,11,2,1,0,3,0,0,21,20,41
p_142,13,0,e_3,773,814,869,17,1,1,0,5,1,0,41,55,96
p_150,3,0,e_0,860,872,883,30,1,1,0,3,0,0,12,11,23
p_152,2,0,e_3,868,877,913,2,0,0,0,3,1,0,9,36,45
p_154,4,0,e_3,874,885,913,7,2,1,1,5,0,2,11,28,39
p_153,6,0,e_3,872,893,913,5,1,0,1,5,0,1,21,20,41
p_147,6,0,e_2,849,870,934,30,1,1,0,3,0,0,21,64,85
p_149,6,0,e_2,859,870,934,27,1,1,3,5,0,1,11,64,75
p_155,11,0,e_2,884,887,934,7,2,2,10,5,1,1,3,47,50
p_151,12,0,e_2,863,892,934,20,1,1,4,5,0,1,29,42,71
p_156,12,0,e_2,884,892,934,8,2,2,10,5,1,2,8,42,50
p_159,8,0,e_2,893,906,934,28,1,1,12,4,1,1,13,28,41
p_158,7,0,e_2,892,911,934,13,1,0,12,4,1,0,19,23,42
p_157,7,0,e_0,889,913,936,2,2,0,0,3,0,0,24,23,47
p_146,10,0,e_1,846,879,943,27,1,1,0,3,0,0,33,64,97
p_148,15,0,e_1,849,896,943,21,1,1,0,5,0,1,47,47,94
p_3,4,0,e_2,25,40,88,4,0,0,0,3,0,0,15,48,63
p_4,5,0,e_2,34,45,88,5,0,0,2,5,0,1,11,43,54
p_5,9,0,e_2,41,59,88,9,0,0,4,5,1,1,18,29,47
p_6,9,0,e_2,45,59,88,9,0,0,5,5,1,1,14,29,43
p_2,11,0,e_1,19,55,90,11,0,0,0,3,0,0,36,35,71
p_1,13,0,e_0,13,55,96,13,0,0,0,3,0,0,42,41,83
p_12,0,8,e_2,86,88,114,21,4,4,0,4,1,0,2,26,28
p_16,4,0,e_1,101,116,130,13,4,1,0,3,0,0,15,14,29
p_15,5,0,e_0,99,117,134,13,4,2,0,3,0,0,18,17,35
p_19,0,7,e_1,125,130,155,11,2,0,1,4,1,0,5,25,30
p_7,2,0,e_3,55,64,162,2,0,0,0,3,0,0,9,98,107
p_10,9,0,e_3,77,87,162,15,3,2,6,5,1,2,10,75,85
p_9,10,0,e_3,67,92,162,17,2,1,3,5,1,1,25,70,95
p_14,13,0,e_3,87,103,162,8,4,1,9,5,1,3,16,59,75
p_8,15,0,e_3,62,111,162,13,1,0,2,5,0,1,49,51,100
p_11,4,0,e_3,84,146,162,18,4,3,8,5,1,3,62,16,78
p_20,3,0,e_3,142,151,162,2,2,1,5,4,1,1,9,11,20
p_21,0,10,e_0,142,143,177,5,2,0,0,3,0,0,1,34,35
p_13,8,0,e_2,87,114,186,13,4,2,0,3,1,0,27,72,99
p_17,10,0,e_2,112,122,186,5,2,0,8,5,1,0,10,64,74
p_18,15,0,e_2,120,139,186,27,2,2,10,5,1,1,19,47,66
p_30,2,0,e_2,200,209,217,16,3,1,0,3,0,0,9,8,17
p_22,6,0,e_1,146,150,232,28,2,2,5,5,1,0,4,82,86
p_23,15,0,e_1,150,181,232,18,1,1,6,5,2,0,31,51,82
p_31,5,0,e_1,203,213,232,12,3,1,8,4,1,0,10,19,29
p_33,1,0,e_1,213,227,232,13,2,0,5,4,1,0,14,5,19
p_24,14,0,e_0,157,191,237,17,1,1,4,5,1,0,34,46,80
p_36,1,0,e_0,225,232,237,10,2,1,3,4,1,0,7,5,12
p_32,0,10,e_2,209,217,249,15,3,3,2,4,1,0,8,32,40
p_35,0,6,e_1,222,232,252,12,3,0,2,4,1,1,10,20,30
p_26,6,0,e_3,169,184,262,11,1,1,1,5,0,1,15,78,93
p_28,7,0,e_3,184,189,262,5,3,1,6,5,1,2,5,73,78
p_25,9,0,e_3,163,197,262,9,0,0,0,3,0,0,34,65,99
p_29,14,0,e_3,192,214,262,6,3,0,8,5,1,2,22,48,70
p_34,11,0,e_3,217,225,262,2,2,0,13,4,1,1,8,37,45
p_27,5,0,e_3,180,245,262,8,2,2,5,5,0,2,65,17,82
p_42,4,0,e_3,269,284,298,4,0,0,0,3,0,0,15,14,29
p_43,4,0,e_3,270,284,298,4,1,0,0,5,0,1,14,14,28
p_44,4,0,e_3,275,284,298,3,1,0,1,5,0,1,9,14,23
p_41,7,0,e_0,257,281,304,24,1,1,0,3,0,0,24,23,47
p_38,12,0,e_1,240,272,312,24,2,2,2,5,1,0,32,40,72
p_47,3,0,e_1,293,301,312,28,3,3,5,4,1,0,8,11,19
p_49,3,0,e_1,298,301,312,19,2,2,4,4,1,1,3,11,14
p_39,13,0,e_2,247,260,315,22,1,1,10,5,1,1,13,55,68
p_37,15,0,e_2,228,268,315,25,2,2,3,5,1,0,40,47,87
p_40,15,0,e_2,255,268,315,17,1,1,12,5,0,2,13,47,60
p_51,0,4,e_1,309,312,326,19,2,2,1,4,1,0,3,14,17
p_57,1,0,e_2,327,333,338,18,3,2,0,3,0,0,6,5,11
p_58,0,6,e_2,330,338,358,18,3,3,0,5,0,1,8,20,28
p_53,8,0,e_0,313,330,368,15,3,2,3,5,0,1,17,38,55
p_48,9,0,e_0,294,335,368,22,3,3,3,4,1,0,41,33,74
p_59,3,0,e_0,335,355,368,14,2,1,9,4,1,0,20,13,33
p_60,2,0,e_0,338,360,368,14,2,1,8,4,1,1,22,8,30
p_54,7,0,e_1,313,337,370,16,3,3,0,5,1,0,24,33,57
p_56,8,0,e_1,324,342,370,12,3,2,4,5,1,1,18,28,46
p_62,1,0,e_1,345,365,370,13,2,0,7,4,1,0,20,5,25
p_63,3,0,e_2,364,376,387,6,1,0,6,3,0,0,12,11,23
p_46,8,0,e_3,291,324,392,24,2,2,2,4,1,1,33,68,101
p_45,11,0,e_3,290,335,392,21,1,1,2,4,1,0,45,57,102
p_50,11,0,e_3,299,335,392,11,2,0,0,5,0,2,36,57,93
p_52,14,0,e_3,312,346,392,10,2,0,4,5,0,2,34,46,80
p_55,14,0,e_3,314,346,392,9,3,0,5,5,0,3,32,46,78
p_61,12,0,e_3,341,354,392,3,2,1,13,5,1,1,13,38,51
p_65,0,7,e_1,369,370,395,7,1,0,0,3,1,0,1,25,26
p_68,2,0,e_2,389,398,406,29,1,1,0,3,0,0,9,8,17
p_64,0,15,e_0,365,368,415,9,1,0,1,4,1,0,3,47,50
p_69,2,0,e_3,391,400,444,2,0,0,0,3,1,0,9,44,53
p_70,3,0,e_3,398,405,444,1,1,0,2,5,0,1,7,39,46
p_71,7,0,e_3,403,419,444,4,2,0,3,5,1,1,16,25,41
p_72,6,0,e_3,417,424,444,1,2,0,7,5,1,1,7,20,27
p_73,3,0,e_2,423,435,446,3,1,0,0,3,0,0,12,11,23
p_66,11,0,e_1,376,409,454,24,1,1,1,5,1,0,33,45,78
p_67,12,0,e_1,377,414,454,23,1,1,1,5,1,1,37,40,77
p_75,3,0,e_1,438,443,454,29,1,1,4,4,1,0,5,11,16
p_74,10,0,e_0,424,442,476,26,1,1,15,3,0,0,18,34,52
p_76,10,0,e_0,440,442,476,21,1,1,10,4,0,1,2,34,36
p_77,4,0,e_0,455,462,476,4,0,0,6,4,1,0,7,14,21
p_81,1,0,e_0,493,499,504,1,0,0,0,3,0,0,6,5,11
p_79,9,0,e_2,457,487,516,9,0,0,0,3,0,0,30,29,59
p_82,0,12,e_3,494,495,535,0,0,0,0,3,0,0,1,40,41
p_78,12,0,e_1,455,494,542,12,0,0,0,3,0,0,39,48,87
p_80,13,0,e_1,474,499,542,13,0,0,6,5,0,1,25,43,68
p_87,3,0,e_1,528,531,542,15,2,2,4,4,1,0,3,11,14
p_83,0,12,e_0,501,504,544,23,1,1,1,4,1,0,3,40,43
p_90,1,0,e_2,538,541,572,14,2,1,0,5,0,1,3,31,34
p_89,5,0,e_2,535,555,572,11,2,1,0,3,0,0,20,17,37
p_97,5,0,e_2,552,555,572,6,1,0,4,5,1,1,3,17,20
p_94,3,0,e_1,546,555,574,10,1,0,0,5,0,1,9,19,28
p_93,4,0,e_1,543,560,574,10,1,0,0,3,0,0,17,14,31
p_88,10,0,e_0,531,536,586,7,2,2,9,5,1,0,5,50,55
p_92,10,0,e_0,540,552,586,5,2,1,11,5,2,0,12,34,46
p_95,10,0,e_0,547,552,586,3,1,0,11,4,1,1,5,34,39
p_96,7,0,e_0,551,563,586,5,1,0,10,1,1,0,12,23,35
p_84,12,0,e_3,504,535,589,10,1,0,2,5,1,0,31,54,85
p_85,14,0,e_3,517,543,589,8,1,0,6,5,1,0,26,46,72
p_86,14,0,e_3,518,543,589,7,2,0,7,5,1,1,25,46,71
p_91,14,0,e_3,539,543,589,1,2,0,13,5,1,1,4,46,50
p_99,9,0,e_3,556,560,589,1,1,0,10,4,1,0,4,29,33
p_111,2,0,e_3,607,616,624,2,0,0,0,3,0,0,9,8,17
p_109,10,0,e_0,590,623,665,10,0,0,0,3,0,0,33,42,75
p_112,11,0,e_0,613,628,665,10,1,0,7,5,0,1,15,37,52
p_113,9,0,e_0,629,636,665,9,0,0,11,4,1,0,7,29,36
p_115,9,0,e_0,632,636,665,9,0,0,10,4,1,1,4,29,33
p_108,7,0,e_2,584,595,668,24,1,1,4,5,0,4,11,73,84
p_101,9,0,e_2,566,603,668,28,1,1,2,4,1,0,37,65,102
p_105,12,0,e_2,582,614,668,20,1,1,3,5,0,2,32,54,86
p_110,12,0,e_2,590,614,668,12,0,0,6,5,0,5,24,54,78
p_102,14,0,e_2,568,622,668,23,1,1,1,4,1,1,54,46,100
p_104,14,0,e_2,581,622,668,18,1,1,3,5,0,2,41,46,87
p_107,3,0,e_2,584,657,668,28,1,1,4,5,0,3,73,11,84
p_106,5,0,e_1,583,591,672,27,1,1,3,5,0,3,8,81,89
p_98,6,0,e_1,555,596,672,4,1,0,3,5,1,1,41,76,117
p_100,10,0,e_1,557,610,672,30,2,2,3,5,1,2,53,62,115
p_103,14,0,e_1,577,624,672,20,1,1,1,5,0,2,47,48,95
p_116,7,0,e_1,633,647,672,19,1,1,11,4,1,0,14,25,39
p_121,3,0,e_1,656,661,672,16,2,2,4,4,1,0,5,11,16
p_117,0,2,e_0,636,665,673,25,1,1,9,4,1,0,29,8,37
p_123,0,2,e_0,661,665,673,18,3,3,1,4,1,0,4,8,12
p_125,2,0,e_2,668,677,685,13,3,1,0,3,0,0,9,8,17
p_126,1,0,e_1,681,687,692,11,2,1,0,3,0,0,6,5,11
p_124,7,0,e_0,664,690,713,10,3,1,0,3,1,0,26,23,49
p_118,8,0,e_3,649,659,719,13,1,1,5,5,0,1,10,60,70
p_119,8,0,e_3,650,659,719,13,2,1,5,5,0,2,9,60,69
p_114,13,0,e_3,632,676,719,13,0,0,0,3,0,0,44,43,87
p_120,13,0,e_3,653,676,719,7,2,0,6,5,0,2,23,43,66
p_122,7,0,e_3,657,696,719,11,2,1,8,5,0,2,39,23,62
p_128,0,15,e_2,705,706,759,4,1,0,0,3,0,0,1,53,54
p_132,4,0,e_3,730,745,773,4,0,0,0,3,0,0,15,28,43
p_133,6,0,e_3,734,753,773,5,1,0,1,5,0,1,19,20,39
p_127,7,0,e_1,701,725,796,29,1,1,0,3,0,0,24,71,95
p_130,11,0,e_1,705,739,796,23,1,1,1,5,0,1,34,57,91
p_134,14,0,e_1,734,750,796,13,2,0,10,5,1,1,16,46,62
p_140,5,0,e_1,768,779,796,26,1,1,8,4,1,0,11,17,28
p_129,5,0,e_2,705,725,810,29,1,1,0,3,0,1,20,85,105
p_136,14,0,e_2,749,754,810,9,2,0,13,5,2,0,5,56,61
p_138,12,0,e_2,756,770,810,23,1,1,14,5,2,0,14,40,54
p_143,5,0,e_2,780,793,810,23,2,2,9,4,1,0,13,17,30
p_131,7,0,e_0,722,746,811,7,0,0,0,3,0,0,24,65,89
p_135,11,0,e_0,739,760,811,9,2,0,5,5,0,1,21,51,72
p_137,13,0,e_0,755,768,811,23,1,1,10,5,1,1,13,43,56
p_141,12,0,e_0,770,773,811,19,1,1,13,4,1,0,3,38,41
p_139,0,15,e_3,758,773,822,5,1,0,5,4,1,0,15,49,64
p_145,1,0,e_1,820,826,831,14,2,0,0,3,0,0,6,5,11
p_144,6,0,e_0,815,836,856,11,2,1,0,3,0,0,21,20,41
p_142,13,0,e_3,773,814,869,17,1,1,0,5,1,0,41,55,96
p_150,3,0,e_0,860,872,883,30,1,1,0,3,0,0,12,11,23
p_152,2,0,e_3,868,877,929,2,0,0,0,3,1,0,9,52,61
p_154,4,0,e_3,874,885,929,7,2,1,1,5,0,2,11,44,55
p_153,6,0,e_3,872,893,929,5,1,0,1,5,0,1,21,36,57
p_157,7,0,e_3,889,898,929,2,2,0,5,5,1,1,9,31,40
p_158,7,0,e_3,892,898,929,1,2,0,6,2,1,1,6,31,37
p_159,8,0,e_3,893,903,929,2,2,0,6,5,1,1,10,26,36
p_147,6,0,e_2,849,870,930,30,1,1,0,3,0,0,21,60,81
p_149,6,0,e_2,859,870,930,27,1,1,3,5,0,1,11,60,71
p_155,11,0,e_2,884,887,930,7,2,2,10,5,1,1,3,43,46
p_151,12,0,e_2,863,892,930,20,1,1,4,5,0,1,29,38,67
p_156,12,0,e_2,884,892,930,8,2,2,10,5,1,2,8,38,46
p_146,10,0,e_1,846,879,943,27,1,1,0,3,0,0,33,64,97
p_148,15,0,e_1,849,896,943,21,1,1,0,5,0,1,47,47,94
p_3,4,0,e_2,25,40,88,4,0,0,0,3,0,0,15,48,63
p_4,5,0,e_2,34,45,88,5,0,0,2,5,0,1,11,43,54
p_5,9,0,e_2,41,59,88,9,0,0,4,5,1,1,18,29,47
p_6,9,0,e_2,45,59,88,9,0,0,5,5,1,1,14,29,43
p_2,11,0,e_1,19,55,90,11,0,0,0,3,0,0,36,35,71
p_1,13,0,e_0,13,55,96,13,0,0,0,3,0,0,42,41,83
p_12,0,8,e_2,86,88,114,21,4,4,0,4,1,0,2,26,28
p_16,4,0,e_1,101,116,130,13,4,1,0,3,0,0,15,14,29
p_15,5,0,e_0,99,117,134,13,4,2,0,3,0,0,18,17,35
p_19,0,7,e_1,125,130,155,11,2,0,1,4,1,0,5,25,30
p_7,2,0,e_3,55,64,162,2,0,0,0,3,0,0,9,98,107
p_10,9,0,e_3,77,87,162,15,3,2,6,5,1,2,10,75,85
p_9,10,0,e_3,67,92,162,17,2,1,3,5,1,1,25,70,95
p_14,13,0,e_3,87,103,162,8,4,1,9,5,1,3,16,59,75
p_8,15,0,e_3,62,111,162,13,1,0,2,5,0,1,49,51,100
p_11,4,0,e_3,84,146,162,18,4,3,8,5,1,3,62,16,78
p_20,3,0,e_3,142,151,162,2,2,1,5,4,1,1,9,11,20
p_21,0,10,e_0,142,143,177,5,2,0,0,3,0,0,1,34,35
p_13,8,0,e_2,87,114,186,13,4,2,0,3,1,0,27,72,99
p_17,10,0,e_2,112,122,186,5,2,0,8,5,1,0,10,64,74
p_18,15,0,e_2,120,139,186,27,2,2,10,5,1,1,19,47,66
p_30,2,0,e_2,200,209,217,16,3,1,0,3,0,0,9,8,17
p_22,6,0,e_1,146,150,234,28,2,2,5,5,1,0,4,84,88
p_23,15,0,e_1,150,181,234,18,1,1,6,5,2,0,31,53,84
p_28,7,0,e_1,184,207,234,5,3,1,14,4,1,0,23,27,50
p_31,5,0,e_1,203,215,234,12,3,1,8,4,1,1,12,19,31
p_33,1,0,e_1,213,229,234,13,2,1,5,4,1,1,16,5,21
p_36,1,0,e_1,225,229,234,10,2,1,2,4,1,1,4,5,9
p_24,14,0,e_0,157,191,235,17,1,1,4,5,1,0,34,44,78
p_32,0,10,e_2,209,217,249,15,3,3,2,4,1,0,8,32,40
p_35,0,6,e_1,222,234,254,11,2,0,3,4,1,1,12,20,32
p_26,6,0,e_3,169,184,260,11,1,1,1,5,0,1,15,76,91
p_25,9,0,e_3,163,195,260,9,0,0,0,3,0,0,32,65,97
p_29,14,0,e_3,192,212,260,6,3,0,8,5,1,2,20,48,68
p_34,11,0,e_3,217,223,260,2,2,0,13,4,1,1,6,37,43
p_27,5,0,e_3,180,243,260,8,2,2,5,5,0,2,63,17,80
p_42,4,0,e_3,269,284,298,4,0,0,0,3,0,0,15,14,29
p_43,4,0,e_3,270,284,298,4,1,0,0,5,0,1,14,14,28
p_44,4,0,e_3,275,284,298,3,1,0,1,5,0,1,9,14,23
p_41,7,0,e_0,257,281,304,24,1,1,0,3,0,0,24,23,47
p_38,12,0,e_1,240,274,314,24,2,2,2,5,1,0,34,40,74
p_47,3,0,e_1,293,303,314,28,3,3,6,4,1,0,10,11,21
p_49,3,0,e_1,298,303,314,19,2,2,4,4,1,1,5,11,16
p_39,13,0,e_2,247,260,315,21,1,1,10,5,1,1,13,55,68
p_37,15,0,e_2,228,268,315,25,2,2,3,5,1,0,40,47,87
p_40,15,0,e_2,255,268,315,16,1,1,12,5,0,2,13,47,60
p_51,0,4,e_1,309,314,328,19,2,2,1,4,1,0,5,14,19
p_57,1,0,e_2,327,333,338,18,3,2,0,3,0,0,6,5,11
p_58,0,6,e_2,330,338,358,18,3,3,0,5,0,1,8,20,28
p_53,8,0,e_0,313,330,366,15,3,2,3,5,0,1,17,36,53
p_56,8,0,e_0,324,330,366,12,3,2,6,5,0,2,6,36,42
p_48,9,0,e_0,294,335,366,22,3,3,3,4,1,0,41,31,72
p_62,1,0,e_0,345,361,366,13,2,0,6,4,1,0,16,5,21
p_54,7,0,e_1,313,339,366,16,3,3,0,3,1,0,26,27,53
p_59,3,0,e_1,335,353,366,14,2,1,6,5,0,1,18,13,31
p_60,2,0,e_1,338,358,366,14,2,1,7,2,0,1,20,8,28
p_63,3,0,e_2,364,376,387,6,1,0,6,3,0,0,12,11,23
p_46,8,0,e_3,291,324,392,24,2,2,2,4,1,1,33,68,101
p_45,11,0,e_3,290,335,392,21,1,1,2,4,1,0,45,57,102
p_50,11,0,e_3,299,335,392,11,2,0,0,5,0,2,36,57,93
p_52,14,0,e_3,312,346,392,10,2,0,4,5,0,2,34,46,80
p_55,14,0,e_3,314,346,392,9,3,0,5,5,0,3,32,46,78
p_61,12,0,e_3,341,354,392,3,2,1,13,5,1,1,13,38,51
p_65,0,7,e_1,369,370,395,7,1,0,0,3,0,0,1,25,26
p_68,2,0,e_2,389,398,406,29,1,1,0,3,0,0,9,8,17
p_64,0,15,e_0,365,366,415,9,1,0,0,3,1,0,1,49,50
p_69,2,0,e_3,391,400,444,2,0,0,0,3,1,0,9,44,53
p_70,3,0,e_3,398,405,444,1,1,0,2,5,0,1,7,39,46
p_71,7,0,e_3,403,419,444,4,2,0,3,5,1,1,16,25,41
p_72,6,0,e_3,417,424,444,1,2,0,7,5,1,1,7,20,27
p_73,3,0,e_2,423,435,446,3,1,0,0,3,0,0,12,11,23
p_66,11,0,e_1,376,409,454,24,1,1,1,5,1,0,33,45,78
p_67,12,0,e_1,377,414,454,23,1,1,1,5,1,1,37,40,77
p_75,3,0,e_1,438,443,454,29,1,1,4,4,1,0,5,11,16
p_74,10,0,e_0,424,442,476,26,1,1,15,3,0,0,18,34,52
p_76,10,0,e_0,440,442,476,21,1,1,10,4,0,1,2,34,36
p_77,4,0,e_0,455,462,476,4,0,0,6,4,1,0,7,14,21
p_81,1,0,e_0,493,499,504,1,0,0,0,3,0,0,6,5,11
p_79,9,0,e_2,457,487,516,9,0,0,0,3,0,0,30,29,59
p_82,0,12,e_3,494,495,535,0,0,0,0,3,0,0,1,40,41
p_78,12,0,e_1,455,494,542,12,0,0,0,3,0,0,39,48,87
p_80,13,0,e_1,474,499,542,13,0,0,6,5,0,1,25,43,68
p_87,3,0,e_1,528,531,542,15,2,2,4,4,1,0,3,11,14
p_83,0,12,e_0,501,504,544,23,1,1,1,4,1,0,3,40,43
p_90,1,0,e_2,538,541,572,14,2,1,0,5,0,1,3,31,34
p_89,5,0,e_2,535,555,572,11,2,1,0,3,0,0,20,17,37
p_97,5,0,e_2,552,555,572,6,1,0,4,5,1,1,3,17,20
p_94,3,0,e_1,546,555,574,10,1,0,0,5,0,1,9,19,28
p_93,4,0,e_1,543,560,574,10,1,0,0,3,0,0,17,14,31
p_88,10,0,e_0,531,536,586,7,2,2,9,5,1,0,5,50,55
p_92,10,0,e_0,540,552,586,5,2,1,11,5,2,0,12,34,46
p_95,10,0,e_0,547,552,586,3,1,0,11,4,1,1,5,34,39
p_96,7,0,e_0,551,563,586,5,1,0,10,1,1,0,12,23,35
p_84,12,0,e_3,504,535,589,10,1,0,2,5,1,0,31,54,85
p_85,14,0,e_3,517,543,589,8,1,0,6,5,1,0,26,46,72
p_86,14,0,e_3,518,543,589,7,2,0,7,5,1,1,25,46,71
p_91,14,0,e_3,539,543,589,1,2,0,13,5,1,1,4,46,50
p_99,9,0,e_3,556,560,589,1,1,0,10,4,1,0,4,29,33
p_109,10,0,e_0,590,623,667,10,0,0,0,3,0,0,33,44,77
p_112,11,0,e_0,613,628,667,6,1,1,7,5,0,2,15,39,54
p_113,9,0,e_0,629,636,667,3,1,0,11,4,1,1,7,31,38
p_111,2,0,e_0,607,659,667,17,1,1,5,5,0,1,52,8,60
p_108,7,0,e_2,584,595,668,24,1,1,4,5,0,4,11,73,84
p_101,9,0,e_2,566,603,668,28,1,1,2,4,1,0,37,65,102
p_105,12,0,e_2,582,614,668,20,1,1,3,5,0,2,32,54,86
p_102,14,0,e_2,568,622,668,23,1,1,1,4,1,1,54,46,100
p_104,14,0,e_2,581,622,668,18,1,1,3,5,0,2,41,46,87
p_107,3,0,e_2,584,657,668,28,1,1,4,5,0,3,73,11,84
p_110,12,0,e_3,590,629,669,12,0,0,0,3,0,0,39,40,79
p_115,9,0,e_3,632,640,669,2,1,0,11,4,1,0,8,29,37
p_106,5,0,e_1,583,591,672,27,1,1,3,5,0,3,8,81,89
p_98,6,0,e_1,555,596,672,4,1,0,3,5,1,1,41,76,117
p_100,10,0,e_1,557,610,672,30,2,2,3,5,1,2,53,62,115
p_103,14,0,e_1,577,624,672,20,1,1,1,5,0,2,47,48,95
p_116,7,0,e_1,633,647,672,4,2,1,11,4,1,1,14,25,39
p_121,3,0,e_1,656,661,672,1,2,0,4,4,1,1,5,11,16
p_117,0,2,e_0,636,667,675,10,2,0,9,4,1,1,31,8,39
p_123,0,2,e_0,661,667,675,2,2,0,2,4,1,1,6,8,14
p_124,7,0,e_0,664,692,725,24,2,2,1,4,1,1,28,33,61
p_119,8,0,e_0,650,697,725,28,2,2,5,4,1,1,47,28,75
p_126,1,0,e_0,681,720,725,12,2,1,4,5,0,2,39,5,44
p_125,2,0,e_3,668,677,725,2,1,1,0,3,1,1,9,48,57
p_118,8,0,e_3,649,697,725,28,1,1,6,4,1,0,48,28,76
p_129,5,0,e_3,705,708,725,1,1,0,6,4,1,0,3,17,20
p_122,7,0,e_2,657,691,756,27,2,2,3,4,1,1,34,65,99
p_120,13,0,e_2,653,711,756,22,2,2,4,4,1,1,58,45,103
p_127,7,0,e_2,701,731,756,30,1,1,10,5,1,1,30,25,55
p_131,7,0,e_2,722,731,756,24,1,1,10,4,1,1,9,25,34
p_132,4,0,e_2,730,742,756,25,1,1,7,1,1,0,12,14,26
p_130,11,0,e_1,705,707,758,25,2,2,11,5,0,1,2,51,53
p_114,13,0,e_1,632,715,758,28,2,2,12,4,1,0,83,43,126
p_133,6,0,e_1,734,738,758,21,1,1,7,4,1,0,4,20,24
p_128,0,15,e_3,705,725,778,6,1,0,6,4,1,0,20,53,73
p_140,5,0,e_2,768,786,803,12,3,2,0,3,0,0,18,17,35
p_143,5,0,e_2,780,786,803,10,2,1,3,5,0,1,6,17,23
p_139,0,15,e_1,758,759,808,19,4,4,0,3,0,0,1,49,50
p_135,11,0,e_3,739,760,827,15,1,1,4,5,1,0,21,67,88
p_138,12,0,e_3,756,765,827,8,3,2,10,5,1,2,9,62,71
p_136,14,0,e_3,749,773,827,8,2,1,8,5,1,1,24,54,78
p_142,13,0,e_3,773,786,827,3,2,1,14,5,2,0,13,41,54
p_141,12,0,e_0,770,773,829,5,3,2,11,5,0,2,3,56,59
p_137,13,0,e_0,755,778,829,7,3,2,6,5,0,1,23,51,74
p_134,14,0,e_0,734,783,829,13,1,1,0,3,0,0,49,46,95
p_145,1,0,e_0,820,824,829,1,1,0,2,4,1,0,4,5,9
p_144,6,0,e_2,815,836,856,28,1,1,0,3,0,0,21,20,41
p_150,3,0,e_2,860,872,885,24,1,1,0,3,0,0,12,13,25
p_152,2,0,e_2,868,877,885,22,1,1,2,5,0,1,9,8,17
p_146,10,0,e_1,846,864,900,10,0,0,15,3,0,0,18,36,54
p_153,6,0,e_1,872,878,900,17,1,1,8,4,1,0,6,22,28
p_154,4,0,e_1,874,886,900,18,1,1,7,4,1,1,12,14,26
p_147,6,0,e_0,849,870,934,6,0,0,0,3,0,0,21,64,85
p_149,6,0,e_0,859,870,934,21,1,1,3,5,0,1,11,64,75
p_155,11,0,e_0,884,887,934,8,1,1,10,5,1,1,3,47,50
p_151,12,0,e_0,863,892,934,14,1,1,4,5,0,1,29,42,71
p_156,12,0,e_0,884,892,934,7,1,1,10,5,1,2,8,42,50
p_159,8,0,e_0,893,906,934,8,1,1,12,4,1,1,13,28,41
p_158,7,0,e_0,892,911,934,9,1,1,12,4,1,0,19,23,42
p_157,7,0,e_2,889,913,936,10,1,1,0,3,0,0,24,23,47
p_148,15,0,e_3,849,897,944,15,0,0,0,3,0,0,48,47,95
p_3,4,0,e_2,25,40,62,4,0,0,0,3,0,0,15,22,37
p_4,5,0,e_2,34,45,62,5,0,0,2,5,0,1,11,17,28
p_5,9,0,e_1,41,49,92,9,0,0,7,5,0,1,8,43,51
p_6,9,0,e_1,45,49,92,9,0,0,8,5,0,2,4,43,47
p_2,11,0,e_1,19,57,92,11,0,0,0,3,0,0,38,35,73
p_1,13,0,e_0,13,55,96,13,0,0,0,3,0,0,42,41,83
p_12,0,8,e_1,86,92,118,21,2,2,2,4,1,0,6,26,32
p_16,4,0,e_0,101,114,136,13,2,1,0,5,0,1,13,22,35
p_15,5,0,e_0,99,119,136,12,2,1,0,3,0,0,20,17,37
p_13,8,0,e_2,87,94,138,13,2,1,6,5,0,3,7,44,51
p_10,9,0,e_2,77,99,138,15,2,1,3,5,0,1,22,39,61
p_9,10,0,e_2,67,104,138,17,2,1,0,3,0,0,37,34,71
p_11,4,0,e_2,84,124,138,18,2,1,5,5,0,2,40,14,54
p_7,2,0,e_3,55,64,156,2,0,0,0,3,0,0,9,92,101
p_14,13,0,e_3,87,99,156,8,2,1,9,5,1,1,12,57,69
p_8,15,0,e_3,62,107,156,13,1,0,2,5,0,1,45,49,94
p_20,3,0,e_3,142,145,156,1,1,0,4,4,1,0,3,11,14
p_19,0,7,e_0,125,136,161,9,1,0,3,4,1,0,11,25,36
p_21,0,10,e_2,142,143,177,4,1,0,0,3,0,0,1,34,35
p_17,10,0,e_1,112,126,192,4,1,0,6,5,1,0,14,66,80
p_18,15,0,e_1,120,143,192,26,1,1,8,5,0,1,23,49,72
p_26,6,0,e_1,169,172,192,11,1,1,7,4,1,0,3,20,23
p_30,2,0,e_1,200,209,217,16,3,1,0,3,0,0,9,8,17
p_24,14,0,e_2,157,191,237,14,0,0,4,5,1,0,34,46,80
p_33,1,0,e_2,213,232,237,13,2,1,7,4,1,0,19,5,24
p_22,6,0,e_0,146,156,238,27,1,1,3,5,1,0,10,82,92
p_23,15,0,e_0,150,187,238,17,1,1,4,5,1,1,37,51,88
p_31,5,0,e_0,203,219,238,12,3,1,10,4,1,0,16,19,35
p_36,1,0,e_0,225,233,238,10,2,1,3,4,1,0,8,5,13
p_32,0,10,e_1,209,217,249,15,3,3,2,4,1,0,8,32,40
p_35,0,6,e_0,222,238,258,11,2,0,4,4,1,0,16,20,36
p_28,7,0,e_3,184,187,260,5,2,1,6,5,0,2,3,73,76
p_25,9,0,e_3,163,195,260,9,0,0,0,3,0,0,32,65,97
p_29,14,0,e_3,192,212,260,6,3,0,8,5,1,2,20,48,68
p_34,11,0,e_3,217,223,260,2,2,0,13,4,1,1,6,37,43
p_27,5,0,e_3,180,243,260,8,1,1,5,5,0,1,63,17,80
p_41,7,0,e_0,257,263,288,24,1,1,6,2,1,0,6,25,31
p_42,4,0,e_0,269,274,288,4,0,0,5,4,1,0,5,14,19
p_43,4,0,e_0,270,274,288,4,0,0,5,4,1,1,4,14,18
p_44,4,0,e_3,275,290,304,4,0,0,0,3,0,0,15,14,29
p_39,13,0,e_1,247,260,317,21,1,1,10,5,1,1,13,57,70
p_37,15,0,e_1,228,268,317,25,2,2,3,5,1,0,40,49,89
p_40,15,0,e_1,255,268,317,16,1,1,12,5,0,2,13,49,62
p_47,3,0,e_1,293,306,317,30,1,1,7,4,1,0,13,11,24
p_38,12,0,e_2,240,279,319,24,2,2,0,3,0,0,39,40,79
p_49,3,0,e_2,298,308,319,29,1,1,6,4,1,0,10,11,21
p_51,0,4,e_3,309,310,326,0,0,0,0,3,0,0,1,16,17
p_57,1,0,e_2,327,333,338,11,2,2,0,3,0,0,6,5,11
p_58,0,6,e_2,330,338,358,11,2,2,0,5,0,1,8,20,28
p_54,7,0,e_3,313,337,374,7,1,0,0,5,1,0,24,37,61
p_53,8,0,e_3,313,342,374,8,2,0,0,5,1,1,29,32,61
p_59,3,0,e_3,335,359,374,6,2,1,7,5,0,2,24,15,39
p_60,2,0,e_3,338,364,374,7,3,1,7,5,1,2,26,10,36
p_62,1,0,e_3,345,369,374,6,3,2,7,4,1,2,24,5,29
p_56,8,0,e_1,324,351,379,4,3,0,0,3,0,0,27,28,55
p_63,3,0,e_1,364,368,379,29,2,2,4,4,1,0,4,11,15
p_46,8,0,e_0,291,317,387,26,1,1,0,5,0,1,26,70,96
p_48,9,0,e_0,294,322,387,24,1,1,1,5,0,2,28,65,93
p_45,11,0,e_0,290,330,387,23,1,1,0,3,0,0,40,57,97
p_50,11,0,e_0,299,330,387,20,1,1,2,5,0,3,31,57,88
p_52,14,0,e_0,312,341,387,14,1,0,7,5,0,3,29,46,75
p_55,14,0,e_0,314,341,387,14,3,0,7,5,0,4,27,46,73
p_61,12,0,e_0,341,349,387,14,3,0,14,4,1,0,8,38,46
p_65,0,7,e_3,369,374,397,1,1,0,1,4,1,0,5,23,28
p_68,2,0,e_0,389,398,406,23,2,2,0,3,0,0,9,8,17
p_69,2,0,e_1,391,400,416,23,2,2,0,3,0,0,9,16,25
p_70,3,0,e_1,398,405,416,20,1,1,2,5,0,1,7,11,18
p_64,0,15,e_3,365,374,423,2,2,0,2,4,1,1,9,49,58
p_66,11,0,e_2,376,394,441,19,2,1,6,3,0,0,18,47,65
p_67,12,0,e_2,377,399,441,17,2,1,6,5,0,1,22,42,64
p_71,7,0,e_2,403,416,441,14,1,1,11,4,1,0,13,25,38
p_72,6,0,e_2,417,421,441,11,1,1,7,4,1,0,4,20,24
p_73,3,0,e_0,423,435,446,12,0,0,0,3,0,0,12,11,23
p_75,3,0,e_1,438,450,461,8,1,1,0,3,0,0,12,11,23
p_74,10,0,e_3,424,442,476,5,0,0,15,3,0,0,18,34,52
p_77,4,0,e_3,455,462,476,2,1,0,6,4,1,0,7,14,21
p_81,1,0,e_1,493,499,504,1,0,0,0,3,0,0,6,5,11
p_79,9,0,e_0,457,487,516,26,2,2,0,3,0,0,30,29,59
p_76,10,0,e_2,440,473,527,20,1,1,0,3,1,0,33,54,87
p_78,12,0,e_2,455,481,527,24,2,2,4,5,0,1,26,46,72
p_80,13,0,e_2,474,486,527,17,1,1,10,5,1,1,12,41,53
p_82,0,12,e_3,494,495,535,0,0,0,0,3,0,0,1,40,41
p_83,0,12,e_1,501,504,544,23,1,1,1,4,1,0,3,40,43
p_90,1,0,e_2,538,544,549,14,2,1,0,3,0,0,6,5,11
p_87,3,0,e_0,528,540,569,15,2,2,0,3,0,0,12,29,41
p_93,4,0,e_0,543,545,569,10,1,0,4,5,1,1,2,24,26
p_89,5,0,e_0,535,550,569,11,2,1,2,5,0,1,15,19,34
p_94,3,0,e_0,546,558,569,10,1,0,4,5,1,1,12,11,23
p_88,10,0,e_1,531,536,586,7,2,2,9,5,1,0,5,50,55
p_92,10,0,e_1,540,552,586,5,2,1,11,5,2,0,12,34,46
p_95,10,0,e_1,547,552,586,3,1,0,11,4,1,1,5,34,39
p_96,7,0,e_1,551,563,586,5,1,0,10,1,1,0,12,23,35
p_84,12,0,e_3,504,535,591,10,1,0,2,5,1,0,31,56,87
p_85,14,0,e_3,517,543,591,8,1,0,6,5,1,0,26,48,74
p_86,14,0,e_3,518,543,591,7,2,0,7,5,1,1,25,48,73
p_91,14,0,e_3,539,543,591,1,2,0,13,5,1,1,4,48,52
p_99,9,0,e_3,556,560,591,1,2,0,10,4,1,1,4,31,35
p_98,6,0,e_3,555,571,591,4,1,0,10,4,1,0,16,20,36
p_111,2,0,e_3,607,616,624,2,0,0,0,3,0,0,9,8,17
p_109,10,0,e_1,590,623,655,10,0,0,0,3,0,0,33,32,65
p_97,5,0,e_2,552,570,655,6,1,0,0,3,0,0,18,85,103
p_101,9,0,e_2,566,584,655,28,2,2,4,5,0,2,18,71,89
p_100,10,0,e_2,557,589,655,30,3,3,1,5,0,1,32,66,98
p_110,12,0,e_2,590,597,655,12,0,0,10,5,1,3,7,58,65
p_102,14,0,e_2,568,605,655,23,2,2,5,5,0,3,37,50,87
p_103,14,0,e_2,577,605,655,20,1,1,7,5,1,3,28,50,78
p_104,14,0,e_2,581,605,655,19,1,1,8,5,1,3,24,50,74
p_112,11,0,e_2,613,616,655,10,1,0,12,4,1,2,3,39,42
p_106,5,0,e_2,583,636,655,27,1,1,9,2,1,2,53,19,72
p_107,3,0,e_2,584,644,655,29,1,1,9,5,1,3,60,11,71
p_117,0,2,e_1,636,655,663,25,2,2,6,4,1,0,19,8,27
p_108,7,0,e_0,584,606,665,25,1,1,0,5,0,1,22,59,81
p_105,12,0,e_0,582,623,665,21,1,1,0,3,0,0,41,42,83
p_113,9,0,e_0,629,634,665,9,0,0,10,4,1,0,5,31,36
p_116,7,0,e_0,633,642,665,19,2,2,9,1,1,0,9,23,32
p_123,0,2,e_0,661,665,673,18,3,3,1,4,1,0,4,8,12
p_121,3,0,e_2,656,668,679,16,3,3,0,3,0,0,12,11,23
p_125,2,0,e_0,668,673,681,14,2,1,1,5,1,0,5,8,13
p_126,1,0,e_0,681,687,692,11,1,0,0,3,0,0,6,5,11
p_122,7,0,e_1,657,680,703,11,3,2,0,5,1,0,23,23,46
p_124,7,0,e_1,664,680,703,10,2,1,2,5,0,1,16,23,39
p_118,8,0,e_3,649,659,719,13,2,2,5,5,0,2,10,60,70
p_119,8,0,e_3,650,659,719,13,3,2,5,5,0,3,9,60,69
p_115,9,0,e_3,632,664,719,9,0,0,0,3,0,0,32,55,87
p_114,13,0,e_3,632,678,719,13,1,1,0,3,0,1,46,41,87
p_120,13,0,e_3,653,678,719,7,3,0,6,5,0,3,25,41,66
p_129,5,0,e_2,705,723,740,29,1,1,0,3,0,0,18,17,35
p_128,0,15,e_1,705,706,755,4,1,0,0,3,0,0,1,49,50
p_132,4,0,e_3,730,737,773,8,1,1,2,5,0,1,7,36,43
p_133,6,0,e_3,734,745,773,5,2,1,3,5,0,2,11,28,39
p_131,7,0,e_3,722,750,773,7,0,0,0,3,0,0,28,23,51
p_127,7,0,e_0,701,725,800,29,1,1,0,3,0,0,24,75,99
p_130,11,0,e_0,705,739,800,23,1,1,1,5,0,1,34,61,95
p_135,11,0,e_0,739,741,800,7,3,0,11,5,1,1,2,59,61
p_134,14,0,e_0,734,752,800,11,3,0,10,5,1,1,18,48,66
p_136,14,0,e_0,749,752,800,21,1,0,13,5,1,1,3,48,51
p_138,12,0,e_0,756,760,800,23,1,1,13,4,1,0,4,40,44
p_140,5,0,e_0,768,783,800,26,1,1,10,4,1,0,15,17,32
p_143,5,0,e_0,780,783,800,19,1,1,6,4,1,1,3,17,20
p_137,13,0,e_1,755,764,805,23,1,1,15,3,0,0,9,41,50
p_139,0,15,e_2,758,759,810,5,1,0,0,3,0,0,1,51,52
p_145,1,0,e_1,820,826,831,11,1,0,0,3,0,0,6,5,11
p_144,6,0,e_0,815,836,856,7,1,0,0,3,0,0,21,20,41
p_142,13,0,e_3,773,815,856,13,0,0,0,3,0,0,42,41,83
p_141,12,0,e_2,770,799,857,19,1,1,3,5,1,0,29,58,87
p_150,3,0,e_2,860,872,885,3,0,0,0,3,0,0,12,13,25
p_152,2,0,e_2,868,877,885,21,1,1,2,5,0,1,9,8,17
p_149,6,0,e_0,859,880,902,6,0,0,0,3,0,0,21,22,43
p_153,6,0,e_0,872,880,902,16,1,1,4,5,0,1,8,22,30
p_154,4,0,e_0,874,888,902,17,1,1,4,5,0,1,14,14,28
p_155,11,0,e_3,884,899,942,7,1,1,6,5,0,1,15,43,58
p_151,12,0,e_3,863,904,942,12,0,0,0,3,0,0,41,38,79
p_156,12,0,e_3,884,904,942,6,2,0,6,5,0,2,20,38,58
p_157,7,0,e_2,889,913,944,9,2,2,0,3,0,0,24,31,55
p_158,7,0,e_2,892,913,944,8,2,2,0,5,0,1,21,31,52
p_159,8,0,e_2,893,918,944,7,2,2,1,5,0,1,25,26,51
p_147,6,0,e_1,849,867,945,26,1,1,0,5,0,1,18,78,96
p_146,10,0,e_1,846,881,945,23,1,1,0,3,0,0,35,64,99
p_148,15,0,e_1,849,898,945,17,1,1,0,5,0,2,49,47,96
p_3,4,0,e_2,25,40,88,4,0,0,0,3,0,0,15,48,63
p_4,5,0,e_2,34,45,88,5,0,0,2,5,0,1,11,43,54
p_5,9,0,e_2,41,59,88,9,0,0,4,5,1,1,18,29,47
p_6,9,0,e_2,45,59,88,9,0,0,5,5,1,1,14,29,43
p_2,11,0,e_1,19,55,90,11,0,0,0,3,0,0,36,35,71
p_1,13,0,e_0,13,55,96,13,0,0,0,3,0,0,42,41,83
p_12,0,8,e_2,86,88,114,21,4,4,0,4,1,0,2,26,28
p_16,4,0,e_1,101,116,130,13,4,1,0,3,0,0,15,14,29
p_15,5,0,e_0,99,117,134,13,4,2,0,3,0,0,18,17,35
p_19,0,7,e_1,125,130,155,11,2,0,1,4,1,0,5,25,30
p_7,2,0,e_3,55,64,162,2,0,0,0,3,0,0,9,98,107
p_10,9,0,e_3,77,87,162,15,3,2,6,5,1,2,10,75,85
p_9,10,0,e_3,67,92,162,17,2,1,3,5,1,1,25,70,95
p_14,13,0,e_3,87,103,162,8,4,1,9,5,1,3,16,59,75
p_8,15,0,e_3,62,111,162,13,1,0,2,5,0,1,49,51,100
p_11,4,0,e_3,84,146,162,18,4,3,8,5,1,3,62,16,78
p_20,3,0,e_3,142,151,162,2,2,1,5,4,1,1,9,11,20
p_21,0,10,e_0,142,143,177,5,2,0,0,3,0,0,1,34,35
p_13,8,0,e_2,87,114,186,13,4,2,0,3,1,0,27,72,99
p_17,10,0,e_2,112,122,186,5,2,0,8,5,1,0,10,64,74
p_18,15,0,e_2,120,139,186,27,2,2,10,5,1,1,19,47,66
p_30,2,0,e_2,200,209,217,16,3,1,0,3,0,0,9,8,17
p_22,6,0,e_1,146,150,232,28,2,2,5,5,1,0,4,82,86
p_23,15,0,e_1,150,181,232,18,1,1,6,5,2,0,31,51,82
p_31,5,0,e_1,203,213,232,12,3,1,8,4,1,0,10,19,29
p_33,1,0,e_1,213,227,232,13,2,0,5,4,1,0,14,5,19
p_24,14,0,e_0,157,191,237,17,1,1,4,5,1,0,34,46,80
p_36,1,0,e_0,225,232,237,10,2,1,3,4,1,0,7,5,12
p_32,0,10,e_2,209,217,249,15,3,3,2,4,1,0,8,32,40
p_35,0,6,e_1,222,232,252,12,3,0,2,4,1,1,10,20,30
p_26,6,0,e_3,169,184,262,11,1,1,1,5,0,1,15,78,93
p_28,7,0,e_3,184,189,262,5,3,1,6,5,1,2,5,73,78
p_25,9,0,e_3,163,197,262,9,0,0,0,3,0,0,34,65,99
p_29,14,0,e_3,192,214,262,6,3,0,8,5,1,2,22,48,70
p_34,11,0,e_3,217,225,262,2,2,0,13,4,1,1,8,37,45
p_27,5,0,e_3,180,245,262,8,2,2,5,5,0,2,65,17,82
p_42,4,0,e_3,269,284,298,4,0,0,0,3,0,0,15,14,29
p_43,4,0,e_3,270,284,298,4,1,0,0,5,0,1,14,14,28
p_44,4,0,e_3,275,284,298,3,1,0,1,5,0,1,9,14,23
p_41,7,0,e_0,257,281,304,24,1,1,0,3,0,0,24,23,47
p_37,15,0,e_2,228,266,315,25,2,2,3,5,1,0,38,49,87
p_40,15,0,e_2,255,266,315,17,1,1,12,5,0,1,11,49,60
p_47,3,0,e_2,293,304,315,28,2,2,6,4,1,0,11,11,22
p_49,3,0,e_2,298,304,315,19,2,2,5,4,1,1,6,11,17
p_38,12,0,e_1,240,272,320,24,2,2,2,5,1,0,32,48,80
p_39,13,0,e_1,247,277,320,22,1,1,5,5,1,1,30,43,73
p_46,8,0,e_1,291,294,320,24,2,2,9,4,1,0,3,26,29
p_51,0,4,e_0,309,310,326,19,2,2,0,3,0,0,1,16,17
p_57,1,0,e_1,327,333,338,18,3,2,0,3,0,0,6,5,11
p_58,0,6,e_2,330,331,353,18,3,3,0,3,0,0,1,22,23
p_60,2,0,e_1,338,347,357,14,2,1,0,3,0,0,9,10,19
p_62,1,0,e_1,345,352,357,13,2,0,2,5,0,1,7,5,12
p_54,7,0,e_0,313,337,370,16,3,3,0,5,1,0,24,33,57
p_53,8,0,e_0,313,342,370,15,3,3,0,5,1,1,29,28,57
p_56,8,0,e_0,324,342,370,12,3,3,4,5,1,2,18,28,46
p_59,3,0,e_0,335,359,370,14,2,1,7,5,0,2,24,11,35
p_63,3,0,e_1,364,376,387,6,1,0,0,3,0,0,12,11,23
p_48,9,0,e_3,294,327,392,22,2,2,1,4,1,1,33,65,98
p_45,11,0,e_3,290,335,392,21,1,1,2,4,1,0,45,57,102
p_50,11,0,e_3,299,335,392,11,2,0,0,5,0,2,36,57,93
p_52,14,0,e_3,312,346,392,10,2,0,4,5,0,2,34,46,80
p_55,14,0,e_3,314,346,392,9,3,0,5,5,0,3,32,46,78
p_61,12,0,e_3,341,354,392,3,2,1,13,5,1,1,13,38,51
p_65,0,7,e_0,369,370,395,7,1,0,0,3,1,0,1,25,26
p_68,2,0,e_1,389,398,406,29,1,1,0,3,0,0,9,8,17
p_69,2,0,e_3,391,400,416,2,0,0,0,3,1,0,9,16,25
p_70,3,0,e_3,398,405,416,1,1,0,2,5,0,1,7,11,18
p_64,0,15,e_0,365,370,421,9,1,0,1,4,1,0,5,51,56
p_66,11,0,e_2,376,394,441,24,1,1,6,3,0,0,18,47,65
p_67,12,0,e_2,377,399,441,23,1,1,6,5,0,1,22,42,64
p_71,7,0,e_2,403,416,441,4,2,0,11,4,1,0,13,25,38
p_72,6,0,e_2,417,421,441,6,0,0,7,4,1,0,4,20,24
p_73,3,0,e_1,423,435,446,3,0,0,0,3,0,0,12,11,23
p_75,3,0,e_3,438,450,461,3,0,0,0,3,0,0,12,11,23
p_74,10,0,e_0,424,442,476,10,0,0,15,3,0,0,18,34,52
p_77,4,0,e_0,455,462,476,28,1,1,6,4,1,0,7,14,21
p_81,1,0,e_0,493,499,504,1,0,0,0,3,0,0,6,5,11
p_79,9,0,e_1,457,487,516,22,1,1,0,3,0,0,30,29,59
p_76,10,0,e_2,440,473,527,10,1,0,0,3,1,0,33,54,87
p_78,12,0,e_2,455,481,527,20,1,1,4,5,0,1,26,46,72
p_80,13,0,e_2,474,486,527,13,0,0,10,5,1,1,12,41,53
p_82,0,12,e_3,494,495,535,0,0,0,0,3,0,0,1,40,41
p_83,0,12,e_0,501,504,544,23,1,1,1,4,1,0,3,40,43
p_90,1,0,e_2,538,544,549,14,2,1,0,3,0,0,6,5,11
p_87,3,0,e_1,528,540,569,15,2,2,0,3,0,0,12,29,41
p_93,4,0,e_1,543,545,569,10,1,0,4,5,1,1,2,24,26
p_89,5,0,e_1,535,550,569,11,2,1,2,5,0,1,15,19,34
p_94,3,0,e_1,546,558,569,10,1,0,4,5,1,1,12,11,23
p_88,10,0,e_0,531,536,586,7,2,2,9,5,1,0,5,50,55
p_92,10,0,e_0,540,552,586,5,2,1,11,5,2,0,12,34,46
p_95,10,0,e_0,547,552,586,3,1,0,11,4,1,1,5,34,39
p_96,7,0,e_0,551,563,586,5,1,0,10,1,1,0,12,23,35
p_84,12,0,e_3,504,535,591,10,1,0,2,5,1,0,31,56,87
p_85,14,0,e_3,517,543,591,8,1,0,6,5,1,0,26,48,74
p_86,14,0,e_3,518,543,591,7,2,0,7,5,1,1,25,48,73
p_91,14,0,e_3,539,543,591,1,2,0,13,5,1,1,4,48,52
p_99,9,0,e_3,556,560,591,1,2,0,10,4,1,1,4,31,35
p_98,6,0,e_3,555,571,591,4,1,0,10,4,1,0,16,20,36
p_111,2,0,e_0,607,616,624,2,0,0,0,3,0,0,9,8,17
p_97,5,0,e_2,552,570,651,6,1,0,0,3,0,0,18,81,99
p_101,9,0,e_2,566,584,651,28,2,2,4,5,0,2,18,67,85
p_100,10,0,e_2,557,589,651,30,3,3,1,5,0,1,32,62,94
p_105,12,0,e_2,582,597,651,21,1,1,9,5,1,3,15,54,69
p_110,12,0,e_2,590,597,651,12,0,0,10,5,1,2,7,54,61
p_102,14,0,e_2,568,605,651,23,2,2,5,5,0,3,37,46,83
p_103,14,0,e_2,577,605,651,20,1,1,7,5,1,3,28,46,74
p_104,14,0,e_2,581,605,651,19,1,1,8,5,1,3,24,46,70
p_112,11,0,e_2,613,616,651,11,0,0,12,4,1,0,3,35,38
p_107,3,0,e_1,584,595,654,29,1,1,0,5,0,1,11,59,70
p_106,5,0,e_1,583,603,654,27,1,1,0,3,0,0,20,51,71
p_108,7,0,e_1,584,611,654,25,1,1,0,5,0,2,27,43,70
p_109,10,0,e_1,590,622,654,10,0,0,2,5,0,3,32,32,64
p_117,0,2,e_2,636,651,659,17,2,2,5,4,1,0,15,8,23
p_123,0,2,e_1,661,662,672,10,2,2,0,3,0,0,1,10,11
p_125,2,0,e_1,668,672,680,7,2,1,1,5,1,0,4,8,12
p_126,1,0,e_1,681,687,692,4,1,0,0,3,0,0,6,5,11
p_116,7,0,e_3,633,656,697,11,1,1,0,5,0,1,23,41,64
p_118,8,0,e_3,649,661,697,5,2,1,5,5,0,2,12,36,48
p_119,8,0,e_3,650,661,697,5,3,1,5,5,0,3,11,36,47
p_115,9,0,e_3,632,666,697,9,0,0,0,3,0,0,34,31,65
p_124,7,0,e_3,664,674,697,2,2,0,9,5,1,1,10,23,33
p_121,3,0,e_2,656,664,701,8,3,2,1,5,1,0,8,37,45
p_122,7,0,e_2,657,678,701,4,3,2,2,5,1,1,21,23,44
p_113,9,0,e_0,629,659,714,9,0,0,0,3,0,0,30,55,85
p_114,13,0,e_0,632,673,714,13,1,1,0,5,0,1,41,41,82
p_120,13,0,e_0,653,673,714,7,3,0,7,5,0,2,20,41,61
p_129,5,0,e_3,705,723,740,5,0,0,0,3,0,0,18,17,35
p_128,0,15,e_2,705,706,755,0,0,0,0,3,0,0,1,49,50
p_132,4,0,e_0,730,737,773,29,1,1,2,5,0,1,7,36,43
p_133,6,0,e_0,734,745,773,26,1,1,3,5,0,2,11,28,39
p_131,7,0,e_0,722,750,773,12,0,0,0,3,0,0,28,23,51
p_127,7,0,e_1,701,725,800,7,0,0,0,3,0,0,24,75,99
p_130,11,0,e_1,705,739,800,11,1,1,1,5,0,1,34,61,95
p_135,11,0,e_1,739,741,800,11,0,0,11,5,1,1,2,59,61
p_134,14,0,e_1,734,752,800,18,1,1,10,5,1,1,18,48,66
p_136,14,0,e_1,749,752,800,14,0,0,13,5,1,1,3,48,51
p_138,12,0,e_1,756,760,800,12,0,0,13,4,1,0,4,40,44
p_140,5,0,e_1,768,783,800,23,1,1,10,4,1,0,15,17,32
p_143,5,0,e_1,780,783,800,19,2,2,6,4,1,1,3,17,20
p_137,13,0,e_2,755,764,805,13,0,0,15,3,0,0,9,41,50
p_139,0,15,e_3,758,759,810,0,0,0,0,3,0,0,1,51,52
p_145,1,0,e_2,820,826,831,11,1,0,0,3,0,0,6,5,11
p_142,13,0,e_0,773,815,856,13,2,1,0,3,0,0,42,41,83
p_144,6,0,e_1,815,836,856,8,1,0,0,3,0,0,21,20,41
p_141,12,0,e_3,770,799,857,15,1,1,3,5,1,0,29,58,87
p_150,3,0,e_1,860,872,883,3,0,0,0,3,0,0,12,11,23
p_152,2,0,e_3,868,877,929,2,0,0,0,3,0,0,9,52,61
p_154,4,0,e_3,874,885,929,7,2,1,1,5,0,2,11,44,55
p_153,6,0,e_3,872,893,929,5,1,0,1,5,0,1,21,36,57
p_157,7,0,e_3,889,898,929,2,2,0,5,5,1,1,9,31,40
p_158,7,0,e_3,892,898,929,1,2,0,6,2,1,1,6,31,37
p_159,8,0,e_3,893,903,929,2,2,0,6,5,1,1,10,26,36
p_149,6,0,e_0,859,880,940,6,0,0,0,3,0,0,21,60,81
p_155,11,0,e_0,884,897,940,7,2,2,7,5,1,1,13,43,56
p_151,12,0,e_0,863,902,940,12,0,0,1,5,0,1,39,38,77
p_156,12,0,e_0,884,902,940,8,2,2,7,5,1,2,18,38,56
p_147,6,0,e_2,849,867,945,26,1,1,0,5,0,1,18,78,96
p_146,10,0,e_2,846,881,945,23,1,1,0,3,0,0,35,64,99
p_148,15,0,e_2,849,898,945,17,1,1,0,5,0,2,49,47,96
p_3,4,0,e_2,25,40,88,4,0,0,0,3,0,0,15,48,63
p_4,5,0,e_2,34,45,88,5,0,0,2,5,0,1,11,43,54
p_5,9,0,e_2,41,59,88,9,0,0,4,5,1,1,18,29,47
p_6,9,0,e_2,45,59,88,9,0,0,5,5,1,1,14,29,43
p_2,11,0,e_1,19,55,90,11,0,0,0,3,0,0,36,35,71
p_1,13,0,e_0,13,55,96,13,0,0,0,3,0,0,42,41,83
p_12,0,8,e_2,86,88,114,21,4,4,0,4,1,0,2,26,28
p_16,4,0,e_1,101,116,130,13,4,1,0,3,0,0,15,14,29
p_15,5,0,e_0,99,117,134,13,4,2,0,3,0,0,18,17,35
p_19,0,7,e_1,125,130,155,11,2,0,1,4,1,0,5,25,30
p_7,2,0,e_3,55,64,162,2,0,0,0,3,0,0,9,98,107
p_10,9,0,e_3,77,87,162,15,3,2,6,5,1,2,10,75,85
p_9,10,0,e_3,67,92,162,17,2,1,3,5,1,1,25,70,95
p_14,13,0,e_3,87,103,162,8,4,1,9,5,1,3,16,59,75
p_8,15,0,e_3,62,111,162,13,1,0,2,5,0,1,49,51,100
p_11,4,0,e_3,84,146,162,18,4,3,8,5,1,3,62,16,78
p_20,3,0,e_3,142,151,162,2,2,1,5,4,1,1,9,11,20
p_21,0,10,e_0,142,143,177,5,2,0,0,3,0,0,1,34,35
p_13,8,0,e_2,87,114,186,13,4,2,0,3,1,0,27,72,99
p_17,10,0,e_2,112,122,186,5,2,0,8,5,1,0,10,64,74
p_18,15,0,e_2,120,139,186,27,2,2,10,5,1,1,19,47,66
p_30,2,0,e_2,200,209,217,16,3,1,0,3,0,0,9,8,17
p_22,6,0,e_1,146,150,234,28,2,2,5,5,1,0,4,84,88
p_23,15,0,e_1,150,181,234,18,1,1,6,5,2,0,31,53,84
p_28,7,0,e_1,184,207,234,5,3,1,14,4,1,0,23,27,50
p_31,5,0,e_1,203,215,234,12,3,1,8,4,1,1,12,19,31
p_33,1,0,e_1,213,229,234,13,2,1,5,4,1,1,16,5,21
p_36,1,0,e_1,225,229,234,10,2,1,2,4,1,1,4,5,9
p_24,14,0,e_0,157,191,235,17,1,1,4,5,1,0,34,44,78
p_32,0,10,e_2,209,217,249,15,3,3,2,4,1,0,8,32,40
p_35,0,6,e_1,222,234,254,11,2,0,3,4,1,1,12,20,32
p_26,6,0,e_3,169,184,260,11,1,1,1,5,0,1,15,76,91
p_25,9,0,e_3,163,195,260,9,0,0,0,3,0,0,32,65,97
p_29,14,0,e_3,192,212,260,6,3,0,8,5,1,2,20,48,68
p_34,11,0,e_3,217,223,260,2,2,0,13,4,1,1,6,37,43
p_27,5,0,e_3,180,243,260,8,2,2,5,5,0,2,63,17,80
p_42,4,0,e_3,269,284,298,4,0,0,0,3,0,0,15,14,29
p_43,4,0,e_3,270,284,298,4,1,0,0,5,0,1,14,14,28
p_44,4,0,e_3,275,284,298,3,1,0,1,5,0,1,9,14,23
p_41,7,0,e_0,257,281,304,24,1,1,0,3,0,0,24,23,47
p_38,12,0,e_1,240,274,314,24,2,2,2,5,1,0,34,40,74
p_47,3,0,e_1,293,303,314,28,3,3,6,4,1,0,10,11,21
p_49,3,0,e_1,298,303,314,19,2,2,4,4,1,1,5,11,16
p_39,13,0,e_2,247,260,315,21,1,1,10,5,1,1,13,55,68
p_37,15,0,e_2,228,268,315,25,2,2,3,5,1,0,40,47,87
p_40,15,0,e_2,255,268,315,16,1,1,12,5,0,2,13,47,60
p_51,0,4,e_1,309,314,328,19,2,2,1,4,1,0,5,14,19
p_57,1,0,e_2,327,333,338,18,3,2,0,3,0,0,6,5,11
p_58,0,6,e_2,330,338,358,18,3,3,0,5,0,1,8,20,28
p_53,8,0,e_0,313,330,366,15,3,2,3,5,0,1,17,36,53
p_56,8,0,e_0,324,330,366,12,3,2,6,5,0,2,6,36,42
p_48,9,0,e_0,294,335,366,22,3,3,3,4,1,0,41,31,72
p_62,1,0,e_0,345,361,366,13,2,0,6,4,1,0,16,5,21
p_54,7,0,e_1,313,339,366,16,3,3,0,3,1,0,26,27,53
p_59,3,0,e_1,335,353,366,14,2,1,6,5,0,1,18,13,31
p_60,2,0,e_1,338,358,366,14,2,1,7,2,0,1,20,8,28
p_63,3,0,e_2,364,376,387,6,1,0,6,3,0,0,12,11,23
p_46,8,0,e_3,291,324,392,24,2,2,2,4,1,1,33,68,101
p_45,11,0,e_3,290,335,392,21,1,1,2,4,1,0,45,57,102
p_50,11,0,e_3,299,335,392,11,2,0,0,5,0,2,36,57,93
p_52,14,0,e_3,312,346,392,10,2,0,4,5,0,2,34,46,80
p_55,14,0,e_3,314,346,392,9,3,0,5,5,0,3,32,46,78
p_61,12,0,e_3,341,354,392,3,2,1,13,5,1,1,13,38,51
p_65,0,7,e_1,369,370,395,7,1,0,0,3,0,0,1,25,26
p_68,2,0,e_2,389,398,406,29,1,1,0,3,0,0,9,8,17
p_64,0,15,e_0,365,366,415,9,1,0,0,3,1,0,1,49,50
p_69,2,0,e_3,391,400,444,2,0,0,0,3,1,0,9,44,53
p_70,3,0,e_3,398,405,444,1,1,0,2,5,0,1,7,39,46
p_71,7,0,e_3,403,419,444,4,2,0,3,5,1,1,16,25,41
p_72,6,0,e_3,417,424,444,1,2,0,7,5,1,1,7,20,27
p_73,3,0,e_2,423,435,446,3,1,0,0,3,0,0,12,11,23
p_66,11,0,e_1,376,409,454,24,1,1,1,5,1,0,33,45,78
p_67,12,0,e_1,377,414,454,23,1,1,1,5,1,1,37,40,77
p_75,3,0,e_1,438,443,454,29,1,1,4,4,1,0,5,11,16
p_74,10,0,e_0,424,442,476,26,1,1,15,3,0,0,18,34,52
p_76,10,0,e_0,440,442,476,21,1,1,10,4,0,1,2,34,36
p_77,4,0,e_0,455,462,476,4,0,0,6,4,1,0,7,14,21
p_81,1,0,e_0,493,499,504,1,0,0,0,3,0,0,6,5,11
p_79,9,0,e_2,457,487,516,9,0,0,0,3,0,0,30,29,59
p_82,0,12,e_3,494,495,535,0,0,0,0,3,0,0,1,40,41
p_78,12,0,e_1,455,494,542,12,0,0,0,3,0,0,39,48,87
p_80,13,0,e_1,474,499,542,13,0,0,6,5,0,1,25,43,68
p_87,3,0,e_1,528,531,542,15,2,2,4,4,1,0,3,11,14
p_83,0,12,e_0,501,504,544,23,1,1,1,4,1,0,3,40,43
p_90,1,0,e_2,538,541,572,14,2,1,0,5,0,1,3,31,34
p_89,5,0,e_2,535,555,572,11,2,1,0,3,0,0,20,17,37
p_97,5,0,e_2,552,555,572,6,1,0,4,5,1,1,3,17,20
p_94,3,0,e_1,546,555,574,10,1,0,0,5,0,1,9,19,28
p_93,4,0,e_1,543,560,574,10,1,0,0,3,0,0,17,14,31
p_88,10,0,e_0,531,536,586,7,2,2,9,5,1,0,5,50,55
p_92,10,0,e_0,540,552,586,5,2,1,11,5,2,0,12,34,46
p_95,10,0,e_0,547,552,586,3,1,0,11,4,1,1,5,34,39
p_96,7,0,e_0,551,563,586,5,1,0,10,1,1,0,12,23,35
p_84,12,0,e_3,504,535,589,10,1,0,2,5,1,0,31,54,85
p_85,14,0,e_3,517,543,589,8,1,0,6,5,1,0,26,46,72
p_86,14,0,e_3,518,543,589,7,2,0,7,5,1,1,25,46,71
p_91,14,0,e_3,539,543,589,1,2,0,13,5,1,1,4,46,50
p_99,9,0,e_3,556,560,589,1,1,0,10,4,1,0,4,29,33
p_109,10,0,e_0,590,623,667,10,0,0,0,3,0,0,33,44,77
p_112,11,0,e_0,613,628,667,6,1,1,7,5,0,2,15,39,54
p_113,9,0,e_0,629,636,667,3,1,0,11,4,1,1,7,31,38
p_111,2,0,e_0,607,659,667,17,1,1,5,5,0,1,52,8,60
p_108,7,0,e_2,584,595,668,24,1,1,4,5,0,4,11,73,84
p_101,9,0,e_2,566,603,668,28,1,1,2,4,1,0,37,65,102
p_105,12,0,e_2,582,614,668,20,1,1,3,5,0,2,32,54,86
p_102,14,0,e_2,568,622,668,23,1,1,1,4,1,1,54,46,100
p_104,14,0,e_2,581,622,668,18,1,1,3,5,0,2,41,46,87
p_107,3,0,e_2,584,657,668,28,1,1,4,5,0,3,73,11,84
p_110,12,0,e_3,590,629,669,12,0,0,0,3,0,0,39,40,79
p_115,9,0,e_3,632,640,669,2,1,0,11,4,1,0,8,29,37
p_106,5,0,e_1,583,591,672,27,1,1,3,5,0,3,8,81,89
p_98,6,0,e_1,555,596,672,4,1,0,3,5,1,1,41,76,117
p_100,10,0,e_1,557,610,672,30,2,2,3,5,1,2,53,62,115
p_103,14,0,e_1,577,624,672,20,1,1,1,5,0,2,47,48,95
p_116,7,0,e_1,633,647,672,4,2,1,11,4,1,1,14,25,39
p_121,3,0,e_1,656,661,672,1,2,0,4,4,1,1,5,11,16
p_117,0,2,e_0,636,667,675,10,2,0,9,4,1,1,31,8,39
p_123,0,2,e_0,661,667,675,2,2,0,2,4,1,1,6,8,14
p_124,7,0,e_0,664,692,725,24,2,2,1,4,1,1,28,33,61
p_119,8,0,e_0,650,697,725,28,2,2,5,4,1,1,47,28,75
p_126,1,0,e_0,681,720,725,12,2,1,4,5,0,2,39,5,44
p_125,2,0,e_3,668,677,725,2,1,1,0,3,1,1,9,48,57
p_118,8,0,e_3,649,697,725,28,1,1,6,4,1,0,48,28,76
p_129,5,0,e_3,705,708,725,1,1,0,6,4,1,0,3,17,20
p_122,7,0,e_2,657,691,756,27,2,2,3,4,1,1,34,65,99
p_120,13,0,e_2,653,711,756,22,2,2,4,4,1,1,58,45,103
p_127,7,0,e_2,701,731,756,30,1,1,10,5,1,1,30,25,55
p_131,7,0,e_2,722,731,756,24,1,1,10,4,1,1,9,25,34
p_132,4,0,e_2,730,742,756,25,1,1,7,1,1,0,12,14,26
p_130,11,0,e_1,705,707,758,25,2,2,11,5,0,1,2,51,53
p_114,13,0,e_1,632,715,758,28,2,2,12,4,1,0,83,43,126
p_133,6,0,e_1,734,738,758,21,1,1,7,4,1,0,4,20,24
p_128,0,15,e_3,705,725,778,6,1,0,6,4,1,0,20,53,73
p_140,5,0,e_2,768,786,803,12,3,2,0,3,0,0,18,17,35
p_143,5,0,e_2,780,786,803,10,2,1,3,5,0,1,6,17,23
p_139,0,15,e_1,758,759,808,19,4,4,0,3,0,0,1,49,50
p_135,11,0,e_3,739,760,827,15,1,1,4,5,1,0,21,67,88
p_138,12,0,e_3,756,765,827,8,3,2,10,5,1,2,9,62,71
p_136,14,0,e_3,749,773,827,8,2,1,8,5,1,1,24,54,78
p_142,13,0,e_3,773,786,827,3,2,1,14,5,2,0,13,41,54
p_141,12,0,e_0,770,773,829,5,3,2,11,5,0,2,3,56,59
p_137,13,0,e_0,755,778,829,7,3,2,6,5,0,1,23,51,74
p_134,14,0,e_0,734,783,829,13,1,1,0,3,0,0,49,46,95
p_145,1,0,e_0,820,824,829,1,1,0,2,4,1,0,4,5,9
p_144,6,0,e_2,815,836,856,28,1,1,0,3,0,0,21,20,41
p_150,3,0,e_2,860,872,885,24,1,1,0,3,0,0,12,13,25
p_152,2,0,e_2,868,877,885,22,1,1,2,5,0,1,9,8,17
p_146,10,0,e_1,846,864,900,10,0,0,15,3,0,0,18,36,54
p_153,6,0,e_1,872,878,900,17,1,1,8,4,1,0,6,22,28
p_154,4,0,e_1,874,886,900,18,1,1,7,4,1,1,12,14,26
p_147,6,0,e_0,849,870,934,6,0,0,0,3,0,0,21,64,85
p_149,6,0,e_0,859,870,934,21,1,1,3,5,0,1,11,64,75
p_155,11,0,e_0,884,887,934,8,1,1,10,5,1,1,3,47,50
p_151,12,0,e_0,863,892,934,14,1,1,4,5,0,1,29,42,71
p_156,12,0,e_0,884,892,934,7,1,1,10,5,1,2,8,42,50
p_159,8,0,e_0,893,906,934,8,1,1,12,4,1,1,13,28,41
p_158,7,0,e_0,892,911,934,9,1,1,12,4,1,0,19,23,42
p_157,7,0,e_2,889,913,936,10,1,1,0,3,0,0,24,23,47
p_148,15,0,e_3,849,897,944,15,0,0,0,3,0,0,48,47,95
p_3,4,0,e_2,25,40,54,4,0,0,0,3,0,0,15,14,29
p_2,11,0,e_1,19,55,90,11,0,0,0,3,0,0,36,35,71
p_4,5,0,e_3,34,52,95,5,0,0,0,3,0,0,18,43,61
p_5,9,0,e_3,41,66,95,7,1,0,2,5,0,1,25,29,54
p_6,9,0,e_3,45,66,95,6,2,0,3,5,0,2,21,29,50
p_1,13,0,e_0,13,55,96,13,0,0,0,3,0,0,42,41,83
p_12,0,8,e_0,86,96,124,3,2,0,3,4,1,0,10,28,38
p_11,4,0,e_3,84,109,131,29,1,1,3,4,1,0,25,22,47
p_15,5,0,e_3,99,114,131,4,1,0,1,5,0,1,15,17,32
p_16,4,0,e_0,101,110,150,4,2,1,1,5,1,0,9,40,49
p_13,8,0,e_0,87,124,150,24,2,2,3,4,1,0,37,26,63
p_19,0,7,e_3,125,131,154,2,1,0,2,4,1,0,6,23,29
p_7,2,0,e_2,55,64,158,10,2,1,0,3,0,0,9,94,103
p_9,10,0,e_2,67,90,158,29,1,1,3,5,1,1,23,68,91
p_14,13,0,e_2,87,101,158,19,2,2,9,5,1,2,14,57,71
p_8,15,0,e_2,62,109,158,7,2,0,2,5,0,1,47,49,96
p_20,3,0,e_2,142,147,158,8,1,1,4,4,1,0,5,11,16
p_21,0,10,e_0,142,150,184,11,1,1,2,4,1,0,8,34,42
p_10,9,0,e_1,77,119,190,27,1,1,4,4,1,0,42,71,113
p_17,10,0,e_1,112,124,190,5,2,0,7,5,0,1,12,66,78
p_18,15,0,e_1,120,141,190,18,1,1,9,5,1,1,21,49,70
p_22,6,0,e_1,146,170,190,3,1,1,14,4,1,0,24,20,44
p_25,9,0,e_0,163,179,222,11,1,1,4,5,1,0,16,43,59
p_28,7,0,e_0,184,195,222,7,2,0,10,4,1,1,11,27,38
p_27,5,0,e_0,180,203,222,10,2,1,9,5,2,0,23,19,42
p_33,1,0,e_0,213,217,222,4,1,0,2,4,1,0,4,5,9
p_23,15,0,e_3,150,180,229,9,1,0,6,5,1,0,30,49,79
p_26,6,0,e_3,169,209,229,12,1,1,12,5,0,1,40,20,60
p_24,14,0,e_2,157,202,248,8,1,1,0,3,1,0,45,46,91
p_29,14,0,e_2,192,202,248,27,2,2,11,5,0,1,10,46,56
p_36,1,0,e_2,225,243,248,30,1,1,7,4,1,0,18,5,23
p_35,0,6,e_3,222,229,249,2,1,0,2,4,1,0,7,20,27
p_32,0,10,e_0,209,222,254,6,1,0,3,4,1,0,13,32,45
p_30,2,0,e_1,200,209,275,7,2,1,0,3,0,0,9,66,75
p_31,5,0,e_1,203,220,275,3,2,1,0,5,0,1,17,55,72
p_34,11,0,e_1,217,240,275,23,1,1,4,5,1,1,23,35,58
p_44,4,0,e_1,275,290,304,12,2,1,0,3,0,0,15,14,29
p_38,12,0,e_0,240,262,326,15,2,1,6,5,1,0,22,64,86
p_40,15,0,e_0,255,273,326,7,1,0,10,5,0,1,18,53,71
p_46,8,0,e_0,291,296,326,3,2,0,9,4,1,1,5,30,35
p_43,4,0,e_0,270,310,326,13,2,1,14,5,1,1,40,16,56
p_49,3,0,e_0,298,315,326,6,3,1,8,4,1,1,17,11,28
p_37,15,0,e_3,228,278,331,15,0,0,0,3,1,0,50,53,103
p_48,9,0,e_3,294,298,331,1,3,0,10,4,1,2,4,33,37
p_41,7,0,e_3,257,306,331,15,1,1,8,5,0,1,49,25,74
p_47,3,0,e_3,293,320,331,7,2,1,10,4,1,1,27,11,38
p_39,13,0,e_2,247,289,336,11,2,1,0,3,1,0,42,47,89
p_45,11,0,e_2,290,297,336,30,2,2,13,4,1,1,7,39,46
p_42,4,0,e_2,269,320,336,14,2,1,7,5,0,1,51,16,67
p_57,1,0,e_2,327,331,336,30,2,2,2,4,1,0,4,5,9
p_51,0,4,e_0,309,326,340,6,2,0,4,1,1,1,17,14,31
p_58,0,6,e_2,330,336,358,0,1,1,1,1,1,0,6,22,28
p_59,3,0,e_2,335,347,380,12,1,1,0,3,1,0,12,33,45
p_62,1,0,e_2,345,375,380,11,2,1,3,5,1,1,30,5,35
p_56,8,0,e_3,324,357,385,24,1,1,2,4,1,0,33,28,61
p_60,2,0,e_3,338,377,385,12,1,1,2,5,0,1,39,8,47
p_54,7,0,e_1,313,327,400,28,2,2,3,5,0,2,14,73,87
p_50,11,0,e_1,299,341,400,28,3,3,1,4,1,0,42,59,101
p_52,14,0,e_1,312,352,400,21,2,2,2,5,0,1,40,48,88
p_55,14,0,e_1,314,352,400,21,2,2,3,5,0,3,38,48,86
p_63,3,0,e_1,364,387,400,3,2,0,10,4,1,0,23,13,36
p_68,2,0,e_1,389,392,400,21,1,1,3,4,1,0,3,8,11
p_65,0,7,e_2,369,380,403,4,2,0,3,4,1,1,11,23,34
p_53,8,0,e_0,313,354,408,27,2,2,3,4,1,1,41,54,95
p_61,12,0,e_0,341,368,408,9,2,0,4,5,0,1,27,40,67
p_69,2,0,e_0,391,400,408,20,1,1,5,4,1,0,9,8,17
p_64,0,15,e_2,365,380,431,6,2,0,4,4,1,1,15,51,66
p_72,6,0,e_0,417,438,460,8,2,1,0,3,0,0,21,22,43
p_75,3,0,e_0,438,449,460,4,2,0,6,4,1,0,11,11,22
p_67,12,0,e_3,377,423,463,20,1,1,2,4,1,0,46,40,86
p_70,3,0,e_3,398,452,463,17,1,1,4,5,0,1,54,11,65
p_73,3,0,e_3,423,452,463,9,2,0,12,4,1,1,29,11,40
p_71,7,0,e_1,403,427,472,11,2,1,0,3,0,0,24,45,69
p_74,10,0,e_1,424,438,472,2,2,0,6,5,0,1,14,34,48
p_77,4,0,e_1,455,458,472,28,1,1,5,4,1,0,3,14,17
p_66,11,0,e_2,376,417,480,21,1,1,1,4,1,0,41,63,104
p_76,10,0,e_2,440,448,480,27,2,2,12,4,1,0,8,32,40
p_81,1,0,e_2,493,499,504,8,1,0,0,3,0,0,6,5,11
p_79,9,0,e_3,457,492,521,23,1,1,2,4,1,0,35,29,64
p_78,12,0,e_0,455,498,536,20,1,1,1,4,1,0,43,38,81
p_83,0,12,e_2,501,504,542,6,1,0,1,4,1,0,3,38,41
p_80,13,0,e_1,474,516,559,10,1,0,0,3,0,0,42,43,85
p_87,3,0,e_1,528,548,559,19,1,1,9,4,1,0,20,11,31
p_82,0,12,e_3,494,521,561,9,1,0,9,4,1,0,27,40,67
p_84,12,0,e_2,504,542,602,23,1,1,0,5,1,0,38,60,98
p_85,14,0,e_2,517,550,602,17,1,1,4,5,1,0,33,52,85
p_86,14,0,e_2,518,550,602,17,1,1,4,5,1,1,32,52,84
p_91,14,0,e_2,539,550,602,8,2,0,11,5,1,1,11,52,63
p_99,9,0,e_2,556,567,602,4,3,1,12,4,1,3,11,35,46
p_96,7,0,e_2,551,575,602,7,2,1,14,4,1,2,24,27,51
p_93,4,0,e_2,543,586,602,13,2,2,12,5,1,1,43,16,59
p_94,3,0,e_2,546,591,602,13,2,2,13,5,1,2,45,11,56
p_88,10,0,e_3,531,553,603,11,1,1,3,5,1,0,22,50,72
p_97,5,0,e_3,552,584,603,9,1,1,10,2,1,0,32,19,51
p_107,3,0,e_3,584,592,603,2,1,0,5,4,1,0,8,11,19
p_90,1,0,e_0,538,541,608,18,2,2,0,5,0,1,3,67,70
p_89,5,0,e_0,535,555,608,15,2,2,0,3,1,0,20,53,73
p_98,6,0,e_0,555,560,608,8,3,1,5,5,1,1,5,48,53
p_92,10,0,e_0,540,574,608,8,2,1,1,2,0,1,34,34,68
p_95,10,0,e_0,547,574,608,6,2,1,3,5,1,2,27,34,61
p_100,10,0,e_0,557,574,608,3,3,1,5,5,1,2,17,34,51
p_106,5,0,e_0,583,591,608,30,1,1,7,4,1,0,8,17,25
p_108,7,0,e_3,584,626,649,28,2,2,5,4,1,1,42,23,65
p_117,0,2,e_3,636,649,657,4,1,0,4,4,1,0,13,8,21
p_101,9,0,e_1,566,596,663,2,2,0,0,3,0,0,30,67,97
p_105,12,0,e_1,582,607,663,23,2,2,5,5,0,2,25,56,81
p_102,14,0,e_1,568,615,663,26,2,2,0,5,0,1,47,48,95
p_103,14,0,e_1,577,615,663,23,2,2,3,5,0,2,38,48,86
p_104,14,0,e_1,581,615,663,22,2,2,4,5,0,2,34,48,82
p_113,9,0,e_1,629,632,663,27,1,1,10,4,1,0,3,31,34
p_116,7,0,e_1,633,640,663,28,1,1,9,4,1,0,7,23,30
p_123,0,2,e_1,661,663,671,23,2,2,0,4,1,0,2,8,10
p_109,10,0,e_2,590,634,682,23,3,3,3,1,1,0,44,48,92
p_112,11,0,e_2,613,639,682,8,1,0,3,5,0,1,26,43,69
p_115,9,0,e_2,632,647,682,26,1,1,10,5,0,2,15,35,50
p_118,8,0,e_2,649,652,682,8,1,0,9,4,1,0,3,30,33
p_121,3,0,e_2,656,669,682,21,2,2,7,4,1,0,13,13,26
p_125,2,0,e_2,668,674,682,19,2,2,3,1,1,0,6,8,14
p_126,1,0,e_2,681,687,692,16,2,1,0,3,1,0,6,5,11
p_111,2,0,e_0,607,616,696,11,1,1,0,3,1,1,9,80,89
p_110,12,0,e_0,590,648,696,21,3,3,5,1,1,0,58,48,106
p_114,13,0,e_0,632,653,696,22,1,1,7,5,1,1,21,43,64
p_122,7,0,e_0,657,673,696,17,2,2,12,4,1,0,16,23,39
p_124,7,0,e_1,664,688,711,15,2,2,0,5,1,0,24,23,47
p_119,8,0,e_3,650,677,737,8,1,0,0,5,1,0,27,60,87
p_120,13,0,e_3,653,694,737,12,2,0,1,5,1,1,41,43,84
p_129,5,0,e_3,705,720,737,5,1,0,10,4,1,0,15,17,32
p_128,0,15,e_2,705,706,755,10,1,0,0,3,0,0,1,49,50
p_132,4,0,e_1,730,737,773,28,1,1,2,5,0,1,7,36,43
p_133,6,0,e_1,734,745,773,25,1,1,3,5,0,2,11,28,39
p_131,7,0,e_1,722,750,773,28,1,1,0,3,0,0,28,23,51
p_127,7,0,e_0,701,725,796,4,1,0,0,3,0,0,24,71,95
p_130,11,0,e_0,705,739,796,29,2,2,1,5,0,1,34,57,91
p_134,14,0,e_0,734,750,796,17,1,1,10,5,1,1,16,46,62
p_140,5,0,e_0,768,779,796,14,2,2,8,4,1,0,11,17,28
p_137,13,0,e_2,755,764,809,10,2,1,15,3,0,0,9,45,54
p_138,12,0,e_2,756,769,809,11,2,1,15,4,0,1,13,40,53
p_143,5,0,e_2,780,792,809,11,2,1,9,4,1,0,12,17,29
p_139,0,15,e_1,758,773,822,22,2,2,5,4,1,0,15,49,64
p_145,1,0,e_2,820,826,831,3,1,0,0,3,0,0,6,5,11
p_135,11,0,e_3,739,775,832,11,0,0,0,3,0,0,36,57,93
p_141,12,0,e_3,770,780,832,6,2,1,10,5,0,2,10,52,62
p_136,14,0,e_3,749,788,832,11,1,0,3,5,0,1,39,44,83
p_144,6,0,e_0,815,836,856,29,1,1,0,3,0,0,21,20,41
p_142,13,0,e_1,773,814,869,4,3,1,0,5,1,0,41,55,96
p_147,6,0,e_3,849,870,894,6,0,0,0,3,0,0,21,24,45
p_154,4,0,e_3,874,878,894,1,2,0,5,4,1,1,4,16,20
p_150,3,0,e_3,860,883,894,6,1,1,3,5,0,1,23,11,34
p_149,6,0,e_0,859,880,940,3,1,0,0,3,0,0,21,60,81
p_151,12,0,e_0,863,900,940,8,2,0,1,5,0,1,37,40,77
p_156,12,0,e_0,884,900,940,21,1,1,7,5,1,1,16,40,56
p_157,7,0,e_0,889,917,940,24,1,1,9,5,1,1,28,23,51
p_146,10,0,e_2,846,879,943,10,0,0,0,3,0,0,33,64,97
p_148,15,0,e_2,849,896,943,15,1,1,0,5,0,1,47,47,94
p_152,2,0,e_1,868,877,945,4,2,0,0,3,1,0,9,68,77
p_153,6,0,e_1,872,891,945,30,2,2,1,5,0,1,19,54,73
p_158,7,0,e_1,892,896,945,23,1,1,6,5,1,1,4,49,53
p_155,11,0,e_1,884,910,945,22,1,1,4,5,1,1,26,35,61
p_159,8,0,e_3,893,920,946,8,0,0,0,3,1,0,27,26,53
p_3,4,0,e_2,25,40,54,4,0,0,0,3,0,0,15,14,29
p_7,2,0,e_2,55,64,72,10,2,1,0,3,0,0,9,8,17
p_2,11,0,e_1,19,55,90,11,0,0,0,3,0,0,36,35,71
p_1,13,0,e_0,13,55,96,13,0,0,0,3,0,0,42,41,83
p_12,0,8,e_1,86,90,116,15,2,2,1,4,1,0,4,26,30
p_15,5,0,e_0,99,117,134,7,1,0,0,3,0,0,18,17,35
p_4,5,0,e_3,34,52,137,5,0,0,0,3,0,0,18,85,103
p_5,9,0,e_3,41,66,137,7,1,0,2,5,0,1,25,71,96
p_6,9,0,e_3,45,66,137,6,2,0,3,5,0,2,21,71,92
p_9,10,0,e_3,67,71,137,11,2,1,9,5,1,1,4,66,70
p_8,15,0,e_3,62,88,137,7,2,0,8,5,1,1,26,49,75
p_16,4,0,e_3,101,123,137,7,1,0,11,4,1,0,22,14,36
p_19,0,7,e_0,125,134,157,4,1,0,3,4,1,0,9,23,32
p_11,4,0,e_2,84,92,168,12,2,1,2,5,0,1,8,76,84
p_13,8,0,e_2,87,106,168,23,1,0,3,5,0,2,19,62,81
p_10,9,0,e_2,77,111,168,9,2,1,0,3,0,0,34,57,91
p_14,13,0,e_2,87,125,168,28,1,0,3,5,0,3,38,43,81
p_20,3,0,e_2,142,157,168,3,1,1,8,4,1,0,15,11,26
p_21,0,10,e_3,142,143,177,0,0,0,0,3,0,0,1,34,35
p_17,10,0,e_1,112,124,190,27,2,2,7,5,1,0,12,66,78
p_18,15,0,e_1,120,141,190,20,2,2,9,5,0,1,21,49,70
p_22,6,0,e_1,146,170,190,14,1,1,14,4,1,0,24,20,44
p_27,5,0,e_2,180,187,224,12,1,1,3,5,0,1,7,37,44
p_26,6,0,e_2,169,192,224,14,2,2,0,3,0,0,23,32,55
p_28,7,0,e_2,184,197,224,9,1,1,4,5,0,2,13,27,40
p_30,2,0,e_2,200,214,224,9,1,0,6,4,1,0,14,10,24
p_33,1,0,e_2,213,219,224,6,1,0,2,1,1,0,6,5,11
p_24,14,0,e_3,157,191,235,10,1,0,4,5,1,0,34,44,78
p_25,9,0,e_0,163,165,236,13,2,2,9,5,0,1,2,71,73
p_23,15,0,e_0,150,185,236,14,1,0,5,5,1,0,35,51,86
p_31,5,0,e_0,203,217,236,5,1,0,9,4,1,0,14,19,33
p_36,1,0,e_0,225,231,236,2,1,0,3,4,1,0,6,5,11
p_35,0,6,e_2,222,224,244,4,1,0,0,4,1,0,2,20,22
p_32,0,10,e_2,209,224,258,8,1,0,3,4,1,1,15,34,49
p_34,11,0,e_1,217,228,295,25,1,1,8,5,0,1,11,67,78
p_29,14,0,e_1,192,239,295,30,1,1,0,3,0,0,47,56,103
p_37,15,0,e_1,228,244,295,17,1,1,11,5,1,1,16,51,67
p_39,13,0,e_1,247,252,295,13,0,0,14,4,1,0,5,43,48
p_42,4,0,e_1,269,281,295,7,1,1,8,4,1,0,12,14,26
p_43,4,0,e_1,270,281,295,6,1,1,7,4,1,1,11,14,25
p_44,4,0,e_1,275,281,295,5,1,1,6,4,1,1,6,14,20
p_41,7,0,e_3,257,281,304,7,0,0,0,3,0,0,24,23,47
p_38,12,0,e_0,240,279,319,12,0,0,0,3,0,0,39,40,79
p_47,3,0,e_0,293,308,319,30,1,1,8,4,1,0,15,11,26
p_40,15,0,e_2,255,275,326,15,0,0,9,5,1,0,20,51,71
p_46,8,0,e_2,291,298,326,26,1,1,10,4,1,0,7,28,35
p_49,3,0,e_2,298,315,326,29,1,1,8,4,1,0,17,11,28
p_51,0,4,e_3,309,310,326,0,0,0,0,3,0,0,1,16,17
p_57,1,0,e_2,327,333,338,11,2,2,0,3,0,0,6,5,11
p_58,0,6,e_2,330,338,358,11,2,2,0,5,0,1,8,20,28
p_54,7,0,e_3,313,337,370,7,1,0,0,5,1,0,24,33,57
p_53,8,0,e_3,313,342,370,8,2,0,0,5,1,1,29,28,57
p_59,3,0,e_3,335,359,370,6,2,1,7,5,0,2,24,11,35
p_56,8,0,e_0,324,351,379,4,3,0,0,3,0,0,27,28,55
p_60,2,0,e_0,338,371,379,7,3,1,4,5,0,1,33,8,41
p_63,3,0,e_2,364,369,382,29,1,1,4,4,0,1,5,13,18
p_62,1,0,e_2,345,377,382,6,2,1,2,5,1,0,32,5,37
p_48,9,0,e_1,294,324,389,24,1,1,0,3,1,1,30,65,95
p_45,11,0,e_1,290,332,389,23,1,1,1,4,1,0,42,57,99
p_50,11,0,e_1,299,332,389,20,1,1,1,5,0,2,33,57,90
p_52,14,0,e_1,312,343,389,14,1,0,5,5,0,2,31,46,77
p_55,14,0,e_1,314,343,389,14,3,0,6,5,0,3,29,46,75
p_61,12,0,e_1,341,351,389,14,2,0,14,5,1,1,10,38,48
p_65,0,7,e_3,369,370,395,0,0,0,0,3,1,0,1,25,26
p_68,2,0,e_1,389,398,406,23,2,2,0,3,0,0,9,8,17
p_69,2,0,e_1,391,398,406,22,2,2,0,5,0,1,7,8,15
p_64,0,15,e_3,365,370,421,1,1,0,1,4,1,0,5,51,56
p_66,11,0,e_0,376,414,451,18,2,1,1,4,1,0,38,37,75
p_70,3,0,e_0,398,440,451,19,1,1,6,5,0,1,42,11,53
p_73,3,0,e_0,423,440,451,12,0,0,8,4,1,1,17,11,28
p_72,6,0,e_1,417,438,460,10,1,1,0,3,0,0,21,22,43
p_75,3,0,e_1,438,449,460,8,1,1,6,4,1,0,11,11,22
p_71,7,0,e_2,403,405,460,14,1,1,7,5,0,1,2,55,57
p_67,12,0,e_2,377,422,460,17,2,1,1,4,1,0,45,38,83
p_74,10,0,e_3,424,442,474,5,0,0,15,3,0,0,18,32,50
p_76,10,0,e_3,440,442,474,20,1,1,10,4,0,1,2,32,34
p_81,1,0,e_2,493,499,504,1,0,0,0,3,0,0,6,5,11
p_82,0,12,e_3,494,495,535,0,0,0,0,3,0,0,1,40,41
p_77,4,0,e_0,455,470,536,2,1,0,0,3,0,0,15,66,81
p_79,9,0,e_0,457,487,536,26,1,1,0,5,0,2,30,49,79
p_78,12,0,e_0,455,498,536,24,1,1,0,3,0,1,43,38,81
p_83,0,12,e_2,501,504,542,23,1,1,1,4,1,0,3,38,41
p_80,13,0,e_1,474,516,561,13,0,0,0,3,0,0,42,45,87
p_87,3,0,e_1,528,548,561,15,2,2,9,4,1,0,20,13,33
p_90,1,0,e_1,538,556,561,14,3,1,6,4,1,1,18,5,23
p_84,12,0,e_3,504,535,595,10,1,0,2,5,1,0,31,60,91
p_85,14,0,e_3,517,543,595,8,1,0,6,5,1,0,26,52,78
p_88,10,0,e_3,531,557,595,7,2,2,11,5,1,1,26,38,64
p_95,10,0,e_3,547,557,595,3,3,0,13,4,1,2,10,38,48
p_99,9,0,e_3,556,562,595,1,3,0,10,1,1,2,6,33,39
p_98,6,0,e_3,555,573,595,4,3,0,10,4,1,2,18,22,40
p_94,3,0,e_3,546,584,595,10,2,1,13,4,1,1,38,11,49
p_86,14,0,e_2,518,550,600,7,2,0,4,5,1,0,32,50,82
p_91,14,0,e_2,539,550,600,1,3,0,11,5,1,1,11,50,61
p_96,7,0,e_2,551,573,600,5,3,1,14,4,1,1,22,27,49
p_93,4,0,e_2,543,584,600,10,2,1,12,5,0,1,41,16,57
p_107,3,0,e_2,584,589,600,30,1,1,4,4,1,0,5,11,16
p_111,2,0,e_2,607,616,624,2,0,0,0,3,0,0,9,8,17
p_89,5,0,e_0,535,553,636,11,3,1,0,3,1,0,18,83,101
p_97,5,0,e_0,552,553,636,6,3,1,5,2,0,1,1,83,84
p_92,10,0,e_0,540,572,636,5,3,1,1,5,0,1,32,64,96
p_100,10,0,e_0,557,572,636,30,4,4,5,5,1,1,15,64,79
p_102,14,0,e_0,568,586,636,23,3,3,9,5,1,1,18,50,68
p_103,14,0,e_0,577,586,636,21,2,2,11,5,1,1,9,50,59
p_104,14,0,e_0,581,586,636,20,2,2,13,5,1,1,5,50,55
p_109,10,0,e_0,590,600,636,21,1,1,13,4,1,2,10,36,46
p_108,7,0,e_0,584,611,636,26,1,1,14,5,1,2,27,25,52
p_106,5,0,e_0,583,619,636,28,1,1,13,5,1,1,36,17,53
p_101,9,0,e_1,566,596,645,29,3,3,0,3,0,0,30,49,79
p_105,12,0,e_1,582,607,645,21,2,2,5,5,0,1,25,38,63
p_110,12,0,e_1,590,607,645,19,1,1,7,5,0,2,17,38,55
p_117,0,2,e_0,636,637,647,19,2,2,0,3,0,0,1,10,11
p_116,7,0,e_2,633,653,694,13,2,2,1,5,0,1,20,41,61
p_113,9,0,e_2,629,661,694,8,1,1,0,3,0,0,32,33,65
p_115,9,0,e_2,632,661,694,7,1,1,0,5,0,1,29,33,62
p_124,7,0,e_2,664,669,694,4,3,0,8,4,1,0,5,25,30
p_125,2,0,e_2,668,686,694,8,3,2,7,1,1,0,18,8,26
p_118,8,0,e_0,649,670,698,7,2,1,2,3,0,0,21,28,49
p_126,1,0,e_0,681,693,698,5,2,1,5,4,1,0,12,5,17
p_123,0,2,e_2,661,694,702,12,3,0,9,4,1,0,33,8,41
p_112,11,0,e_3,613,649,702,11,0,0,0,3,0,0,36,53,89
p_114,13,0,e_3,632,657,702,7,1,0,6,5,0,1,25,45,70
p_120,13,0,e_3,653,657,702,1,2,0,12,5,1,1,4,45,49
p_122,7,0,e_3,657,677,702,6,2,0,13,4,1,1,20,25,45
p_121,3,0,e_3,656,691,702,16,1,0,13,2,1,0,35,11,46
p_119,8,0,e_1,650,677,703,7,2,1,0,3,0,0,27,26,53
p_129,5,0,e_2,705,717,734,5,0,0,2,3,0,0,12,17,29
p_127,7,0,e_0,701,725,750,7,0,0,0,3,0,0,24,25,49
p_131,7,0,e_0,722,725,750,10,1,1,6,5,0,1,3,25,28
p_132,4,0,e_0,730,736,750,10,1,1,6,4,1,0,6,14,20
p_128,0,15,e_1,705,706,755,0,0,0,0,3,0,0,1,49,50
p_130,11,0,e_3,705,741,800,11,0,0,0,3,0,0,36,59,95
p_134,14,0,e_3,734,752,800,5,1,0,9,5,0,1,18,48,66
p_136,14,0,e_3,749,752,800,1,2,0,13,5,1,1,3,48,51
p_138,12,0,e_3,756,760,800,1,1,0,13,4,1,0,4,40,44
p_140,5,0,e_3,768,783,800,5,1,0,10,4,1,0,15,17,32
p_137,13,0,e_1,755,764,807,30,1,1,15,3,0,0,9,43,52
p_143,5,0,e_1,780,790,807,1,2,0,8,4,1,0,10,17,27
p_139,0,15,e_0,758,759,808,12,2,0,0,3,0,0,1,49,50
p_133,6,0,e_2,734,755,823,7,1,1,0,3,0,0,21,68,89
p_135,11,0,e_2,739,772,823,6,2,1,1,5,0,1,33,51,84
p_141,12,0,e_2,770,777,823,27,2,2,11,5,1,1,7,46,53
p_142,13,0,e_2,773,782,823,25,2,2,11,5,1,1,9,41,50
p_145,1,0,e_3,820,826,831,1,0,0,0,3,0,0,6,5,11
p_144,6,0,e_1,815,836,856,6,0,0,0,3,0,0,21,20,41
p_147,6,0,e_2,849,870,894,6,0,0,0,3,0,0,21,24,45
p_154,4,0,e_2,874,878,894,18,1,1,5,4,1,1,4,16,20
p_150,3,0,e_2,860,883,894,24,1,1,3,5,0,1,23,11,34
p_146,10,0,e_0,846,864,900,10,0,0,15,3,0,0,18,36,54
p_153,6,0,e_0,872,878,900,17,1,1,8,4,1,1,6,22,28
p_152,2,0,e_0,868,892,900,22,1,1,9,4,1,0,24,8,32
p_149,6,0,e_1,859,880,940,21,1,1,0,3,0,0,21,60,81
p_151,12,0,e_1,863,900,940,14,1,1,1,5,0,1,37,40,77
p_156,12,0,e_1,884,900,940,7,2,1,7,5,1,1,16,40,56
p_157,7,0,e_1,889,917,940,10,2,1,9,5,1,1,28,23,51
p_159,8,0,e_2,893,920,946,8,3,1,0,3,1,0,27,26,53
p_148,15,0,e_3,849,897,948,15,0,0,0,3,0,0,48,51,99
p_155,11,0,e_3,884,911,948,8,1,1,11,5,0,1,27,37,64
p_158,7,0,e_3,892,925,948,9,2,1,14,5,0,2,33,23,56
p_3,4,0,e_2,25,40,62,4,0,0,0,3,0,0,15,22,37
p_4,5,0,e_2,34,45,62,5,0,0,2,5,0,1,11,17,28
p_5,9,0,e_1,41,49,94,9,0,0,7,5,0,1,8,45,53
p_2,11,0,e_1,19,57,94,11,0,0,0,3,0,0,38,37,75
p_7,2,0,e_1,55,86,94,13,1,1,11,5,1,1,31,8,39
p_1,13,0,e_0,13,55,96,13,0,0,0,3,0,0,42,41,83
p_12,0,8,e_1,86,94,120,18,2,2,2,4,1,0,8,26,34
p_16,4,0,e_0,101,114,136,10,1,0,0,5,0,1,13,22,35
p_15,5,0,e_0,99,119,136,10,1,0,0,3,0,0,20,17,37
p_13,8,0,e_2,87,94,138,9,2,1,6,5,0,3,7,44,51
p_10,9,0,e_2,77,99,138,12,2,1,3,5,0,1,22,39,61
p_9,10,0,e_2,67,104,138,13,2,1,0,3,0,0,37,34,71
p_11,4,0,e_2,84,124,138,14,2,1,5,5,0,2,40,14,54
p_6,9,0,e_3,45,75,144,9,0,0,0,3,0,0,30,69,99
p_14,13,0,e_3,87,89,144,4,2,1,13,5,1,1,2,55,57
p_8,15,0,e_3,62,97,144,10,1,0,5,5,0,1,35,47,82
p_19,0,7,e_0,125,136,159,6,1,0,3,4,1,0,11,23,34
p_21,0,10,e_2,142,143,181,0,1,0,0,3,0,0,1,38,39
p_17,10,0,e_1,112,128,194,30,1,1,6,5,1,0,16,66,82
p_18,15,0,e_1,120,145,194,23,1,1,8,5,0,1,25,49,74
p_26,6,0,e_1,169,174,194,16,2,1,7,4,1,0,5,20,25
p_20,3,0,e_2,142,156,217,27,1,1,0,3,0,1,14,61,75
p_25,9,0,e_2,163,176,217,14,2,1,5,5,2,0,13,41,54
p_28,7,0,e_2,184,192,217,10,2,1,9,4,1,0,8,25,33
p_30,2,0,e_2,200,209,217,10,1,0,5,4,1,0,9,8,17
p_23,15,0,e_0,150,185,236,14,1,0,4,5,1,0,35,51,86
p_27,5,0,e_0,180,217,236,13,2,1,14,5,0,1,37,19,56
p_31,5,0,e_0,203,217,236,6,1,0,9,4,1,1,14,19,33
p_36,1,0,e_0,225,231,236,3,2,0,3,4,1,0,6,5,11
p_22,6,0,e_3,146,167,239,6,0,0,0,3,0,0,21,72,93
p_24,14,0,e_3,157,193,239,11,1,0,3,5,0,1,36,46,82
p_33,1,0,e_3,213,234,239,7,1,0,8,4,1,0,21,5,26
p_32,0,10,e_2,209,217,249,9,1,0,2,4,1,0,8,32,40
p_35,0,6,e_0,222,236,256,5,2,0,4,4,1,0,14,20,34
p_41,7,0,e_0,257,263,288,7,0,0,6,3,0,0,6,25,31
p_42,4,0,e_0,269,274,288,4,0,0,5,4,1,0,5,14,19
p_34,11,0,e_1,217,229,296,25,2,2,7,5,0,1,12,67,79
p_29,14,0,e_1,192,240,296,28,1,0,0,4,1,0,48,56,104
p_37,15,0,e_1,228,245,296,18,2,2,11,2,0,1,17,51,68
p_39,13,0,e_1,247,253,296,13,0,0,15,4,1,0,6,43,49
p_44,4,0,e_1,275,282,296,3,1,0,6,4,1,0,7,14,21
p_43,4,0,e_3,270,285,299,4,0,0,0,3,0,0,15,14,29
p_38,12,0,e_2,240,257,317,12,0,0,7,5,1,0,17,60,77
p_40,15,0,e_2,255,268,317,15,0,0,12,5,0,1,13,49,62
p_47,3,0,e_2,293,306,317,29,1,1,7,4,1,0,13,11,24
p_49,3,0,e_1,298,310,321,3,0,0,0,3,0,0,12,11,23
p_51,0,4,e_1,309,321,335,19,1,1,3,2,0,0,12,14,26
p_59,3,0,e_1,335,340,355,14,2,1,4,4,0,2,5,15,20
p_60,2,0,e_1,338,345,355,14,2,1,3,4,0,3,7,10,17
p_57,1,0,e_1,327,350,355,18,2,2,2,5,1,0,23,5,28
p_62,1,0,e_1,345,350,355,13,2,0,2,4,1,1,5,5,10
p_46,8,0,e_0,291,317,367,24,1,1,0,5,0,1,26,50,76
p_53,8,0,e_0,313,317,367,16,2,2,7,5,0,4,4,50,54
p_48,9,0,e_0,294,322,367,22,1,1,1,5,0,2,28,45,73
p_45,11,0,e_0,290,330,367,22,1,1,0,3,0,0,40,37,77
p_54,7,0,e_0,313,344,367,17,2,2,7,5,0,3,31,23,54
p_58,0,6,e_1,330,355,375,18,2,2,3,5,1,1,25,20,45
p_56,8,0,e_2,324,351,379,12,2,2,0,3,0,0,27,28,55
p_63,3,0,e_2,364,368,379,6,1,0,4,4,1,0,4,11,15
p_50,11,0,e_3,299,335,392,11,0,0,0,3,0,0,36,57,93
p_52,14,0,e_3,312,346,392,10,1,0,4,5,0,1,34,46,80
p_55,14,0,e_3,314,346,392,10,2,0,4,5,0,2,32,46,78
p_61,12,0,e_3,341,354,392,3,2,1,13,5,1,1,13,38,51
p_65,0,7,e_2,369,379,402,7,1,0,3,4,1,0,10,23,33
p_64,0,15,e_0,365,367,414,9,1,0,0,4,1,0,2,47,49
p_69,2,0,e_3,391,400,416,2,0,0,0,3,1,0,9,16,25
p_70,3,0,e_3,398,405,416,1,1,0,2,5,0,1,7,11,18
p_68,2,0,e_2,389,419,427,29,1,1,3,5,1,0,30,8,38
p_66,11,0,e_1,376,394,441,24,1,1,6,3,0,0,18,47,65
p_67,12,0,e_1,377,399,441,23,1,1,6,5,0,1,22,42,64
p_71,7,0,e_1,403,416,441,4,2,0,11,4,1,0,13,25,38
p_72,6,0,e_1,417,421,441,6,0,0,7,4,1,0,4,20,24
p_73,3,0,e_3,423,435,446,3,0,0,0,3,0,0,12,11,23
p_75,3,0,e_2,438,450,461,29,1,1,0,3,0,0,12,11,23
p_74,10,0,e_0,424,442,476,10,1,0,15,3,0,0,18,34,52
p_77,4,0,e_0,455,462,476,4,0,0,6,4,1,0,7,14,21
p_81,1,0,e_0,493,499,504,6,1,0,0,3,0,0,6,5,11
p_79,9,0,e_3,457,487,516,9,0,0,0,3,0,0,30,29,59
p_76,10,0,e_1,440,473,527,22,1,1,0,3,1,0,33,54,87
p_78,12,0,e_1,455,481,527,12,0,0,4,5,0,1,26,46,72
p_80,13,0,e_1,474,486,527,8,1,0,10,5,1,1,12,41,53
p_82,0,12,e_2,494,495,535,7,1,0,0,3,0,0,1,40,41
p_83,0,12,e_0,501,504,544,5,1,0,1,4,1,0,3,40,43
p_87,3,0,e_1,528,540,567,3,0,0,0,3,0,0,12,27,39
p_89,5,0,e_1,535,548,567,5,0,0,2,5,0,1,13,19,32
p_94,3,0,e_1,546,556,567,4,2,1,5,5,1,1,10,11,21
p_90,1,0,e_3,538,544,569,1,0,0,0,3,0,0,6,25,31
p_93,4,0,e_3,543,555,569,5,0,0,1,2,0,0,12,14,26
p_88,10,0,e_0,531,536,586,10,0,0,9,5,1,0,5,50,55
p_92,10,0,e_0,540,552,586,10,1,0,11,5,2,0,12,34,46
p_95,10,0,e_0,547,552,586,8,2,0,11,4,1,1,5,34,39
p_96,7,0,e_0,551,563,586,4,2,0,10,1,1,0,12,23,35
p_84,12,0,e_2,504,535,591,22,1,1,2,5,1,0,31,56,87
p_85,14,0,e_2,517,543,591,14,0,0,6,5,1,0,26,48,74
p_86,14,0,e_2,518,543,591,14,0,0,7,5,1,1,25,48,73
p_91,14,0,e_2,539,543,591,14,1,0,13,5,1,1,4,48,52
p_99,9,0,e_2,556,560,591,25,2,2,10,4,1,1,4,31,35
p_98,6,0,e_2,555,571,591,28,2,2,10,4,1,0,16,20,36
p_101,9,0,e_1,566,596,663,22,2,2,0,3,1,1,30,67,97
p_100,10,0,e_1,557,601,663,24,2,2,3,4,1,0,44,62,106
p_103,14,0,e_1,577,615,663,12,2,0,3,5,0,2,38,48,86
p_113,9,0,e_1,629,632,663,2,2,0,10,4,1,1,3,31,34
p_106,5,0,e_1,583,646,663,19,3,2,5,5,0,3,63,17,80
p_97,5,0,e_3,552,586,665,2,2,0,3,5,1,1,34,79,113
p_108,7,0,e_3,584,594,665,16,4,2,5,5,0,4,10,71,81
p_105,12,0,e_3,582,611,665,12,2,1,4,5,0,2,29,54,83
p_102,14,0,e_3,568,619,665,14,1,1,0,3,1,1,51,46,97
p_104,14,0,e_3,581,619,665,10,2,0,4,5,0,2,38,46,84
p_107,3,0,e_3,584,654,665,20,3,2,5,5,0,3,70,11,81
p_109,10,0,e_0,590,623,667,12,5,2,0,3,0,0,33,44,77
p_112,11,0,e_0,613,628,667,5,3,1,7,5,0,2,15,39,54
p_116,7,0,e_0,633,642,667,3,2,0,10,4,1,1,9,25,34
p_111,2,0,e_0,607,659,667,15,4,2,5,5,0,1,52,8,60
p_110,12,0,e_2,590,629,671,10,5,1,0,3,1,0,39,42,81
p_115,9,0,e_2,632,640,671,1,2,0,11,4,1,0,8,31,39
p_121,3,0,e_2,656,660,671,30,2,2,4,4,1,1,4,11,15
p_117,0,2,e_3,636,665,673,9,2,0,9,4,1,1,29,8,37
p_123,0,2,e_3,661,665,673,1,2,0,1,4,1,1,4,8,12
p_125,2,0,e_0,668,675,717,23,3,2,0,5,0,1,7,42,49
p_122,7,0,e_0,657,692,717,25,2,2,2,4,1,1,35,25,60
p_126,1,0,e_0,681,712,717,21,2,2,4,5,1,1,31,5,36
p_118,8,0,e_2,649,697,725,26,2,2,6,4,1,0,48,28,76
p_129,5,0,e_2,705,708,725,9,2,1,6,4,1,0,3,17,20
p_119,8,0,e_1,650,689,751,26,2,2,4,4,1,1,39,62,101
p_114,13,0,e_1,632,706,751,27,2,2,9,4,1,1,74,45,119
p_127,7,0,e_1,701,726,751,9,2,1,12,5,1,1,25,25,50
p_131,7,0,e_1,722,726,751,3,1,0,8,4,1,1,4,25,29
p_132,4,0,e_1,730,737,751,3,1,0,6,4,1,0,7,14,21
p_124,7,0,e_3,664,690,753,7,1,1,0,3,1,1,26,63,89
p_120,13,0,e_3,653,710,753,20,1,1,3,1,1,0,57,43,100
p_130,11,0,e_3,705,718,753,3,2,1,12,5,1,1,13,35,48
p_128,0,15,e_0,705,717,768,14,2,2,3,4,1,1,12,51,63
p_140,5,0,e_3,768,786,803,5,0,0,0,3,0,0,18,17,35
p_143,5,0,e_3,780,786,803,2,1,0,3,5,0,1,6,17,23
p_139,0,15,e_1,758,759,808,0,0,0,0,3,0,0,1,49,50
p_133,6,0,e_2,734,755,815,30,1,1,0,3,0,0,21,60,81
p_135,11,0,e_2,739,772,815,23,1,1,1,5,0,1,33,43,76
p_138,12,0,e_2,756,777,815,12,0,0,6,5,1,1,21,38,59
p_137,13,0,e_0,755,758,819,13,0,0,12,5,1,1,3,61,64
p_134,14,0,e_0,734,763,819,22,1,1,5,5,1,0,29,56,85
p_136,14,0,e_0,749,763,819,17,1,1,10,5,1,1,14,56,70
p_142,13,0,e_0,773,776,819,12,1,0,14,4,1,1,3,43,46
p_141,12,0,e_0,770,781,819,12,1,0,15,4,1,0,11,38,49
p_145,1,0,e_0,820,826,831,1,0,0,0,3,0,0,6,5,11
p_144,6,0,e_2,815,836,856,6,0,0,0,3,0,0,21,20,41
p_150,3,0,e_2,860,872,885,24,1,1,0,3,0,0,12,13,25
p_152,2,0,e_2,868,877,885,22,1,1,2,5,0,1,9,8,17
p_146,10,0,e_1,846,864,900,10,0,0,15,3,0,0,18,36,54
p_153,6,0,e_1,872,878,900,17,1,1,8,4,1,0,6,22,28
p_154,4,0,e_1,874,886,900,18,1,1,7,4,1,1,12,14,26
p_147,6,0,e_0,849,870,934,6,0,0,0,3,0,0,21,64,85
p_149,6,0,e_0,859,870,934,21,1,1,3,5,0,1,11,64,75
p_155,11,0,e_0,884,887,934,8,1,1,10,5,1,1,3,47,50
p_151,12,0,e_0,863,892,934,14,1,1,4,5,0,1,29,42,71
p_156,12,0,e_0,884,892,934,7,1,1,10,5,1,2,8,42,50
p_159,8,0,e_0,893,906,934,8,1,1,12,4,1,1,13,28,41
p_158,7,0,e_0,892,911,934,9,1,1,12,4,1,0,19,23,42
p_157,7,0,e_2,889,913,936,10,1,1,0,3,0,0,24,23,47
p_148,15,0,e_3,849,897,944,15,0,0,0,3,0,0,48,47,95
p_3,4,0,e_2,25,40,88,4,0,0,0,3,0,0,15,48,63
p_4,5,0,e_2,34,45,88,5,0,0,2,5,0,1,11,43,54
p_5,9,0,e_2,41,59,88,9,0,0,4,5,1,1,18,29,47
p_6,9,0,e_2,45,59,88,9,0,0,5,5,1,1,14,29,43
p_2,11,0,e_1,19,55,90,11,0,0,0,3,0,0,36,35,71
p_1,13,0,e_0,13,55,96,13,0,0,0,3,0,0,42,41,83
p_12,0,8,e_2,86,88,114,21,4,4,0,4,1,0,2,26,28
p_16,4,0,e_1,101,116,130,13,4,1,0,3,0,0,15,14,29
p_15,5,0,e_0,99,117,134,13,4,2,0,3,0,0,18,17,35
p_19,0,7,e_1,125,130,155,11,2,0,1,4,1,0,5,25,30
p_7,2,0,e_3,55,64,162,2,0,0,0,3,0,0,9,98,107
p_10,9,0,e_3,77,87,162,15,3,2,6,5,1,2,10,75,85
p_9,10,0,e_3,67,92,162,17,2,1,3,5,1,1,25,70,95
p_14,13,0,e_3,87,103,162,8,4,1,9,5,1,3,16,59,75
p_8,15,0,e_3,62,111,162,13,1,0,2,5,0,1,49,51,100
p_11,4,0,e_3,84,146,162,18,4,3,8,5,1,3,62,16,78
p_20,3,0,e_3,142,151,162,2,2,1,5,4,1,1,9,11,20
p_21,0,10,e_0,142,143,179,5,2,0,0,3,0,0,1,36,37
p_13,8,0,e_2,87,114,186,13,4,2,0,3,1,0,27,72,99
p_17,10,0,e_2,112,122,186,5,2,0,8,5,1,0,10,64,74
p_18,15,0,e_2,120,139,186,27,2,2,10,5,1,1,19,47,66
p_27,5,0,e_3,180,187,212,4,1,1,3,5,0,1,7,25,32
p_26,6,0,e_3,169,192,212,6,0,0,0,3,0,0,23,20,43
p_25,9,0,e_0,163,174,215,9,0,0,6,5,1,0,11,41,52
p_28,7,0,e_0,184,190,215,3,2,0,9,4,1,0,6,25,31
p_30,2,0,e_0,200,207,215,2,1,0,4,4,1,0,7,8,15
p_22,6,0,e_1,146,150,234,28,2,2,5,5,1,0,4,84,88
p_24,14,0,e_1,157,178,234,17,1,1,7,5,1,1,21,56,77
p_23,15,0,e_1,150,183,234,18,1,1,6,5,2,0,33,51,84
p_31,5,0,e_1,203,215,234,28,1,1,9,4,1,0,12,19,31
p_33,1,0,e_1,213,229,234,19,1,1,5,4,1,1,16,5,21
p_36,1,0,e_1,225,229,234,15,1,1,2,4,1,1,4,5,9
p_32,0,10,e_3,209,212,244,1,1,0,1,4,1,0,3,32,35
p_35,0,6,e_0,222,223,245,17,1,1,0,3,0,0,1,22,23
p_38,12,0,e_3,240,252,294,3,1,0,9,5,1,0,12,42,54
p_41,7,0,e_3,257,269,294,4,1,0,11,4,1,0,12,25,37
p_42,4,0,e_3,269,280,294,3,1,0,7,4,1,0,11,14,25
p_44,4,0,e_3,275,280,294,1,2,0,5,4,1,1,5,14,19
p_34,11,0,e_2,217,228,295,10,1,0,8,5,0,1,11,67,78
p_29,14,0,e_2,192,239,295,22,1,1,0,3,0,0,47,56,103
p_37,15,0,e_2,228,244,295,10,1,0,11,5,1,1,16,51,67
p_39,13,0,e_2,247,252,295,2,1,0,14,4,1,0,5,43,48
p_43,4,0,e_2,270,281,295,3,2,0,7,4,1,0,11,14,25
p_51,0,4,e_2,309,310,326,0,0,0,0,3,0,0,1,16,17
p_40,15,0,e_0,255,285,342,26,1,1,6,3,0,0,30,57,87
p_45,11,0,e_0,290,299,342,20,1,1,14,4,1,0,9,43,52
p_48,9,0,e_0,294,307,342,9,0,0,12,4,1,2,13,35,48
p_46,8,0,e_0,291,312,342,23,1,1,13,4,1,1,21,30,51
p_54,7,0,e_0,313,317,342,7,0,0,8,4,1,0,4,25,29
p_57,1,0,e_0,327,337,342,11,1,1,4,4,1,0,10,5,15
p_58,0,6,e_0,330,342,362,11,1,1,3,4,1,1,12,20,32
p_53,8,0,e_3,313,340,368,8,0,0,0,3,0,0,27,28,55
p_60,2,0,e_3,338,360,368,6,1,0,8,5,0,1,22,8,30
p_56,8,0,e_2,324,340,370,5,1,0,4,5,1,0,16,30,46
p_59,3,0,e_2,335,357,370,6,1,1,7,5,0,1,22,13,35
p_62,1,0,e_2,345,365,370,6,2,1,7,4,1,1,20,5,25
p_47,3,0,e_1,293,305,388,3,0,0,0,3,0,0,12,83,95
p_49,3,0,e_1,298,305,388,3,0,0,1,5,0,1,7,83,90
p_50,11,0,e_1,299,331,388,11,0,0,1,5,0,1,32,57,89
p_52,14,0,e_1,312,342,388,14,0,0,5,5,1,1,30,46,76
p_55,14,0,e_1,314,342,388,14,1,0,6,5,1,2,28,46,74
p_63,3,0,e_1,364,377,388,28,1,1,7,4,1,0,13,11,24
p_65,0,7,e_2,369,370,395,0,0,0,0,3,1,0,1,25,26
p_68,2,0,e_1,389,398,406,2,0,0,0,3,0,0,9,8,17
p_64,0,15,e_2,365,370,421,1,1,0,1,4,1,0,5,51,56
p_66,11,0,e_0,376,379,422,11,0,0,10,5,0,1,3,43,46
p_61,12,0,e_0,341,384,422,26,2,2,0,3,1,0,43,38,81
p_67,12,0,e_0,377,384,422,12,0,0,11,5,0,2,7,38,45
p_69,2,0,e_3,391,400,444,2,0,0,0,3,0,0,9,44,53
p_70,3,0,e_3,398,405,444,1,1,0,2,5,0,1,7,39,46
p_71,7,0,e_3,403,419,444,4,2,0,3,5,1,1,16,25,41
p_72,6,0,e_3,417,424,444,1,2,0,7,5,1,1,7,20,27
p_73,3,0,e_0,423,435,446,3,1,0,0,3,0,0,12,11,23
p_74,10,0,e_2,424,442,476,26,1,1,15,3,0,0,18,34,52
p_77,4,0,e_2,455,462,476,4,0,0,6,4,1,0,7,14,21
p_81,1,0,e_2,493,499,504,1,0,0,0,3,0,0,6,5,11
p_79,9,0,e_0,457,487,516,9,0,0,0,3,0,0,30,29,59
p_75,3,0,e_1,438,450,527,29,1,1,0,3,0,0,12,77,89
p_76,10,0,e_1,440,473,527,21,1,1,0,5,0,1,33,54,87
p_78,12,0,e_1,455,481,527,12,0,0,4,5,1,1,26,46,72
p_80,13,0,e_1,474,486,527,13,0,0,10,5,1,1,12,41,53
p_82,0,12,e_3,494,495,535,0,0,0,0,3,0,0,1,40,41
p_83,0,12,e_2,501,504,544,23,1,1,1,4,1,0,3,40,43
p_90,1,0,e_1,538,544,549,14,2,1,0,3,0,0,6,5,11
p_87,3,0,e_0,528,540,569,15,2,2,0,3,0,0,12,29,41
p_93,4,0,e_0,543,545,569,10,1,0,4,5,1,1,2,24,26
p_89,5,0,e_0,535,550,569,11,2,1,2,5,0,1,15,19,34
p_94,3,0,e_0,546,558,569,10,1,0,4,5,1,1,12,11,23
p_88,10,0,e_2,531,536,588,7,2,2,9,5,1,0,5,52,57
p_92,10,0,e_2,540,552,588,5,2,1,11,5,2,0,12,36,48
p_95,10,0,e_2,547,552,588,3,1,0,11,4,1,1,5,36,41
p_96,7,0,e_2,551,563,588,5,1,0,10,1,1,0,12,25,37
p_98,6,0,e_2,555,568,588,4,1,0,9,4,1,1,13,20,33
p_84,12,0,e_3,504,535,589,10,1,0,2,5,1,0,31,54,85
p_85,14,0,e_3,517,543,589,8,1,0,6,5,1,0,26,46,72
p_86,14,0,e_3,518,543,589,7,2,0,7,5,1,1,25,46,71
p_91,14,0,e_3,539,543,589,1,2,0,13,5,1,1,4,46,50
p_99,9,0,e_3,556,560,589,1,1,0,10,4,1,0,4,29,33
p_111,2,0,e_2,607,616,624,2,0,0,0,3,0,0,9,8,17
p_97,5,0,e_1,552,570,651,6,1,0,0,3,0,0,18,81,99
p_101,9,0,e_1,566,584,651,28,1,1,4,5,0,2,18,67,85
p_100,10,0,e_1,557,589,651,30,2,2,1,5,0,1,32,62,94
p_105,12,0,e_1,582,597,651,20,1,1,9,5,1,3,15,54,69
p_110,12,0,e_1,590,597,651,12,0,0,10,5,1,2,7,54,61
p_102,14,0,e_1,568,605,651,23,1,1,5,5,0,3,37,46,83
p_103,14,0,e_1,577,605,651,20,1,1,7,5,1,3,28,46,74
p_104,14,0,e_1,581,605,651,18,1,1,8,5,1,3,24,46,70
p_112,11,0,e_1,613,616,651,11,0,0,12,4,1,0,3,35,38
p_107,3,0,e_0,584,595,654,28,1,1,0,5,0,1,11,59,70
p_106,5,0,e_0,583,603,654,27,1,1,0,3,0,0,20,51,71
p_108,7,0,e_0,584,611,654,24,1,1,0,5,0,2,27,43,70
p_109,10,0,e_0,590,622,654,10,0,0,2,5,0,3,32,32,64
p_117,0,2,e_1,636,651,659,17,2,2,5,4,1,0,15,8,23
p_123,0,2,e_0,661,662,672,10,3,3,0,3,0,0,1,10,11
p_121,3,0,e_1,656,664,675,8,3,2,1,5,1,0,8,11,19
p_125,2,0,e_0,668,672,680,7,2,1,1,5,1,0,4,8,12
p_126,1,0,e_0,681,687,692,4,1,0,0,3,0,0,6,5,11
p_116,7,0,e_3,633,656,697,11,1,1,0,5,0,1,23,41,64
p_118,8,0,e_3,649,661,697,5,2,1,5,5,0,2,12,36,48
p_119,8,0,e_3,650,661,697,5,3,1,5,5,0,3,11,36,47
p_115,9,0,e_3,632,666,697,9,0,0,0,3,0,0,34,31,65
p_122,7,0,e_3,657,674,697,4,3,2,7,5,1,2,17,23,40
p_124,7,0,e_3,664,674,697,2,3,0,9,5,1,2,10,23,33
p_113,9,0,e_2,629,659,714,9,0,0,0,3,0,0,30,55,85
p_114,13,0,e_2,632,673,714,13,1,1,0,5,0,1,41,41,82
p_120,13,0,e_2,653,673,714,7,3,0,7,5,0,2,20,41,61
p_129,5,0,e_3,705,723,740,5,0,0,0,3,0,0,18,17,35
p_128,0,15,e_1,705,706,755,0,0,0,0,3,0,0,1,49,50
p_132,4,0,e_2,730,737,773,29,1,1,2,5,0,1,7,36,43
p_133,6,0,e_2,734,745,773,26,1,1,3,5,0,2,11,28,39
p_131,7,0,e_2,722,750,773,12,0,0,0,3,0,0,28,23,51
p_127,7,0,e_0,701,725,800,7,0,0,0,3,0,0,24,75,99
p_130,11,0,e_0,705,739,800,11,1,1,1,5,0,1,34,61,95
p_135,11,0,e_0,739,741,800,11,0,0,11,5,1,1,2,59,61
p_134,14,0,e_0,734,752,800,18,1,1,10,5,1,1,18,48,66
p_136,14,0,e_0,749,752,800,14,0,0,13,5,1,1,3,48,51
p_138,12,0,e_0,756,760,800,12,0,0,13,4,1,0,4,40,44
p_140,5,0,e_0,768,783,800,23,1,1,10,4,1,0,15,17,32
p_143,5,0,e_0,780,783,800,19,2,2,6,4,1,1,3,17,20
p_137,13,0,e_1,755,764,805,13,0,0,15,3,0,0,9,41,50
p_139,0,15,e_3,758,759,810,0,0,0,0,3,0,0,1,51,52
p_145,1,0,e_1,820,826,831,11,1,0,0,3,0,0,6,5,11
p_144,6,0,e_0,815,836,856,8,1,0,0,3,0,0,21,20,41
p_142,13,0,e_2,773,815,856,13,2,1,0,3,0,0,42,41,83
p_141,12,0,e_3,770,799,857,15,1,1,3,5,1,0,29,58,87
p_150,3,0,e_2,860,872,883,3,0,0,0,3,0,0,12,11,23
p_152,2,0,e_3,868,877,929,2,0,0,0,3,0,0,9,52,61
p_154,4,0,e_3,874,885,929,7,2,1,1,5,0,2,11,44,55
p_153,6,0,e_3,872,893,929,5,1,0,1,5,0,1,21,36,57
p_157,7,0,e_3,889,898,929,2,2,0,5,5,1,1,9,31,40
p_158,7,0,e_3,892,898,929,1,2,0,6,2,1,1,6,31,37
p_159,8,0,e_3,893,903,929,2,2,0,6,5,1,1,10,26,36
p_149,6,0,e_0,859,880,940,6,0,0,0,3,0,0,21,60,81
p_155,11,0,e_0,884,897,940,7,2,2,7,5,1,1,13,43,56
p_151,12,0,e_0,863,902,940,12,0,0,1,5,0,1,39,38,77
p_156,12,0,e_0,884,902,940,8,2,2,7,5,1,2,18,38,56
p_147,6,0,e_1,849,867,945,26,1,1,0,5,0,1,18,78,96
p_146,10,0,e_1,846,881,945,23,1,1,0,3,0,0,35,64,99
p_148,15,0,e_1,849,898,945,17,1,1,0,5,0,2,49,47,96
p_3,4,0,e_2,25,40,54,4,0,0,0,3,0,0,15,14,29
p_2,11,0,e_1,19,55,90,11,0,0,0,3,0,0,36,35,71
p_4,5,0,e_3,34,52,95,5,0,0,0,3,0,0,18,43,61
p_5,9,0,e_3,41,66,95,7,1,0,2,5,0,1,25,29,54
p_6,9,0,e_3,45,66,95,6,2,0,3,5,0,2,21,29,50
p_1,13,0,e_0,13,55,96,13,0,0,0,3,0,0,42,41,83
p_12,0,8,e_1,86,90,116,3,2,0,1,4,1,1,4,26,30
p_11,4,0,e_3,84,109,131,29,1,1,3,4,1,0,25,22,47
p_15,5,0,e_3,99,114,131,4,1,0,1,5,0,1,15,17,32
p_19,0,7,e_3,125,131,154,2,1,0,2,4,1,0,6,23,29
p_7,2,0,e_2,55,64,156,10,2,1,0,3,0,0,9,92,101
p_14,13,0,e_2,87,99,156,19,2,2,9,5,1,2,12,57,69
p_8,15,0,e_2,62,107,156,7,2,0,2,5,0,1,45,49,94
p_13,8,0,e_2,87,130,156,24,2,2,9,5,1,1,43,26,69
p_16,4,0,e_0,101,110,158,4,2,1,1,5,0,1,9,48,57
p_10,9,0,e_0,77,127,158,27,1,1,6,4,1,0,50,31,81
p_20,3,0,e_0,142,147,158,8,1,1,4,4,1,0,5,11,16
p_21,0,10,e_0,142,158,190,11,1,1,4,4,1,0,16,32,48
p_9,10,0,e_1,67,124,190,29,1,1,7,4,1,0,57,66,123
p_17,10,0,e_1,112,124,190,5,2,0,7,5,1,1,12,66,78
p_18,15,0,e_1,120,141,190,18,1,1,9,5,0,1,21,49,70
p_22,6,0,e_1,146,170,190,3,1,1,14,4,1,0,24,20,44
p_26,6,0,e_2,169,184,226,12,1,1,1,5,0,1,15,42,57
p_25,9,0,e_2,163,195,226,11,1,1,0,3,0,0,32,31,63
p_30,2,0,e_2,200,218,226,7,3,2,8,4,1,0,18,8,26
p_23,15,0,e_3,150,180,233,9,1,0,6,5,1,0,30,53,83
p_28,7,0,e_3,184,206,233,7,2,0,14,4,1,1,22,27,49
p_27,5,0,e_3,180,214,233,10,1,0,15,4,1,0,34,19,53
p_33,1,0,e_3,213,228,233,4,1,0,5,1,1,0,15,5,20
p_35,0,6,e_2,222,226,248,3,2,0,1,4,1,0,4,22,26
p_24,14,0,e_0,157,204,250,8,1,1,0,3,1,0,47,46,93
p_31,5,0,e_0,203,233,250,3,3,1,14,2,0,0,30,17,47
p_32,0,10,e_2,209,226,262,6,2,0,5,4,1,1,17,36,53
p_36,1,0,e_2,225,231,296,1,2,0,0,3,1,0,6,65,71
p_42,4,0,e_2,269,282,296,11,1,1,8,4,1,0,13,14,27
p_34,11,0,e_1,217,228,297,23,2,2,8,5,0,1,11,69,80
p_29,14,0,e_1,192,239,297,27,3,3,0,3,0,0,47,58,105
p_37,15,0,e_1,228,244,297,16,1,1,11,5,1,1,16,53,69
p_39,13,0,e_1,247,252,297,11,1,0,14,4,1,0,5,45,50
p_41,7,0,e_1,257,272,297,12,1,1,12,4,1,0,15,25,40
p_43,4,0,e_1,270,283,297,11,1,1,7,4,1,1,13,14,27
p_44,4,0,e_1,275,283,297,9,1,1,6,4,1,1,8,14,22
p_38,12,0,e_3,240,279,319,12,0,0,0,3,0,0,39,40,79
p_47,3,0,e_3,293,308,319,5,1,0,8,4,1,0,15,11,26
p_49,3,0,e_3,298,308,319,3,2,0,6,4,1,1,10,11,21
p_51,0,4,e_3,309,319,333,3,1,0,3,4,1,0,10,14,24
p_40,15,0,e_0,255,303,358,11,1,0,0,3,0,0,48,55,103
p_45,11,0,e_0,290,317,358,28,1,1,11,5,0,1,27,41,68
p_54,7,0,e_0,313,331,358,25,1,1,12,4,1,1,18,27,45
p_59,3,0,e_0,335,345,358,9,1,1,6,4,1,1,10,13,23
p_57,1,0,e_0,327,353,358,13,2,2,8,4,1,1,26,5,31
p_56,8,0,e_3,324,347,375,7,1,0,1,5,1,0,23,28,51
p_60,2,0,e_3,338,367,375,9,1,1,5,5,0,1,29,8,37
p_58,0,6,e_0,330,358,378,13,2,2,7,1,1,1,28,20,48
p_46,8,0,e_2,291,322,390,30,1,1,1,4,1,0,31,68,99
p_53,8,0,e_2,313,322,390,24,1,1,5,5,0,2,9,68,77
p_50,11,0,e_2,299,333,390,25,2,2,1,5,0,1,34,57,91
p_55,14,0,e_2,314,344,390,17,1,1,6,5,0,2,30,46,76
p_62,1,0,e_2,345,385,390,7,2,0,14,4,1,0,40,5,45
p_48,9,0,e_1,294,326,391,28,2,2,1,4,1,0,32,65,97
p_52,14,0,e_1,312,343,391,18,1,1,5,5,0,1,31,48,79
p_61,12,0,e_1,341,351,391,6,2,0,14,5,1,1,10,40,50
p_63,3,0,e_1,364,380,391,30,2,2,8,4,1,0,16,11,27
p_65,0,7,e_3,369,375,398,2,1,0,2,4,1,0,6,23,29
p_68,2,0,e_2,389,398,406,24,2,2,0,3,1,0,9,8,17
p_69,2,0,e_1,391,400,416,23,2,2,0,3,0,0,9,16,25
p_70,3,0,e_1,398,405,416,20,1,1,2,5,0,1,7,11,18
p_64,0,15,e_3,365,375,424,2,2,0,2,4,1,1,10,49,59
p_66,11,0,e_0,376,395,440,19,2,1,6,5,1,0,19,45,64
p_67,12,0,e_0,377,400,440,18,2,1,6,2,1,1,23,40,63
p_71,7,0,e_0,403,417,440,15,1,1,11,4,1,0,14,23,37
p_73,3,0,e_2,423,435,446,18,0,0,0,3,0,0,12,11,23
p_72,6,0,e_1,417,438,460,11,1,1,0,3,0,0,21,22,43
p_75,3,0,e_1,438,449,460,8,1,1,6,4,1,0,11,11,22
p_74,10,0,e_3,424,442,474,5,0,0,15,3,0,0,18,32,50
p_81,1,0,e_3,493,499,504,1,0,0,0,3,0,0,6,5,11
p_77,4,0,e_2,455,470,516,2,1,0,0,3,0,0,15,46,61
p_79,9,0,e_2,457,487,516,26,1,1,0,5,0,1,30,29,59
p_76,10,0,e_0,440,473,519,20,1,1,0,3,0,0,33,46,79
p_78,12,0,e_0,455,481,519,24,1,1,4,5,0,1,26,38,64
p_83,0,12,e_3,501,504,542,1,1,0,1,4,1,0,3,38,41
p_82,0,12,e_2,494,516,558,2,1,1,7,4,1,0,22,42,64
p_80,13,0,e_1,474,516,563,13,0,0,0,3,0,0,42,47,89
p_89,5,0,e_1,535,542,563,13,2,2,7,4,1,1,7,21,28
p_93,4,0,e_1,543,547,563,12,2,1,5,4,1,1,4,16,20
p_87,3,0,e_1,528,552,563,17,2,2,9,4,1,0,24,11,35
p_94,3,0,e_1,546,552,563,12,2,1,4,1,1,1,6,11,17
p_88,10,0,e_2,531,548,600,9,2,2,5,5,1,0,17,52,69
p_92,10,0,e_2,540,548,600,6,2,1,8,5,1,1,8,52,60
p_95,10,0,e_2,547,548,600,5,2,1,10,2,1,0,1,52,53
p_99,9,0,e_2,556,569,600,3,3,0,12,5,2,1,13,31,44
p_97,5,0,e_2,552,583,600,9,2,1,10,5,2,0,31,17,48
p_84,12,0,e_3,504,542,602,12,1,0,0,5,1,0,38,60,98
p_85,14,0,e_3,517,550,602,10,1,0,4,5,1,0,33,52,85
p_91,14,0,e_3,539,550,602,3,2,0,11,5,1,1,11,52,63
p_100,10,0,e_3,557,564,602,2,3,0,12,4,1,2,7,38,45
p_96,7,0,e_3,551,575,602,7,1,0,14,4,1,0,24,27,51
p_98,6,0,e_3,555,580,602,7,2,1,13,4,1,1,25,22,47
p_107,3,0,e_3,584,591,602,2,1,0,5,4,1,0,7,11,18
p_86,14,0,e_0,518,563,611,10,2,0,0,3,1,0,45,48,93
p_106,5,0,e_0,583,592,611,30,1,1,8,4,1,1,9,19,28
p_90,1,0,e_0,538,606,611,16,2,2,6,5,0,1,68,5,73
p_108,7,0,e_1,584,590,665,28,2,2,5,5,0,2,6,75,81
p_101,9,0,e_1,566,598,665,1,3,0,0,3,0,0,32,67,99
p_110,12,0,e_1,590,609,665,21,2,2,7,5,1,2,19,56,75
p_102,14,0,e_1,568,617,665,25,3,3,0,5,0,1,49,48,97
p_103,14,0,e_1,577,617,665,23,2,2,3,5,0,2,40,48,88
p_104,14,0,e_1,581,617,665,22,1,1,4,5,0,2,36,48,84
p_113,9,0,e_1,629,634,665,3,2,1,10,4,1,0,5,31,36
p_116,7,0,e_1,633,642,665,4,2,1,9,1,1,0,9,23,32
p_111,2,0,e_3,607,610,670,17,1,1,1,5,0,1,3,60,63
p_109,10,0,e_3,590,636,670,23,1,1,3,1,1,0,46,34,80
p_121,3,0,e_3,656,659,670,1,1,0,4,4,1,0,3,11,14
p_123,0,2,e_1,661,665,673,3,1,0,1,4,1,0,4,8,12
p_117,0,2,e_3,636,670,678,10,1,0,10,4,1,0,34,8,42
p_105,12,0,e_2,582,638,682,24,1,1,5,1,1,0,56,44,100
p_115,9,0,e_2,632,649,682,2,2,1,10,5,0,1,17,33,50
p_118,8,0,e_2,649,654,682,28,1,1,9,4,1,0,5,28,33
p_119,8,0,e_2,650,654,682,28,1,1,9,4,1,1,4,28,32
p_125,2,0,e_2,668,674,682,28,1,1,4,4,1,0,6,8,14
p_126,1,0,e_2,681,687,692,1,0,0,0,3,1,0,6,5,11
p_112,11,0,e_0,613,649,700,8,2,0,0,3,0,0,36,51,87
p_114,13,0,e_0,632,657,700,4,2,0,6,5,0,1,25,43,68
p_120,13,0,e_0,653,657,700,22,1,1,12,5,1,1,4,43,47
p_122,7,0,e_0,657,677,700,26,2,2,13,4,1,0,20,23,43
p_124,7,0,e_1,664,690,713,25,1,1,0,3,1,0,26,23,49
p_129,5,0,e_2,705,723,740,6,1,1,0,3,0,0,18,17,35
p_128,0,15,e_0,705,706,755,11,1,1,0,3,0,0,1,49,50
p_127,7,0,e_3,701,719,770,5,0,0,2,3,0,0,18,51,69
p_130,11,0,e_3,705,733,770,8,1,0,3,5,0,1,28,37,65
p_133,6,0,e_3,734,750,770,5,1,0,11,4,1,0,16,20,36
p_137,13,0,e_0,755,764,809,22,1,1,15,3,0,0,9,45,54
p_138,12,0,e_0,756,769,809,22,1,1,15,4,0,1,13,40,53
p_140,5,0,e_0,768,792,809,25,1,1,12,1,1,0,24,17,41
p_139,0,15,e_3,758,770,817,4,1,0,4,4,1,0,12,47,59
p_132,4,0,e_1,730,737,821,8,2,1,2,5,0,1,7,84,91
p_131,7,0,e_1,722,748,821,7,2,1,0,3,0,0,26,73,99
p_134,14,0,e_1,734,771,821,27,2,2,3,5,0,2,37,50,87
p_142,13,0,e_1,773,776,821,16,1,1,14,4,1,1,3,45,48
p_141,12,0,e_1,770,781,821,18,1,1,14,2,1,0,11,40,51
p_143,5,0,e_1,780,804,821,22,1,1,12,1,1,0,24,17,41
p_135,11,0,e_2,739,775,830,28,2,2,0,3,1,0,36,55,91
p_136,14,0,e_2,749,786,830,22,1,1,3,5,0,1,37,44,81
p_145,1,0,e_1,820,826,831,14,0,0,0,3,1,0,6,5,11
p_144,6,0,e_0,815,836,856,9,1,0,0,3,0,0,21,20,41
p_147,6,0,e_1,849,870,894,9,1,1,0,3,0,0,21,24,45
p_154,4,0,e_1,874,878,894,3,3,1,5,4,1,1,4,16,20
p_150,3,0,e_1,860,883,894,8,1,1,3,5,0,1,23,11,34
p_146,10,0,e_3,846,864,900,5,0,0,15,3,0,0,18,36,54
p_153,6,0,e_3,872,878,900,2,2,0,8,4,1,1,6,22,28
p_152,2,0,e_3,868,892,900,7,1,0,9,4,1,0,24,8,32
p_149,6,0,e_0,859,880,940,5,1,1,0,3,0,0,21,60,81
p_151,12,0,e_0,863,900,940,28,0,0,1,5,0,1,37,40,77
p_156,12,0,e_0,884,900,940,22,2,2,7,5,1,1,16,40,56
p_157,7,0,e_0,889,917,940,26,2,2,9,5,1,1,28,23,51
p_148,15,0,e_2,849,897,946,20,1,1,0,3,0,0,48,49,97
p_155,11,0,e_2,884,911,946,23,2,2,11,5,0,1,27,35,62
p_158,7,0,e_1,892,917,948,25,1,1,0,4,1,0,25,31,56
p_159,8,0,e_1,893,922,948,24,1,1,0,3,1,1,29,26,55
p_3,4,0,e_2,25,40,88,4,0,0,0,3,0,0,15,48,63
p_4,5,0,e_2,34,45,88,5,0,0,2,5,0,1,11,43,54
p_5,9,0,e_2,41,59,88,9,0,0,4,5,1,1,18,29,47
p_6,9,0,e_2,45,59,88,9,0,0,5,5,1,1,14,29,43
p_2,11,0,e_1,19,55,90,11,0,0,0,3,0,0,36,35,71
p_1,13,0,e_0,13,55,96,13,0,0,0,3,0,0,42,41,83
p_12,0,8,e_2,86,88,114,21,4,4,0,4,1,0,2,26,28
p_16,4,0,e_1,101,116,130,13,4,1,0,3,0,0,15,14,29
p_15,5,0,e_0,99,117,134,13,4,2,0,3,0,0,18,17,35
p_19,0,7,e_1,125,130,155,11,2,0,1,4,1,0,5,25,30
p_7,2,0,e_3,55,64,162,2,0,0,0,3,0,0,9,98,107
p_10,9,0,e_3,77,87,162,15,3,2,6,5,1,2,10,75,85
p_9,10,0,e_3,67,92,162,17,2,1,3,5,1,1,25,70,95
p_14,13,0,e_3,87,103,162,8,4,1,9,5,1,3,16,59,75
p_8,15,0,e_3,62,111,162,13,1,0,2,5,0,1,49,51,100
p_11,4,0,e_3,84,146,162,18,4,3,8,5,1,3,62,16,78
p_20,3,0,e_3,142,151,162,2,2,1,5,4,1,1,9,11,20
p_21,0,10,e_0,142,143,177,5,2,0,0,3,0,0,1,34,35
p_13,8,0,e_2,87,114,186,13,4,2,0,3,1,0,27,72,99
p_17,10,0,e_2,112,122,186,5,2,0,8,5,1,0,10,64,74
p_18,15,0,e_2,120,139,186,27,2,2,10,5,1,1,19,47,66
p_30,2,0,e_2,200,209,217,16,3,1,0,3,0,0,9,8,17
p_22,6,0,e_1,146,150,232,28,2,2,5,5,1,0,4,82,86
p_23,15,0,e_1,150,181,232,18,1,1,6,5,2,0,31,51,82
p_31,5,0,e_1,203,213,232,12,3,1,8,4,1,0,10,19,29
p_33,1,0,e_1,213,227,232,13,2,0,5,4,1,0,14,5,19
p_24,14,0,e_0,157,191,237,17,1,1,4,5,1,0,34,46,80
p_36,1,0,e_0,225,232,237,10,2,1,3,4,1,0,7,5,12
p_32,0,10,e_2,209,217,249,15,3,3,2,4,1,0,8,32,40
p_35,0,6,e_1,222,232,252,12,3,0,2,4,1,1,10,20,30
p_26,6,0,e_3,169,184,262,11,1,1,1,5,0,1,15,78,93
p_28,7,0,e_3,184,189,262,5,3,1,6,5,1,2,5,73,78
p_25,9,0,e_3,163,197,262,9,0,0,0,3,0,0,34,65,99
p_29,14,0,e_3,192,214,262,6,3,0,8,5,1,2,22,48,70
p_34,11,0,e_3,217,225,262,2,2,0,13,4,1,1,8,37,45
p_27,5,0,e_3,180,245,262,8,2,2,5,5,0,2,65,17,82
p_42,4,0,e_3,269,284,298,4,0,0,0,3,0,0,15,14,29
p_43,4,0,e_3,270,284,298,4,1,0,0,5,0,1,14,14,28
p_44,4,0,e_3,275,284,298,3,1,0,1,5,0,1,9,14,23
p_41,7,0,e_0,257,281,304,24,1,1,0,3,0,0,24,23,47
p_38,12,0,e_1,240,272,312,24,2,2,2,5,1,0,32,40,72
p_47,3,0,e_1,293,301,312,28,3,3,5,4,1,0,8,11,19
p_49,3,0,e_1,298,301,312,19,2,2,4,4,1,1,3,11,14
p_39,13,0,e_2,247,260,315,22,1,1,10,5,1,1,13,55,68
p_37,15,0,e_2,228,268,315,25,2,2,3,5,1,0,40,47,87
p_40,15,0,e_2,255,268,315,17,1,1,12,5,0,2,13,47,60
p_51,0,4,e_1,309,312,326,19,2,2,1,4,1,0,3,14,17
p_57,1,0,e_2,327,333,338,18,3,2,0,3,0,0,6,5,11
p_58,0,6,e_2,330,338,358,18,3,3,0,5,0,1,8,20,28
p_53,8,0,e_0,313,330,368,15,3,2,3,5,0,1,17,38,55
p_48,9,0,e_0,294,335,368,22,3,3,3,4,1,0,41,33,74
p_59,3,0,e_0,335,355,368,14,2,1,9,4,1,0,20,13,33
p_60,2,0,e_0,338,360,368,14,2,1,8,4,1,1,22,8,30
p_54,7,0,e_1,313,337,370,16,3,3,0,5,1,0,24,33,57
p_56,8,0,e_1,324,342,370,12,3,2,4,5,1,1,18,28,46
p_62,1,0,e_1,345,365,370,13,2,0,7,4,1,0,20,5,25
p_63,3,0,e_2,364,376,387,6,1,0,6,3,0,0,12,11,23
p_46,8,0,e_3,291,324,392,24,2,2,2,4,1,1,33,68,101
p_45,11,0,e_3,290,335,392,21,1,1,2,4,1,0,45,57,102
p_50,11,0,e_3,299,335,392,11,2,0,0,5,0,2,36,57,93
p_52,14,0,e_3,312,346,392,10,2,0,4,5,0,2,34,46,80
p_55,14,0,e_3,314,346,392,9,3,0,5,5,0,3,32,46,78
p_61,12,0,e_3,341,354,392,3,2,1,13,5,1,1,13,38,51
p_65,0,7,e_1,369,370,395,7,1,0,0,3,1,0,1,25,26
p_68,2,0,e_2,389,398,406,29,1,1,0,3,0,0,9,8,17
p_64,0,15,e_0,365,368,415,9,1,0,1,4,1,0,3,47,50
p_69,2,0,e_3,391,400,444,2,0,0,0,3,1,0,9,44,53
p_70,3,0,e_3,398,405,444,1,1,0,2,5,0,1,7,39,46
p_71,7,0,e_3,403,419,444,4,2,0,3,5,1,1,16,25,41
p_72,6,0,e_3,417,424,444,1,2,0,7,5,1,1,7,20,27
p_73,3,0,e_2,423,435,446,3,1,0,0,3,0,0,12,11,23
p_66,11,0,e_1,376,409,454,24,1,1,1,5,1,0,33,45,78
p_67,12,0,e_1,377,414,454,23,1,1,1,5,1,1,37,40,77
p_75,3,0,e_1,438,443,454,29,1,1,4,4,1,0,5,11,16
p_74,10,0,e_0,424,442,476,26,1,1,15,3,0,0,18,34,52
p_76,10,0,e_0,440,442,476,21,1,1,10,4,0,1,2,34,36
p_77,4,0,e_0,455,462,476,4,0,0,6,4,1,0,7,14,21
p_81,1,0,e_0,493,499,504,1,0,0,0,3,0,0,6,5,11
p_79,9,0,e_2,457,487,516,9,0,0,0,3,0,0,30,29,59
p_82,0,12,e_3,494,495,535,0,0,0,0,3,0,0,1,40,41
p_78,12,0,e_1,455,494,542,12,0,0,0,3,0,0,39,48,87
p_80,13,0,e_1,474,499,542,13,0,0,6,5,0,1,25,43,68
p_87,3,0,e_1,528,531,542,15,2,2,4,4,1,0,3,11,14
p_83,0,12,e_0,501,504,544,23,1,1,1,4,1,0,3,40,43
p_90,1,0,e_2,538,541,572,14,2,1,0,5,0,1,3,31,34
p_89,5,0,e_2,535,555,572,11,2,1,0,3,0,0,20,17,37
p_97,5,0,e_2,552,555,572,6,1,0,4,5,1,1,3,17,20
p_94,3,0,e_1,546,555,574,10,1,0,0,5,0,1,9,19,28
p_93,4,0,e_1,543,560,574,10,1,0,0,3,0,0,17,14,31
p_88,10,0,e_0,531,536,586,7,2,2,9,5,1,0,5,50,55
p_92,10,0,e_0,540,552,586,5,2,1,11,5,2,0,12,34,46
p_95,10,0,e_0,547,552,586,3,1,0,11,4,1,1,5,34,39
p_96,7,0,e_0,551,563,586,5,1,0,10,1,1,0,12,23,35
p_84,12,0,e_3,504,535,589,10,1,0,2,5,1,0,31,54,85
p_85,14,0,e_3,517,543,589,8,1,0,6,5,1,0,26,46,72
p_86,14,0,e_3,518,543,589,7,2,0,7,5,1,1,25,46,71
p_91,14,0,e_3,539,543,589,1,2,0,13,5,1,1,4,46,50
p_99,9,0,e_3,556,560,589,1,1,0,10,4,1,0,4,29,33
p_109,10,0,e_0,590,623,667,10,0,0,0,3,0,0,33,44,77
p_112,11,0,e_0,613,628,667,6,1,1,7,5,0,2,15,39,54
p_113,9,0,e_0,629,636,667,3,1,0,11,4,1,1,7,31,38
p_115,9,0,e_0,632,636,667,2,1,0,10,4,1,2,4,31,35
p_111,2,0,e_0,607,659,667,17,1,1,5,5,0,1,52,8,60
p_110,12,0,e_3,590,629,667,12,0,0,0,3,0,0,39,38,77
p_108,7,0,e_2,584,595,668,24,1,1,4,5,0,4,11,73,84
p_101,9,0,e_2,566,603,668,28,1,1,2,4,1,0,37,65,102
p_105,12,0,e_2,582,614,668,20,1,1,3,5,0,2,32,54,86
p_102,14,0,e_2,568,622,668,23,1,1,1,4,1,1,54,46,100
p_104,14,0,e_2,581,622,668,18,1,1,3,5,0,2,41,46,87
p_107,3,0,e_2,584,657,668,28,1,1,4,5,0,3,73,11,84
p_106,5,0,e_1,583,591,672,27,1,1,3,5,0,3,8,81,89
p_98,6,0,e_1,555,596,672,4,1,0,3,5,1,1,41,76,117
p_100,10,0,e_1,557,610,672,30,2,2,3,5,1,2,53,62,115
p_103,14,0,e_1,577,624,672,20,1,1,1,5,0,2,47,48,95
p_116,7,0,e_1,633,647,672,4,2,0,11,4,1,0,14,25,39
p_121,3,0,e_1,656,661,672,30,2,2,4,4,1,1,5,11,16
p_117,0,2,e_0,636,667,675,10,2,0,9,4,1,1,31,8,39
p_123,0,2,e_0,661,667,675,2,2,0,2,4,1,1,6,8,14
p_125,2,0,e_0,668,675,725,24,1,1,0,5,1,2,7,50,57
p_124,7,0,e_0,664,692,725,24,2,2,1,4,1,1,28,33,61
p_118,8,0,e_0,649,697,725,28,2,2,5,4,1,1,48,28,76
p_129,5,0,e_0,705,708,725,9,2,1,6,4,1,0,3,17,20
p_119,8,0,e_1,650,698,726,27,2,2,6,4,1,0,48,28,76
p_126,1,0,e_1,681,721,726,21,1,1,3,5,0,1,40,5,45
p_114,13,0,e_3,632,708,753,28,1,1,11,4,1,0,76,45,121
p_130,11,0,e_3,705,716,753,3,2,1,12,5,0,2,11,37,48
p_127,7,0,e_3,701,730,753,8,1,1,11,5,0,1,29,23,52
p_131,7,0,e_3,722,730,753,2,2,0,9,4,1,1,8,23,31
p_122,7,0,e_2,657,691,754,26,2,2,3,4,1,1,34,63,97
p_120,13,0,e_2,653,711,754,21,2,2,4,4,1,1,58,43,101
p_132,4,0,e_2,730,740,754,3,1,0,7,4,1,0,10,14,24
p_128,0,15,e_0,705,725,774,14,2,2,6,4,1,0,20,49,69
p_140,5,0,e_3,768,786,803,5,0,0,0,3,0,0,18,17,35
p_143,5,0,e_3,780,786,803,2,1,0,3,5,0,1,6,17,23
p_139,0,15,e_2,758,759,808,0,0,0,0,3,0,0,1,49,50
p_134,14,0,e_0,734,769,821,22,1,1,3,5,1,0,35,52,87
p_136,14,0,e_0,749,769,821,17,1,1,8,5,1,1,20,52,72
p_133,6,0,e_1,734,755,823,30,1,1,0,3,0,0,21,68,89
p_135,11,0,e_1,739,772,823,23,1,1,1,5,0,1,33,51,84
p_138,12,0,e_1,756,777,823,12,0,0,6,5,1,2,21,46,67
p_141,12,0,e_1,770,777,823,12,1,0,11,5,1,3,7,46,53
p_137,13,0,e_1,755,782,823,13,0,0,6,5,1,1,27,41,68
p_142,13,0,e_1,773,782,823,12,1,0,11,5,1,2,9,41,50
p_145,1,0,e_0,820,826,831,10,1,1,0,3,1,0,6,5,11
p_144,6,0,e_3,815,836,856,6,0,0,0,3,0,0,21,20,41
p_150,3,0,e_3,860,872,885,3,0,0,0,3,0,0,12,13,25
p_152,2,0,e_3,868,877,885,2,1,1,2,5,0,1,9,8,17
p_146,10,0,e_2,846,864,900,23,1,1,15,3,0,0,18,36,54
p_153,6,0,e_2,872,878,900,27,2,2,8,4,1,0,6,22,28
p_154,4,0,e_2,874,886,900,29,2,2,7,4,1,1,12,14,26
p_147,6,0,e_0,849,870,934,26,1,1,0,3,0,0,21,64,85
p_149,6,0,e_0,859,870,934,6,0,0,3,5,0,1,11,64,75
p_155,11,0,e_0,884,887,934,11,0,0,10,5,1,1,3,47,50
p_151,12,0,e_0,863,892,934,12,1,0,4,5,0,1,29,42,71
p_156,12,0,e_0,884,892,934,12,0,0,10,5,1,2,8,42,50
p_159,8,0,e_0,893,906,934,7,1,0,12,4,1,1,13,28,41
p_158,7,0,e_0,892,911,934,7,1,0,12,4,1,0,19,23,42
p_157,7,0,e_3,889,913,936,7,0,0,0,3,0,0,24,23,47
p_148,15,0,e_1,849,897,944,17,1,1,0,3,0,0,48,47,95
p_3,4,0,e_2,25,40,62,4,0,0,0,3,0,0,15,22,37
p_4,5,0,e_2,34,45,62,5,0,0,2,5,0,1,11,17,28
p_5,9,0,e_1,41,49,92,9,0,0,7,5,0,1,8,43,51
p_6,9,0,e_1,45,49,92,9,0,0,8,5,0,2,4,43,47
p_2,11,0,e_1,19,57,92,11,0,0,0,3,0,0,38,35,73
p_1,13,0,e_0,13,55,96,13,0,0,0,3,0,0,42,41,83
p_12,0,8,e_1,86,92,118,21,2,2,2,4,1,0,6,26,32
p_16,4,0,e_0,101,114,136,13,2,1,0,5,0,1,13,22,35
p_15,5,0,e_0,99,119,136,12,2,1,0,3,0,0,20,17,37
p_13,8,0,e_2,87,94,138,13,2,1,6,5,0,3,7,44,51
p_10,9,0,e_2,77,99,138,15,2,1,3,5,0,1,22,39,61
p_9,10,0,e_2,67,104,138,17,2,1,0,3,0,0,37,34,71
p_11,4,0,e_2,84,124,138,18,2,1,5,5,0,2,40,14,54
p_7,2,0,e_3,55,64,156,2,0,0,0,3,0,0,9,92,101
p_14,13,0,e_3,87,99,156,8,2,1,9,5,1,1,12,57,69
p_8,15,0,e_3,62,107,156,13,1,0,2,5,0,1,45,49,94
p_20,3,0,e_3,142,145,156,1,1,0,4,4,1,0,3,11,14
p_19,0,7,e_0,125,136,161,9,1,0,3,4,1,0,11,25,36
p_21,0,10,e_2,142,143,177,4,1,0,0,3,0,0,1,34,35
p_17,10,0,e_1,112,126,192,4,1,0,6,5,1,0,14,66,80
p_18,15,0,e_1,120,143,192,26,1,1,8,5,0,1,23,49,72
p_26,6,0,e_1,169,172,192,11,1,1,7,4,1,0,3,20,23
p_30,2,0,e_1,200,209,217,16,3,1,0,3,0,0,9,8,17
p_24,14,0,e_2,157,191,237,14,0,0,4,5,1,0,34,46,80
p_33,1,0,e_2,213,232,237,13,2,1,7,4,1,0,19,5,24
p_22,6,0,e_0,146,156,238,27,1,1,3,5,1,0,10,82,92
p_23,15,0,e_0,150,187,238,17,1,1,4,5,1,1,37,51,88
p_31,5,0,e_0,203,219,238,12,3,1,10,4,1,0,16,19,35
p_36,1,0,e_0,225,233,238,10,2,1,3,4,1,0,8,5,13
p_32,0,10,e_1,209,217,249,15,3,3,2,4,1,0,8,32,40
p_35,0,6,e_0,222,238,258,11,2,0,4,4,1,0,16,20,36
p_28,7,0,e_3,184,187,260,5,2,1,6,5,0,2,3,73,76
p_25,9,0,e_3,163,195,260,9,0,0,0,3,0,0,32,65,97
p_29,14,0,e_3,192,212,260,6,3,0,8,5,1,2,20,48,68
p_34,11,0,e_3,217,223,260,2,2,0,13,4,1,1,6,37,43
p_27,5,0,e_3,180,243,260,8,1,1,5,5,0,1,63,17,80
p_41,7,0,e_0,257,263,288,24,1,1,6,2,1,0,6,25,31
p_42,4,0,e_0,269,274,288,4,0,0,5,4,1,0,5,14,19
p_43,4,0,e_0,270,274,288,4,0,0,5,4,1,1,4,14,18
p_44,4,0,e_3,275,290,304,4,0,0,0,3,0,0,15,14,29
p_39,13,0,e_1,247,260,317,21,1,1,10,5,1,1,13,57,70
p_37,15,0,e_1,228,268,317,25,2,2,3,5,1,0,40,49,89
p_40,15,0,e_1,255,268,317,16,1,1,12,5,0,2,13,49,62
p_47,3,0,e_1,293,306,317,30,1,1,7,4,1,0,13,11,24
p_38,12,0,e_2,240,279,319,24,2,2,0,3,0,0,39,40,79
p_49,3,0,e_2,298,308,319,29,1,1,6,4,1,0,10,11,21
p_51,0,4,e_3,309,310,326,0,0,0,0,3,0,0,1,16,17
p_57,1,0,e_1,327,333,338,11,2,2,0,3,0,0,6,5,11
p_58,0,6,e_2,330,331,353,11,2,2,0,3,0,0,1,22,23
p_60,2,0,e_1,338,347,357,7,3,1,0,3,0,0,9,10,19
p_62,1,0,e_1,345,352,357,6,2,1,2,5,0,1,7,5,12
p_54,7,0,e_3,313,337,370,7,1,0,0,5,1,0,24,33,57
p_53,8,0,e_3,313,342,370,8,2,0,0,5,1,1,29,28,57
p_56,8,0,e_3,324,342,370,4,3,0,4,5,1,2,18,28,46
p_59,3,0,e_3,335,359,370,6,2,1,7,5,0,2,24,11,35
p_46,8,0,e_0,291,317,387,26,1,1,0,5,0,1,26,70,96
p_48,9,0,e_0,294,322,387,24,1,1,1,5,0,2,28,65,93
p_45,11,0,e_0,290,330,387,23,1,1,0,3,0,0,40,57,97
p_50,11,0,e_0,299,330,387,20,1,1,2,5,0,3,31,57,88
p_52,14,0,e_0,312,341,387,14,1,0,7,5,0,3,29,46,75
p_55,14,0,e_0,314,341,387,14,3,0,7,5,0,4,27,46,73
p_61,12,0,e_0,341,349,387,14,2,0,14,4,1,0,8,38,46
p_63,3,0,e_1,364,376,387,29,1,1,0,3,0,0,12,11,23
p_65,0,7,e_3,369,370,395,0,0,0,0,3,1,0,1,25,26
p_68,2,0,e_0,389,398,406,23,2,2,0,3,0,0,9,8,17
p_69,2,0,e_1,391,400,416,22,2,2,0,3,0,0,9,16,25
p_70,3,0,e_1,398,405,416,19,1,1,2,5,0,1,7,11,18
p_64,0,15,e_3,365,370,421,1,1,0,1,4,1,0,5,51,56
p_66,11,0,e_2,376,394,441,18,2,1,6,3,0,0,18,47,65
p_67,12,0,e_2,377,399,441,17,2,1,6,5,0,1,22,42,64
p_71,7,0,e_2,403,416,441,14,1,1,11,4,1,0,13,25,38
p_72,6,0,e_2,417,421,441,10,1,1,7,4,1,0,4,20,24
p_73,3,0,e_0,423,435,446,12,0,0,0,3,0,0,12,11,23
p_75,3,0,e_1,438,450,461,8,1,1,0,3,0,0,12,11,23
p_74,10,0,e_3,424,442,476,5,0,0,15,3,0,0,18,34,52
p_77,4,0,e_3,455,462,476,2,1,0,6,4,1,0,7,14,21
p_81,1,0,e_1,493,499,504,1,0,0,0,3,0,0,6,5,11
p_79,9,0,e_0,457,487,516,26,2,2,0,3,0,0,30,29,59
p_76,10,0,e_2,440,473,527,20,1,1,0,3,1,0,33,54,87
p_78,12,0,e_2,455,481,527,24,2,2,4,5,0,1,26,46,72
p_80,13,0,e_2,474,486,527,17,1,1,10,5,1,1,12,41,53
p_82,0,12,e_3,494,495,535,0,0,0,0,3,0,0,1,40,41
p_83,0,12,e_1,501,504,544,23,1,1,1,4,1,0,3,40,43
p_90,1,0,e_2,538,544,549,14,2,1,0,3,0,0,6,5,11
p_87,3,0,e_0,528,540,569,15,2,2,0,3,0,0,12,29,41
p_93,4,0,e_0,543,545,569,10,1,0,4,5,1,1,2,24,26
p_89,5,0,e_0,535,550,569,11,2,1,2,5,0,1,15,19,34
p_94,3,0,e_0,546,558,569,10,1,0,4,5,1,1,12,11,23
p_88,10,0,e_1,531,536,586,7,2,2,9,5,1,0,5,50,55
p_92,10,0,e_1,540,552,586,5,2,1,11,5,2,0,12,34,46
p_95,10,0,e_1,547,552,586,3,1,0,11,4,1,1,5,34,39
p_96,7,0,e_1,551,563,586,5,1,0,10,1,1,0,12,23,35
p_84,12,0,e_3,504,535,591,10,1,0,2,5,1,0,31,56,87
p_85,14,0,e_3,517,543,591,8,1,0,6,5,1,0,26,48,74
p_86,14,0,e_3,518,543,591,7,2,0,7,5,1,1,25,48,73
p_91,14,0,e_3,539,543,591,1,2,0,13,5,1,1,4,48,52
p_99,9,0,e_3,556,560,591,1,2,0,10,4,1,1,4,31,35
p_98,6,0,e_3,555,571,591,4,1,0,10,4,1,0,16,20,36
p_111,2,0,e_3,607,616,624,2,0,0,0,3,0,0,9,8,17
p_107,3,0,e_0,584,595,634,29,1,1,0,5,0,1,11,39,50
p_106,5,0,e_0,583,603,634,27,1,1,0,3,0,0,20,31,51
p_108,7,0,e_0,584,611,634,25,1,1,0,5,0,2,27,23,50
p_97,5,0,e_2,552,570,651,6,1,0,0,3,0,0,18,81,99
p_101,9,0,e_2,566,584,651,28,2,2,4,5,0,2,18,67,85
p_100,10,0,e_2,557,589,651,30,3,3,1,5,0,1,32,62,94
p_105,12,0,e_2,582,597,651,21,1,1,9,5,1,3,15,54,69
p_110,12,0,e_2,590,597,651,12,0,0,10,5,1,2,7,54,61
p_102,14,0,e_2,568,605,651,23,2,2,5,5,0,3,37,46,83
p_103,14,0,e_2,577,605,651,20,1,1,7,5,1,3,28,46,74
p_104,14,0,e_2,581,605,651,19,1,1,8,5,1,3,24,46,70
p_112,11,0,e_2,613,616,651,10,1,0,12,4,1,0,3,35,38
p_109,10,0,e_1,590,623,655,10,0,0,0,3,0,0,33,32,65
p_117,0,2,e_2,636,651,659,24,2,2,5,4,1,0,15,8,23
p_123,0,2,e_2,661,670,678,17,2,2,2,3,0,0,9,8,17
p_121,3,0,e_1,656,668,681,15,2,2,0,3,0,0,12,13,25
p_125,2,0,e_1,668,673,681,12,2,1,3,4,1,0,5,8,13
p_116,7,0,e_0,633,657,692,18,2,2,0,3,1,0,24,35,59
p_122,7,0,e_0,657,659,692,10,2,1,7,5,1,1,2,33,35
p_118,8,0,e_0,649,664,692,12,2,2,5,5,0,1,15,28,43
p_119,8,0,e_0,650,664,692,12,2,2,5,5,0,2,14,28,42
p_124,7,0,e_0,664,669,692,9,2,1,8,4,1,0,5,23,28
p_126,1,0,e_1,681,687,692,10,1,0,0,3,0,0,6,5,11
p_113,9,0,e_3,629,659,714,9,0,0,0,3,0,0,30,55,85
p_115,9,0,e_3,632,659,714,9,1,0,0,5,0,1,27,55,82
p_114,13,0,e_3,632,673,714,13,1,0,0,5,0,1,41,41,82
p_120,13,0,e_3,653,673,714,6,2,0,7,5,0,2,20,41,61
p_129,5,0,e_1,705,723,740,28,1,1,0,3,0,0,18,17,35
p_128,0,15,e_0,705,706,757,3,1,0,0,3,0,0,1,51,52
p_127,7,0,e_2,701,719,770,27,1,1,2,3,0,0,18,51,69
p_130,11,0,e_2,705,733,770,22,1,1,3,5,0,1,28,37,65
p_133,6,0,e_2,734,750,770,5,2,1,11,4,1,0,16,20,36
p_132,4,0,e_3,730,737,799,8,1,1,2,5,0,1,7,62,69
p_131,7,0,e_3,722,748,799,7,0,0,0,3,0,0,26,51,77
p_135,11,0,e_3,739,762,799,7,2,0,4,5,1,1,23,37,60
p_140,5,0,e_3,768,782,799,4,1,0,9,4,1,0,14,17,31
p_139,0,15,e_1,758,759,808,12,2,2,0,3,0,0,1,49,50
p_134,14,0,e_0,734,752,810,11,2,0,8,5,1,0,18,58,76
p_136,14,0,e_0,749,752,810,7,2,0,13,5,1,1,3,58,61
p_137,13,0,e_0,755,765,810,4,2,0,15,5,2,0,10,45,55
p_138,12,0,e_0,756,770,810,3,2,0,15,2,2,1,14,40,54
p_143,5,0,e_0,780,793,810,30,2,2,9,4,1,0,13,17,30
p_145,1,0,e_3,820,826,831,1,0,0,0,3,0,0,6,5,11
p_141,12,0,e_2,770,809,855,27,2,2,0,3,0,0,39,46,85
p_142,13,0,e_2,773,814,855,25,2,2,0,5,0,1,41,41,82
p_144,6,0,e_0,815,836,856,6,0,0,0,3,0,0,21,20,41
p_150,3,0,e_2,860,872,885,24,2,2,0,3,0,0,12,13,25
p_152,2,0,e_2,868,877,885,22,2,1,2,5,0,1,9,8,17
p_146,10,0,e_1,846,864,900,10,0,0,15,3,0,0,18,36,54
p_153,6,0,e_1,872,878,900,18,2,1,8,4,1,0,6,22,28
p_154,4,0,e_1,874,886,900,19,2,1,7,4,1,1,12,14,26
p_149,6,0,e_0,859,880,940,21,2,1,0,3,0,0,21,60,81
p_155,11,0,e_0,884,897,940,9,2,1,7,5,1,1,13,43,56
p_151,12,0,e_0,863,902,940,14,2,1,1,5,0,1,39,38,77
p_156,12,0,e_0,884,902,940,8,2,1,7,5,1,2,18,38,56
p_157,7,0,e_2,889,913,944,11,2,1,0,3,0,0,24,31,55
p_158,7,0,e_2,892,913,944,10,2,1,0,5,0,1,21,31,52
p_159,8,0,e_2,893,918,944,9,2,1,1,5,0,1,25,26,51
p_147,6,0,e_3,849,870,946,6,0,0,0,3,0,0,21,76,97
p_148,15,0,e_3,849,899,946,15,1,1,0,3,0,1,50,47,97
