p_300,0,4,e_0,8,9,25,0,0,0,0,3,0,0,1,16,17
p_299,0,5,e_1,9,10,29,0,0,0,0,3,0,0,1,19,20
p_297,0,6,e_3,15,16,38,0,0,0,0,3,0,0,1,22,23
p_298,0,9,e_2,11,12,43,0,0,0,0,3,0,0,1,31,32
p_296,0,4,e_0,28,43,57,9,1,1,4,3,0,0,15,14,29
p_286,0,3,e_1,46,47,60,4,1,0,0,3,0,0,1,13,14
p_290,0,6,e_0,40,43,65,6,1,0,1,4,0,1,3,22,25
p_289,0,4,e_1,43,47,65,5,1,0,1,4,0,1,4,18,22
p_295,0,5,e_1,29,47,70,9,1,1,5,3,0,0,18,23,41
p_287,0,5,e_1,45,47,70,4,1,0,0,4,0,1,2,23,25
p_285,0,4,e_3,53,59,73,2,1,0,2,4,0,1,6,14,20
p_284,0,4,e_3,54,59,73,1,1,0,1,4,0,1,5,14,19
p_288,0,8,e_1,44,47,81,5,1,0,1,4,0,1,3,34,37
p_292,0,6,e_3,38,59,81,6,0,0,6,3,0,0,21,22,43
p_291,0,11,e_0,39,43,82,6,1,0,1,4,0,1,4,39,43
p_294,0,12,e_0,31,43,87,8,1,1,4,4,0,1,12,44,56
p_293,0,12,e_0,33,43,87,7,1,1,3,4,0,1,10,44,54
p_283,0,9,e_3,57,59,92,0,1,0,0,4,0,1,2,33,35
p_281,0,1,e_2,73,96,101,14,2,2,7,4,0,1,23,5,28
p_278,0,2,e_2,77,96,106,13,2,2,6,4,0,1,19,10,29
p_279,0,5,e_2,76,96,117,13,2,2,6,4,0,1,20,21,41
p_282,0,7,e_2,66,96,125,16,3,3,9,3,0,0,30,29,59
p_277,0,6,e_1,82,109,129,12,1,1,8,3,0,0,27,20,47
p_274,0,8,e_2,88,96,130,10,1,1,2,4,0,1,8,34,42
p_276,0,11,e_2,84,96,141,11,1,1,4,4,0,1,12,45,57
p_271,0,1,e_3,121,140,145,6,1,0,6,4,0,1,19,5,24
p_280,0,14,e_2,75,96,152,14,2,2,7,4,0,1,21,56,77
p_275,0,14,e_2,86,96,152,11,1,1,3,4,0,1,10,56,66
p_273,0,4,e_3,110,140,156,9,0,0,9,3,0,0,30,16,46
p_267,0,1,e_0,148,152,159,16,2,2,1,4,0,1,4,7,11
p_270,0,9,e_3,122,140,173,6,1,0,6,4,0,1,18,33,51
p_269,0,9,e_3,127,140,173,4,1,0,4,4,0,1,13,33,46
p_268,0,2,e_1,144,165,175,17,2,2,6,3,0,0,21,10,31
p_266,0,6,e_0,151,152,176,15,2,2,0,3,0,0,1,24,25
p_265,0,4,e_1,152,165,183,15,2,2,4,4,0,1,13,18,31
p_262,0,5,e_1,157,165,188,14,1,1,2,4,0,1,8,23,31
p_261,0,5,e_1,164,165,188,12,1,1,0,3,0,0,1,23,24
p_272,0,10,e_0,113,152,190,9,1,0,12,3,0,0,39,38,77
p_263,0,7,e_1,154,165,196,14,2,2,3,4,0,1,11,31,42
p_264,0,11,e_1,153,165,210,15,2,2,4,4,0,1,12,45,57
p_255,0,3,e_2,184,210,223,9,1,0,8,4,0,1,26,13,39
p_254,0,4,e_2,187,210,228,8,1,0,7,4,0,1,23,18,41
p_250,0,2,e_0,217,223,231,19,1,1,2,4,0,1,6,8,14
p_252,0,5,e_2,205,210,233,2,1,0,1,4,0,1,5,23,28
p_260,0,7,e_2,165,210,241,11,1,1,14,3,0,0,45,31,76
p_258,0,7,e_2,168,210,241,10,1,1,14,4,0,1,42,31,73
p_253,0,5,e_0,190,223,242,7,1,0,10,3,0,0,33,19,52
p_256,0,10,e_3,182,212,244,9,0,0,9,3,0,0,30,32,62
p_257,0,14,e_2,169,210,264,10,1,1,13,4,0,1,41,54,95
p_259,0,15,e_2,167,210,269,11,1,1,14,4,0,1,43,59,102
p_251,0,15,e_2,209,210,269,1,1,0,0,3,0,0,1,59,60
p_248,0,5,e_0,246,264,281,10,0,0,5,3,0,0,18,17,35
p_249,0,6,e_1,239,275,295,11,1,1,11,3,0,0,36,20,56
p_246,0,10,e_0,262,264,298,7,1,0,0,4,0,1,2,34,36
p_245,0,7,e_1,269,275,300,4,1,0,2,4,0,1,6,25,31
p_247,0,5,e_3,250,283,300,10,0,0,10,3,0,0,33,17,50
p_242,0,8,e_3,277,283,311,2,1,0,2,4,0,1,6,28,34
p_244,0,12,e_1,271,275,317,4,1,0,1,4,0,1,4,42,46
p_243,0,15,e_1,272,275,328,3,1,0,1,4,0,1,3,53,56
p_241,0,1,e_2,283,331,338,16,2,2,15,3,0,0,48,7,55
p_236,0,1,e_2,305,331,338,10,1,1,8,4,0,1,26,7,33
p_233,0,1,e_2,311,331,338,8,1,0,6,4,0,1,20,7,27
p_226,0,2,e_2,329,331,343,2,1,0,0,4,0,1,2,12,14
p_223,0,2,e_3,336,337,347,0,0,0,0,3,0,0,1,10,11
p_230,0,3,e_2,319,331,348,6,1,0,4,4,0,1,12,17,29
p_224,0,5,e_0,331,334,351,2,1,0,1,4,0,1,3,17,20
p_228,0,4,e_2,325,331,353,4,1,0,2,4,0,1,6,22,28
p_232,0,5,e_2,314,331,358,7,1,0,5,4,0,1,17,27,44
p_225,0,5,e_2,330,331,358,2,1,0,0,3,0,0,1,27,28
p_240,0,9,e_0,301,334,365,11,1,1,10,3,0,0,33,31,64
p_237,0,7,e_2,304,331,366,10,1,1,9,4,0,1,27,35,62
p_231,0,7,e_2,317,331,366,6,1,0,4,4,0,1,14,35,49
p_234,0,8,e_3,310,337,367,8,0,0,8,2,1,0,27,30,57
p_235,0,8,e_2,308,331,371,9,1,1,7,4,0,1,23,40,63
p_239,0,11,e_2,302,331,382,11,1,1,9,4,0,1,29,51,80
p_227,0,12,e_2,327,331,387,3,1,0,1,4,0,1,4,56,60
p_216,0,1,e_1,347,385,392,14,1,1,12,4,0,1,38,7,45
p_238,0,13,e_2,303,331,392,10,1,1,9,4,0,1,28,61,89
p_229,0,13,e_2,320,331,392,5,1,0,3,4,0,1,11,61,72
p_209,0,2,e_1,357,385,397,11,1,1,9,4,0,1,28,12,40
p_214,0,3,e_1,349,385,402,14,1,1,12,4,0,1,36,17,53
p_186,0,4,e_0,390,394,408,1,1,0,1,4,0,1,4,14,18
p_222,0,5,e_1,337,385,410,16,3,3,15,3,0,0,48,25,73
p_219,0,5,e_1,342,385,410,15,2,2,14,4,0,1,43,25,68
p_201,0,5,e_3,366,393,412,8,0,0,8,2,1,0,27,19,46
p_221,0,6,e_1,339,385,415,16,2,2,15,4,0,1,46,30,76
p_220,0,6,e_1,341,385,415,16,2,2,14,4,0,1,44,30,74
p_210,0,6,e_1,354,385,415,12,1,1,10,4,0,1,31,30,61
p_208,0,6,e_1,358,385,415,11,1,1,9,4,0,1,27,30,57
p_217,0,7,e_1,346,385,420,14,1,1,13,4,0,1,39,35,74
p_212,0,7,e_1,351,385,420,13,1,1,11,4,0,1,34,35,69
p_185,0,10,e_3,391,393,429,0,1,0,0,4,0,1,2,36,38
p_203,0,12,e_0,364,394,434,9,1,1,9,2,1,0,30,40,70
p_187,0,12,e_0,389,394,434,1,1,0,1,4,0,1,5,40,45
p_218,0,11,e_1,343,385,434,15,2,2,14,4,0,1,42,49,91
p_184,0,12,e_3,392,393,437,0,0,0,0,3,0,0,1,44,45
p_183,0,1,e_2,396,438,445,24,3,3,13,3,0,0,42,7,49
p_215,0,15,e_1,348,385,448,14,1,1,12,4,0,1,37,63,100
p_213,0,15,e_1,350,385,448,13,1,1,11,4,0,1,35,63,98
p_211,0,15,e_1,353,385,448,12,1,1,10,4,0,1,32,63,95
p_182,0,2,e_2,397,438,450,24,3,3,13,4,0,1,41,12,53
p_180,0,2,e_2,399,438,450,23,3,3,13,4,0,1,39,12,51
p_178,0,3,e_2,401,438,455,22,3,3,12,4,0,1,37,17,54
p_176,0,4,e_2,403,438,460,22,3,3,11,4,0,1,35,22,57
p_179,0,8,e_2,400,438,474,23,3,3,12,4,0,1,38,36,74
p_146,0,1,e_0,453,472,479,9,1,0,6,4,0,1,19,7,26
p_177,0,9,e_2,402,438,479,22,3,3,12,4,0,1,36,41,77
p_169,0,9,e_2,411,438,479,19,2,2,9,4,0,1,27,41,68
p_143,0,3,e_0,456,472,487,8,1,0,5,4,0,1,16,15,31
p_130,0,1,e_3,472,480,487,2,1,0,2,4,0,1,8,7,15
p_171,0,13,e_2,409,438,493,20,3,3,9,4,0,1,29,55,84
p_168,0,13,e_2,412,438,493,19,2,2,8,4,0,1,26,55,81
p_129,0,3,e_3,473,480,495,2,1,0,2,4,0,1,7,15,22
p_150,0,6,e_0,443,472,498,12,1,0,9,4,0,1,29,26,55
p_141,0,6,e_0,458,472,498,7,1,0,4,4,0,1,14,26,40
p_175,0,14,e_2,405,438,498,21,3,3,11,4,0,1,33,60,93
p_174,0,14,e_2,406,438,498,21,3,3,10,4,0,1,32,60,92
p_170,0,14,e_2,410,438,498,19,3,3,9,4,0,1,28,60,88
p_205,0,2,e_1,362,495,503,9,1,1,7,4,0,1,133,8,141
p_181,0,15,e_2,398,438,503,23,3,3,13,4,0,1,40,65,105
p_172,0,15,e_2,408,438,503,20,3,3,10,4,0,1,30,65,95
p_148,0,8,e_0,449,472,506,10,1,0,7,4,0,1,23,34,57
p_140,0,8,e_0,459,472,506,7,1,0,4,4,0,1,13,34,47
p_124,0,7,e_3,478,480,509,0,1,0,0,4,0,1,2,29,31
p_147,0,9,e_0,452,472,511,9,1,0,6,4,0,1,20,39,59
p_144,0,9,e_0,455,472,511,8,1,0,5,4,0,1,17,39,56
p_142,0,9,e_0,457,472,511,7,1,0,5,4,0,1,15,39,54
p_200,0,4,e_1,367,495,511,8,1,0,6,4,0,1,128,16,144
p_196,0,4,e_1,371,495,511,7,1,0,4,4,0,1,124,16,140
p_139,0,10,e_0,461,472,516,6,1,0,3,4,0,1,11,44,55
p_194,0,6,e_1,373,495,519,6,1,0,4,4,0,1,122,24,146
p_127,0,10,e_3,475,480,520,1,1,0,1,4,0,1,5,40,45
p_173,0,11,e_0,407,472,521,20,3,3,4,3,2,0,65,49,114
p_145,0,11,e_0,454,472,521,8,1,0,6,4,0,1,18,49,67
p_138,0,11,e_0,463,472,521,5,1,0,3,4,0,1,9,49,58
p_128,0,11,e_3,474,480,525,2,1,0,2,4,0,1,6,45,51
p_123,0,11,e_3,479,480,525,0,0,0,0,3,0,0,1,45,46
p_192,0,8,e_1,375,495,527,6,1,0,3,4,0,1,120,32,152
p_126,0,12,e_3,476,480,530,1,1,0,1,4,0,1,4,50,54
p_198,0,9,e_1,369,495,532,8,1,0,5,4,0,1,126,37,163
p_151,0,15,e_0,442,472,535,12,1,0,10,4,0,1,30,63,93
p_149,0,15,e_0,444,472,535,12,1,0,9,4,0,1,28,63,91
p_197,0,10,e_1,370,495,537,7,1,0,5,4,0,1,125,42,167
p_191,0,10,e_1,376,495,537,5,1,0,3,4,0,1,119,42,161
p_125,0,14,e_3,477,480,538,1,1,0,1,4,0,1,3,58,61
p_207,0,11,e_1,359,495,542,10,1,1,8,4,0,1,136,47,183
p_193,0,11,e_1,374,495,542,6,1,0,3,4,0,1,121,47,168
p_152,0,15,e_3,441,480,543,12,0,0,12,3,0,0,39,63,102
p_206,0,12,e_1,361,495,547,10,1,1,8,4,0,1,134,52,186
p_204,0,14,e_1,363,495,555,9,1,1,7,4,0,1,132,60,192
p_167,0,1,e_2,413,550,557,19,2,2,8,4,0,1,137,7,144
p_161,0,1,e_2,421,550,557,16,2,2,5,4,0,1,129,7,136
p_158,0,1,e_2,430,550,557,14,1,1,2,4,0,1,120,7,127
p_202,0,15,e_1,365,495,560,8,1,1,6,4,0,1,130,65,195
p_199,0,15,e_1,368,495,560,8,1,0,5,4,0,1,127,65,192
p_195,0,15,e_1,372,495,560,7,1,0,4,4,0,1,123,65,188
p_165,0,4,e_2,417,550,568,18,2,2,7,4,0,1,133,18,151
p_159,0,6,e_2,429,550,576,14,1,1,3,4,0,1,121,26,147
p_154,0,7,e_2,436,550,581,12,0,0,0,4,0,1,114,31,145
p_153,0,9,e_2,437,550,589,12,0,0,0,3,0,0,113,39,152
p_163,0,10,e_2,419,550,594,17,2,2,6,4,0,1,131,44,175
p_136,0,3,e_0,465,582,595,5,1,0,2,4,0,1,117,13,130
p_77,0,3,e_0,557,582,595,13,1,0,8,4,0,1,25,13,38
p_164,0,11,e_2,418,550,599,17,2,2,6,4,0,1,132,49,181
p_162,0,11,e_2,420,550,599,17,2,2,6,4,0,1,130,49,179
p_137,0,4,e_0,464,582,600,5,1,0,2,4,0,1,118,18,136
p_166,0,12,e_2,416,550,604,18,2,2,7,4,0,1,134,54,188
p_75,0,5,e_0,559,582,605,13,1,0,7,4,0,1,23,23,46
p_45,0,2,e_3,595,598,608,1,1,0,1,4,0,1,3,10,13
p_76,0,6,e_0,558,582,610,13,1,0,8,4,0,1,24,28,52
p_190,0,1,e_1,379,607,612,4,1,0,2,4,0,1,228,5,233
p_119,0,1,e_1,483,607,612,30,8,8,4,4,0,1,124,5,129
p_113,0,1,e_1,489,607,612,29,7,7,2,4,0,1,118,5,123
p_157,0,14,e_2,431,550,612,14,1,1,2,4,0,1,119,62,181
p_155,0,14,e_2,435,550,612,12,1,1,1,4,0,1,115,62,177
p_55,0,3,e_3,585,598,613,4,1,0,4,4,0,1,13,15,28
p_54,0,3,e_3,586,598,613,4,1,0,4,4,0,1,12,15,27
p_52,0,3,e_3,588,598,613,3,1,0,3,4,0,1,10,15,25
p_80,0,7,e_0,552,582,615,15,1,0,10,4,0,1,30,33,63
p_74,0,7,e_0,560,582,615,12,1,0,7,4,0,1,22,33,55
p_160,0,15,e_2,426,550,617,15,2,2,4,4,0,1,124,67,191
p_156,0,15,e_2,434,550,617,13,1,1,1,4,0,1,116,67,183
p_48,0,4,e_3,592,598,618,2,1,0,2,4,0,1,6,20,26
p_46,0,4,e_3,594,598,618,1,1,0,1,4,0,1,4,20,24
p_114,0,3,e_1,488,607,620,29,7,7,2,4,0,1,119,13,132
p_135,0,10,e_0,466,582,626,4,1,0,2,4,0,1,116,44,160
p_56,0,6,e_3,584,598,626,4,1,0,4,4,0,1,14,28,42
p_132,0,11,e_0,470,582,631,3,1,0,0,4,0,1,112,49,161
p_50,0,7,e_3,590,598,631,2,1,0,2,4,0,1,8,33,41
p_118,0,7,e_1,484,607,634,30,8,8,3,4,0,1,123,27,150
p_133,0,12,e_0,469,582,636,3,1,0,1,4,0,1,113,54,167
p_78,0,12,e_0,556,582,636,14,1,0,8,4,0,1,26,54,80
p_189,0,8,e_1,382,607,639,3,1,0,1,4,0,1,225,32,257
p_111,0,8,e_1,491,607,639,28,7,7,1,4,0,1,116,32,148
p_53,0,9,e_3,587,598,639,3,1,0,3,4,0,1,11,41,52
p_51,0,9,e_3,589,598,639,3,1,0,3,4,0,1,9,41,50
p_47,0,9,e_3,593,598,639,1,1,0,1,4,0,1,5,41,46
p_131,0,14,e_0,471,582,644,3,1,0,0,3,0,0,111,62,173
p_81,0,14,e_0,551,582,644,15,1,0,10,4,0,1,31,62,93
p_79,0,14,e_0,553,582,644,15,1,0,9,4,0,1,29,62,91
p_115,0,9,e_1,487,607,644,29,7,7,2,4,0,1,120,37,157
p_58,0,11,e_3,582,598,647,5,1,0,5,4,0,1,16,49,65
p_57,0,11,e_3,583,598,647,5,1,0,5,4,0,1,15,49,64
p_134,0,15,e_0,467,582,649,4,1,0,1,4,0,1,115,67,182
p_117,0,10,e_1,485,607,649,29,8,8,3,4,0,1,122,42,164
p_116,0,10,e_1,486,607,649,29,7,7,3,4,0,1,121,42,163
p_121,0,11,e_1,481,607,654,30,8,8,4,4,0,1,126,47,173
p_120,0,11,e_1,482,607,654,30,8,8,4,4,0,1,125,47,172
p_112,0,11,e_1,490,607,654,28,7,7,1,4,0,1,117,47,164
p_82,0,14,e_3,550,598,658,15,0,0,15,3,0,0,48,60,108
p_49,0,14,e_3,591,598,658,2,1,0,2,4,0,1,7,60,67
p_188,0,13,e_1,384,607,662,3,1,0,0,3,0,0,223,55,278
p_96,0,1,e_2,517,664,669,21,5,5,11,4,0,1,147,5,152
p_122,0,15,e_1,480,607,670,30,9,9,5,4,0,1,127,63,190
p_106,0,3,e_2,500,664,677,26,6,6,14,5,1,1,164,13,177
p_108,0,6,e_2,496,664,688,27,6,6,14,5,2,1,168,24,192
p_99,0,6,e_2,514,664,688,22,5,5,12,4,0,1,150,24,174
p_94,0,6,e_2,519,664,688,20,4,4,10,4,0,1,145,24,169
p_102,0,7,e_2,509,664,693,23,5,5,13,4,0,1,155,29,184
p_98,0,7,e_2,515,664,693,21,5,5,11,4,0,1,149,29,178
p_97,0,7,e_2,516,664,693,21,5,5,11,4,0,1,148,29,177
p_101,0,8,e_2,511,664,698,23,5,5,13,4,0,1,153,34,187
p_65,0,1,e_0,573,696,703,8,1,0,3,4,0,1,123,7,130
p_100,0,9,e_2,513,664,703,22,5,5,12,4,0,1,151,39,190
p_72,0,3,e_0,562,696,711,12,1,0,6,4,0,1,134,15,149
p_71,0,3,e_0,564,696,711,11,1,0,6,4,0,1,132,15,147
p_70,0,3,e_0,565,696,711,11,1,0,5,4,0,1,131,15,146
p_67,0,3,e_0,568,696,711,10,1,0,4,4,0,1,128,15,143
p_66,0,3,e_0,569,696,711,9,1,0,4,4,0,1,127,15,142
p_107,0,11,e_2,499,664,711,26,6,6,14,5,1,1,165,47,212
p_103,0,11,e_2,508,664,711,23,5,5,14,4,0,1,156,47,203
p_64,0,4,e_0,574,696,716,8,1,0,2,4,0,1,122,20,142
p_105,0,12,e_2,502,664,716,25,6,6,15,2,1,1,162,52,214
p_61,0,6,e_0,579,696,724,6,1,0,1,4,0,1,117,28,145
p_104,0,14,e_2,503,664,724,25,6,6,15,4,0,1,161,60,221
p_95,0,14,e_2,518,664,724,20,5,5,10,4,0,1,146,60,206
p_43,0,7,e_3,597,702,725,0,0,0,0,3,0,0,105,23,128
p_44,0,8,e_3,596,702,730,0,1,0,0,4,0,1,106,28,134
p_42,0,6,e_1,598,717,737,28,9,9,3,4,0,1,119,20,139
p_60,0,10,e_0,580,696,738,6,1,0,0,4,0,1,116,42,158
p_73,0,11,e_0,561,696,743,12,1,0,7,4,0,1,135,47,182
p_68,0,13,e_0,567,696,751,10,1,0,5,4,0,1,129,55,184
p_63,0,13,e_0,577,696,751,7,1,0,1,4,0,1,119,55,174
p_62,0,13,e_0,578,696,751,6,1,0,1,4,0,1,118,55,173
p_110,0,11,e_1,492,717,754,28,7,7,1,4,0,1,225,37,262
p_41,0,11,e_1,600,717,754,28,8,8,2,4,0,1,117,37,154
p_69,0,14,e_0,566,696,756,10,1,0,5,4,0,1,130,60,190
p_59,0,14,e_0,581,696,756,5,1,0,0,3,0,0,115,60,175
p_23,0,12,e_1,711,717,759,13,2,2,2,4,0,1,6,42,48
p_40,0,13,e_1,602,717,764,28,8,8,1,4,0,1,115,47,162
p_22,0,3,e_3,719,756,767,11,2,2,5,5,2,0,37,11,48
p_109,0,15,e_1,493,717,772,27,7,7,0,4,0,1,224,55,279
p_21,0,4,e_3,731,756,772,8,1,0,8,4,0,1,25,16,41
p_86,0,2,e_2,544,768,776,15,0,0,2,4,0,1,224,8,232
p_92,0,4,e_2,525,768,784,19,3,3,8,4,0,1,243,16,259
p_88,0,5,e_2,538,768,789,16,1,1,4,4,0,1,230,21,251
p_19,0,11,e_3,754,756,795,0,1,0,0,4,0,1,2,39,41
p_87,0,8,e_2,539,768,800,16,1,1,3,4,0,1,229,32,261
p_83,0,8,e_2,549,768,800,15,0,0,0,3,0,0,219,32,251
p_89,0,9,e_2,535,768,805,17,2,2,5,4,0,1,233,37,270
p_37,0,9,e_2,615,768,805,25,7,7,15,5,1,1,153,37,190
p_20,0,14,e_3,734,756,806,7,1,0,7,4,0,1,22,50,72
p_24,0,2,e_0,695,800,808,2,1,0,0,3,0,0,105,8,113
p_16,0,2,e_0,780,800,808,22,2,2,6,4,0,1,20,8,28
p_30,0,3,e_0,668,800,813,11,1,0,9,4,0,1,132,13,145
p_91,0,12,e_2,526,768,816,19,3,3,8,4,0,1,242,48,290
p_84,0,12,e_2,546,768,816,15,0,0,1,4,0,1,222,48,270
p_39,0,12,e_2,607,768,816,26,8,8,13,5,2,1,161,48,209
p_14,0,4,e_0,794,800,818,17,1,1,2,4,0,1,6,18,24
p_93,0,13,e_2,520,768,821,20,4,4,10,4,0,1,248,53,301
p_90,0,13,e_2,527,768,821,19,3,3,7,4,0,1,241,53,294
p_38,0,13,e_2,608,768,821,26,8,8,13,5,2,1,160,53,213
p_36,0,13,e_2,628,768,821,22,5,5,12,4,0,1,140,53,193
p_29,0,5,e_0,670,800,823,10,1,0,8,4,0,1,130,23,153
p_31,0,6,e_0,666,800,828,12,1,0,10,4,0,1,134,28,162
p_85,0,15,e_2,545,768,829,15,0,0,1,4,0,1,223,61,284
p_26,0,8,e_0,684,800,836,6,1,0,4,4,0,1,116,36,152
p_25,0,8,e_0,686,800,836,5,1,0,3,4,0,1,114,36,150
p_15,0,9,e_0,793,800,841,17,2,2,2,4,0,1,7,41,48
p_27,0,10,e_0,677,800,846,8,1,0,6,4,0,1,123,46,169
p_17,0,10,e_0,776,800,846,23,2,2,8,4,0,1,24,46,70
p_28,0,11,e_0,676,800,851,8,1,0,6,4,0,1,124,51,175
p_13,0,11,e_0,796,800,851,17,1,1,1,4,0,1,4,51,55
p_12,0,11,e_0,798,800,851,16,1,1,0,4,0,1,2,51,53
p_9,0,2,e_3,846,852,860,2,1,0,2,4,0,1,6,8,14
p_10,0,8,e_3,835,852,880,5,1,0,5,4,0,1,17,28,45
p_11,0,9,e_3,807,852,885,14,0,0,14,3,0,0,45,33,78
p_7,0,5,e_2,875,876,895,11,2,2,0,3,0,0,1,19,20
p_32,0,6,e_2,650,876,900,16,2,2,4,4,0,1,226,24,250
p_35,0,9,e_2,630,876,911,21,4,4,11,4,0,1,246,35,281
p_18,0,10,e_2,766,876,916,25,3,3,0,4,0,1,110,40,150
p_8,0,11,e_2,874,876,921,12,2,2,0,4,0,1,2,45,47
p_4,0,1,e_3,886,916,921,9,0,0,9,3,0,0,30,5,35
p_6,0,3,e_0,877,913,924,11,2,2,11,3,0,0,36,11,47
p_34,0,12,e_2,646,876,926,17,2,2,6,4,0,1,230,50,280
p_1,0,5,e_0,894,913,932,7,1,0,6,4,0,1,19,19,38
p_33,0,15,e_2,649,876,937,17,2,2,5,4,0,1,227,61,288
p_3,0,8,e_0,888,913,943,9,1,0,8,4,0,1,25,30,55
p_2,0,11,e_0,892,913,954,8,1,0,7,4,0,1,21,41,62
p_5,0,8,e_1,883,931,957,9,1,1,15,3,0,0,48,26,74
p_300,0,4,e_0,8,9,25,0,0,0,0,3,0,0,1,16,17
p_299,0,5,e_1,9,10,29,0,0,0,0,3,0,0,1,19,20
p_297,0,6,e_3,15,16,38,0,0,0,0,3,0,0,1,22,23
p_298,0,9,e_2,11,12,43,0,0,0,0,3,0,0,1,31,32
p_296,0,4,e_0,28,43,57,9,1,1,4,3,0,0,15,14,29
p_286,0,3,e_1,46,47,60,6,0,0,0,3,0,0,1,13,14
p_292,0,6,e_0,38,43,65,6,0,0,1,4,0,1,5,22,27
p_290,0,6,e_0,40,43,65,6,0,0,1,4,0,1,3,22,25
p_289,0,4,e_1,43,47,65,6,0,0,1,4,0,1,4,18,22
p_295,0,5,e_1,29,47,70,9,1,1,5,3,0,0,18,23,41
p_287,0,5,e_1,45,47,70,6,0,0,0,4,0,1,2,23,25
p_288,0,8,e_1,44,47,81,6,0,0,1,4,0,1,3,34,37
p_281,0,1,e_3,73,74,81,0,0,0,0,3,0,0,1,7,8
p_291,0,11,e_0,39,43,82,6,0,0,1,4,0,1,4,39,43
p_294,0,12,e_0,31,43,87,8,1,1,4,4,0,1,12,44,56
p_293,0,12,e_0,33,43,87,7,1,1,3,4,0,1,10,44,54
p_278,0,2,e_2,77,84,92,18,4,4,2,4,0,1,7,8,15
p_285,0,4,e_3,53,74,92,6,0,0,6,3,0,0,21,18,39
p_284,0,4,e_2,54,84,100,6,1,0,9,3,0,0,30,16,46
p_282,0,7,e_3,66,74,103,2,1,0,2,4,0,1,8,29,37
p_279,0,5,e_2,76,84,105,18,4,4,2,4,0,1,8,21,29
p_277,0,6,e_2,82,84,110,17,3,3,0,4,0,1,2,26,28
p_283,0,9,e_3,57,74,111,5,1,0,5,4,0,1,17,37,54
p_273,0,4,e_1,110,111,127,9,0,0,0,3,0,0,1,16,17
p_271,0,1,e_0,121,125,130,9,0,0,1,4,0,1,4,5,9
p_280,0,14,e_2,75,84,136,18,4,4,3,4,0,1,9,52,61
p_274,0,8,e_1,88,111,141,15,3,3,7,4,0,1,23,30,53
p_276,0,11,e_1,84,111,152,16,3,3,8,3,0,0,27,41,68
p_270,0,9,e_0,122,125,156,9,0,0,1,4,0,1,3,31,34
p_272,0,10,e_0,113,125,161,9,0,0,4,4,0,1,12,36,48
p_267,0,1,e_3,148,157,162,3,1,0,3,4,0,1,9,5,14
p_268,0,2,e_3,144,157,167,4,1,0,4,4,0,1,13,10,23
p_275,0,14,e_0,86,125,175,16,3,3,12,2,1,0,39,50,89
p_265,0,4,e_3,152,157,175,1,1,0,1,4,0,1,5,18,23
p_266,0,6,e_3,151,157,183,2,1,0,2,4,0,1,6,26,32
p_263,0,7,e_3,154,157,188,1,1,0,1,4,0,1,3,31,34
p_269,0,9,e_3,127,157,196,9,0,0,9,3,0,0,30,39,69
p_255,0,3,e_1,184,193,204,16,3,3,3,4,0,1,9,11,20
p_264,0,11,e_3,153,157,204,1,1,0,1,4,0,1,4,47,51
p_254,0,4,e_1,187,193,209,15,2,2,2,4,0,1,6,16,22
p_262,0,5,e_1,157,193,214,22,7,7,11,3,0,0,36,21,57
p_261,0,5,e_1,164,193,214,21,6,6,9,4,0,1,29,21,50
p_253,0,5,e_1,190,193,214,15,2,2,1,4,0,1,3,21,24
p_260,0,7,e_1,165,193,222,20,6,6,9,4,0,1,28,29,57
p_258,0,7,e_1,168,193,222,20,5,5,8,4,0,1,25,29,54
p_256,0,10,e_1,182,193,233,16,3,3,3,4,0,1,11,40,51
p_257,0,14,e_1,169,193,247,20,5,5,8,4,0,1,24,54,78
p_250,0,2,e_3,217,241,249,8,1,0,8,4,0,1,24,8,32
p_259,0,15,e_1,167,193,252,20,5,5,8,4,0,1,26,59,85
p_252,0,5,e_3,205,241,260,11,0,0,11,3,0,0,36,19,55
p_249,0,6,e_3,239,241,265,0,1,0,0,4,0,1,2,24,26
p_248,0,5,e_0,246,254,271,11,3,3,2,4,0,1,8,17,25
p_247,0,5,e_0,250,254,271,10,2,2,1,4,0,1,4,17,21
p_241,0,1,e_3,283,290,295,2,1,0,2,4,0,1,7,5,12
p_251,0,15,e_0,209,254,303,10,1,0,14,3,0,0,45,49,94
p_236,0,1,e_2,305,307,312,26,4,4,0,4,0,1,2,5,7
p_245,0,7,e_3,269,290,315,6,0,0,6,3,0,0,21,25,46
p_242,0,8,e_3,277,290,320,4,1,0,4,4,0,1,13,30,43
p_237,0,7,e_2,304,307,332,26,4,4,1,4,0,1,3,25,28
p_244,0,12,e_3,271,290,334,6,1,0,6,4,0,1,19,44,63
p_240,0,9,e_2,301,307,340,27,4,4,2,4,0,1,6,33,39
p_246,0,10,e_2,262,307,345,7,1,1,14,3,0,0,45,38,83
p_243,0,15,e_3,272,290,345,6,1,0,6,4,0,1,18,55,73
p_239,0,11,e_2,302,307,350,27,4,4,1,4,0,1,5,43,48
p_238,0,13,e_2,303,307,358,27,4,4,1,4,0,1,4,51,55
p_233,0,1,e_0,311,356,361,24,4,4,15,4,0,1,45,5,50
p_226,0,2,e_0,329,356,366,19,2,2,9,4,0,1,27,10,37
p_223,0,2,e_0,336,356,366,18,1,1,6,4,0,1,20,10,30
p_209,0,2,e_1,357,358,368,15,0,0,0,3,0,0,1,10,11
p_230,0,3,e_0,319,356,371,22,2,2,12,4,0,1,37,15,52
p_228,0,4,e_0,325,356,376,21,2,2,10,4,0,1,31,20,51
p_232,0,5,e_0,314,356,381,23,3,3,14,4,0,1,42,25,67
p_225,0,5,e_0,330,356,381,19,2,2,8,4,0,1,26,25,51
p_224,0,5,e_0,331,356,381,19,2,2,8,4,0,1,25,25,50
p_222,0,5,e_0,337,356,381,17,1,1,6,4,0,1,19,25,44
p_221,0,6,e_0,339,356,386,17,1,1,5,4,0,1,17,30,47
p_220,0,6,e_0,341,356,386,16,1,1,5,4,0,1,15,30,45
p_234,0,8,e_1,310,358,388,24,4,4,15,3,0,0,48,30,78
p_231,0,7,e_0,317,356,391,23,3,3,13,4,0,1,39,35,74
p_235,0,8,e_0,308,356,396,25,4,4,15,3,0,0,48,40,88
p_227,0,12,e_0,327,356,410,20,2,2,9,4,0,1,29,54,83
p_205,0,2,e_2,362,400,410,15,1,0,12,4,0,1,38,10,48
p_229,0,13,e_0,320,356,415,22,2,2,12,4,0,1,36,59,95
p_200,0,4,e_2,367,400,418,13,1,0,11,4,0,1,33,18,51
p_196,0,4,e_2,371,400,418,12,1,0,9,4,0,1,29,18,47
p_178,0,3,e_3,401,407,420,2,1,0,2,4,0,1,6,13,19
p_201,0,5,e_2,366,400,423,13,1,0,11,4,0,1,34,23,57
p_176,0,4,e_3,403,407,425,1,1,0,1,4,0,1,4,18,22
p_208,0,6,e_2,358,400,428,15,0,0,13,3,0,0,42,28,70
p_194,0,6,e_2,373,400,428,11,1,0,9,4,0,1,27,28,55
p_167,0,1,e_1,413,434,439,27,6,6,7,4,0,1,21,5,26
p_161,0,1,e_1,421,434,439,25,5,5,4,4,0,1,13,5,18
p_198,0,9,e_2,369,400,439,12,1,0,10,4,0,1,31,39,70
p_179,0,8,e_3,400,407,439,2,1,0,2,4,0,1,7,32,39
p_197,0,10,e_2,370,400,444,12,1,0,10,4,0,1,30,44,74
p_177,0,9,e_3,402,407,444,1,1,0,1,4,0,1,5,37,42
p_193,0,11,e_2,374,400,449,11,1,0,8,4,0,1,26,49,75
p_165,0,4,e_1,417,434,450,26,6,6,5,4,0,1,17,16,33
p_207,0,11,e_3,359,407,452,15,0,0,15,3,0,0,48,45,93
p_206,0,12,e_2,361,400,454,15,1,0,13,4,0,1,39,54,93
p_203,0,12,e_2,364,400,454,14,1,0,12,4,0,1,36,54,90
p_159,0,6,e_1,429,434,458,23,4,4,1,4,0,1,5,24,29
p_204,0,14,e_2,363,400,462,14,1,0,12,4,0,1,37,62,99
p_216,0,1,e_0,347,456,463,15,0,0,3,4,0,1,109,7,116
p_175,0,14,e_3,405,407,463,0,1,0,0,4,0,1,2,56,58
p_174,0,14,e_3,406,407,463,0,0,0,0,3,0,0,1,56,57
p_202,0,15,e_2,365,400,467,14,1,0,11,4,0,1,35,67,102
p_199,0,15,e_2,368,400,467,13,1,0,10,4,0,1,32,67,99
p_195,0,15,e_2,372,400,467,11,1,0,9,4,0,1,28,67,95
p_169,0,9,e_1,411,434,469,28,6,6,7,4,0,1,23,35,58
p_214,0,3,e_0,349,456,471,15,0,0,2,4,0,1,107,15,122
p_163,0,10,e_1,419,434,474,25,5,5,5,4,0,1,15,40,55
p_219,0,5,e_0,342,456,479,16,1,1,4,4,0,1,114,23,137
p_173,0,11,e_1,407,434,479,28,7,7,8,3,0,0,27,45,72
p_164,0,11,e_1,418,434,479,25,6,6,5,4,0,1,16,45,61
p_162,0,11,e_1,420,434,479,25,5,5,4,4,0,1,14,45,59
p_210,0,6,e_0,354,456,484,15,0,0,0,4,0,1,102,28,130
p_166,0,12,e_1,416,434,484,26,6,6,6,4,0,1,18,50,68
p_217,0,7,e_0,346,456,489,15,0,0,3,4,0,1,110,33,143
p_212,0,7,e_0,351,456,489,15,0,0,1,4,0,1,105,33,138
p_154,0,7,e_0,436,456,489,21,4,4,6,4,0,1,20,33,53
p_171,0,13,e_1,409,434,489,28,6,6,8,4,0,1,25,55,80
p_168,0,13,e_1,412,434,489,27,6,6,7,4,0,1,22,55,77
p_170,0,14,e_1,410,434,494,28,6,6,8,4,0,1,24,60,84
p_153,0,9,e_0,437,456,497,20,4,4,6,4,0,1,19,41,60
p_172,0,15,e_1,408,434,499,28,6,6,8,4,0,1,26,65,91
p_160,0,15,e_1,426,434,499,24,4,4,2,4,0,1,8,65,73
p_218,0,11,e_0,343,456,505,15,1,1,4,4,0,1,113,49,162
p_130,0,1,e_3,472,507,512,11,1,0,11,4,0,1,35,5,40
p_155,0,14,e_0,435,456,516,21,4,4,7,4,0,1,21,60,81
p_143,0,3,e_3,456,507,520,16,1,1,12,5,1,0,51,13,64
p_136,0,3,e_3,465,507,520,14,1,0,14,4,0,1,42,13,55
p_129,0,3,e_3,473,507,520,11,1,0,11,4,0,1,34,13,47
p_215,0,15,e_0,348,456,521,15,0,0,2,4,0,1,108,65,173
p_213,0,15,e_0,350,456,521,15,0,0,2,4,0,1,106,65,171
p_211,0,15,e_0,353,456,521,15,0,0,1,4,0,1,103,65,168
p_156,0,15,e_0,434,456,521,21,4,4,7,4,0,1,22,65,87
p_152,0,15,e_0,441,456,521,20,3,3,5,4,0,1,15,65,80
p_190,0,1,e_2,379,514,521,9,1,0,7,4,0,1,135,7,142
p_183,0,1,e_2,396,514,521,3,1,0,1,4,0,1,118,7,125
p_137,0,4,e_3,464,507,525,14,1,0,14,4,0,1,43,18,61
p_182,0,2,e_2,397,514,526,3,1,0,1,4,0,1,117,12,129
p_180,0,2,e_2,399,514,526,2,1,0,0,3,0,0,115,12,127
p_141,0,6,e_3,458,507,533,15,2,2,13,5,1,1,49,26,75
p_186,0,4,e_2,390,514,534,5,1,0,3,4,0,1,124,20,144
p_140,0,8,e_3,459,507,541,15,2,2,13,5,1,1,48,34,82
p_102,0,7,e_2,509,514,545,30,11,11,1,4,0,1,5,31,36
p_142,0,9,e_3,457,507,546,16,2,2,12,5,1,1,50,39,89
p_192,0,8,e_2,375,514,550,10,1,0,8,4,0,1,139,36,175
p_189,0,8,e_2,382,514,550,8,1,0,6,4,0,1,132,36,168
p_139,0,10,e_3,461,507,551,14,2,2,14,5,1,1,46,44,90
p_135,0,10,e_3,466,507,551,13,1,0,13,4,0,1,41,44,85
p_158,0,1,e_1,430,546,553,23,4,4,1,4,0,1,116,7,123
p_96,0,1,e_1,517,546,553,28,11,11,9,4,0,1,29,7,36
p_138,0,11,e_3,463,507,556,14,1,0,14,4,0,1,44,49,93
p_132,0,11,e_3,470,507,556,12,1,0,12,4,0,1,37,49,86
p_191,0,10,e_2,376,514,558,10,1,0,8,4,0,1,138,44,182
p_185,0,10,e_2,391,514,558,5,1,0,3,4,0,1,123,44,167
p_133,0,12,e_3,469,507,561,12,1,0,12,4,0,1,38,54,92
p_103,0,11,e_2,508,514,563,30,11,11,2,4,0,1,6,49,55
p_92,0,4,e_1,525,546,564,26,9,9,7,4,0,1,21,18,39
p_187,0,12,e_2,389,514,568,6,1,0,3,4,0,1,125,54,179
p_184,0,12,e_2,392,514,568,5,1,0,2,4,0,1,122,54,176
p_88,0,5,e_1,538,546,569,23,8,8,2,4,0,1,8,23,31
p_131,0,14,e_3,471,507,569,12,1,0,12,4,0,1,36,62,98
p_188,0,13,e_2,384,514,573,7,1,0,5,4,0,1,130,59,189
p_99,0,6,e_1,514,546,574,29,11,11,10,4,0,1,32,28,60
p_94,0,6,e_1,519,546,574,27,10,10,9,4,0,1,27,28,55
p_134,0,15,e_3,467,507,574,13,1,0,13,4,0,1,40,67,107
p_146,0,1,e_0,453,568,575,17,1,1,1,4,0,1,115,7,122
p_98,0,7,e_1,515,546,579,28,11,11,10,4,0,1,31,33,64
p_97,0,7,e_1,516,546,579,28,11,11,10,4,0,1,30,33,63
p_181,0,15,e_2,398,514,581,3,1,0,0,4,0,1,116,67,183
p_87,0,8,e_1,539,546,584,22,8,8,2,4,0,1,7,38,45
p_89,0,9,e_1,535,546,589,24,8,8,3,4,0,1,11,43,54
p_150,0,6,e_0,443,568,592,19,2,2,4,4,0,1,125,24,149
p_80,0,7,e_0,552,568,597,20,5,5,5,4,0,1,16,29,45
p_91,0,12,e_1,526,546,600,26,9,9,6,4,0,1,20,54,74
p_148,0,8,e_0,449,568,602,18,2,2,2,4,0,1,119,34,153
p_83,0,8,e_0,549,568,602,20,6,6,6,4,0,1,19,34,53
p_93,0,13,e_1,520,546,605,27,10,10,8,4,0,1,26,59,85
p_90,0,13,e_1,527,546,605,26,9,9,6,4,0,1,19,59,78
p_147,0,9,e_0,452,568,607,17,1,1,1,4,0,1,116,39,155
p_144,0,9,e_0,455,568,607,16,1,1,0,3,0,0,113,39,152
p_157,0,14,e_1,431,546,610,22,4,4,1,4,0,1,115,64,179
p_95,0,14,e_1,518,546,610,27,11,11,9,4,0,1,28,64,92
p_145,0,11,e_0,454,568,615,17,1,1,0,4,0,1,114,47,161
p_84,0,12,e_0,546,568,620,21,6,6,7,4,0,1,22,52,74
p_78,0,12,e_0,556,568,620,19,4,4,4,4,0,1,12,52,64
p_119,0,1,e_3,483,621,626,8,1,0,8,4,0,1,138,5,143
p_82,0,14,e_0,550,568,628,20,5,5,6,4,0,1,18,60,78
p_81,0,14,e_0,551,568,628,20,5,5,5,4,0,1,17,60,77
p_79,0,14,e_0,553,568,628,20,5,5,5,4,0,1,15,60,75
p_151,0,15,e_0,442,568,633,19,3,3,4,4,0,1,126,65,191
p_149,0,15,e_0,444,568,633,19,2,2,4,4,0,1,124,65,189
p_114,0,3,e_3,488,621,634,6,1,0,6,4,0,1,133,13,146
p_124,0,7,e_3,478,621,648,9,1,0,9,4,0,1,143,27,170
p_118,0,7,e_3,484,621,648,7,1,0,7,4,0,1,137,27,164
p_101,0,8,e_2,511,628,654,29,11,11,1,4,0,1,117,26,143
p_115,0,9,e_3,487,621,656,6,1,0,6,4,0,1,134,35,169
p_100,0,9,e_2,513,628,659,29,11,11,0,3,0,0,115,31,146
p_127,0,10,e_3,475,621,661,10,1,0,10,4,0,1,146,40,186
p_117,0,10,e_3,485,621,661,7,1,0,7,4,0,1,136,40,176
p_116,0,10,e_3,486,621,661,7,1,0,7,4,0,1,135,40,175
p_86,0,2,e_1,544,654,662,21,7,7,0,4,0,1,110,8,118
p_128,0,11,e_3,474,621,666,11,1,0,11,4,0,1,147,45,192
p_123,0,11,e_3,479,621,666,9,1,0,9,4,0,1,142,45,187
p_121,0,11,e_3,481,621,666,8,1,0,8,4,0,1,140,45,185
p_120,0,11,e_3,482,621,666,8,1,0,8,4,0,1,139,45,184
p_126,0,12,e_3,476,621,671,10,1,0,10,4,0,1,145,50,195
p_32,0,6,e_1,650,654,676,23,7,7,1,4,0,1,4,22,26
p_125,0,14,e_3,477,621,679,10,1,0,10,4,0,1,144,58,202
p_122,0,15,e_3,480,621,684,9,1,0,9,4,0,1,141,63,204
p_35,0,9,e_1,630,654,687,28,9,9,8,4,0,1,24,33,57
p_77,0,3,e_0,557,680,691,19,4,4,3,4,0,1,123,11,134
p_72,0,3,e_0,562,680,691,18,3,3,2,4,0,1,118,11,129
p_71,0,3,e_0,564,680,691,17,3,3,1,4,0,1,116,11,127
p_70,0,3,e_0,565,680,691,17,3,3,1,4,0,1,115,11,126
p_30,0,3,e_0,668,680,691,19,4,4,4,4,0,1,12,11,23
p_34,0,12,e_1,646,654,698,23,8,8,2,4,0,1,8,44,52
p_75,0,5,e_0,559,680,699,18,4,4,3,4,0,1,121,19,140
p_29,0,5,e_0,670,680,699,18,3,3,3,4,0,1,10,19,29
p_36,0,13,e_1,628,654,703,29,9,9,8,4,0,1,26,49,75
p_76,0,6,e_0,558,680,704,19,4,4,3,4,0,1,122,24,146
p_31,0,6,e_0,666,680,704,19,4,4,4,4,0,1,14,24,38
p_74,0,7,e_0,560,680,709,18,3,3,2,4,0,1,120,29,149
p_85,0,15,e_1,545,654,711,21,6,6,0,3,0,0,109,57,166
p_33,0,15,e_1,649,654,711,23,7,7,1,4,0,1,5,57,62
p_27,0,10,e_0,677,680,720,16,3,3,1,4,0,1,3,40,43
p_24,0,2,e_2,695,714,722,12,1,0,6,4,0,1,19,8,27
p_73,0,11,e_0,561,680,725,18,3,3,2,4,0,1,119,45,164
p_28,0,11,e_0,676,680,725,17,3,3,1,4,0,1,4,45,49
p_68,0,13,e_0,567,680,733,16,3,3,0,3,0,0,113,53,166
p_113,0,1,e_3,489,731,736,6,1,0,6,4,0,1,242,5,247
p_65,0,1,e_3,573,731,736,15,1,1,15,2,1,1,158,5,163
p_69,0,14,e_0,566,680,738,17,3,3,0,4,0,1,114,58,172
p_26,0,8,e_2,684,714,742,15,1,0,9,3,0,0,30,28,58
p_25,0,8,e_2,686,714,742,15,1,0,9,4,0,1,28,28,56
p_106,0,3,e_3,500,731,744,2,1,0,2,4,0,1,231,13,244
p_67,0,3,e_3,568,731,744,16,2,2,14,2,2,1,163,13,176
p_66,0,3,e_3,569,731,744,16,2,2,14,5,1,1,162,13,175
p_64,0,4,e_3,574,731,749,15,1,0,15,4,0,1,157,18,175
p_23,0,12,e_2,711,714,756,6,1,0,1,4,0,1,3,42,45
p_108,0,6,e_3,496,731,757,3,1,0,3,4,0,1,235,26,261
p_111,0,8,e_3,491,731,765,5,1,0,5,4,0,1,240,34,274
p_112,0,11,e_3,490,731,776,5,1,0,5,4,0,1,241,45,286
p_110,0,11,e_3,492,731,776,5,1,0,5,4,0,1,239,45,284
p_107,0,11,e_3,499,731,776,2,1,0,2,4,0,1,232,45,277
p_105,0,12,e_3,502,731,781,1,1,0,1,4,0,1,229,50,279
p_63,0,13,e_3,577,731,786,14,1,0,14,4,0,1,154,55,209
p_104,0,14,e_3,503,731,791,1,1,0,1,4,0,1,228,60,288
p_21,0,4,e_1,731,779,793,30,10,10,15,3,0,0,48,14,62
p_109,0,15,e_3,493,731,796,4,1,0,4,4,0,1,238,65,303
p_18,0,10,e_1,766,779,813,22,6,6,4,4,0,1,13,34,47
p_17,0,10,e_1,776,779,813,19,5,5,1,4,0,1,3,34,37
p_19,0,11,e_1,754,779,818,25,8,8,8,4,0,1,25,39,64
p_16,0,2,e_2,780,819,827,18,4,4,12,3,0,0,39,8,47
p_20,0,14,e_1,734,779,829,29,11,11,15,4,0,1,45,50,95
p_14,0,4,e_2,794,819,835,15,2,2,8,4,0,1,25,16,41
p_15,0,9,e_2,793,819,852,16,2,2,8,4,0,1,26,33,59
p_11,0,9,e_2,807,819,852,12,1,0,4,4,0,1,12,33,45
p_55,0,3,e_3,585,843,854,12,1,0,12,4,0,1,258,11,269
p_54,0,3,e_3,586,843,854,11,1,0,11,4,0,1,257,11,268
p_52,0,3,e_3,588,843,854,11,1,0,11,4,0,1,255,11,266
p_48,0,4,e_3,592,843,859,9,1,0,9,4,0,1,251,16,267
p_13,0,11,e_2,796,819,860,15,1,0,7,4,0,1,23,41,64
p_12,0,11,e_2,798,819,860,15,1,0,7,4,0,1,21,41,62
p_61,0,6,e_3,579,843,867,14,1,0,14,4,0,1,264,24,288
p_56,0,6,e_3,584,843,867,12,1,0,12,4,0,1,259,24,283
p_50,0,7,e_3,590,843,872,10,1,0,10,4,0,1,253,29,282
p_53,0,9,e_3,587,843,880,11,1,0,11,4,0,1,256,37,293
p_51,0,9,e_3,589,843,880,10,1,0,10,4,0,1,254,37,291
p_60,0,10,e_3,580,843,885,13,1,0,13,4,0,1,263,42,305
p_58,0,11,e_3,582,843,890,13,1,0,13,4,0,1,261,47,308
p_57,0,11,e_3,583,843,890,12,1,0,12,4,0,1,260,47,307
p_4,0,1,e_0,886,891,896,18,4,4,1,4,0,1,5,5,10
p_62,0,13,e_3,578,843,898,14,1,0,14,4,0,1,265,55,320
p_9,0,2,e_0,846,891,901,27,10,10,14,3,0,0,45,10,55
p_59,0,14,e_3,581,843,903,13,1,0,13,4,0,1,262,60,322
p_49,0,14,e_3,591,843,903,10,1,0,10,4,0,1,252,60,312
p_6,0,3,e_0,877,891,906,20,6,6,4,4,0,1,14,15,29
p_7,0,5,e_0,875,891,914,20,6,6,5,4,0,1,16,23,39
p_5,0,8,e_0,883,891,925,18,5,5,2,4,0,1,8,34,42
p_3,0,8,e_0,888,891,925,17,4,4,1,4,0,1,3,34,37
p_8,0,11,e_0,874,891,936,21,6,6,5,4,0,1,17,45,62
p_45,0,2,e_3,595,947,955,8,1,0,8,4,0,1,352,8,360
p_1,0,5,e_1,894,939,956,16,3,3,14,3,0,0,45,17,62
p_22,0,3,e_3,719,947,960,4,1,0,4,4,0,1,228,13,241
p_2,0,11,e_2,892,928,963,17,3,3,11,3,0,0,36,35,71
p_46,0,4,e_3,594,947,965,9,1,0,9,4,0,1,353,18,371
p_42,0,6,e_3,598,947,973,7,1,0,7,4,0,1,349,26,375
p_43,0,7,e_3,597,947,978,8,1,0,8,4,0,1,350,31,381
p_44,0,8,e_3,596,947,983,8,1,0,8,4,0,1,351,36,387
p_10,0,8,e_3,835,947,983,2,1,0,2,4,0,1,112,36,148
p_47,0,9,e_3,593,947,988,9,1,0,9,4,0,1,354,41,395
p_37,0,9,e_3,615,947,988,2,1,0,2,4,0,1,332,41,373
p_41,0,11,e_3,600,947,996,7,1,0,7,4,0,1,347,49,396
p_39,0,12,e_3,607,947,1001,4,1,0,4,4,0,1,340,54,394
p_40,0,13,e_3,602,947,1006,6,1,0,6,4,0,1,345,59,404
p_38,0,13,e_3,608,947,1006,4,1,0,4,4,0,1,339,59,398
p_300,0,4,e_0,8,9,25,0,0,0,0,3,0,0,1,16,17
p_299,0,5,e_1,9,10,29,0,0,0,0,3,0,0,1,19,20
p_297,0,6,e_3,15,16,38,0,0,0,0,3,0,0,1,22,23
p_298,0,9,e_2,11,12,43,0,0,0,0,3,0,0,1,31,32
p_296,0,4,e_0,28,43,57,9,1,1,4,3,0,0,15,14,29
p_295,0,5,e_0,29,43,62,9,1,1,4,4,0,1,14,19,33
p_292,0,6,e_0,38,43,67,6,0,0,1,4,0,1,5,24,29
p_290,0,6,e_0,40,43,67,6,0,0,1,4,0,1,3,24,27
p_286,0,3,e_1,46,61,72,6,0,0,5,4,0,1,15,11,26
p_289,0,4,e_1,43,61,77,6,0,0,5,3,0,0,18,16,34
p_285,0,4,e_1,53,61,77,6,0,0,2,4,0,1,8,16,24
p_284,0,4,e_1,54,61,77,6,0,0,2,4,0,1,7,16,23
p_287,0,5,e_1,45,61,82,6,0,0,5,4,0,1,16,21,37
p_291,0,11,e_0,39,43,84,6,0,0,1,4,0,1,4,41,45
p_294,0,12,e_0,31,43,89,8,1,1,4,4,0,1,12,46,58
p_293,0,12,e_0,33,43,89,7,1,1,3,4,0,1,10,46,56
p_288,0,8,e_1,44,61,93,6,0,0,5,4,0,1,17,32,49
p_281,0,1,e_3,73,87,94,4,1,0,4,4,0,1,14,7,21
p_283,0,9,e_1,57,61,98,6,0,0,1,4,0,1,4,37,41
p_278,0,2,e_3,77,87,99,3,1,0,3,4,0,1,10,12,22
p_279,0,5,e_3,76,87,110,3,1,0,3,4,0,1,11,23,34
p_277,0,6,e_3,82,87,115,1,1,0,1,4,0,1,5,28,33
p_282,0,7,e_3,66,87,120,6,0,0,6,3,0,0,21,33,54
p_273,0,4,e_2,110,118,132,23,4,4,2,4,0,1,8,14,22
p_276,0,11,e_3,84,87,134,1,1,0,1,4,0,1,3,47,50
p_280,0,14,e_3,75,87,145,4,1,0,4,4,0,1,12,58,70
p_275,0,14,e_3,86,87,145,0,0,0,0,3,0,0,1,58,59
p_274,0,8,e_2,88,118,146,28,7,7,9,3,0,0,30,28,58
p_272,0,10,e_2,113,118,154,22,4,4,1,4,0,1,5,36,41
p_271,0,1,e_1,121,151,156,21,2,2,9,3,0,0,30,5,35
p_267,0,1,e_1,148,151,156,14,0,0,1,4,0,1,3,5,8
p_268,0,2,e_1,144,151,161,14,0,0,2,4,0,1,7,10,17
p_270,0,9,e_1,122,151,184,21,2,2,9,4,0,1,29,33,62
p_269,0,9,e_1,127,151,184,19,2,2,8,4,0,1,24,33,57
p_255,0,3,e_2,184,186,197,14,0,0,0,4,0,1,2,11,13
p_265,0,4,e_2,152,186,202,14,0,0,10,5,1,0,34,16,50
p_254,0,4,e_0,187,190,204,14,0,0,1,4,0,1,3,14,17
p_262,0,5,e_2,157,186,207,14,0,0,9,4,0,1,29,21,50
p_261,0,5,e_2,164,186,207,14,0,0,7,4,0,1,22,21,43
p_266,0,6,e_0,151,190,212,14,0,0,12,3,0,0,39,22,61
p_263,0,7,e_2,154,186,215,14,0,0,10,4,0,1,32,29,61
p_260,0,7,e_2,165,186,215,14,0,0,7,4,0,1,21,29,50
p_258,0,7,e_2,168,186,215,14,0,0,6,4,0,1,18,29,47
p_256,0,10,e_2,182,186,226,14,0,0,1,4,0,1,4,40,44
p_250,0,2,e_1,217,220,228,14,0,0,1,4,0,1,3,8,11
p_264,0,11,e_2,153,186,231,14,0,0,10,2,1,1,33,45,78
p_253,0,5,e_1,190,220,239,14,0,0,9,3,0,0,30,19,49
p_252,0,5,e_1,205,220,239,14,0,0,5,4,0,1,15,19,34
p_257,0,14,e_2,169,186,242,14,0,0,5,4,0,1,17,56,73
p_259,0,15,e_2,167,186,247,14,0,0,6,4,0,1,19,61,80
p_251,0,15,e_1,209,220,271,14,0,0,3,4,0,1,11,51,62
p_248,0,5,e_0,246,260,277,14,0,0,4,4,0,1,14,17,31
p_247,0,5,e_0,250,260,277,14,0,0,3,4,0,1,10,17,27
p_249,0,6,e_0,239,260,282,14,0,0,6,3,0,0,21,22,43
p_241,0,1,e_0,283,302,309,8,1,0,6,4,0,1,19,7,26
p_236,0,1,e_3,305,307,312,0,1,0,0,4,0,1,2,5,7
p_245,0,7,e_0,269,302,329,12,1,0,3,5,2,0,33,27,60
p_237,0,7,e_3,304,307,332,1,1,0,1,4,0,1,3,25,28
p_242,0,8,e_0,277,302,334,10,1,0,5,5,1,1,25,32,57
p_240,0,9,e_0,301,302,339,2,1,0,0,3,0,0,1,37,38
p_246,0,10,e_3,262,307,343,14,0,0,14,3,0,0,45,36,81
p_239,0,11,e_3,302,307,348,1,1,0,1,4,0,1,5,41,46
p_244,0,12,e_3,271,307,353,12,1,0,12,4,0,1,36,46,82
p_238,0,13,e_3,303,307,358,1,1,0,1,4,0,1,4,51,55
p_233,0,1,e_1,311,356,361,29,6,6,15,4,0,1,45,5,50
p_226,0,2,e_1,329,356,366,24,6,6,9,4,0,1,27,10,37
p_223,0,2,e_1,336,356,366,22,5,5,6,4,0,1,20,10,30
p_243,0,15,e_3,272,307,366,11,1,0,11,4,0,1,35,59,94
p_209,0,2,e_2,357,358,368,17,1,1,0,3,0,0,1,10,11
p_230,0,3,e_1,319,356,371,27,6,6,12,4,0,1,37,15,52
p_228,0,4,e_1,325,356,376,25,6,6,10,4,0,1,31,20,51
p_232,0,5,e_1,314,356,381,29,6,6,14,4,0,1,42,25,67
p_225,0,5,e_1,330,356,381,23,6,6,8,4,0,1,26,25,51
p_224,0,5,e_1,331,356,381,23,5,5,8,4,0,1,25,25,50
p_222,0,5,e_1,337,356,381,22,5,5,6,4,0,1,19,25,44
p_221,0,6,e_1,339,356,386,21,5,5,5,4,0,1,17,30,47
p_220,0,6,e_1,341,356,386,20,5,5,5,4,0,1,15,30,45
p_234,0,8,e_2,310,358,388,29,7,7,15,3,0,0,48,30,78
p_231,0,7,e_1,317,356,391,28,6,6,13,4,0,1,39,35,74
p_205,0,2,e_0,362,388,396,16,1,1,8,4,0,1,26,8,34
p_235,0,8,e_1,308,356,396,30,7,7,15,3,0,0,48,40,88
p_200,0,4,e_0,367,388,404,15,0,0,7,4,0,1,21,16,37
p_196,0,4,e_0,371,388,404,15,0,0,5,4,0,1,17,16,33
p_201,0,5,e_0,366,388,409,15,0,0,7,4,0,1,22,21,43
p_227,0,12,e_1,327,356,410,24,6,6,9,4,0,1,29,54,83
p_208,0,6,e_0,358,388,414,17,1,1,9,3,0,0,30,26,56
p_194,0,6,e_0,373,388,414,15,0,0,5,4,0,1,15,26,41
p_229,0,13,e_1,320,356,415,27,6,6,12,4,0,1,36,59,95
p_183,0,1,e_2,396,416,421,15,0,0,6,4,0,1,20,5,25
p_198,0,9,e_0,369,388,425,15,0,0,6,4,0,1,19,37,56
p_182,0,2,e_2,397,416,426,15,0,0,6,4,0,1,19,10,29
p_180,0,2,e_2,399,416,426,15,0,0,5,4,0,1,17,10,27
p_197,0,10,e_0,370,388,430,15,0,0,6,4,0,1,18,42,60
p_178,0,3,e_2,401,416,431,15,0,0,5,4,0,1,15,15,30
p_207,0,11,e_0,359,388,435,17,1,1,9,4,0,1,29,47,76
p_186,0,4,e_2,390,416,436,15,0,0,8,4,0,1,26,20,46
p_176,0,4,e_2,403,416,436,15,0,0,4,4,0,1,13,20,33
p_206,0,12,e_0,361,388,440,16,1,1,9,4,0,1,27,52,79
p_203,0,12,e_0,364,388,440,15,1,1,8,4,0,1,24,52,76
p_204,0,14,e_0,363,388,448,16,1,1,8,4,0,1,25,60,85
p_179,0,8,e_2,400,416,450,15,0,0,5,4,0,1,16,34,50
p_202,0,15,e_0,365,388,453,15,0,0,7,4,0,1,23,65,88
p_199,0,15,e_0,368,388,453,15,0,0,6,4,0,1,20,65,85
p_195,0,15,e_0,372,388,453,15,0,0,5,4,0,1,16,65,81
p_177,0,9,e_2,402,416,455,15,0,0,4,4,0,1,14,39,53
p_185,0,10,e_2,391,416,460,15,0,0,8,4,0,1,25,44,69
p_216,0,1,e_1,347,456,463,19,3,3,3,4,0,1,109,7,116
p_173,0,11,e_2,407,416,465,15,0,0,3,4,0,1,9,49,58
p_187,0,12,e_2,389,416,470,15,0,0,8,3,0,0,27,54,81
p_184,0,12,e_2,392,416,470,15,0,0,8,4,0,1,24,54,78
p_214,0,3,e_1,349,456,471,19,3,3,2,4,0,1,107,15,122
p_165,0,4,e_1,417,456,476,15,0,0,13,4,0,1,39,20,59
p_175,0,14,e_2,405,416,478,15,0,0,3,4,0,1,11,62,73
p_174,0,14,e_2,406,416,478,15,0,0,3,4,0,1,10,62,72
p_219,0,5,e_1,342,456,481,20,4,4,4,4,0,1,114,25,139
p_181,0,15,e_2,398,416,483,15,0,0,6,4,0,1,18,67,85
p_210,0,6,e_1,354,456,486,18,2,2,0,4,0,1,102,30,132
p_217,0,7,e_1,346,456,491,19,4,4,3,4,0,1,110,35,145
p_212,0,7,e_1,351,456,491,18,3,3,1,4,0,1,105,35,140
p_163,0,10,e_1,419,456,502,15,0,0,12,4,0,1,37,46,83
p_190,0,1,e_0,379,500,507,15,0,0,3,4,0,1,121,7,128
p_218,0,11,e_1,343,456,507,20,4,4,4,4,0,1,113,51,164
p_164,0,11,e_1,418,456,507,15,0,0,12,4,0,1,38,51,89
p_162,0,11,e_1,420,456,507,15,0,0,12,4,0,1,36,51,87
p_166,0,12,e_1,416,456,512,15,0,0,13,4,0,1,40,56,96
p_143,0,3,e_0,456,500,515,15,0,0,14,4,0,1,44,15,59
p_136,0,3,e_0,465,500,515,15,0,0,11,4,0,1,35,15,50
p_137,0,4,e_0,464,500,520,15,0,0,12,4,0,1,36,20,56
p_215,0,15,e_1,348,456,523,19,3,3,2,4,0,1,108,67,175
p_213,0,15,e_1,350,456,523,19,3,3,2,4,0,1,106,67,173
p_211,0,15,e_1,353,456,523,18,2,2,1,4,0,1,103,67,170
p_141,0,6,e_0,458,500,528,15,0,0,14,4,0,1,42,28,70
p_167,0,1,e_2,413,530,535,15,0,0,1,4,0,1,117,5,122
p_192,0,8,e_0,375,500,536,15,0,0,4,4,0,1,125,36,161
p_189,0,8,e_0,382,500,536,15,0,0,2,4,0,1,118,36,154
p_140,0,8,e_0,459,500,536,15,0,0,13,4,0,1,41,36,77
p_142,0,9,e_0,457,500,541,15,0,0,14,4,0,1,43,41,84
p_106,0,3,e_2,500,530,543,15,0,0,10,4,0,1,30,13,43
p_191,0,10,e_0,376,500,546,15,0,0,4,4,0,1,124,46,170
p_139,0,10,e_0,461,500,546,15,0,0,13,4,0,1,39,46,85
p_135,0,10,e_0,466,500,546,15,0,0,11,4,0,1,34,46,80
p_193,0,11,e_0,374,500,551,15,0,0,4,4,0,1,126,51,177
p_138,0,11,e_0,463,500,551,15,0,0,12,4,0,1,37,51,88
p_99,0,6,e_2,514,530,554,15,0,0,5,4,0,1,16,24,40
p_188,0,13,e_0,384,500,559,15,0,0,1,4,0,1,116,59,175
p_102,0,7,e_2,509,530,559,15,0,0,7,4,0,1,21,29,50
p_98,0,7,e_2,515,530,559,15,0,0,5,4,0,1,15,29,44
p_101,0,8,e_2,511,530,564,15,0,0,6,4,0,1,19,34,53
p_169,0,9,e_2,411,530,569,15,0,0,1,4,0,1,119,39,158
p_100,0,9,e_2,513,530,569,15,0,0,5,4,0,1,17,39,56
p_161,0,1,e_1,421,570,577,15,0,0,11,4,0,1,149,7,156
p_158,0,1,e_1,430,570,577,15,0,0,8,4,0,1,140,7,147
p_103,0,11,e_2,508,530,577,15,0,0,7,4,0,1,22,47,69
p_105,0,12,e_2,502,530,582,15,0,0,9,4,0,1,28,52,80
p_171,0,13,e_2,409,530,587,15,0,0,2,4,0,1,121,57,178
p_168,0,13,e_2,412,530,587,15,0,0,1,4,0,1,118,57,175
p_170,0,14,e_2,410,530,592,15,0,0,2,4,0,1,120,62,182
p_104,0,14,e_2,503,530,592,15,0,0,9,4,0,1,27,62,89
p_159,0,6,e_1,429,570,594,15,0,0,9,4,0,1,141,24,165
p_150,0,6,e_1,443,570,594,15,0,0,4,4,0,1,127,24,151
p_172,0,15,e_2,408,530,597,15,0,0,2,4,0,1,122,67,189
p_154,0,7,e_1,436,570,599,15,0,0,6,4,0,1,134,29,163
p_148,0,8,e_1,449,570,604,15,0,0,2,4,0,1,121,34,155
p_130,0,1,e_0,472,600,605,15,0,0,9,4,0,1,128,5,133
p_153,0,9,e_1,437,570,609,15,0,0,6,4,0,1,133,39,172
p_147,0,9,e_1,452,570,609,15,0,0,1,4,0,1,118,39,157
p_129,0,3,e_0,473,600,613,15,0,0,9,4,0,1,127,13,140
p_157,0,14,e_1,431,570,626,15,0,0,8,4,0,1,139,56,195
p_155,0,14,e_1,435,570,626,15,0,0,7,4,0,1,135,56,191
p_124,0,7,e_0,478,600,627,15,0,0,7,4,0,1,122,27,149
p_160,0,15,e_1,426,570,631,15,0,0,10,4,0,1,144,61,205
p_156,0,15,e_1,434,570,631,15,0,0,7,4,0,1,136,61,197
p_152,0,15,e_1,441,570,631,15,0,0,5,4,0,1,129,61,190
p_151,0,15,e_1,442,570,631,15,0,0,4,4,0,1,128,61,189
p_149,0,15,e_1,444,570,631,15,0,0,4,4,0,1,126,61,187
p_127,0,10,e_0,475,600,638,15,0,0,8,4,0,1,125,38,163
p_132,0,11,e_0,470,600,643,15,0,0,10,4,0,1,130,43,173
p_128,0,11,e_0,474,600,643,15,0,0,8,4,0,1,126,43,169
p_123,0,11,e_0,479,600,643,15,0,0,7,4,0,1,121,43,164
p_121,0,11,e_0,481,600,643,15,0,0,6,4,0,1,119,43,162
p_120,0,11,e_0,482,600,643,15,0,0,6,4,0,1,118,43,161
p_133,0,12,e_0,469,600,648,15,0,0,10,4,0,1,131,48,179
p_126,0,12,e_0,476,600,648,15,0,0,8,4,0,1,124,48,172
p_96,0,1,e_2,517,644,649,15,0,0,4,4,0,1,127,5,132
p_131,0,14,e_0,471,600,656,15,0,0,9,4,0,1,129,56,185
p_125,0,14,e_0,477,600,656,15,0,0,7,4,0,1,123,56,179
p_92,0,4,e_2,525,644,660,15,0,0,1,4,0,1,119,16,135
p_134,0,15,e_0,467,600,661,15,0,0,11,4,0,1,133,61,194
p_122,0,15,e_0,480,600,661,15,0,0,6,4,0,1,120,61,181
p_94,0,6,e_2,519,644,668,15,0,0,3,4,0,1,125,24,149
p_97,0,7,e_2,516,644,673,15,0,0,4,4,0,1,128,29,157
p_37,0,9,e_2,615,644,681,15,0,0,9,4,0,1,29,37,66
p_35,0,9,e_2,630,644,681,15,0,0,4,4,0,1,14,37,51
p_146,0,1,e_1,453,678,685,15,0,0,1,4,0,1,225,7,232
p_41,0,11,e_2,600,644,689,15,0,0,14,4,0,1,44,45,89
p_86,0,2,e_1,544,678,690,15,0,0,8,4,0,1,134,12,146
p_91,0,12,e_2,526,644,694,15,0,0,1,4,0,1,118,50,168
p_39,0,12,e_2,607,644,694,15,0,0,12,4,0,1,37,50,87
p_93,0,13,e_2,520,644,699,15,0,0,3,4,0,1,124,55,179
p_90,0,13,e_2,527,644,699,15,0,0,1,4,0,1,117,55,172
p_40,0,13,e_2,602,644,699,15,0,0,14,4,0,1,42,55,97
p_38,0,13,e_2,608,644,699,15,0,0,12,4,0,1,36,55,91
p_36,0,13,e_2,628,644,699,15,0,0,5,4,0,1,16,55,71
p_88,0,5,e_1,538,678,701,15,0,0,10,4,0,1,140,23,163
p_95,0,14,e_2,518,644,704,15,0,0,4,4,0,1,126,60,186
p_80,0,7,e_1,552,678,709,15,0,0,6,4,0,1,126,31,157
p_119,0,1,e_0,483,708,713,15,0,0,5,4,0,1,225,5,230
p_113,0,1,e_0,489,708,713,15,0,0,3,4,0,1,219,5,224
p_65,0,1,e_0,573,708,713,15,0,0,9,4,0,1,135,5,140
p_87,0,8,e_1,539,678,714,15,0,0,10,4,0,1,139,36,175
p_83,0,8,e_1,549,678,714,15,0,0,7,4,0,1,129,36,165
p_144,0,9,e_1,455,678,719,15,0,0,0,3,0,0,223,41,264
p_89,0,9,e_1,535,678,719,15,0,0,11,4,0,1,143,41,184
p_114,0,3,e_0,488,708,721,15,0,0,4,4,0,1,220,13,233
p_64,0,4,e_0,574,708,726,15,0,0,8,4,0,1,134,18,152
p_145,0,11,e_1,454,678,727,15,0,0,0,4,0,1,224,49,273
p_84,0,12,e_1,546,678,732,15,0,0,8,4,0,1,132,54,186
p_78,0,12,e_1,556,678,732,15,0,0,4,4,0,1,122,54,176
p_108,0,6,e_0,496,708,734,15,0,0,1,4,0,1,212,26,238
p_118,0,7,e_0,484,708,739,15,0,0,5,4,0,1,224,31,255
p_82,0,14,e_1,550,678,740,15,0,0,6,4,0,1,128,62,190
p_81,0,14,e_1,551,678,740,15,0,0,6,4,0,1,127,62,189
p_79,0,14,e_1,553,678,740,15,0,0,5,4,0,1,125,62,187
p_111,0,8,e_0,491,708,744,15,0,0,3,4,0,1,217,36,253
p_85,0,15,e_1,545,678,745,15,0,0,8,4,0,1,133,67,200
p_115,0,9,e_0,487,708,749,15,0,0,4,4,0,1,221,41,262
p_117,0,10,e_0,485,708,754,15,0,0,5,4,0,1,223,46,269
p_116,0,10,e_0,486,708,754,15,0,0,4,4,0,1,222,46,268
p_112,0,11,e_0,490,708,759,15,0,0,3,4,0,1,218,51,269
p_110,0,11,e_0,492,708,759,15,0,0,2,4,0,1,216,51,267
p_107,0,11,e_0,499,708,759,15,0,0,0,3,0,0,209,51,260
p_22,0,3,e_2,719,756,767,15,0,0,12,4,0,1,37,11,48
p_21,0,4,e_2,731,756,772,15,0,0,8,4,0,1,25,16,41
p_109,0,15,e_0,493,708,773,15,0,0,2,4,0,1,215,65,280
p_19,0,11,e_2,754,756,795,15,0,0,0,4,0,1,2,39,41
p_23,0,12,e_2,711,756,800,15,0,0,14,3,0,0,45,44,89
p_77,0,3,e_1,557,792,803,15,0,0,4,4,0,1,235,11,246
p_72,0,3,e_1,562,792,803,15,0,0,2,4,0,1,230,11,241
p_71,0,3,e_1,564,792,803,15,0,0,2,4,0,1,228,11,239
p_70,0,3,e_1,565,792,803,15,0,0,1,4,0,1,227,11,238
p_67,0,3,e_1,568,792,803,15,0,0,0,4,0,1,224,11,235
p_66,0,3,e_1,569,792,803,15,0,0,0,3,0,0,223,11,234
p_20,0,14,e_2,734,756,808,15,0,0,7,4,0,1,22,52,74
p_75,0,5,e_1,559,792,811,15,0,0,3,4,0,1,233,19,252
p_76,0,6,e_1,558,792,816,15,0,0,4,4,0,1,234,24,258
p_32,0,6,e_1,650,792,816,15,0,0,9,4,0,1,142,24,166
p_74,0,7,e_1,560,792,821,15,0,0,3,4,0,1,232,29,261
p_55,0,3,e_0,585,820,831,15,0,0,5,4,0,1,235,11,246
p_54,0,3,e_0,586,820,831,15,0,0,4,4,0,1,234,11,245
p_52,0,3,e_0,588,820,831,15,0,0,4,4,0,1,232,11,243
p_73,0,11,e_1,561,792,835,15,0,0,3,4,0,1,231,43,274
p_34,0,12,e_1,646,792,840,15,0,0,10,4,0,1,146,48,194
p_61,0,6,e_0,579,820,842,15,0,0,7,4,0,1,241,22,263
p_56,0,6,e_0,584,820,842,15,0,0,5,4,0,1,236,22,258
p_68,0,13,e_1,567,792,845,15,0,0,1,4,0,1,225,53,278
p_50,0,7,e_0,590,820,847,15,0,0,3,4,0,1,230,27,257
p_69,0,14,e_1,566,792,850,15,0,0,1,4,0,1,226,58,284
p_53,0,9,e_0,587,820,855,15,0,0,4,4,0,1,233,35,268
p_51,0,9,e_0,589,820,855,15,0,0,3,4,0,1,231,35,266
p_33,0,15,e_1,649,792,855,15,0,0,9,4,0,1,143,63,206
p_60,0,10,e_0,580,820,860,15,0,0,6,4,0,1,240,40,280
p_58,0,11,e_0,582,820,865,15,0,0,6,4,0,1,238,45,283
p_57,0,11,e_0,583,820,865,15,0,0,5,4,0,1,237,45,282
p_63,0,13,e_0,577,820,873,15,0,0,7,4,0,1,243,53,296
p_62,0,13,e_0,578,820,873,15,0,0,7,4,0,1,242,53,295
p_59,0,14,e_0,581,820,878,15,0,0,6,4,0,1,239,58,297
p_49,0,14,e_0,591,820,878,15,0,0,3,4,0,1,229,58,287
p_9,0,2,e_2,846,880,888,15,0,0,11,4,0,1,34,8,42
p_6,0,3,e_2,877,880,893,15,0,0,1,4,0,1,3,13,16
p_7,0,5,e_2,875,880,901,15,0,0,1,4,0,1,5,21,26
p_4,0,1,e_1,886,902,907,15,0,0,5,4,0,1,16,5,21
p_16,0,2,e_1,780,902,912,15,0,0,4,4,0,1,122,10,132
p_10,0,8,e_2,835,880,912,15,0,0,14,3,0,0,45,32,77
p_30,0,3,e_1,668,902,917,15,0,0,3,4,0,1,234,15,249
p_8,0,11,e_2,874,880,923,15,0,0,2,4,0,1,6,43,49
p_29,0,5,e_1,670,902,925,15,0,0,2,4,0,1,232,23,255
p_1,0,5,e_1,894,902,925,15,0,0,2,4,0,1,8,23,31
p_45,0,2,e_0,595,922,930,15,0,0,1,4,0,1,327,8,335
p_24,0,2,e_0,695,922,930,15,0,0,4,4,0,1,227,8,235
p_31,0,6,e_1,666,902,930,15,0,0,4,4,0,1,236,28,264
p_48,0,4,e_0,592,922,938,15,0,0,2,4,0,1,330,16,346
p_46,0,4,e_0,594,922,938,15,0,0,2,4,0,1,328,16,344
p_14,0,4,e_0,794,922,938,15,0,0,8,4,0,1,128,16,144
p_5,0,8,e_1,883,902,938,15,0,0,6,4,0,1,19,36,55
p_3,0,8,e_1,888,902,938,15,0,0,4,4,0,1,14,36,50
p_42,0,6,e_0,598,922,946,15,0,0,0,4,0,1,324,24,348
p_27,0,10,e_1,677,902,946,15,0,0,0,3,0,0,225,44,269
p_18,0,10,e_1,766,902,946,15,0,0,8,4,0,1,136,44,180
p_17,0,10,e_1,776,902,946,15,0,0,5,4,0,1,126,44,170
p_43,0,7,e_0,597,922,951,15,0,0,1,4,0,1,325,29,354
p_28,0,11,e_1,676,902,951,15,0,0,0,4,0,1,226,49,275
p_2,0,11,e_1,892,902,951,15,0,0,3,4,0,1,10,49,59
p_44,0,8,e_0,596,922,956,15,0,0,1,4,0,1,326,34,360
p_26,0,8,e_0,684,922,956,15,0,0,8,4,0,1,238,34,272
p_25,0,8,e_0,686,922,956,15,0,0,7,4,0,1,236,34,270
p_47,0,9,e_0,593,922,961,15,0,0,2,4,0,1,329,39,368
p_15,0,9,e_0,793,922,961,15,0,0,9,4,0,1,129,39,168
p_11,0,9,e_0,807,922,961,15,0,0,4,4,0,1,115,39,154
p_13,0,11,e_0,796,922,969,15,0,0,8,4,0,1,126,47,173
p_12,0,11,e_0,798,922,969,15,0,0,7,4,0,1,124,47,171
p_300,0,4,e_0,8,9,25,0,0,0,0,3,0,0,1,16,17
p_299,0,5,e_1,9,10,29,0,0,0,0,3,0,0,1,19,20
p_297,0,6,e_3,15,16,38,0,0,0,0,3,0,0,1,22,23
p_298,0,9,e_2,11,12,43,0,0,0,0,3,0,0,1,31,32
p_296,0,4,e_0,28,43,57,9,1,1,4,3,0,0,15,14,29
p_286,0,3,e_1,46,47,60,4,1,0,0,3,0,0,1,13,14
p_290,0,6,e_0,40,43,65,6,1,0,1,4,0,1,3,22,25
p_295,0,5,e_1,29,47,68,9,1,1,5,3,0,0,18,21,39
p_287,0,5,e_1,45,47,68,4,1,0,0,4,0,1,2,21,23
p_285,0,4,e_3,53,59,73,2,1,0,2,4,0,1,6,14,20
p_284,0,4,e_3,54,59,73,1,1,0,1,4,0,1,5,14,19
p_288,0,8,e_1,44,47,79,5,1,0,1,4,0,1,3,32,35
p_292,0,6,e_3,38,59,81,6,0,0,6,3,0,0,21,22,43
p_291,0,11,e_0,39,43,82,6,1,0,1,4,0,1,4,39,43
p_294,0,12,e_0,31,43,87,8,1,1,4,4,0,1,12,44,56
p_293,0,12,e_0,33,43,87,7,1,1,3,4,0,1,10,44,54
p_289,0,4,e_2,43,73,87,5,1,0,9,3,0,0,30,14,44
p_283,0,9,e_3,57,59,92,0,1,0,0,4,0,1,2,33,35
p_282,0,7,e_2,66,73,98,16,3,3,2,4,0,1,7,25,32
p_281,0,1,e_1,73,105,110,14,2,2,6,5,1,0,32,5,37
p_278,0,2,e_1,77,105,115,13,2,2,8,5,1,1,28,10,38
p_279,0,5,e_1,76,105,126,13,2,2,7,5,1,1,29,21,50
p_271,0,1,e_0,121,125,130,7,1,0,1,4,0,1,4,5,9
p_277,0,6,e_1,82,105,131,12,1,1,7,4,0,1,23,26,49
p_274,0,8,e_1,88,105,139,10,1,1,5,4,0,1,17,34,51
p_273,0,4,e_2,110,134,148,9,0,0,7,3,0,0,24,14,38
p_276,0,11,e_1,84,105,150,11,1,1,7,4,0,1,21,45,66
p_270,0,9,e_0,122,125,156,7,1,0,1,4,0,1,3,31,34
p_280,0,14,e_1,75,105,161,14,2,2,7,5,1,1,30,56,86
p_269,0,9,e_2,127,134,165,5,1,0,2,4,0,1,7,31,38
p_275,0,14,e_0,86,125,173,11,1,1,12,2,1,0,39,48,87
p_272,0,10,e_3,113,143,175,9,0,0,9,3,0,0,30,32,62
p_267,0,1,e_2,148,194,199,19,2,2,4,5,1,0,46,5,51
p_255,0,3,e_2,184,194,207,7,1,0,3,4,0,1,10,13,23
p_265,0,4,e_2,152,194,212,17,2,2,5,5,1,1,42,18,60
p_254,0,4,e_2,187,194,212,6,1,0,2,4,0,1,7,18,25
p_268,0,2,e_3,144,207,215,20,1,1,0,5,1,0,63,8,71
p_253,0,5,e_2,190,194,217,5,1,0,1,4,0,1,4,23,27
p_261,0,5,e_1,164,205,222,13,2,2,13,4,0,1,41,17,58
p_263,0,7,e_2,154,194,225,17,2,2,6,5,1,1,40,31,71
p_260,0,7,e_2,165,194,225,13,2,2,9,4,0,1,29,31,60
p_258,0,7,e_2,168,194,225,12,2,2,8,4,0,1,26,31,57
p_252,0,5,e_3,205,207,226,0,1,0,0,4,0,1,2,19,21
p_266,0,6,e_1,151,205,227,18,2,2,11,5,1,0,54,22,76
p_262,0,5,e_0,157,217,234,16,2,2,9,5,1,0,60,17,77
p_256,0,10,e_2,182,194,236,8,1,0,4,4,0,1,12,42,54
p_264,0,11,e_2,153,194,241,17,2,2,5,5,1,1,41,47,88
p_250,0,2,e_3,217,243,251,8,1,1,2,5,1,0,26,8,34
p_257,0,14,e_2,169,194,252,12,2,2,8,4,0,1,25,58,83
p_259,0,15,e_2,167,194,257,12,2,2,9,4,0,1,27,63,90
p_251,0,15,e_0,209,217,266,10,2,2,2,4,0,1,8,49,57
p_247,0,5,e_3,250,259,276,2,0,0,2,2,1,0,9,17,26
p_248,0,5,e_1,246,260,277,3,1,1,4,4,0,1,14,17,31
p_249,0,6,e_1,239,260,282,1,1,0,6,3,0,0,21,22,43
p_241,0,1,e_1,283,304,311,3,1,0,6,3,0,0,21,7,28
p_236,0,1,e_2,305,310,315,20,2,2,1,4,0,1,5,5,10
p_242,0,8,e_3,277,293,319,5,1,0,5,4,0,1,16,26,42
p_233,0,1,e_0,311,317,322,18,2,2,2,4,0,1,6,5,11
p_244,0,12,e_3,271,293,333,6,1,1,4,5,1,0,22,40,62
p_237,0,7,e_2,304,310,335,21,2,2,2,4,0,1,6,25,31
p_232,0,5,e_0,314,317,336,17,2,2,1,4,0,1,3,19,22
p_240,0,9,e_1,301,304,337,22,2,2,1,4,0,1,3,33,36
p_235,0,8,e_2,308,310,340,19,2,2,0,4,0,1,2,30,32
p_245,0,7,e_0,269,317,344,7,1,1,15,3,0,0,48,27,75
p_239,0,11,e_1,302,304,345,21,2,2,0,4,0,1,2,41,43
p_246,0,10,e_2,262,310,348,9,1,1,15,3,0,0,48,38,86
p_234,0,8,e_0,310,317,349,19,2,2,2,4,0,1,7,32,39
p_238,0,13,e_1,303,304,353,21,2,2,0,3,0,0,1,49,50
p_243,0,15,e_2,272,310,365,6,2,2,12,4,0,1,38,55,93
p_226,0,2,e_3,329,371,381,13,2,2,11,5,1,1,42,10,52
p_223,0,2,e_3,336,371,381,11,1,0,11,4,0,1,35,10,45
p_230,0,3,e_3,319,371,386,16,2,2,8,5,1,1,52,15,67
p_196,0,4,e_0,371,375,391,26,10,10,1,4,0,1,4,16,20
p_228,0,4,e_3,325,371,391,14,2,2,10,5,1,1,46,20,66
p_225,0,5,e_3,330,371,396,13,2,2,11,5,1,1,41,25,66
p_224,0,5,e_3,331,371,396,12,2,2,12,5,1,1,40,25,65
p_222,0,5,e_3,337,371,396,11,1,0,11,4,0,1,34,25,59
p_219,0,5,e_3,342,371,396,9,1,0,9,4,0,1,29,25,54
p_194,0,6,e_0,373,375,399,26,9,9,0,4,0,1,2,24,26
p_190,0,1,e_1,379,395,400,24,10,10,5,4,0,1,16,5,21
p_221,0,6,e_3,339,371,401,10,1,0,10,4,0,1,32,30,62
p_220,0,6,e_3,341,371,401,10,1,0,10,4,0,1,30,30,60
p_231,0,7,e_3,317,371,406,16,2,2,8,5,2,0,54,35,89
p_217,0,7,e_3,346,371,406,8,1,0,8,4,0,1,25,35,60
p_186,0,4,e_1,390,395,411,4,7,7,1,4,0,1,5,16,21
p_193,0,11,e_0,374,375,416,26,9,9,0,3,0,0,1,41,42
p_218,0,11,e_3,343,371,420,9,1,0,9,4,0,1,28,49,77
p_189,0,8,e_1,382,395,425,24,9,9,4,4,0,1,13,30,43
p_227,0,12,e_3,327,371,425,14,2,2,10,5,1,1,44,54,98
p_183,0,1,e_2,396,423,428,21,6,6,9,4,0,1,27,5,32
p_215,0,15,e_0,348,375,430,7,1,0,8,2,1,0,27,55,82
p_195,0,15,e_0,372,375,430,26,9,9,1,4,0,1,3,55,58
p_229,0,13,e_3,320,371,430,16,2,2,8,5,1,1,51,59,110
p_191,0,10,e_1,376,395,433,25,10,10,6,4,0,1,19,38,57
p_185,0,10,e_1,391,395,433,22,7,7,1,4,0,1,4,38,42
p_182,0,2,e_2,397,423,433,21,6,6,8,4,0,1,26,10,36
p_180,0,2,e_2,399,423,433,20,6,6,8,4,0,1,24,10,34
p_178,0,3,e_2,401,423,438,20,5,5,7,4,0,1,22,15,37
p_187,0,12,e_1,389,395,441,22,8,8,2,4,0,1,6,46,52
p_184,0,12,e_1,392,395,441,22,7,7,1,4,0,1,3,46,49
p_176,0,4,e_2,403,423,443,20,5,5,6,4,0,1,20,20,40
p_188,0,13,e_1,384,395,446,23,9,9,3,4,0,1,11,51,62
p_211,0,15,e_1,353,395,454,6,1,0,13,3,0,0,42,59,101
p_192,0,8,e_2,375,423,457,26,9,9,15,3,0,0,48,34,82
p_179,0,8,e_2,400,423,457,20,5,5,7,4,0,1,23,34,57
p_177,0,9,e_2,402,423,462,20,5,5,7,4,0,1,21,39,60
p_173,0,11,e_2,407,423,470,19,4,4,5,4,0,1,16,47,63
p_171,0,13,e_2,409,423,478,18,4,4,4,4,0,1,14,55,69
p_216,0,1,e_3,347,471,478,8,1,0,8,4,0,1,124,7,131
p_175,0,14,e_2,405,423,483,19,4,4,6,4,0,1,18,60,78
p_174,0,14,e_2,406,423,483,19,4,4,5,4,0,1,17,60,77
p_170,0,14,e_2,410,423,483,18,4,4,4,4,0,1,13,60,73
p_209,0,2,e_3,357,471,483,4,1,0,4,4,0,1,114,12,126
p_205,0,2,e_3,362,471,483,3,1,0,3,4,0,1,109,12,121
p_130,0,1,e_0,472,477,484,30,11,11,1,4,0,1,5,7,12
p_181,0,15,e_2,398,423,488,21,6,6,8,4,0,1,25,65,90
p_172,0,15,e_2,408,423,488,19,4,4,5,4,0,1,15,65,80
p_214,0,3,e_3,349,471,488,7,1,0,7,4,0,1,122,17,139
p_129,0,3,e_0,473,477,492,30,11,11,1,4,0,1,4,15,19
p_200,0,4,e_3,367,471,493,1,1,0,1,4,0,1,104,22,126
p_201,0,5,e_3,366,471,498,1,1,0,1,4,0,1,105,27,132
p_210,0,6,e_3,354,471,503,5,1,0,5,4,0,1,117,32,149
p_208,0,6,e_3,358,471,503,4,1,0,4,4,0,1,113,32,145
p_146,0,1,e_1,453,501,508,6,1,0,15,2,1,0,48,7,55
p_119,0,1,e_1,483,501,508,28,10,10,6,4,0,1,18,7,25
p_113,0,1,e_1,489,501,508,27,9,9,4,4,0,1,12,7,19
p_212,0,7,e_3,351,471,508,6,1,0,6,4,0,1,120,37,157
p_127,0,10,e_0,475,477,515,30,11,11,0,4,0,1,2,38,40
p_114,0,3,e_1,488,501,516,27,9,9,4,4,0,1,13,15,28
p_128,0,11,e_0,474,477,520,30,11,11,1,4,0,1,3,43,46
p_207,0,11,e_3,359,471,522,4,1,0,4,4,0,1,112,51,163
p_126,0,12,e_0,476,477,525,29,12,12,0,3,0,0,1,48,49
p_206,0,12,e_3,361,471,527,3,1,0,3,4,0,1,110,56,166
p_203,0,12,e_3,364,471,527,2,1,0,2,4,0,1,107,56,163
p_124,0,7,e_1,478,501,530,29,11,11,7,4,0,1,23,29,52
p_118,0,7,e_1,484,501,530,28,10,10,5,4,0,1,17,29,46
p_131,0,14,e_0,471,477,533,30,12,12,2,4,0,1,6,56,62
p_204,0,14,e_3,363,471,535,2,1,0,2,4,0,1,108,64,172
p_160,0,15,e_0,426,477,538,14,2,2,14,5,1,0,51,61,112
p_115,0,9,e_1,487,501,538,27,9,9,4,4,0,1,14,37,51
p_167,0,1,e_2,413,535,540,17,4,4,3,4,0,1,122,5,127
p_161,0,1,e_2,421,535,540,15,3,3,0,4,0,1,114,5,119
p_213,0,15,e_3,350,471,540,7,1,0,7,4,0,1,121,69,190
p_202,0,15,e_3,365,471,540,2,1,0,2,4,0,1,106,69,175
p_117,0,10,e_1,485,501,543,28,10,10,5,4,0,1,16,42,58
p_116,0,10,e_1,486,501,543,27,10,10,5,4,0,1,15,42,57
p_123,0,11,e_1,479,501,548,29,11,11,7,4,0,1,22,47,69
p_121,0,11,e_1,481,501,548,28,11,11,6,4,0,1,20,47,67
p_120,0,11,e_1,482,501,548,28,10,10,6,4,0,1,19,47,66
p_112,0,11,e_1,490,501,548,27,9,9,3,4,0,1,11,47,58
p_165,0,4,e_2,417,535,551,16,4,4,2,4,0,1,118,16,134
p_125,0,14,e_1,477,501,559,29,11,11,8,4,0,1,24,58,82
p_102,0,7,e_2,509,535,562,23,5,5,8,4,0,1,26,27,53
p_122,0,15,e_1,480,501,564,29,11,11,7,4,0,1,21,63,84
p_101,0,8,e_2,511,535,567,22,5,5,8,4,0,1,24,32,56
p_169,0,9,e_2,411,535,572,18,4,4,4,4,0,1,124,37,161
p_100,0,9,e_2,513,535,572,22,5,5,7,4,0,1,22,37,59
p_163,0,10,e_2,419,535,577,15,3,3,1,4,0,1,116,42,158
p_164,0,11,e_2,418,535,582,15,4,4,1,4,0,1,117,47,164
p_162,0,11,e_2,420,535,582,15,3,3,1,4,0,1,115,47,162
p_103,0,11,e_2,508,535,582,23,5,5,9,4,0,1,27,47,74
p_166,0,12,e_2,416,535,587,16,4,4,2,4,0,1,119,52,171
p_105,0,12,e_2,502,535,587,24,6,6,11,4,0,1,33,52,85
p_168,0,13,e_2,412,535,592,17,4,4,3,4,0,1,123,57,180
p_158,0,1,e_3,430,587,594,13,1,0,13,4,0,1,157,7,164
p_86,0,2,e_0,544,585,595,14,1,0,13,4,0,1,41,10,51
p_104,0,14,e_2,503,535,597,24,6,6,10,4,0,1,32,62,94
p_77,0,3,e_0,557,585,600,10,1,0,9,4,0,1,28,15,43
p_88,0,5,e_0,538,585,608,15,2,2,15,4,0,1,47,23,70
p_75,0,5,e_0,559,585,608,9,1,0,8,4,0,1,26,23,49
p_159,0,6,e_3,429,587,611,13,1,1,13,2,1,1,158,24,182
p_150,0,6,e_3,443,587,611,9,1,0,9,4,0,1,144,24,168
p_76,0,6,e_0,558,585,613,9,1,0,9,4,0,1,27,28,55
p_154,0,7,e_3,436,587,616,11,1,0,11,4,0,1,151,29,180
p_80,0,7,e_0,552,585,618,11,1,0,11,4,0,1,33,33,66
p_45,0,2,e_1,595,611,619,29,8,8,5,4,0,1,16,8,24
p_148,0,8,e_3,449,587,621,7,1,0,7,4,0,1,138,34,172
p_87,0,8,e_0,539,585,623,15,1,1,15,4,0,1,46,38,84
p_83,0,8,e_0,549,585,623,12,1,0,12,4,0,1,36,38,74
p_106,0,3,e_1,500,611,624,25,7,7,0,3,0,0,111,13,124
p_52,0,3,e_1,588,611,624,30,8,8,7,4,0,1,23,13,36
p_198,0,9,e_3,369,587,626,0,1,0,0,4,0,1,218,39,257
p_153,0,9,e_3,437,587,626,11,1,0,11,4,0,1,150,39,189
p_89,0,9,e_0,535,585,628,16,2,2,14,5,1,0,50,43,93
p_48,0,4,e_1,592,611,629,29,9,9,6,4,0,1,19,18,37
p_46,0,4,e_1,594,611,629,29,8,8,5,4,0,1,17,18,35
p_197,0,10,e_3,370,587,631,0,0,0,0,3,0,0,217,44,261
p_108,0,6,e_1,496,611,637,25,8,8,1,4,0,1,115,26,141
p_84,0,12,e_0,546,585,639,13,1,0,13,4,0,1,39,54,93
p_78,0,12,e_0,556,585,639,10,1,0,9,4,0,1,29,54,83
p_50,0,7,e_1,590,611,642,30,8,8,7,4,0,1,21,31,52
p_157,0,14,e_3,431,587,645,13,1,0,13,4,0,1,156,58,214
p_155,0,14,e_3,435,587,645,12,1,0,12,4,0,1,152,58,210
p_96,0,1,e_2,517,641,646,20,5,5,6,4,0,1,124,5,129
p_82,0,14,e_0,550,585,647,12,1,0,11,4,0,1,35,62,97
p_81,0,14,e_0,551,585,647,12,1,0,11,4,0,1,34,62,96
p_79,0,14,e_0,553,585,647,11,1,0,10,4,0,1,32,62,94
p_111,0,8,e_1,491,611,647,26,9,9,3,4,0,1,120,36,156
p_199,0,15,e_3,368,587,650,1,1,0,1,4,0,1,219,63,282
p_156,0,15,e_3,434,587,650,12,1,0,12,4,0,1,153,63,216
p_152,0,15,e_3,441,587,650,10,1,0,10,4,0,1,146,63,209
p_151,0,15,e_3,442,587,650,9,1,0,9,4,0,1,145,63,208
p_149,0,15,e_3,444,587,650,9,1,0,9,4,0,1,143,63,206
p_85,0,15,e_0,545,585,652,14,1,0,13,4,0,1,40,67,107
p_53,0,9,e_1,587,611,652,30,9,9,8,4,0,1,24,41,65
p_51,0,9,e_1,589,611,652,30,8,8,7,4,0,1,22,41,63
p_47,0,9,e_1,593,611,652,29,8,8,6,4,0,1,18,41,59
p_92,0,4,e_2,525,641,657,18,4,4,3,4,0,1,116,16,132
p_110,0,11,e_1,492,611,660,4,8,8,3,4,0,1,119,49,168
p_107,0,11,e_1,499,611,660,25,7,7,0,4,0,1,112,49,161
p_99,0,6,e_2,514,641,665,21,5,5,7,4,0,1,127,24,151
p_94,0,6,e_2,519,641,665,20,5,5,5,4,0,1,122,24,146
p_98,0,7,e_2,515,641,670,21,5,5,6,4,0,1,126,29,155
p_97,0,7,e_2,516,641,670,21,5,5,6,4,0,1,125,29,154
p_49,0,14,e_1,591,611,671,30,8,8,6,4,0,1,20,60,80
p_109,0,15,e_1,493,611,676,26,8,8,2,4,0,1,118,65,183
p_37,0,9,e_2,615,641,678,23,6,6,8,4,0,1,26,37,63
p_35,0,9,e_2,630,641,678,20,3,3,3,4,0,1,11,37,48
p_91,0,12,e_2,526,641,689,18,3,3,3,4,0,1,115,48,163
p_93,0,13,e_2,520,641,694,19,5,5,5,4,0,1,121,53,174
p_90,0,13,e_2,527,641,694,18,3,3,2,4,0,1,114,53,167
p_36,0,13,e_2,628,641,694,21,4,4,4,4,0,1,13,53,66
p_95,0,14,e_2,518,641,699,20,5,5,5,4,0,1,123,58,181
p_65,0,1,e_0,573,699,704,4,1,0,4,4,0,1,126,5,131
p_143,0,3,e_3,456,697,708,5,1,0,5,4,0,1,241,11,252
p_136,0,3,e_3,465,697,708,2,1,0,2,4,0,1,232,11,243
p_72,0,3,e_0,562,699,712,8,1,0,7,4,0,1,137,13,150
p_71,0,3,e_0,564,699,712,7,1,0,7,4,0,1,135,13,148
p_70,0,3,e_0,565,699,712,7,1,0,6,4,0,1,134,13,147
p_67,0,3,e_0,568,699,712,6,1,0,5,4,0,1,131,13,144
p_66,0,3,e_0,569,699,712,6,1,0,5,4,0,1,130,13,143
p_137,0,4,e_3,464,697,713,2,1,0,2,4,0,1,233,16,249
p_64,0,4,e_0,574,699,717,4,1,0,3,4,0,1,125,18,143
p_141,0,6,e_3,458,697,721,4,1,0,4,4,0,1,239,24,263
p_61,0,6,e_0,579,699,725,2,1,0,2,4,0,1,120,26,146
p_140,0,8,e_3,459,697,729,4,1,0,4,4,0,1,238,32,270
p_74,0,7,e_0,560,699,730,9,1,0,8,4,0,1,139,31,170
p_22,0,3,e_1,719,723,734,24,8,8,1,4,0,1,4,11,15
p_147,0,9,e_3,452,697,734,6,1,0,6,4,0,1,245,37,282
p_144,0,9,e_3,455,697,734,5,1,0,5,4,0,1,242,37,279
p_142,0,9,e_3,457,697,734,4,1,0,4,4,0,1,240,37,277
p_139,0,10,e_3,461,697,739,3,1,0,3,4,0,1,236,42,278
p_135,0,10,e_3,466,697,739,1,1,0,1,4,0,1,231,42,273
p_60,0,10,e_0,580,699,741,2,1,0,1,4,0,1,119,42,161
p_145,0,11,e_3,454,697,744,5,1,0,5,4,0,1,243,47,290
p_138,0,11,e_3,463,697,744,2,1,0,2,4,0,1,234,47,281
p_132,0,11,e_3,470,697,744,0,0,0,0,3,0,0,227,47,274
p_42,0,6,e_1,598,723,745,28,8,8,4,4,0,1,125,22,147
p_73,0,11,e_0,561,699,746,8,1,0,8,4,0,1,138,47,185
p_133,0,12,e_3,469,697,749,0,1,0,0,4,0,1,228,52,280
p_43,0,7,e_1,597,723,750,28,8,8,4,4,0,1,126,27,153
p_68,0,13,e_0,567,699,754,6,1,0,6,4,0,1,132,55,187
p_63,0,13,e_0,577,699,754,3,1,0,2,4,0,1,122,55,177
p_62,0,13,e_0,578,699,754,3,1,0,2,4,0,1,121,55,176
p_44,0,8,e_1,596,723,755,29,8,8,5,4,0,1,127,32,159
p_69,0,14,e_0,566,699,759,7,1,0,6,4,0,1,133,60,193
p_134,0,15,e_3,467,697,760,1,1,0,1,4,0,1,230,63,293
p_41,0,11,e_1,600,723,766,27,8,8,3,4,0,1,123,43,166
p_39,0,12,e_1,607,723,771,25,8,8,1,4,0,1,116,48,164
p_23,0,12,e_1,711,723,771,26,9,9,4,4,0,1,12,48,60
p_40,0,13,e_1,602,723,776,27,8,8,3,4,0,1,121,53,174
p_38,0,13,e_1,608,723,776,25,8,8,1,4,0,1,115,53,168
p_21,0,4,e_2,731,776,790,22,6,6,14,3,0,0,45,14,59
p_18,0,10,e_2,766,776,810,13,1,0,3,4,0,1,10,34,44
p_16,0,2,e_0,780,803,811,9,1,0,7,4,0,1,23,8,31
p_19,0,11,e_2,754,776,815,17,2,2,7,4,0,1,22,39,61
p_24,0,2,e_3,695,807,815,0,1,0,0,4,0,1,112,8,120
p_14,0,4,e_0,794,803,819,4,1,0,3,4,0,1,9,16,25
p_55,0,3,e_3,585,807,820,0,1,0,0,4,0,1,222,13,235
p_54,0,3,e_3,586,807,820,0,0,0,0,3,0,0,221,13,234
p_30,0,3,e_3,668,807,820,9,1,0,9,4,0,1,139,13,152
p_29,0,5,e_0,670,803,824,9,1,0,9,4,0,1,133,21,154
p_20,0,14,e_2,734,776,826,21,5,5,14,4,0,1,42,50,92
p_56,0,6,e_0,584,803,829,1,1,0,0,3,0,0,219,26,245
p_32,0,6,e_3,650,807,831,15,1,0,15,4,0,1,157,24,181
p_31,0,6,e_3,666,807,831,10,1,0,10,4,0,1,141,24,165
p_26,0,8,e_3,684,807,839,4,1,0,4,4,0,1,123,32,155
p_25,0,8,e_3,686,807,839,3,1,0,3,4,0,1,121,32,153
p_15,0,9,e_0,793,803,840,4,1,0,3,4,0,1,10,37,47
p_11,0,9,e_1,807,818,847,30,6,6,3,4,0,1,11,29,40
p_27,0,10,e_3,677,807,847,6,1,0,6,4,0,1,130,40,170
p_58,0,11,e_0,582,803,848,1,1,0,1,4,0,1,221,45,266
p_57,0,11,e_0,583,803,848,1,1,0,0,4,0,1,220,45,265
p_28,0,11,e_0,676,803,848,7,1,0,7,4,0,1,127,45,172
p_13,0,11,e_0,796,803,848,3,1,0,2,4,0,1,7,45,52
p_12,0,11,e_0,798,803,848,3,1,0,1,4,0,1,5,45,50
p_17,0,10,e_1,776,818,852,10,1,0,13,3,0,0,42,34,76
p_34,0,12,e_0,646,803,853,16,2,2,14,2,2,1,157,50,207
p_59,0,14,e_0,581,803,861,2,1,0,1,4,0,1,222,58,280
p_33,0,15,e_3,649,807,864,15,1,1,15,2,1,1,158,57,215
p_9,0,2,e_2,846,880,888,20,1,1,11,4,0,1,34,8,42
p_6,0,3,e_2,877,880,893,15,0,0,1,4,0,1,3,13,16
p_7,0,5,e_2,875,880,901,15,0,0,1,4,0,1,5,21,26
p_10,0,8,e_2,835,880,912,23,3,3,14,3,0,0,45,32,77
p_1,0,5,e_1,894,907,924,13,1,0,4,4,0,1,13,17,30
p_3,0,8,e_1,888,907,935,15,1,0,6,4,0,1,19,28,47
p_4,0,1,e_3,886,934,939,15,0,0,15,3,0,0,48,5,53
p_8,0,11,e_1,874,907,946,15,0,0,10,3,0,0,33,39,72
p_2,0,11,e_1,892,907,946,14,1,0,5,4,0,1,15,39,54
p_5,0,8,e_0,883,928,954,15,0,0,14,3,0,0,45,26,71
p_300,0,4,e_0,8,9,25,0,0,0,0,3,0,0,1,16,17
p_299,0,5,e_1,9,10,29,0,0,0,0,3,0,0,1,19,20
p_297,0,6,e_3,15,16,38,0,0,0,0,3,0,0,1,22,23
p_298,0,9,e_2,11,12,43,0,0,0,0,3,0,0,1,31,32
p_296,0,4,e_0,28,43,57,9,1,1,4,3,0,0,15,14,29
p_295,0,5,e_0,29,43,62,9,1,1,4,4,0,1,14,19,33
p_292,0,6,e_0,38,43,67,6,0,0,1,4,0,1,5,24,29
p_290,0,6,e_0,40,43,67,6,0,0,1,4,0,1,3,24,27
p_286,0,3,e_1,46,61,72,6,0,0,5,4,0,1,15,11,26
p_289,0,4,e_1,43,61,77,6,0,0,5,3,0,0,18,16,34
p_285,0,4,e_1,53,61,77,6,0,0,2,4,0,1,8,16,24
p_284,0,4,e_1,54,61,77,6,0,0,2,4,0,1,7,16,23
p_287,0,5,e_1,45,61,82,6,0,0,5,4,0,1,16,21,37
p_291,0,11,e_0,39,43,84,6,0,0,1,4,0,1,4,41,45
p_294,0,12,e_0,31,43,89,8,1,1,4,4,0,1,12,46,58
p_293,0,12,e_0,33,43,89,7,1,1,3,4,0,1,10,46,56
p_288,0,8,e_1,44,61,93,6,0,0,5,4,0,1,17,32,49
p_281,0,1,e_3,73,87,94,4,1,0,4,4,0,1,14,7,21
p_283,0,9,e_1,57,61,98,6,0,0,1,4,0,1,4,37,41
p_278,0,2,e_3,77,87,99,3,1,0,3,4,0,1,10,12,22
p_279,0,5,e_3,76,87,110,3,1,0,3,4,0,1,11,23,34
p_277,0,6,e_3,82,87,115,1,1,0,1,4,0,1,5,28,33
p_282,0,7,e_3,66,87,120,6,0,0,6,3,0,0,21,33,54
p_273,0,4,e_2,110,118,132,23,4,4,2,4,0,1,8,14,22
p_276,0,11,e_3,84,87,134,1,1,0,1,4,0,1,3,47,50
p_280,0,14,e_3,75,87,145,4,1,0,4,4,0,1,12,58,70
p_275,0,14,e_3,86,87,145,0,0,0,0,3,0,0,1,58,59
p_274,0,8,e_2,88,118,146,28,7,7,9,3,0,0,30,28,58
p_272,0,10,e_2,113,118,154,22,4,4,1,4,0,1,5,36,41
p_271,0,1,e_1,121,151,156,21,2,2,9,3,0,0,30,5,35
p_267,0,1,e_1,148,151,156,14,0,0,1,4,0,1,3,5,8
p_268,0,2,e_1,144,151,161,14,0,0,2,4,0,1,7,10,17
p_270,0,9,e_1,122,151,184,21,2,2,9,4,0,1,29,33,62
p_269,0,9,e_1,127,151,184,19,2,2,8,4,0,1,24,33,57
p_255,0,3,e_2,184,186,197,14,0,0,0,4,0,1,2,11,13
p_265,0,4,e_2,152,186,202,14,0,0,10,5,1,0,34,16,50
p_254,0,4,e_0,187,190,204,14,0,0,1,4,0,1,3,14,17
p_262,0,5,e_2,157,186,207,14,0,0,9,4,0,1,29,21,50
p_261,0,5,e_2,164,186,207,14,0,0,7,4,0,1,22,21,43
p_266,0,6,e_0,151,190,212,14,0,0,12,3,0,0,39,22,61
p_263,0,7,e_2,154,186,215,14,0,0,10,4,0,1,32,29,61
p_260,0,7,e_2,165,186,215,14,0,0,7,4,0,1,21,29,50
p_258,0,7,e_2,168,186,215,14,0,0,6,4,0,1,18,29,47
p_256,0,10,e_2,182,186,226,14,0,0,1,4,0,1,4,40,44
p_250,0,2,e_1,217,220,228,14,0,0,1,4,0,1,3,8,11
p_264,0,11,e_2,153,186,231,14,0,0,10,2,1,1,33,45,78
p_253,0,5,e_1,190,220,239,14,0,0,9,3,0,0,30,19,49
p_252,0,5,e_1,205,220,239,14,0,0,5,4,0,1,15,19,34
p_257,0,14,e_2,169,186,242,14,0,0,5,4,0,1,17,56,73
p_259,0,15,e_2,167,186,247,14,0,0,6,4,0,1,19,61,80
p_251,0,15,e_1,209,220,271,14,0,0,3,4,0,1,11,51,62
p_248,0,5,e_0,246,260,277,14,0,0,4,4,0,1,14,17,31
p_247,0,5,e_0,250,260,277,14,0,0,3,4,0,1,10,17,27
p_249,0,6,e_0,239,260,282,14,0,0,6,3,0,0,21,22,43
p_241,0,1,e_0,283,302,309,8,1,0,6,4,0,1,19,7,26
p_236,0,1,e_3,305,307,312,0,1,0,0,4,0,1,2,5,7
p_245,0,7,e_0,269,302,329,12,1,0,3,5,2,0,33,27,60
p_237,0,7,e_3,304,307,332,1,1,0,1,4,0,1,3,25,28
p_242,0,8,e_0,277,302,334,10,1,0,5,5,1,1,25,32,57
p_240,0,9,e_0,301,302,339,2,1,0,0,3,0,0,1,37,38
p_246,0,10,e_3,262,307,343,14,0,0,14,3,0,0,45,36,81
p_239,0,11,e_3,302,307,348,1,1,0,1,4,0,1,5,41,46
p_244,0,12,e_3,271,307,353,12,1,0,12,4,0,1,36,46,82
p_238,0,13,e_3,303,307,358,1,1,0,1,4,0,1,4,51,55
p_233,0,1,e_1,311,356,361,29,6,6,15,4,0,1,45,5,50
p_226,0,2,e_1,329,356,366,24,6,6,9,4,0,1,27,10,37
p_223,0,2,e_1,336,356,366,22,5,5,6,4,0,1,20,10,30
p_243,0,15,e_3,272,307,366,11,1,0,11,4,0,1,35,59,94
p_209,0,2,e_2,357,358,368,17,1,1,0,3,0,0,1,10,11
p_230,0,3,e_1,319,356,371,27,6,6,12,4,0,1,37,15,52
p_228,0,4,e_1,325,356,376,25,6,6,10,4,0,1,31,20,51
p_232,0,5,e_1,314,356,381,29,6,6,14,4,0,1,42,25,67
p_225,0,5,e_1,330,356,381,23,6,6,8,4,0,1,26,25,51
p_224,0,5,e_1,331,356,381,23,5,5,8,4,0,1,25,25,50
p_222,0,5,e_1,337,356,381,22,5,5,6,4,0,1,19,25,44
p_221,0,6,e_1,339,356,386,21,5,5,5,4,0,1,17,30,47
p_220,0,6,e_1,341,356,386,20,5,5,5,4,0,1,15,30,45
p_234,0,8,e_2,310,358,388,29,7,7,15,3,0,0,48,30,78
p_231,0,7,e_1,317,356,391,28,6,6,13,4,0,1,39,35,74
p_205,0,2,e_0,362,388,396,16,1,1,8,4,0,1,26,8,34
p_235,0,8,e_1,308,356,396,30,7,7,15,3,0,0,48,40,88
p_200,0,4,e_0,367,388,404,15,0,0,7,4,0,1,21,16,37
p_196,0,4,e_0,371,388,404,15,0,0,5,4,0,1,17,16,33
p_201,0,5,e_0,366,388,409,15,0,0,7,4,0,1,22,21,43
p_227,0,12,e_1,327,356,410,24,6,6,9,4,0,1,29,54,83
p_208,0,6,e_0,358,388,414,17,1,1,9,3,0,0,30,26,56
p_194,0,6,e_0,373,388,414,15,0,0,5,4,0,1,15,26,41
p_229,0,13,e_1,320,356,415,27,6,6,12,4,0,1,36,59,95
p_183,0,1,e_2,396,416,421,15,0,0,6,4,0,1,20,5,25
p_198,0,9,e_0,369,388,425,15,0,0,6,4,0,1,19,37,56
p_182,0,2,e_2,397,416,426,15,0,0,6,4,0,1,19,10,29
p_180,0,2,e_2,399,416,426,15,0,0,5,4,0,1,17,10,27
p_197,0,10,e_0,370,388,430,15,0,0,6,4,0,1,18,42,60
p_178,0,3,e_2,401,416,431,15,0,0,5,4,0,1,15,15,30
p_207,0,11,e_0,359,388,435,17,1,1,9,4,0,1,29,47,76
p_186,0,4,e_2,390,416,436,15,0,0,8,4,0,1,26,20,46
p_176,0,4,e_2,403,416,436,15,0,0,4,4,0,1,13,20,33
p_206,0,12,e_0,361,388,440,16,1,1,9,4,0,1,27,52,79
p_203,0,12,e_0,364,388,440,15,1,1,8,4,0,1,24,52,76
p_204,0,14,e_0,363,388,448,16,1,1,8,4,0,1,25,60,85
p_179,0,8,e_2,400,416,450,15,0,0,5,4,0,1,16,34,50
p_202,0,15,e_0,365,388,453,15,0,0,7,4,0,1,23,65,88
p_199,0,15,e_0,368,388,453,15,0,0,6,4,0,1,20,65,85
p_195,0,15,e_0,372,388,453,15,0,0,5,4,0,1,16,65,81
p_177,0,9,e_2,402,416,455,15,0,0,4,4,0,1,14,39,53
p_185,0,10,e_2,391,416,460,15,0,0,8,4,0,1,25,44,69
p_216,0,1,e_1,347,456,463,19,3,3,3,4,0,1,109,7,116
p_173,0,11,e_2,407,416,465,15,0,0,3,4,0,1,9,49,58
p_187,0,12,e_2,389,416,470,15,0,0,8,3,0,0,27,54,81
p_184,0,12,e_2,392,416,470,15,0,0,8,4,0,1,24,54,78
p_214,0,3,e_1,349,456,471,19,3,3,2,4,0,1,107,15,122
p_165,0,4,e_1,417,456,476,15,0,0,13,4,0,1,39,20,59
p_175,0,14,e_2,405,416,478,15,0,0,3,4,0,1,11,62,73
p_174,0,14,e_2,406,416,478,15,0,0,3,4,0,1,10,62,72
p_219,0,5,e_1,342,456,481,20,4,4,4,4,0,1,114,25,139
p_181,0,15,e_2,398,416,483,15,0,0,6,4,0,1,18,67,85
p_210,0,6,e_1,354,456,486,18,2,2,0,4,0,1,102,30,132
p_217,0,7,e_1,346,456,491,19,4,4,3,4,0,1,110,35,145
p_212,0,7,e_1,351,456,491,18,3,3,1,4,0,1,105,35,140
p_163,0,10,e_1,419,456,502,15,0,0,12,4,0,1,37,46,83
p_190,0,1,e_0,379,500,507,15,0,0,3,4,0,1,121,7,128
p_218,0,11,e_1,343,456,507,20,4,4,4,4,0,1,113,51,164
p_164,0,11,e_1,418,456,507,15,0,0,12,4,0,1,38,51,89
p_162,0,11,e_1,420,456,507,15,0,0,12,4,0,1,36,51,87
p_166,0,12,e_1,416,456,512,15,0,0,13,4,0,1,40,56,96
p_143,0,3,e_0,456,500,515,15,0,0,14,4,0,1,44,15,59
p_136,0,3,e_0,465,500,515,15,0,0,11,4,0,1,35,15,50
p_137,0,4,e_0,464,500,520,15,0,0,12,4,0,1,36,20,56
p_215,0,15,e_1,348,456,523,19,3,3,2,4,0,1,108,67,175
p_213,0,15,e_1,350,456,523,19,3,3,2,4,0,1,106,67,173
p_211,0,15,e_1,353,456,523,18,2,2,1,4,0,1,103,67,170
p_141,0,6,e_0,458,500,528,15,0,0,14,4,0,1,42,28,70
p_167,0,1,e_2,413,530,535,15,0,0,1,4,0,1,117,5,122
p_192,0,8,e_0,375,500,536,15,0,0,4,4,0,1,125,36,161
p_189,0,8,e_0,382,500,536,15,0,0,2,4,0,1,118,36,154
p_140,0,8,e_0,459,500,536,15,0,0,13,4,0,1,41,36,77
p_142,0,9,e_0,457,500,541,15,0,0,14,4,0,1,43,41,84
p_106,0,3,e_2,500,530,543,15,0,0,10,4,0,1,30,13,43
p_191,0,10,e_0,376,500,546,15,0,0,4,4,0,1,124,46,170
p_139,0,10,e_0,461,500,546,15,0,0,13,4,0,1,39,46,85
p_135,0,10,e_0,466,500,546,15,0,0,11,4,0,1,34,46,80
p_193,0,11,e_0,374,500,551,15,0,0,4,4,0,1,126,51,177
p_138,0,11,e_0,463,500,551,15,0,0,12,4,0,1,37,51,88
p_99,0,6,e_2,514,530,554,15,0,0,5,4,0,1,16,24,40
p_188,0,13,e_0,384,500,559,15,0,0,1,4,0,1,116,59,175
p_102,0,7,e_2,509,530,559,15,0,0,7,4,0,1,21,29,50
p_98,0,7,e_2,515,530,559,15,0,0,5,4,0,1,15,29,44
p_101,0,8,e_2,511,530,564,15,0,0,6,4,0,1,19,34,53
p_169,0,9,e_2,411,530,569,15,0,0,1,4,0,1,119,39,158
p_100,0,9,e_2,513,530,569,15,0,0,5,4,0,1,17,39,56
p_161,0,1,e_1,421,570,577,15,0,0,11,4,0,1,149,7,156
p_158,0,1,e_1,430,570,577,15,0,0,8,4,0,1,140,7,147
p_103,0,11,e_2,508,530,577,15,0,0,7,4,0,1,22,47,69
p_105,0,12,e_2,502,530,582,15,0,0,9,4,0,1,28,52,80
p_171,0,13,e_2,409,530,587,15,0,0,2,4,0,1,121,57,178
p_168,0,13,e_2,412,530,587,15,0,0,1,4,0,1,118,57,175
p_170,0,14,e_2,410,530,592,15,0,0,2,4,0,1,120,62,182
p_104,0,14,e_2,503,530,592,15,0,0,9,4,0,1,27,62,89
p_159,0,6,e_1,429,570,594,15,0,0,9,4,0,1,141,24,165
p_150,0,6,e_1,443,570,594,15,0,0,4,4,0,1,127,24,151
p_172,0,15,e_2,408,530,597,15,0,0,2,4,0,1,122,67,189
p_154,0,7,e_1,436,570,599,15,0,0,6,4,0,1,134,29,163
p_148,0,8,e_1,449,570,604,15,0,0,2,4,0,1,121,34,155
p_130,0,1,e_0,472,600,605,15,0,0,9,4,0,1,128,5,133
p_153,0,9,e_1,437,570,609,15,0,0,6,4,0,1,133,39,172
p_147,0,9,e_1,452,570,609,15,0,0,1,4,0,1,118,39,157
p_129,0,3,e_0,473,600,613,15,0,0,9,4,0,1,127,13,140
p_157,0,14,e_1,431,570,626,15,0,0,8,4,0,1,139,56,195
p_155,0,14,e_1,435,570,626,15,0,0,7,4,0,1,135,56,191
p_124,0,7,e_0,478,600,627,15,0,0,7,4,0,1,122,27,149
p_160,0,15,e_1,426,570,631,15,0,0,10,4,0,1,144,61,205
p_156,0,15,e_1,434,570,631,15,0,0,7,4,0,1,136,61,197
p_152,0,15,e_1,441,570,631,15,0,0,5,4,0,1,129,61,190
p_151,0,15,e_1,442,570,631,15,0,0,4,4,0,1,128,61,189
p_149,0,15,e_1,444,570,631,15,0,0,4,4,0,1,126,61,187
p_127,0,10,e_0,475,600,638,15,0,0,8,4,0,1,125,38,163
p_132,0,11,e_0,470,600,643,15,0,0,10,4,0,1,130,43,173
p_128,0,11,e_0,474,600,643,15,0,0,8,4,0,1,126,43,169
p_123,0,11,e_0,479,600,643,15,0,0,7,4,0,1,121,43,164
p_121,0,11,e_0,481,600,643,15,0,0,6,4,0,1,119,43,162
p_120,0,11,e_0,482,600,643,15,0,0,6,4,0,1,118,43,161
p_133,0,12,e_0,469,600,648,15,0,0,10,4,0,1,131,48,179
p_126,0,12,e_0,476,600,648,15,0,0,8,4,0,1,124,48,172
p_96,0,1,e_2,517,644,649,15,0,0,4,4,0,1,127,5,132
p_131,0,14,e_0,471,600,656,15,0,0,9,4,0,1,129,56,185
p_125,0,14,e_0,477,600,656,15,0,0,7,4,0,1,123,56,179
p_92,0,4,e_2,525,644,660,15,0,0,1,4,0,1,119,16,135
p_134,0,15,e_0,467,600,661,15,0,0,11,4,0,1,133,61,194
p_122,0,15,e_0,480,600,661,15,0,0,6,4,0,1,120,61,181
p_94,0,6,e_2,519,644,668,15,0,0,3,4,0,1,125,24,149
p_97,0,7,e_2,516,644,673,15,0,0,4,4,0,1,128,29,157
p_37,0,9,e_2,615,644,681,15,0,0,9,4,0,1,29,37,66
p_35,0,9,e_2,630,644,681,15,0,0,4,4,0,1,14,37,51
p_146,0,1,e_1,453,678,685,15,0,0,1,4,0,1,225,7,232
p_41,0,11,e_2,600,644,689,15,0,0,14,4,0,1,44,45,89
p_86,0,2,e_1,544,678,690,15,0,0,8,4,0,1,134,12,146
p_91,0,12,e_2,526,644,694,15,0,0,1,4,0,1,118,50,168
p_39,0,12,e_2,607,644,694,15,0,0,12,4,0,1,37,50,87
p_93,0,13,e_2,520,644,699,15,0,0,3,4,0,1,124,55,179
p_90,0,13,e_2,527,644,699,15,0,0,1,4,0,1,117,55,172
p_40,0,13,e_2,602,644,699,15,0,0,14,4,0,1,42,55,97
p_38,0,13,e_2,608,644,699,15,0,0,12,4,0,1,36,55,91
p_36,0,13,e_2,628,644,699,15,0,0,5,4,0,1,16,55,71
p_88,0,5,e_1,538,678,701,15,0,0,10,4,0,1,140,23,163
p_95,0,14,e_2,518,644,704,15,0,0,4,4,0,1,126,60,186
p_80,0,7,e_1,552,678,709,15,0,0,6,4,0,1,126,31,157
p_119,0,1,e_0,483,708,713,15,0,0,5,4,0,1,225,5,230
p_113,0,1,e_0,489,708,713,15,0,0,3,4,0,1,219,5,224
p_65,0,1,e_0,573,708,713,15,0,0,9,4,0,1,135,5,140
p_87,0,8,e_1,539,678,714,15,0,0,10,4,0,1,139,36,175
p_83,0,8,e_1,549,678,714,15,0,0,7,4,0,1,129,36,165
p_144,0,9,e_1,455,678,719,15,0,0,0,3,0,0,223,41,264
p_89,0,9,e_1,535,678,719,15,0,0,11,4,0,1,143,41,184
p_114,0,3,e_0,488,708,721,15,0,0,4,4,0,1,220,13,233
p_64,0,4,e_0,574,708,726,15,0,0,8,4,0,1,134,18,152
p_145,0,11,e_1,454,678,727,15,0,0,0,4,0,1,224,49,273
p_84,0,12,e_1,546,678,732,15,0,0,8,4,0,1,132,54,186
p_78,0,12,e_1,556,678,732,15,0,0,4,4,0,1,122,54,176
p_108,0,6,e_0,496,708,734,15,0,0,1,4,0,1,212,26,238
p_118,0,7,e_0,484,708,739,15,0,0,5,4,0,1,224,31,255
p_82,0,14,e_1,550,678,740,15,0,0,6,4,0,1,128,62,190
p_81,0,14,e_1,551,678,740,15,0,0,6,4,0,1,127,62,189
p_79,0,14,e_1,553,678,740,15,0,0,5,4,0,1,125,62,187
p_111,0,8,e_0,491,708,744,15,0,0,3,4,0,1,217,36,253
p_85,0,15,e_1,545,678,745,15,0,0,8,4,0,1,133,67,200
p_115,0,9,e_0,487,708,749,15,0,0,4,4,0,1,221,41,262
p_117,0,10,e_0,485,708,754,15,0,0,5,4,0,1,223,46,269
p_116,0,10,e_0,486,708,754,15,0,0,4,4,0,1,222,46,268
p_112,0,11,e_0,490,708,759,15,0,0,3,4,0,1,218,51,269
p_110,0,11,e_0,492,708,759,15,0,0,2,4,0,1,216,51,267
p_107,0,11,e_0,499,708,759,15,0,0,0,3,0,0,209,51,260
p_22,0,3,e_2,719,756,767,15,0,0,12,4,0,1,37,11,48
p_21,0,4,e_2,731,756,772,15,0,0,8,4,0,1,25,16,41
p_109,0,15,e_0,493,708,773,15,0,0,2,4,0,1,215,65,280
p_19,0,11,e_2,754,756,795,15,0,0,0,4,0,1,2,39,41
p_23,0,12,e_2,711,756,800,15,0,0,14,3,0,0,45,44,89
p_77,0,3,e_1,557,792,803,15,0,0,4,4,0,1,235,11,246
p_72,0,3,e_1,562,792,803,15,0,0,2,4,0,1,230,11,241
p_71,0,3,e_1,564,792,803,15,0,0,2,4,0,1,228,11,239
p_70,0,3,e_1,565,792,803,15,0,0,1,4,0,1,227,11,238
p_67,0,3,e_1,568,792,803,15,0,0,0,4,0,1,224,11,235
p_66,0,3,e_1,569,792,803,15,0,0,0,3,0,0,223,11,234
p_20,0,14,e_2,734,756,808,15,0,0,7,4,0,1,22,52,74
p_75,0,5,e_1,559,792,811,15,0,0,3,4,0,1,233,19,252
p_76,0,6,e_1,558,792,816,15,0,0,4,4,0,1,234,24,258
p_32,0,6,e_1,650,792,816,15,0,0,9,4,0,1,142,24,166
p_74,0,7,e_1,560,792,821,15,0,0,3,4,0,1,232,29,261
p_55,0,3,e_0,585,820,831,15,0,0,5,4,0,1,235,11,246
p_54,0,3,e_0,586,820,831,15,0,0,4,4,0,1,234,11,245
p_52,0,3,e_0,588,820,831,15,0,0,4,4,0,1,232,11,243
p_73,0,11,e_1,561,792,835,15,0,0,3,4,0,1,231,43,274
p_34,0,12,e_1,646,792,840,15,0,0,10,4,0,1,146,48,194
p_61,0,6,e_0,579,820,842,15,0,0,7,4,0,1,241,22,263
p_56,0,6,e_0,584,820,842,15,0,0,5,4,0,1,236,22,258
p_68,0,13,e_1,567,792,845,15,0,0,1,4,0,1,225,53,278
p_50,0,7,e_0,590,820,847,15,0,0,3,4,0,1,230,27,257
p_69,0,14,e_1,566,792,850,15,0,0,1,4,0,1,226,58,284
p_53,0,9,e_0,587,820,855,15,0,0,4,4,0,1,233,35,268
p_51,0,9,e_0,589,820,855,15,0,0,3,4,0,1,231,35,266
p_33,0,15,e_1,649,792,855,15,0,0,9,4,0,1,143,63,206
p_60,0,10,e_0,580,820,860,15,0,0,6,4,0,1,240,40,280
p_58,0,11,e_0,582,820,865,15,0,0,6,4,0,1,238,45,283
p_57,0,11,e_0,583,820,865,15,0,0,5,4,0,1,237,45,282
p_63,0,13,e_0,577,820,873,15,0,0,7,4,0,1,243,53,296
p_62,0,13,e_0,578,820,873,15,0,0,7,4,0,1,242,53,295
p_59,0,14,e_0,581,820,878,15,0,0,6,4,0,1,239,58,297
p_49,0,14,e_0,591,820,878,15,0,0,3,4,0,1,229,58,287
p_9,0,2,e_2,846,880,888,15,0,0,11,4,0,1,34,8,42
p_6,0,3,e_2,877,880,893,15,0,0,1,4,0,1,3,13,16
p_7,0,5,e_2,875,880,901,15,0,0,1,4,0,1,5,21,26
p_4,0,1,e_1,886,902,907,15,0,0,5,4,0,1,16,5,21
p_16,0,2,e_1,780,902,912,15,0,0,4,4,0,1,122,10,132
p_10,0,8,e_2,835,880,912,15,0,0,14,3,0,0,45,32,77
p_30,0,3,e_1,668,902,917,15,0,0,3,4,0,1,234,15,249
p_8,0,11,e_2,874,880,923,15,0,0,2,4,0,1,6,43,49
p_29,0,5,e_1,670,902,925,15,0,0,2,4,0,1,232,23,255
p_1,0,5,e_1,894,902,925,15,0,0,2,4,0,1,8,23,31
p_45,0,2,e_0,595,922,930,15,0,0,1,4,0,1,327,8,335
p_24,0,2,e_0,695,922,930,15,0,0,4,4,0,1,227,8,235
p_31,0,6,e_1,666,902,930,15,0,0,4,4,0,1,236,28,264
p_48,0,4,e_0,592,922,938,15,0,0,2,4,0,1,330,16,346
p_46,0,4,e_0,594,922,938,15,0,0,2,4,0,1,328,16,344
p_14,0,4,e_0,794,922,938,15,0,0,8,4,0,1,128,16,144
p_5,0,8,e_1,883,902,938,15,0,0,6,4,0,1,19,36,55
p_3,0,8,e_1,888,902,938,15,0,0,4,4,0,1,14,36,50
p_42,0,6,e_0,598,922,946,15,0,0,0,4,0,1,324,24,348
p_27,0,10,e_1,677,902,946,15,0,0,0,3,0,0,225,44,269
p_18,0,10,e_1,766,902,946,15,0,0,8,4,0,1,136,44,180
p_17,0,10,e_1,776,902,946,15,0,0,5,4,0,1,126,44,170
p_43,0,7,e_0,597,922,951,15,0,0,1,4,0,1,325,29,354
p_28,0,11,e_1,676,902,951,15,0,0,0,4,0,1,226,49,275
p_2,0,11,e_1,892,902,951,15,0,0,3,4,0,1,10,49,59
p_44,0,8,e_0,596,922,956,15,0,0,1,4,0,1,326,34,360
p_26,0,8,e_0,684,922,956,15,0,0,8,4,0,1,238,34,272
p_25,0,8,e_0,686,922,956,15,0,0,7,4,0,1,236,34,270
p_47,0,9,e_0,593,922,961,15,0,0,2,4,0,1,329,39,368
p_15,0,9,e_0,793,922,961,15,0,0,9,4,0,1,129,39,168
p_11,0,9,e_0,807,922,961,15,0,0,4,4,0,1,115,39,154
p_13,0,11,e_0,796,922,969,15,0,0,8,4,0,1,126,47,173
p_12,0,11,e_0,798,922,969,15,0,0,7,4,0,1,124,47,171
p_300,0,4,e_0,8,9,25,0,0,0,0,3,0,0,1,16,17
p_299,0,5,e_1,9,10,29,0,0,0,0,3,0,0,1,19,20
p_297,0,6,e_3,15,16,38,0,0,0,0,3,0,0,1,22,23
p_298,0,9,e_2,11,12,43,0,0,0,0,3,0,0,1,31,32
p_296,0,4,e_0,28,43,57,9,1,1,4,3,0,0,15,14,29
p_286,0,3,e_1,46,47,60,6,0,0,0,3,0,0,1,13,14
p_292,0,6,e_0,38,43,65,6,0,0,1,4,0,1,5,22,27
p_290,0,6,e_0,40,43,65,6,0,0,1,4,0,1,3,22,25
p_289,0,4,e_1,43,47,65,6,0,0,1,4,0,1,4,18,22
p_295,0,5,e_1,29,47,70,9,1,1,5,3,0,0,18,23,41
p_287,0,5,e_1,45,47,70,6,0,0,0,4,0,1,2,23,25
p_288,0,8,e_1,44,47,81,6,0,0,1,4,0,1,3,34,37
p_281,0,1,e_3,73,74,81,0,0,0,0,3,0,0,1,7,8
p_291,0,11,e_0,39,43,82,6,0,0,1,4,0,1,4,39,43
p_294,0,12,e_0,31,43,87,8,1,1,4,4,0,1,12,44,56
p_293,0,12,e_0,33,43,87,7,1,1,3,4,0,1,10,44,54
p_278,0,2,e_2,77,84,92,18,4,4,2,4,0,1,7,8,15
p_285,0,4,e_3,53,74,92,6,0,0,6,3,0,0,21,18,39
p_284,0,4,e_2,54,84,100,6,1,0,9,3,0,0,30,16,46
p_282,0,7,e_3,66,74,103,2,1,0,2,4,0,1,8,29,37
p_279,0,5,e_2,76,84,105,18,4,4,2,4,0,1,8,21,29
p_277,0,6,e_2,82,84,110,17,3,3,0,4,0,1,2,26,28
p_283,0,9,e_3,57,74,111,5,1,0,5,4,0,1,17,37,54
p_273,0,4,e_1,110,111,127,9,0,0,0,3,0,0,1,16,17
p_280,0,14,e_2,75,84,136,18,4,4,3,4,0,1,9,52,61
p_274,0,8,e_1,88,111,141,15,3,3,7,4,0,1,23,30,53
p_271,0,1,e_3,121,143,148,7,1,0,7,4,0,1,22,5,27
p_276,0,11,e_1,84,111,152,16,3,3,8,3,0,0,27,41,68
p_275,0,14,e_1,86,111,163,16,3,3,8,4,0,1,25,52,77
p_270,0,9,e_3,122,143,174,7,1,0,7,4,0,1,21,31,52
p_269,0,9,e_3,127,143,174,5,1,0,5,4,0,1,16,31,47
p_272,0,10,e_3,113,143,179,9,0,0,9,3,0,0,30,36,66
p_268,0,2,e_0,144,183,193,20,3,3,12,3,0,0,39,10,49
p_267,0,1,e_2,148,193,198,19,2,2,14,3,0,0,45,5,50
p_265,0,4,e_0,152,183,201,18,2,2,10,4,0,1,31,18,49
p_262,0,5,e_0,157,183,206,16,2,2,8,4,0,1,26,23,49
p_261,0,5,e_0,164,183,206,14,2,2,6,4,0,1,19,23,42
p_255,0,3,e_2,184,193,206,10,0,0,3,4,0,1,9,13,22
p_266,0,6,e_0,151,183,211,18,2,2,10,4,0,1,32,28,60
p_254,0,4,e_2,187,193,211,10,0,0,2,4,0,1,6,18,24
p_263,0,7,e_0,154,183,216,17,2,2,9,4,0,1,29,33,62
p_260,0,7,e_0,165,183,216,14,2,2,6,4,0,1,18,33,51
p_258,0,7,e_0,168,183,216,13,2,2,5,4,0,1,15,33,48
p_253,0,5,e_2,190,193,216,10,0,0,1,4,0,1,3,23,26
p_256,0,10,e_0,182,183,227,10,0,0,0,3,0,0,1,44,45
p_264,0,11,e_0,153,183,232,18,2,2,10,4,0,1,30,49,79
p_257,0,14,e_0,169,183,243,12,2,2,4,4,0,1,14,60,74
p_250,0,2,e_2,217,235,243,7,1,0,5,3,0,0,18,8,26
p_259,0,15,e_0,167,183,248,13,2,2,5,4,0,1,16,65,81
p_252,0,5,e_3,205,238,255,10,0,0,10,3,0,0,33,17,50
p_248,0,5,e_2,246,251,270,28,2,2,1,4,0,1,5,19,24
p_247,0,5,e_2,250,251,270,26,2,2,0,3,0,0,1,19,20
p_249,0,6,e_2,239,251,275,30,2,2,1,5,1,0,12,24,36
p_251,0,15,e_3,209,238,287,9,1,0,9,4,0,1,29,49,78
p_241,0,1,e_2,283,298,303,16,1,1,5,4,0,1,15,5,20
p_236,0,1,e_1,305,307,312,15,0,0,0,4,0,1,2,5,7
p_233,0,1,e_0,311,317,322,15,0,0,2,4,0,1,6,5,11
p_242,0,8,e_2,277,298,326,18,1,1,6,3,0,0,21,28,49
p_237,0,7,e_1,304,307,332,15,0,0,1,4,0,1,3,25,28
p_232,0,5,e_0,314,317,336,15,0,0,1,4,0,1,3,19,22
p_240,0,9,e_1,301,307,340,15,0,0,2,4,0,1,6,33,39
p_245,0,7,e_0,269,317,344,21,1,1,15,3,0,0,48,27,75
p_246,0,10,e_1,262,307,345,23,1,1,14,3,0,0,45,38,83
p_235,0,8,e_0,308,317,349,15,0,0,3,4,0,1,9,32,41
p_234,0,8,e_0,310,317,349,15,0,0,2,4,0,1,7,32,39
p_239,0,11,e_1,302,307,350,15,0,0,1,4,0,1,5,43,48
p_244,0,12,e_1,271,307,355,20,1,1,12,4,0,1,36,48,84
p_216,0,1,e_2,347,352,359,6,1,0,1,4,0,1,5,7,12
p_238,0,13,e_1,303,307,360,15,0,0,1,4,0,1,4,53,57
p_226,0,2,e_2,329,352,364,12,1,0,7,4,0,1,23,12,35
p_223,0,2,e_2,336,352,364,9,1,0,5,4,0,1,16,12,28
p_243,0,15,e_1,272,307,368,20,1,1,11,4,0,1,35,61,96
p_214,0,3,e_2,349,352,369,5,1,0,1,4,0,1,3,17,20
p_228,0,4,e_2,325,352,374,13,1,0,8,2,1,0,27,22,49
p_209,0,2,e_3,357,365,375,2,1,0,2,4,0,1,8,10,18
p_205,0,2,e_3,362,365,375,1,1,0,1,4,0,1,3,10,13
p_225,0,5,e_2,330,352,379,11,1,0,7,4,0,1,22,27,49
p_224,0,5,e_2,331,352,379,11,1,0,7,4,0,1,21,27,48
p_222,0,5,e_2,337,352,379,9,1,0,5,4,0,1,15,27,42
p_219,0,5,e_2,342,352,379,7,1,0,3,4,0,1,10,27,37
p_230,0,3,e_3,319,365,380,15,1,0,15,4,0,1,46,15,61
p_221,0,6,e_2,339,352,384,8,1,0,4,4,0,1,13,32,45
p_220,0,6,e_2,341,352,384,8,1,0,3,4,0,1,11,32,43
p_217,0,7,e_2,346,352,389,6,1,0,2,4,0,1,6,37,43
p_210,0,6,e_3,354,365,391,3,1,0,3,4,0,1,11,26,37
p_208,0,6,e_3,358,365,391,2,1,0,2,4,0,1,7,26,33
p_231,0,7,e_3,317,365,396,15,0,0,15,3,0,0,48,31,79
p_190,0,1,e_0,379,392,399,27,7,7,4,4,0,1,13,7,20
p_218,0,11,e_2,343,352,403,7,1,0,3,4,0,1,9,51,60
p_227,0,12,e_2,327,352,408,12,1,0,8,4,0,1,25,56,81
p_200,0,4,e_0,367,392,410,30,9,9,8,4,0,1,25,18,43
p_196,0,4,e_0,371,392,410,29,9,9,7,4,0,1,21,18,39
p_207,0,11,e_3,359,365,410,2,1,0,2,4,0,1,6,45,51
p_201,0,5,e_0,366,392,415,30,9,9,8,4,0,1,26,23,49
p_206,0,12,e_3,361,365,415,1,1,0,1,4,0,1,4,50,54
p_203,0,12,e_3,364,365,415,0,0,0,0,3,0,0,1,50,51
p_215,0,15,e_2,348,352,419,5,1,0,1,4,0,1,4,67,71
p_194,0,6,e_0,373,392,420,28,9,9,6,4,0,1,19,28,47
p_229,0,13,e_3,320,365,420,15,1,0,15,4,0,1,45,55,100
p_204,0,14,e_3,363,365,425,0,1,0,0,4,0,1,2,60,62
p_192,0,8,e_0,375,392,428,28,8,8,5,4,0,1,17,36,53
p_189,0,8,e_0,382,392,428,27,7,7,3,4,0,1,10,36,46
p_211,0,15,e_3,353,365,430,4,1,0,4,4,0,1,12,65,77
p_198,0,9,e_0,369,392,433,30,9,9,7,4,0,1,23,41,64
p_197,0,10,e_0,370,392,438,29,9,9,7,4,0,1,22,46,68
p_191,0,10,e_0,376,392,438,28,8,8,5,4,0,1,16,46,62
p_193,0,11,e_0,374,392,443,28,8,8,6,4,0,1,18,51,69
p_183,0,1,e_1,396,440,445,23,5,5,14,4,0,1,44,5,49
p_182,0,2,e_1,397,440,450,23,5,5,14,4,0,1,43,10,53
p_180,0,2,e_1,399,440,450,22,5,5,13,4,0,1,41,10,51
p_188,0,13,e_0,384,392,451,26,7,7,2,4,0,1,8,59,67
p_178,0,3,e_1,401,440,455,22,5,5,13,4,0,1,39,15,54
p_202,0,15,e_0,365,392,459,30,10,10,8,3,0,0,27,67,94
p_199,0,15,e_0,368,392,459,30,9,9,8,4,0,1,24,67,91
p_195,0,15,e_0,372,392,459,29,9,9,6,4,0,1,20,67,87
p_176,0,4,e_1,403,440,460,21,5,5,12,4,0,1,37,20,57
p_146,0,1,e_2,453,466,473,15,0,0,4,4,0,1,13,7,20
p_179,0,8,e_1,400,440,474,22,5,5,13,4,0,1,40,34,74
p_177,0,9,e_1,402,440,479,21,5,5,12,4,0,1,38,39,77
p_143,0,3,e_2,456,466,481,15,0,0,3,4,0,1,10,15,25
p_173,0,11,e_1,407,440,487,20,5,5,11,4,0,1,33,47,80
p_184,0,12,e_1,392,440,492,24,6,6,15,3,0,0,48,52,100
p_150,0,6,e_2,443,466,492,15,0,0,7,4,0,1,23,26,49
p_141,0,6,e_2,458,466,492,15,0,0,2,4,0,1,8,26,34
p_171,0,13,e_1,409,440,497,19,4,4,10,4,0,1,31,57,88
p_212,0,7,e_2,351,466,497,4,1,0,0,3,0,0,115,31,146
p_175,0,14,e_1,405,440,502,20,5,5,11,4,0,1,35,62,97
p_174,0,14,e_1,406,440,502,20,5,5,11,4,0,1,34,62,96
p_170,0,14,e_1,410,440,502,19,4,4,10,4,0,1,30,62,92
p_148,0,8,e_2,449,466,502,15,0,0,5,4,0,1,17,36,53
p_140,0,8,e_2,459,466,502,15,0,0,2,4,0,1,7,36,43
p_181,0,15,e_1,398,440,507,23,5,5,14,4,0,1,42,67,109
p_172,0,15,e_1,408,440,507,19,5,5,10,4,0,1,32,67,99
p_147,0,9,e_2,452,466,507,15,0,0,4,4,0,1,14,41,55
p_144,0,9,e_2,455,466,507,15,0,0,3,4,0,1,11,41,52
p_142,0,9,e_2,457,466,507,15,0,0,3,4,0,1,9,41,50
p_130,0,1,e_0,472,506,511,14,1,0,11,4,0,1,34,5,39
p_145,0,11,e_2,454,466,515,15,0,0,4,4,0,1,12,49,61
p_129,0,3,e_0,473,506,519,13,1,0,11,4,0,1,33,13,46
p_186,0,4,e_0,390,506,524,24,6,6,0,4,0,1,116,18,134
p_213,0,15,e_2,350,466,529,5,1,0,0,4,0,1,116,63,179
p_152,0,15,e_2,441,466,529,15,0,0,8,4,0,1,25,63,88
p_151,0,15,e_2,442,466,529,15,0,0,8,4,0,1,24,63,87
p_149,0,15,e_2,444,466,529,15,0,0,7,4,0,1,22,63,85
p_124,0,7,e_0,478,506,535,12,1,0,9,4,0,1,28,29,57
p_102,0,7,e_3,509,514,539,1,1,0,1,4,0,1,5,25,30
p_101,0,8,e_3,511,514,544,1,1,0,1,4,0,1,3,30,33
p_185,0,10,e_0,391,506,546,24,6,6,0,3,0,0,115,40,155
p_127,0,10,e_0,475,506,546,13,1,0,10,4,0,1,31,40,71
p_100,0,9,e_3,513,514,549,0,0,0,0,3,0,0,1,35,36
p_132,0,11,e_0,470,506,551,14,1,0,12,4,0,1,36,45,81
p_128,0,11,e_0,474,506,551,13,1,0,10,4,0,1,32,45,77
p_123,0,11,e_0,479,506,551,11,1,0,9,4,0,1,27,45,72
p_135,0,10,e_3,466,514,554,15,0,0,15,3,0,0,48,40,88
p_187,0,12,e_0,389,506,556,24,7,7,1,4,0,1,117,50,167
p_133,0,12,e_0,469,506,556,15,1,0,12,4,0,1,37,50,87
p_126,0,12,e_0,476,506,556,12,1,0,10,4,0,1,30,50,80
p_103,0,11,e_3,508,514,559,2,1,0,2,4,0,1,6,45,51
p_167,0,1,e_1,413,554,561,18,4,4,9,4,0,1,141,7,148
p_161,0,1,e_1,421,554,561,17,2,2,6,4,0,1,133,7,140
p_158,0,1,e_1,430,554,561,15,0,0,3,4,0,1,124,7,131
p_131,0,14,e_0,471,506,564,14,1,0,11,4,0,1,35,58,93
p_125,0,14,e_0,477,506,564,12,1,0,9,4,0,1,29,58,87
p_134,0,15,e_0,467,506,569,15,1,0,13,4,0,1,39,63,102
p_165,0,4,e_1,417,554,572,18,3,3,7,4,0,1,137,18,155
p_159,0,6,e_1,429,554,580,15,0,0,3,4,0,1,125,26,151
p_136,0,3,e_2,465,576,587,15,0,0,0,3,0,0,111,11,122
p_77,0,3,e_2,557,576,587,11,1,1,6,4,0,1,19,11,30
p_72,0,3,e_2,562,576,587,11,0,0,4,4,0,1,14,11,25
p_71,0,3,e_2,564,576,587,11,0,0,4,4,0,1,12,11,23
p_70,0,3,e_2,565,576,587,11,0,0,3,4,0,1,11,11,22
p_169,0,9,e_1,411,554,591,19,4,4,9,4,0,1,143,37,180
p_137,0,4,e_2,464,576,592,15,0,0,0,4,0,1,112,16,128
p_163,0,10,e_1,419,554,596,17,2,2,7,4,0,1,135,42,177
p_75,0,5,e_2,559,576,597,11,0,0,5,4,0,1,17,21,38
p_164,0,11,e_1,418,554,601,17,3,3,7,4,0,1,136,47,183
p_162,0,11,e_1,420,554,601,17,2,2,6,4,0,1,134,47,181
p_76,0,6,e_2,558,576,602,11,0,0,6,4,0,1,18,26,44
p_166,0,12,e_1,416,554,606,18,3,3,8,4,0,1,138,52,190
p_74,0,7,e_2,560,576,607,11,0,0,5,4,0,1,16,31,47
p_168,0,13,e_1,412,554,611,19,4,4,9,4,0,1,142,57,199
p_157,0,14,e_1,431,554,616,15,0,0,3,4,0,1,123,62,185
p_155,0,14,e_1,435,554,616,15,0,0,1,4,0,1,119,62,181
p_139,0,10,e_2,461,576,618,15,0,0,1,4,0,1,115,42,157
p_160,0,15,e_1,426,554,621,16,1,1,4,4,0,1,128,67,195
p_156,0,15,e_1,434,554,621,15,0,0,2,4,0,1,120,67,187
p_119,0,1,e_0,483,616,623,10,1,0,7,4,0,1,133,7,140
p_113,0,1,e_0,489,616,623,8,1,0,5,4,0,1,127,7,134
p_138,0,11,e_2,463,576,623,15,0,0,1,4,0,1,113,47,160
p_73,0,11,e_2,561,576,623,11,0,0,5,4,0,1,15,47,62
p_55,0,3,e_3,585,613,624,9,1,0,9,4,0,1,28,11,39
p_54,0,3,e_3,586,613,624,9,1,0,9,4,0,1,27,11,38
p_52,0,3,e_3,588,613,624,8,1,0,8,4,0,1,25,11,36
p_78,0,12,e_2,556,576,628,12,1,1,6,4,0,1,20,52,72
p_114,0,3,e_0,488,616,631,8,1,0,6,4,0,1,128,15,143
p_68,0,13,e_2,567,576,633,11,0,0,3,4,0,1,9,57,66
p_61,0,6,e_3,579,613,635,11,1,0,11,4,0,1,34,22,56
p_56,0,6,e_3,584,613,635,9,1,0,9,4,0,1,29,22,51
p_69,0,14,e_2,566,576,638,11,0,0,3,4,0,1,10,62,72
p_50,0,7,e_3,590,613,640,7,1,0,7,4,0,1,23,27,50
p_108,0,6,e_0,496,616,642,6,1,0,3,4,0,1,120,26,146
p_118,0,7,e_0,484,616,647,10,1,0,7,4,0,1,132,31,163
p_53,0,9,e_3,587,613,648,8,1,0,8,4,0,1,26,35,61
p_51,0,9,e_3,589,613,648,8,1,0,8,4,0,1,24,35,59
p_111,0,8,e_0,491,616,652,7,1,0,5,4,0,1,125,36,161
p_60,0,10,e_3,580,613,653,11,1,0,11,4,0,1,33,40,73
p_115,0,9,e_0,487,616,657,9,1,0,6,4,0,1,129,41,170
p_58,0,11,e_3,582,613,658,10,1,0,10,4,0,1,31,45,76
p_57,0,11,e_3,583,613,658,10,1,0,10,4,0,1,30,45,75
p_117,0,10,e_0,485,616,662,9,1,0,7,4,0,1,131,46,177
p_116,0,10,e_0,486,616,662,9,1,0,6,4,0,1,130,46,176
p_63,0,13,e_3,577,613,666,11,0,0,11,3,0,0,36,53,89
p_62,0,13,e_3,578,613,666,11,1,0,11,4,0,1,35,53,88
p_121,0,11,e_0,481,616,667,11,1,0,8,4,0,1,135,51,186
p_120,0,11,e_0,482,616,667,10,1,0,8,4,0,1,134,51,185
p_112,0,11,e_0,490,616,667,8,1,0,5,4,0,1,126,51,177
p_110,0,11,e_0,492,616,667,7,1,0,4,4,0,1,124,51,175
p_59,0,14,e_3,581,613,671,10,1,0,10,4,0,1,32,58,90
p_49,0,14,e_3,591,613,671,7,1,0,7,4,0,1,22,58,80
p_96,0,1,e_1,517,668,673,22,5,5,12,4,0,1,151,5,156
p_122,0,15,e_0,480,616,681,11,1,0,8,4,0,1,136,65,201
p_109,0,15,e_0,493,616,681,7,1,0,4,4,0,1,123,65,188
p_92,0,4,e_1,525,668,684,19,5,5,9,4,0,1,143,16,159
p_65,0,1,e_2,573,682,687,11,0,0,1,4,0,1,109,5,114
p_88,0,5,e_1,538,668,689,15,4,4,5,4,0,1,130,21,151
p_99,0,6,e_1,514,668,694,22,6,6,13,4,0,1,154,26,180
p_94,0,6,e_1,519,668,694,21,5,5,11,4,0,1,149,26,175
p_67,0,3,e_2,568,682,695,11,0,0,2,4,0,1,114,13,127
p_66,0,3,e_2,569,682,695,11,0,0,2,4,0,1,113,13,126
p_30,0,3,e_2,668,682,695,15,2,2,4,4,0,1,14,13,27
p_154,0,7,e_1,436,668,699,15,0,0,1,4,0,1,232,31,263
p_98,0,7,e_1,515,668,699,22,5,5,13,4,0,1,153,31,184
p_97,0,7,e_1,516,668,699,22,5,5,12,4,0,1,152,31,183
p_64,0,4,e_2,574,682,700,11,0,0,0,4,0,1,108,18,126
p_87,0,8,e_1,539,668,704,15,4,4,5,4,0,1,129,36,165
p_29,0,5,e_2,670,682,705,14,1,1,4,4,0,1,12,23,35
p_153,0,9,e_1,437,668,709,15,0,0,1,4,0,1,231,41,272
p_89,0,9,e_1,535,668,709,16,5,5,6,4,0,1,133,41,174
p_91,0,12,e_1,526,668,720,19,5,5,9,4,0,1,142,52,194
p_27,0,10,e_2,677,682,722,12,1,0,1,4,0,1,5,40,45
p_45,0,2,e_3,595,715,723,6,1,0,6,4,0,1,120,8,128
p_24,0,2,e_3,695,715,723,6,1,0,6,4,0,1,20,8,28
p_93,0,13,e_1,520,668,725,21,5,5,11,4,0,1,148,57,205
p_90,0,13,e_1,527,668,725,19,5,5,9,4,0,1,141,57,198
p_28,0,11,e_2,676,682,727,13,1,0,2,4,0,1,6,45,51
p_95,0,14,e_1,518,668,730,22,5,5,12,4,0,1,150,62,212
p_48,0,4,e_3,592,715,731,7,1,0,7,4,0,1,123,16,139
p_46,0,4,e_3,594,715,731,6,1,0,6,4,0,1,121,16,137
p_106,0,3,e_0,500,728,739,4,1,0,2,4,0,1,228,11,239
p_22,0,3,e_0,719,728,739,25,9,9,3,4,0,1,9,11,20
p_42,0,6,e_3,598,715,739,5,1,0,5,4,0,1,117,24,141
p_43,0,7,e_3,597,715,744,5,1,0,5,4,0,1,118,29,147
p_44,0,8,e_3,596,715,749,5,1,0,5,4,0,1,119,34,153
p_26,0,8,e_3,684,715,749,10,1,0,10,4,0,1,31,34,65
p_25,0,8,e_3,686,715,749,9,1,0,9,4,0,1,29,34,63
p_47,0,9,e_3,593,715,754,6,1,0,6,4,0,1,122,39,161
p_37,0,9,e_0,615,728,759,28,8,8,0,3,0,0,113,31,144
p_41,0,11,e_3,600,715,762,4,1,0,4,4,0,1,115,47,162
p_107,0,11,e_0,499,728,767,5,1,0,2,4,0,1,229,39,268
p_39,0,12,e_3,607,715,767,2,1,0,2,4,0,1,108,52,160
p_23,0,12,e_3,711,715,767,1,1,0,1,4,0,1,4,52,56
p_105,0,12,e_0,502,728,772,4,1,0,1,4,0,1,226,44,270
p_40,0,13,e_3,602,715,772,3,1,0,3,4,0,1,113,57,170
p_38,0,13,e_3,608,715,772,1,1,0,1,4,0,1,107,57,164
p_104,0,14,e_0,503,728,780,3,1,0,1,4,0,1,225,52,277
p_86,0,2,e_1,544,774,782,14,3,3,3,4,0,1,230,8,238
p_21,0,4,e_2,731,767,783,22,7,7,11,3,0,0,36,16,52
p_32,0,6,e_1,650,774,796,19,5,5,6,4,0,1,124,22,146
p_31,0,6,e_1,666,774,796,15,2,2,0,4,0,1,108,22,130
p_80,0,7,e_1,552,774,801,12,2,2,0,4,0,1,222,27,249
p_18,0,10,e_2,766,767,803,14,1,1,0,3,0,0,1,36,37
p_83,0,8,e_1,549,774,806,13,2,2,1,4,0,1,225,32,257
p_19,0,11,e_2,754,767,808,17,3,3,4,4,0,1,13,41,54
p_35,0,9,e_1,630,774,811,23,8,8,12,4,0,1,144,37,181
p_20,0,14,e_2,734,767,819,21,7,7,11,4,0,1,33,52,85
p_84,0,12,e_1,546,774,822,14,3,3,2,4,0,1,228,48,276
p_34,0,12,e_1,646,774,822,19,6,6,7,4,0,1,128,48,176
p_36,0,13,e_1,628,774,827,24,8,8,13,4,0,1,146,53,199
p_82,0,14,e_1,550,774,832,13,2,2,1,4,0,1,224,58,282
p_81,0,14,e_1,551,774,832,13,2,2,1,4,0,1,223,58,281
p_79,0,14,e_1,553,774,832,12,1,1,0,3,0,0,221,58,279
p_14,0,4,e_3,794,818,832,8,1,0,8,4,0,1,24,14,38
p_16,0,2,e_0,780,825,833,12,1,0,14,3,0,0,45,8,53
p_85,0,15,e_1,545,774,837,14,3,3,3,4,0,1,229,63,292
p_33,0,15,e_1,649,774,837,19,5,5,6,4,0,1,125,63,188
p_15,0,9,e_3,793,818,849,8,1,0,8,4,0,1,25,31,56
p_11,0,9,e_3,807,818,849,3,1,0,3,4,0,1,11,31,42
p_17,0,10,e_3,776,818,854,13,0,0,13,3,0,0,42,36,78
p_13,0,11,e_3,796,818,859,7,1,0,7,4,0,1,22,41,63
p_12,0,11,e_3,798,818,859,6,1,0,6,4,0,1,20,41,61
p_10,0,8,e_0,835,844,870,17,3,3,2,3,0,0,9,26,35
p_4,0,1,e_2,886,891,896,11,0,0,1,4,0,1,5,5,10
p_9,0,2,e_2,846,891,901,14,3,3,14,3,0,0,45,10,55
p_6,0,3,e_2,877,891,906,11,0,0,4,4,0,1,14,15,29
p_7,0,5,e_2,875,891,914,11,0,0,5,4,0,1,16,23,39
p_1,0,5,e_0,894,901,918,11,0,0,2,4,0,1,7,17,24
p_5,0,8,e_2,883,891,925,11,0,0,2,4,0,1,8,34,42
p_3,0,8,e_2,888,891,925,11,0,0,1,4,0,1,3,34,37
p_8,0,11,e_0,874,901,938,11,0,0,8,3,0,0,27,37,64
p_2,0,11,e_0,892,901,938,11,0,0,3,4,0,1,9,37,46
p_300,0,4,e_0,8,9,25,0,0,0,0,3,0,0,1,16,17
p_299,0,5,e_1,9,10,29,0,0,0,0,3,0,0,1,19,20
p_297,0,6,e_3,15,16,38,0,0,0,0,3,0,0,1,22,23
p_298,0,9,e_2,11,12,43,0,0,0,0,3,0,0,1,31,32
p_296,0,4,e_0,28,43,57,9,1,1,4,3,0,0,15,14,29
p_295,0,5,e_0,29,43,62,9,1,1,4,4,0,1,14,19,33
p_292,0,6,e_0,38,43,67,6,0,0,1,4,0,1,5,24,29
p_290,0,6,e_0,40,43,67,6,0,0,1,4,0,1,3,24,27
p_286,0,3,e_1,46,61,72,6,0,0,5,4,0,1,15,11,26
p_289,0,4,e_1,43,61,77,6,0,0,5,3,0,0,18,16,34
p_285,0,4,e_1,53,61,77,6,0,0,2,4,0,1,8,16,24
p_284,0,4,e_1,54,61,77,6,0,0,2,4,0,1,7,16,23
p_287,0,5,e_1,45,61,82,6,0,0,5,4,0,1,16,21,37
p_291,0,11,e_0,39,43,84,6,0,0,1,4,0,1,4,41,45
p_294,0,12,e_0,31,43,89,8,1,1,4,4,0,1,12,46,58
p_293,0,12,e_0,33,43,89,7,1,1,3,4,0,1,10,46,56
p_288,0,8,e_1,44,61,93,6,0,0,5,4,0,1,17,32,49
p_281,0,1,e_3,73,87,94,4,1,0,4,4,0,1,14,7,21
p_283,0,9,e_1,57,61,98,6,0,0,1,4,0,1,4,37,41
p_278,0,2,e_3,77,87,99,3,1,0,3,4,0,1,10,12,22
p_279,0,5,e_3,76,87,110,3,1,0,3,4,0,1,11,23,34
p_277,0,6,e_3,82,87,115,1,1,0,1,4,0,1,5,28,33
p_282,0,7,e_3,66,87,120,6,0,0,6,3,0,0,21,33,54
p_273,0,4,e_2,110,118,132,23,4,4,2,4,0,1,8,14,22
p_276,0,11,e_3,84,87,134,1,1,0,1,4,0,1,3,47,50
p_280,0,14,e_3,75,87,145,4,1,0,4,4,0,1,12,58,70
p_275,0,14,e_3,86,87,145,0,0,0,0,3,0,0,1,58,59
p_274,0,8,e_2,88,118,146,28,7,7,9,3,0,0,30,28,58
p_272,0,10,e_2,113,118,154,22,4,4,1,4,0,1,5,36,41
p_271,0,1,e_1,121,151,156,21,2,2,9,3,0,0,30,5,35
p_267,0,1,e_1,148,151,156,14,0,0,1,4,0,1,3,5,8
p_268,0,2,e_1,144,151,161,14,0,0,2,4,0,1,7,10,17
p_270,0,9,e_1,122,151,184,21,2,2,9,4,0,1,29,33,62
p_269,0,9,e_1,127,151,184,19,2,2,8,4,0,1,24,33,57
p_255,0,3,e_2,184,186,197,14,0,0,0,4,0,1,2,11,13
p_265,0,4,e_2,152,186,202,14,0,0,10,5,1,0,34,16,50
p_254,0,4,e_0,187,190,204,14,0,0,1,4,0,1,3,14,17
p_262,0,5,e_2,157,186,207,14,0,0,9,4,0,1,29,21,50
p_261,0,5,e_2,164,186,207,14,0,0,7,4,0,1,22,21,43
p_266,0,6,e_0,151,190,212,14,0,0,12,3,0,0,39,22,61
p_263,0,7,e_2,154,186,215,14,0,0,10,4,0,1,32,29,61
p_260,0,7,e_2,165,186,215,14,0,0,7,4,0,1,21,29,50
p_258,0,7,e_2,168,186,215,14,0,0,6,4,0,1,18,29,47
p_256,0,10,e_2,182,186,226,14,0,0,1,4,0,1,4,40,44
p_250,0,2,e_1,217,220,228,14,0,0,1,4,0,1,3,8,11
p_264,0,11,e_2,153,186,231,14,0,0,10,2,1,1,33,45,78
p_253,0,5,e_1,190,220,239,14,0,0,9,3,0,0,30,19,49
p_252,0,5,e_1,205,220,239,14,0,0,5,4,0,1,15,19,34
p_257,0,14,e_2,169,186,242,14,0,0,5,4,0,1,17,56,73
p_259,0,15,e_2,167,186,247,14,0,0,6,4,0,1,19,61,80
p_251,0,15,e_1,209,220,271,14,0,0,3,4,0,1,11,51,62
p_248,0,5,e_0,246,260,277,14,0,0,4,4,0,1,14,17,31
p_247,0,5,e_0,250,260,277,14,0,0,3,4,0,1,10,17,27
p_249,0,6,e_0,239,260,282,14,0,0,6,3,0,0,21,22,43
p_241,0,1,e_0,283,302,309,8,1,0,6,4,0,1,19,7,26
p_236,0,1,e_3,305,307,312,0,1,0,0,4,0,1,2,5,7
p_242,0,8,e_0,277,302,332,10,1,0,5,5,1,0,25,30,55
p_245,0,7,e_3,269,307,332,12,1,0,12,4,0,1,38,25,63
p_237,0,7,e_3,304,307,332,1,1,0,1,4,0,1,3,25,28
p_240,0,9,e_0,301,302,337,2,1,0,0,3,0,0,1,35,36
p_246,0,10,e_3,262,307,343,14,0,0,14,3,0,0,45,36,81
p_239,0,11,e_3,302,307,348,1,1,0,1,4,0,1,5,41,46
p_244,0,12,e_3,271,307,353,12,1,0,12,4,0,1,36,46,82
p_238,0,13,e_3,303,307,358,1,1,0,1,4,0,1,4,51,55
p_233,0,1,e_1,311,356,361,29,6,6,15,4,0,1,45,5,50
p_226,0,2,e_1,329,356,366,24,6,6,9,4,0,1,27,10,37
p_223,0,2,e_1,336,356,366,22,5,5,6,4,0,1,20,10,30
p_243,0,15,e_3,272,307,366,11,1,0,11,4,0,1,35,59,94
p_209,0,2,e_2,357,358,368,17,1,1,0,3,0,0,1,10,11
p_230,0,3,e_1,319,356,371,27,6,6,12,4,0,1,37,15,52
p_228,0,4,e_1,325,356,376,25,6,6,10,4,0,1,31,20,51
p_232,0,5,e_1,314,356,381,29,6,6,14,4,0,1,42,25,67
p_225,0,5,e_1,330,356,381,23,6,6,8,4,0,1,26,25,51
p_224,0,5,e_1,331,356,381,23,5,5,8,4,0,1,25,25,50
p_222,0,5,e_1,337,356,381,22,5,5,6,4,0,1,19,25,44
p_221,0,6,e_1,339,356,386,21,5,5,5,4,0,1,17,30,47
p_220,0,6,e_1,341,356,386,20,5,5,5,4,0,1,15,30,45
p_234,0,8,e_2,310,358,388,29,7,7,15,3,0,0,48,30,78
p_231,0,7,e_1,317,356,391,28,6,6,13,4,0,1,39,35,74
p_205,0,2,e_0,362,388,396,16,1,1,8,4,0,1,26,8,34
p_235,0,8,e_1,308,356,396,30,7,7,15,3,0,0,48,40,88
p_200,0,4,e_0,367,388,404,15,0,0,7,4,0,1,21,16,37
p_196,0,4,e_0,371,388,404,15,0,0,5,4,0,1,17,16,33
p_201,0,5,e_0,366,388,409,15,0,0,7,4,0,1,22,21,43
p_227,0,12,e_1,327,356,410,24,6,6,9,4,0,1,29,54,83
p_208,0,6,e_0,358,388,414,17,1,1,9,3,0,0,30,26,56
p_194,0,6,e_0,373,388,414,15,0,0,5,4,0,1,15,26,41
p_229,0,13,e_1,320,356,415,27,6,6,12,4,0,1,36,59,95
p_183,0,1,e_2,396,416,421,15,0,0,6,4,0,1,20,5,25
p_198,0,9,e_0,369,388,425,15,0,0,6,4,0,1,19,37,56
p_182,0,2,e_2,397,416,426,15,0,0,6,4,0,1,19,10,29
p_180,0,2,e_2,399,416,426,15,0,0,5,4,0,1,17,10,27
p_197,0,10,e_0,370,388,430,15,0,0,6,4,0,1,18,42,60
p_178,0,3,e_2,401,416,431,15,0,0,5,4,0,1,15,15,30
p_207,0,11,e_0,359,388,435,17,1,1,9,4,0,1,29,47,76
p_186,0,4,e_2,390,416,436,15,0,0,8,4,0,1,26,20,46
p_176,0,4,e_2,403,416,436,15,0,0,4,4,0,1,13,20,33
p_206,0,12,e_0,361,388,440,16,1,1,9,4,0,1,27,52,79
p_203,0,12,e_0,364,388,440,15,1,1,8,4,0,1,24,52,76
p_204,0,14,e_0,363,388,448,16,1,1,8,4,0,1,25,60,85
p_179,0,8,e_2,400,416,450,15,0,0,5,4,0,1,16,34,50
p_202,0,15,e_0,365,388,453,15,0,0,7,4,0,1,23,65,88
p_199,0,15,e_0,368,388,453,15,0,0,6,4,0,1,20,65,85
p_195,0,15,e_0,372,388,453,15,0,0,5,4,0,1,16,65,81
p_177,0,9,e_2,402,416,455,15,0,0,4,4,0,1,14,39,53
p_185,0,10,e_2,391,416,460,15,0,0,8,4,0,1,25,44,69
p_216,0,1,e_1,347,456,463,19,3,3,3,4,0,1,109,7,116
p_173,0,11,e_2,407,416,465,15,0,0,3,4,0,1,9,49,58
p_187,0,12,e_2,389,416,470,15,0,0,8,3,0,0,27,54,81
p_184,0,12,e_2,392,416,470,15,0,0,8,4,0,1,24,54,78
p_214,0,3,e_1,349,456,471,19,3,3,2,4,0,1,107,15,122
p_165,0,4,e_1,417,456,476,15,0,0,13,4,0,1,39,20,59
p_175,0,14,e_2,405,416,478,15,0,0,3,4,0,1,11,62,73
p_174,0,14,e_2,406,416,478,15,0,0,3,4,0,1,10,62,72
p_219,0,5,e_1,342,456,481,20,4,4,4,4,0,1,114,25,139
p_181,0,15,e_2,398,416,483,15,0,0,6,4,0,1,18,67,85
p_210,0,6,e_1,354,456,486,18,2,2,0,4,0,1,102,30,132
p_217,0,7,e_1,346,456,491,19,4,4,3,4,0,1,110,35,145
p_212,0,7,e_1,351,456,491,18,3,3,1,4,0,1,105,35,140
p_163,0,10,e_1,419,456,502,15,0,0,12,4,0,1,37,46,83
p_190,0,1,e_0,379,500,507,15,0,0,3,4,0,1,121,7,128
p_218,0,11,e_1,343,456,507,20,4,4,4,4,0,1,113,51,164
p_164,0,11,e_1,418,456,507,15,0,0,12,4,0,1,38,51,89
p_162,0,11,e_1,420,456,507,15,0,0,12,4,0,1,36,51,87
p_166,0,12,e_1,416,456,512,15,0,0,13,4,0,1,40,56,96
p_143,0,3,e_0,456,500,515,15,0,0,14,4,0,1,44,15,59
p_136,0,3,e_0,465,500,515,15,0,0,11,4,0,1,35,15,50
p_137,0,4,e_0,464,500,520,15,0,0,12,4,0,1,36,20,56
p_215,0,15,e_1,348,456,523,19,3,3,2,4,0,1,108,67,175
p_213,0,15,e_1,350,456,523,19,3,3,2,4,0,1,106,67,173
p_211,0,15,e_1,353,456,523,18,2,2,1,4,0,1,103,67,170
p_141,0,6,e_0,458,500,528,15,0,0,14,4,0,1,42,28,70
p_167,0,1,e_2,413,530,535,15,0,0,1,4,0,1,117,5,122
p_192,0,8,e_0,375,500,536,15,0,0,4,4,0,1,125,36,161
p_189,0,8,e_0,382,500,536,15,0,0,2,4,0,1,118,36,154
p_140,0,8,e_0,459,500,536,15,0,0,13,4,0,1,41,36,77
p_142,0,9,e_0,457,500,541,15,0,0,14,4,0,1,43,41,84
p_106,0,3,e_2,500,530,543,15,0,0,10,4,0,1,30,13,43
p_191,0,10,e_0,376,500,546,15,0,0,4,4,0,1,124,46,170
p_139,0,10,e_0,461,500,546,15,0,0,13,4,0,1,39,46,85
p_135,0,10,e_0,466,500,546,15,0,0,11,4,0,1,34,46,80
p_193,0,11,e_0,374,500,551,15,0,0,4,4,0,1,126,51,177
p_138,0,11,e_0,463,500,551,15,0,0,12,4,0,1,37,51,88
p_99,0,6,e_2,514,530,554,15,0,0,5,4,0,1,16,24,40
p_188,0,13,e_0,384,500,559,15,0,0,1,4,0,1,116,59,175
p_102,0,7,e_2,509,530,559,15,0,0,7,4,0,1,21,29,50
p_98,0,7,e_2,515,530,559,15,0,0,5,4,0,1,15,29,44
p_101,0,8,e_2,511,530,564,15,0,0,6,4,0,1,19,34,53
p_169,0,9,e_2,411,530,569,15,0,0,1,4,0,1,119,39,158
p_100,0,9,e_2,513,530,569,15,0,0,5,4,0,1,17,39,56
p_161,0,1,e_1,421,570,577,15,0,0,11,4,0,1,149,7,156
p_158,0,1,e_1,430,570,577,15,0,0,8,4,0,1,140,7,147
p_103,0,11,e_2,508,530,577,15,0,0,7,4,0,1,22,47,69
p_105,0,12,e_2,502,530,582,15,0,0,9,4,0,1,28,52,80
p_171,0,13,e_2,409,530,587,15,0,0,2,4,0,1,121,57,178
p_168,0,13,e_2,412,530,587,15,0,0,1,4,0,1,118,57,175
p_170,0,14,e_2,410,530,592,15,0,0,2,4,0,1,120,62,182
p_104,0,14,e_2,503,530,592,15,0,0,9,4,0,1,27,62,89
p_159,0,6,e_1,429,570,594,15,0,0,9,4,0,1,141,24,165
p_150,0,6,e_1,443,570,594,15,0,0,4,4,0,1,127,24,151
p_172,0,15,e_2,408,530,597,15,0,0,2,4,0,1,122,67,189
p_154,0,7,e_1,436,570,599,15,0,0,6,4,0,1,134,29,163
p_148,0,8,e_1,449,570,604,15,0,0,2,4,0,1,121,34,155
p_130,0,1,e_0,472,600,605,15,0,0,9,4,0,1,128,5,133
p_153,0,9,e_1,437,570,609,15,0,0,6,4,0,1,133,39,172
p_147,0,9,e_1,452,570,609,15,0,0,1,4,0,1,118,39,157
p_129,0,3,e_0,473,600,613,15,0,0,9,4,0,1,127,13,140
p_157,0,14,e_1,431,570,626,15,0,0,8,4,0,1,139,56,195
p_155,0,14,e_1,435,570,626,15,0,0,7,4,0,1,135,56,191
p_124,0,7,e_0,478,600,627,15,0,0,7,4,0,1,122,27,149
p_160,0,15,e_1,426,570,631,15,0,0,10,4,0,1,144,61,205
p_156,0,15,e_1,434,570,631,15,0,0,7,4,0,1,136,61,197
p_152,0,15,e_1,441,570,631,15,0,0,5,4,0,1,129,61,190
p_151,0,15,e_1,442,570,631,15,0,0,4,4,0,1,128,61,189
p_149,0,15,e_1,444,570,631,15,0,0,4,4,0,1,126,61,187
p_127,0,10,e_0,475,600,638,15,0,0,8,4,0,1,125,38,163
p_132,0,11,e_0,470,600,643,15,0,0,10,4,0,1,130,43,173
p_128,0,11,e_0,474,600,643,15,0,0,8,4,0,1,126,43,169
p_123,0,11,e_0,479,600,643,15,0,0,7,4,0,1,121,43,164
p_121,0,11,e_0,481,600,643,15,0,0,6,4,0,1,119,43,162
p_120,0,11,e_0,482,600,643,15,0,0,6,4,0,1,118,43,161
p_133,0,12,e_0,469,600,648,15,0,0,10,4,0,1,131,48,179
p_126,0,12,e_0,476,600,648,15,0,0,8,4,0,1,124,48,172
p_96,0,1,e_2,517,644,649,15,0,0,4,4,0,1,127,5,132
p_131,0,14,e_0,471,600,656,15,0,0,9,4,0,1,129,56,185
p_125,0,14,e_0,477,600,656,15,0,0,7,4,0,1,123,56,179
p_92,0,4,e_2,525,644,660,15,0,0,1,4,0,1,119,16,135
p_134,0,15,e_0,467,600,661,15,0,0,11,4,0,1,133,61,194
p_122,0,15,e_0,480,600,661,15,0,0,6,4,0,1,120,61,181
p_94,0,6,e_2,519,644,668,15,0,0,3,4,0,1,125,24,149
p_97,0,7,e_2,516,644,673,15,0,0,4,4,0,1,128,29,157
p_37,0,9,e_2,615,644,681,15,0,0,9,4,0,1,29,37,66
p_35,0,9,e_2,630,644,681,15,0,0,4,4,0,1,14,37,51
p_146,0,1,e_1,453,678,685,15,0,0,1,4,0,1,225,7,232
p_41,0,11,e_2,600,644,689,15,0,0,14,4,0,1,44,45,89
p_86,0,2,e_1,544,678,690,15,0,0,8,4,0,1,134,12,146
p_91,0,12,e_2,526,644,694,15,0,0,1,4,0,1,118,50,168
p_39,0,12,e_2,607,644,694,15,0,0,12,4,0,1,37,50,87
p_93,0,13,e_2,520,644,699,15,0,0,3,4,0,1,124,55,179
p_90,0,13,e_2,527,644,699,15,0,0,1,4,0,1,117,55,172
p_40,0,13,e_2,602,644,699,15,0,0,14,4,0,1,42,55,97
p_38,0,13,e_2,608,644,699,15,0,0,12,4,0,1,36,55,91
p_36,0,13,e_2,628,644,699,15,0,0,5,4,0,1,16,55,71
p_88,0,5,e_1,538,678,701,15,0,0,10,4,0,1,140,23,163
p_95,0,14,e_2,518,644,704,15,0,0,4,4,0,1,126,60,186
p_80,0,7,e_1,552,678,709,15,0,0,6,4,0,1,126,31,157
p_119,0,1,e_0,483,708,713,15,0,0,5,4,0,1,225,5,230
p_113,0,1,e_0,489,708,713,15,0,0,3,4,0,1,219,5,224
p_65,0,1,e_0,573,708,713,15,0,0,9,4,0,1,135,5,140
p_87,0,8,e_1,539,678,714,15,0,0,10,4,0,1,139,36,175
p_83,0,8,e_1,549,678,714,15,0,0,7,4,0,1,129,36,165
p_144,0,9,e_1,455,678,719,15,0,0,0,3,0,0,223,41,264
p_89,0,9,e_1,535,678,719,15,0,0,11,4,0,1,143,41,184
p_114,0,3,e_0,488,708,721,15,0,0,4,4,0,1,220,13,233
p_64,0,4,e_0,574,708,726,15,0,0,8,4,0,1,134,18,152
p_145,0,11,e_1,454,678,727,15,0,0,0,4,0,1,224,49,273
p_84,0,12,e_1,546,678,732,15,0,0,8,4,0,1,132,54,186
p_78,0,12,e_1,556,678,732,15,0,0,4,4,0,1,122,54,176
p_108,0,6,e_0,496,708,734,15,0,0,1,4,0,1,212,26,238
p_118,0,7,e_0,484,708,739,15,0,0,5,4,0,1,224,31,255
p_82,0,14,e_1,550,678,740,15,0,0,6,4,0,1,128,62,190
p_81,0,14,e_1,551,678,740,15,0,0,6,4,0,1,127,62,189
p_79,0,14,e_1,553,678,740,15,0,0,5,4,0,1,125,62,187
p_111,0,8,e_0,491,708,744,15,0,0,3,4,0,1,217,36,253
p_85,0,15,e_1,545,678,745,15,0,0,8,4,0,1,133,67,200
p_115,0,9,e_0,487,708,749,15,0,0,4,4,0,1,221,41,262
p_117,0,10,e_0,485,708,754,15,0,0,5,4,0,1,223,46,269
p_116,0,10,e_0,486,708,754,15,0,0,4,4,0,1,222,46,268
p_112,0,11,e_0,490,708,759,15,0,0,3,4,0,1,218,51,269
p_110,0,11,e_0,492,708,759,15,0,0,2,4,0,1,216,51,267
p_107,0,11,e_0,499,708,759,15,0,0,0,3,0,0,209,51,260
p_22,0,3,e_2,719,756,767,15,0,0,12,4,0,1,37,11,48
p_21,0,4,e_2,731,756,772,15,0,0,8,4,0,1,25,16,41
p_109,0,15,e_0,493,708,773,15,0,0,2,4,0,1,215,65,280
p_19,0,11,e_2,754,756,795,15,0,0,0,4,0,1,2,39,41
p_23,0,12,e_2,711,756,800,15,0,0,14,3,0,0,45,44,89
p_77,0,3,e_1,557,792,803,15,0,0,4,4,0,1,235,11,246
p_72,0,3,e_1,562,792,803,15,0,0,2,4,0,1,230,11,241
p_71,0,3,e_1,564,792,803,15,0,0,2,4,0,1,228,11,239
p_70,0,3,e_1,565,792,803,15,0,0,1,4,0,1,227,11,238
p_67,0,3,e_1,568,792,803,15,0,0,0,4,0,1,224,11,235
p_66,0,3,e_1,569,792,803,15,0,0,0,3,0,0,223,11,234
p_20,0,14,e_2,734,756,808,15,0,0,7,4,0,1,22,52,74
p_75,0,5,e_1,559,792,811,15,0,0,3,4,0,1,233,19,252
p_76,0,6,e_1,558,792,816,15,0,0,4,4,0,1,234,24,258
p_32,0,6,e_1,650,792,816,15,0,0,9,4,0,1,142,24,166
p_74,0,7,e_1,560,792,821,15,0,0,3,4,0,1,232,29,261
p_55,0,3,e_0,585,820,831,15,0,0,5,4,0,1,235,11,246
p_54,0,3,e_0,586,820,831,15,0,0,4,4,0,1,234,11,245
p_52,0,3,e_0,588,820,831,15,0,0,4,4,0,1,232,11,243
p_73,0,11,e_1,561,792,835,15,0,0,3,4,0,1,231,43,274
p_34,0,12,e_1,646,792,840,15,0,0,10,4,0,1,146,48,194
p_61,0,6,e_0,579,820,842,15,0,0,7,4,0,1,241,22,263
p_56,0,6,e_0,584,820,842,15,0,0,5,4,0,1,236,22,258
p_68,0,13,e_1,567,792,845,15,0,0,1,4,0,1,225,53,278
p_50,0,7,e_0,590,820,847,15,0,0,3,4,0,1,230,27,257
p_69,0,14,e_1,566,792,850,15,0,0,1,4,0,1,226,58,284
p_53,0,9,e_0,587,820,855,15,0,0,4,4,0,1,233,35,268
p_51,0,9,e_0,589,820,855,15,0,0,3,4,0,1,231,35,266
p_33,0,15,e_1,649,792,855,15,0,0,9,4,0,1,143,63,206
p_60,0,10,e_0,580,820,860,15,0,0,6,4,0,1,240,40,280
p_58,0,11,e_0,582,820,865,15,0,0,6,4,0,1,238,45,283
p_57,0,11,e_0,583,820,865,15,0,0,5,4,0,1,237,45,282
p_63,0,13,e_0,577,820,873,15,0,0,7,4,0,1,243,53,296
p_62,0,13,e_0,578,820,873,15,0,0,7,4,0,1,242,53,295
p_59,0,14,e_0,581,820,878,15,0,0,6,4,0,1,239,58,297
p_49,0,14,e_0,591,820,878,15,0,0,3,4,0,1,229,58,287
p_9,0,2,e_2,846,880,888,15,0,0,11,4,0,1,34,8,42
p_6,0,3,e_2,877,880,893,15,0,0,1,4,0,1,3,13,16
p_7,0,5,e_2,875,880,901,15,0,0,1,4,0,1,5,21,26
p_4,0,1,e_1,886,902,907,15,0,0,5,4,0,1,16,5,21
p_16,0,2,e_1,780,902,912,15,0,0,4,4,0,1,122,10,132
p_10,0,8,e_2,835,880,912,15,0,0,14,3,0,0,45,32,77
p_30,0,3,e_1,668,902,917,15,0,0,3,4,0,1,234,15,249
p_8,0,11,e_2,874,880,923,15,0,0,2,4,0,1,6,43,49
p_29,0,5,e_1,670,902,925,15,0,0,2,4,0,1,232,23,255
p_1,0,5,e_1,894,902,925,15,0,0,2,4,0,1,8,23,31
p_45,0,2,e_0,595,922,930,15,0,0,1,4,0,1,327,8,335
p_24,0,2,e_0,695,922,930,15,0,0,4,4,0,1,227,8,235
p_31,0,6,e_1,666,902,930,15,0,0,4,4,0,1,236,28,264
p_48,0,4,e_0,592,922,938,15,0,0,2,4,0,1,330,16,346
p_46,0,4,e_0,594,922,938,15,0,0,2,4,0,1,328,16,344
p_14,0,4,e_0,794,922,938,15,0,0,8,4,0,1,128,16,144
p_5,0,8,e_1,883,902,938,15,0,0,6,4,0,1,19,36,55
p_3,0,8,e_1,888,902,938,15,0,0,4,4,0,1,14,36,50
p_42,0,6,e_0,598,922,946,15,0,0,0,4,0,1,324,24,348
p_27,0,10,e_1,677,902,946,15,0,0,0,3,0,0,225,44,269
p_18,0,10,e_1,766,902,946,15,0,0,8,4,0,1,136,44,180
p_17,0,10,e_1,776,902,946,15,0,0,5,4,0,1,126,44,170
p_43,0,7,e_0,597,922,951,15,0,0,1,4,0,1,325,29,354
p_28,0,11,e_1,676,902,951,15,0,0,0,4,0,1,226,49,275
p_2,0,11,e_1,892,902,951,15,0,0,3,4,0,1,10,49,59
p_44,0,8,e_0,596,922,956,15,0,0,1,4,0,1,326,34,360
p_26,0,8,e_0,684,922,956,15,0,0,8,4,0,1,238,34,272
p_25,0,8,e_0,686,922,956,15,0,0,7,4,0,1,236,34,270
p_47,0,9,e_0,593,922,961,15,0,0,2,4,0,1,329,39,368
p_15,0,9,e_0,793,922,961,15,0,0,9,4,0,1,129,39,168
p_11,0,9,e_0,807,922,961,15,0,0,4,4,0,1,115,39,154
p_13,0,11,e_0,796,922,969,15,0,0,8,4,0,1,126,47,173
p_12,0,11,e_0,798,922,969,15,0,0,7,4,0,1,124,47,171
p_300,0,4,e_0,8,9,25,0,0,0,0,3,0,0,1,16,17
p_299,0,5,e_1,9,10,29,0,0,0,0,3,0,0,1,19,20
p_297,0,6,e_3,15,16,38,0,0,0,0,3,0,0,1,22,23
p_298,0,9,e_2,11,12,43,0,0,0,0,3,0,0,1,31,32
p_296,0,4,e_0,28,43,57,9,1,1,4,3,0,0,15,14,29
p_286,0,3,e_1,46,47,60,4,1,0,0,3,0,0,1,13,14
p_290,0,6,e_0,40,43,65,6,1,0,1,4,0,1,3,22,25
p_289,0,4,e_1,43,47,65,5,1,0,1,4,0,1,4,18,22
p_295,0,5,e_1,29,47,70,9,1,1,5,3,0,0,18,23,41
p_287,0,5,e_1,45,47,70,4,1,0,0,4,0,1,2,23,25
p_285,0,4,e_3,53,59,73,2,1,0,2,4,0,1,6,14,20
p_284,0,4,e_3,54,59,73,1,1,0,1,4,0,1,5,14,19
p_288,0,8,e_1,44,47,81,5,1,0,1,4,0,1,3,34,37
p_292,0,6,e_3,38,59,81,6,0,0,6,3,0,0,21,22,43
p_291,0,11,e_0,39,43,82,6,1,0,1,4,0,1,4,39,43
p_294,0,12,e_0,31,43,87,8,1,1,4,4,0,1,12,44,56
p_293,0,12,e_0,33,43,87,7,1,1,3,4,0,1,10,44,54
p_283,0,9,e_3,57,59,92,0,1,0,0,4,0,1,2,33,35
p_281,0,1,e_2,73,96,101,14,2,2,7,4,0,1,23,5,28
p_278,0,2,e_2,77,96,106,13,2,2,6,4,0,1,19,10,29
p_279,0,5,e_2,76,96,117,13,2,2,6,4,0,1,20,21,41
p_282,0,7,e_2,66,96,125,16,3,3,9,3,0,0,30,29,59
p_277,0,6,e_1,82,109,129,12,1,1,8,3,0,0,27,20,47
p_274,0,8,e_2,88,96,130,10,1,1,2,4,0,1,8,34,42
p_276,0,11,e_2,84,96,141,11,1,1,4,4,0,1,12,45,57
p_271,0,1,e_3,121,140,145,6,1,0,6,4,0,1,19,5,24
p_280,0,14,e_2,75,96,152,14,2,2,7,4,0,1,21,56,77
p_275,0,14,e_2,86,96,152,11,1,1,3,4,0,1,10,56,66
p_273,0,4,e_3,110,140,156,9,0,0,9,3,0,0,30,16,46
p_267,0,1,e_0,148,152,159,16,2,2,1,4,0,1,4,7,11
p_270,0,9,e_3,122,140,173,6,1,0,6,4,0,1,18,33,51
p_269,0,9,e_3,127,140,173,4,1,0,4,4,0,1,13,33,46
p_268,0,2,e_1,144,165,175,17,2,2,6,3,0,0,21,10,31
p_266,0,6,e_0,151,152,176,15,2,2,0,3,0,0,1,24,25
p_265,0,4,e_1,152,165,183,15,2,2,4,4,0,1,13,18,31
p_262,0,5,e_1,157,165,188,14,1,1,2,4,0,1,8,23,31
p_261,0,5,e_1,164,165,188,12,1,1,0,3,0,0,1,23,24
p_272,0,10,e_0,113,152,190,9,1,0,12,3,0,0,39,38,77
p_263,0,7,e_1,154,165,196,14,2,2,3,4,0,1,11,31,42
p_264,0,11,e_1,153,165,210,15,2,2,4,4,0,1,12,45,57
p_255,0,3,e_2,184,210,223,9,1,0,8,4,0,1,26,13,39
p_254,0,4,e_2,187,210,228,8,1,0,7,4,0,1,23,18,41
p_250,0,2,e_0,217,223,231,19,1,1,2,4,0,1,6,8,14
p_252,0,5,e_2,205,210,233,2,1,0,1,4,0,1,5,23,28
p_260,0,7,e_2,165,210,241,11,1,1,14,3,0,0,45,31,76
p_258,0,7,e_2,168,210,241,10,1,1,14,4,0,1,42,31,73
p_253,0,5,e_0,190,223,242,7,1,0,10,3,0,0,33,19,52
p_256,0,10,e_3,182,212,244,9,0,0,9,3,0,0,30,32,62
p_257,0,14,e_2,169,210,264,10,1,1,13,4,0,1,41,54,95
p_259,0,15,e_2,167,210,269,11,1,1,14,4,0,1,43,59,102
p_251,0,15,e_2,209,210,269,1,1,0,0,3,0,0,1,59,60
p_248,0,5,e_0,246,264,281,10,0,0,5,3,0,0,18,17,35
p_249,0,6,e_1,239,275,295,11,1,1,11,3,0,0,36,20,56
p_246,0,10,e_0,262,264,298,7,1,0,0,4,0,1,2,34,36
p_245,0,7,e_1,269,275,300,4,1,0,2,4,0,1,6,25,31
p_247,0,5,e_3,250,283,300,10,0,0,10,3,0,0,33,17,50
p_242,0,8,e_3,277,283,311,2,1,0,2,4,0,1,6,28,34
p_244,0,12,e_1,271,275,317,4,1,0,1,4,0,1,4,42,46
p_243,0,15,e_1,272,275,328,3,1,0,1,4,0,1,3,53,56
p_241,0,1,e_2,283,331,338,16,2,2,15,3,0,0,48,7,55
p_236,0,1,e_2,305,331,338,10,1,1,8,4,0,1,26,7,33
p_233,0,1,e_2,311,331,338,8,1,0,6,4,0,1,20,7,27
p_226,0,2,e_2,329,331,343,2,1,0,0,4,0,1,2,12,14
p_223,0,2,e_3,336,337,347,0,0,0,0,3,0,0,1,10,11
p_230,0,3,e_2,319,331,348,6,1,0,4,4,0,1,12,17,29
p_224,0,5,e_0,331,334,351,2,1,0,1,4,0,1,3,17,20
p_228,0,4,e_2,325,331,353,4,1,0,2,4,0,1,6,22,28
p_232,0,5,e_2,314,331,358,7,1,0,5,4,0,1,17,27,44
p_225,0,5,e_2,330,331,358,2,1,0,0,3,0,0,1,27,28
p_240,0,9,e_0,301,334,365,11,1,1,10,3,0,0,33,31,64
p_237,0,7,e_2,304,331,366,10,1,1,9,4,0,1,27,35,62
p_231,0,7,e_2,317,331,366,6,1,0,4,4,0,1,14,35,49
p_234,0,8,e_3,310,337,367,8,0,0,8,2,1,0,27,30,57
p_235,0,8,e_2,308,331,371,9,1,1,7,4,0,1,23,40,63
p_239,0,11,e_2,302,331,382,11,1,1,9,4,0,1,29,51,80
p_227,0,12,e_2,327,331,387,3,1,0,1,4,0,1,4,56,60
p_216,0,1,e_1,347,385,392,14,1,1,12,4,0,1,38,7,45
p_238,0,13,e_2,303,331,392,10,1,1,9,4,0,1,28,61,89
p_229,0,13,e_2,320,331,392,5,1,0,3,4,0,1,11,61,72
p_209,0,2,e_1,357,385,397,11,1,1,9,4,0,1,28,12,40
p_214,0,3,e_1,349,385,402,14,1,1,12,4,0,1,36,17,53
p_186,0,4,e_0,390,394,408,1,1,0,1,4,0,1,4,14,18
p_222,0,5,e_1,337,385,410,16,3,3,15,3,0,0,48,25,73
p_219,0,5,e_1,342,385,410,15,2,2,14,4,0,1,43,25,68
p_201,0,5,e_3,366,393,412,8,0,0,8,2,1,0,27,19,46
p_221,0,6,e_1,339,385,415,16,2,2,15,4,0,1,46,30,76
p_220,0,6,e_1,341,385,415,16,2,2,14,4,0,1,44,30,74
p_210,0,6,e_1,354,385,415,12,1,1,10,4,0,1,31,30,61
p_208,0,6,e_1,358,385,415,11,1,1,9,4,0,1,27,30,57
p_217,0,7,e_1,346,385,420,14,1,1,13,4,0,1,39,35,74
p_212,0,7,e_1,351,385,420,13,1,1,11,4,0,1,34,35,69
p_185,0,10,e_3,391,393,429,0,1,0,0,4,0,1,2,36,38
p_203,0,12,e_0,364,394,434,9,1,1,9,2,1,0,30,40,70
p_187,0,12,e_0,389,394,434,1,1,0,1,4,0,1,5,40,45
p_218,0,11,e_1,343,385,434,15,2,2,14,4,0,1,42,49,91
p_184,0,12,e_3,392,393,437,0,0,0,0,3,0,0,1,44,45
p_183,0,1,e_2,396,438,445,24,3,3,13,3,0,0,42,7,49
p_215,0,15,e_1,348,385,448,14,1,1,12,4,0,1,37,63,100
p_213,0,15,e_1,350,385,448,13,1,1,11,4,0,1,35,63,98
p_211,0,15,e_1,353,385,448,12,1,1,10,4,0,1,32,63,95
p_182,0,2,e_2,397,438,450,24,3,3,13,4,0,1,41,12,53
p_180,0,2,e_2,399,438,450,23,3,3,13,4,0,1,39,12,51
p_178,0,3,e_2,401,438,455,22,3,3,12,4,0,1,37,17,54
p_176,0,4,e_2,403,438,460,22,3,3,11,4,0,1,35,22,57
p_179,0,8,e_2,400,438,474,23,3,3,12,4,0,1,38,36,74
p_177,0,9,e_2,402,438,479,22,3,3,12,4,0,1,36,41,77
p_169,0,9,e_2,411,438,479,19,2,2,9,4,0,1,27,41,68
p_146,0,1,e_0,453,480,487,9,1,0,9,4,0,1,27,7,34
p_173,0,11,e_2,407,438,487,20,3,3,10,4,0,1,31,49,80
p_143,0,3,e_0,456,480,495,8,1,0,8,4,0,1,24,15,39
p_171,0,13,e_2,409,438,495,20,3,3,9,4,0,1,29,57,86
p_137,0,4,e_0,464,480,500,5,1,0,5,4,0,1,16,20,36
p_175,0,14,e_2,405,438,500,21,3,3,11,4,0,1,33,62,95
p_174,0,14,e_2,406,438,500,21,3,3,10,4,0,1,32,62,94
p_170,0,14,e_2,410,438,500,19,3,3,9,4,0,1,28,62,90
p_205,0,2,e_1,362,495,503,9,1,1,7,4,0,1,133,8,141
p_181,0,15,e_2,398,438,505,23,3,3,13,4,0,1,40,67,107
p_172,0,15,e_2,408,438,505,20,3,3,10,4,0,1,30,67,97
p_150,0,6,e_0,443,480,508,12,1,0,12,4,0,1,37,28,65
p_141,0,6,e_0,458,480,508,7,1,0,7,4,0,1,22,28,50
p_200,0,4,e_1,367,495,511,8,1,0,6,4,0,1,128,16,144
p_196,0,4,e_1,371,495,511,7,1,0,4,4,0,1,124,16,140
p_148,0,8,e_0,449,480,516,10,1,0,10,4,0,1,31,36,67
p_140,0,8,e_0,459,480,516,7,1,0,7,4,0,1,21,36,57
p_194,0,6,e_1,373,495,519,6,1,0,4,4,0,1,122,24,146
p_147,0,9,e_0,452,480,521,9,1,0,9,4,0,1,28,41,69
p_144,0,9,e_0,455,480,521,8,1,0,8,4,0,1,25,41,66
p_142,0,9,e_0,457,480,521,8,1,0,7,4,0,1,23,41,64
p_139,0,10,e_0,461,480,526,6,1,0,6,4,0,1,19,46,65
p_192,0,8,e_1,375,495,527,6,1,0,3,4,0,1,120,32,152
p_151,0,15,e_3,442,481,530,12,0,0,12,3,0,0,39,49,88
p_122,0,15,e_3,480,481,530,0,0,0,0,3,0,0,1,49,50
p_145,0,11,e_0,454,480,531,9,1,0,8,4,0,1,26,51,77
p_138,0,11,e_0,463,480,531,6,1,0,5,4,0,1,17,51,68
p_198,0,9,e_1,369,495,532,8,1,0,5,4,0,1,126,37,163
p_197,0,10,e_1,370,495,537,7,1,0,5,4,0,1,125,42,167
p_191,0,10,e_1,376,495,537,5,1,0,3,4,0,1,119,42,161
p_207,0,11,e_1,359,495,542,10,1,1,8,4,0,1,136,47,183
p_193,0,11,e_1,374,495,542,6,1,0,3,4,0,1,121,47,168
p_152,0,15,e_0,441,480,545,12,0,0,12,3,0,0,39,65,104
p_149,0,15,e_0,444,480,545,12,1,0,12,4,0,1,36,65,101
p_206,0,12,e_1,361,495,547,10,1,1,8,4,0,1,134,52,186
p_204,0,14,e_1,363,495,555,9,1,1,7,4,0,1,132,60,192
p_167,0,1,e_2,413,552,559,19,2,2,8,4,0,1,139,7,146
p_161,0,1,e_2,421,552,559,16,2,2,5,4,0,1,131,7,138
p_158,0,1,e_2,430,552,559,14,1,1,2,4,0,1,122,7,129
p_202,0,15,e_1,365,495,560,8,1,1,6,4,0,1,130,65,195
p_199,0,15,e_1,368,495,560,8,1,0,5,4,0,1,127,65,192
p_195,0,15,e_1,372,495,560,7,1,0,4,4,0,1,123,65,188
p_165,0,4,e_2,417,552,570,18,2,2,7,4,0,1,135,18,153
p_159,0,6,e_2,429,552,578,14,1,1,3,4,0,1,123,26,149
p_154,0,7,e_2,436,552,583,12,0,0,0,4,0,1,116,31,147
p_77,0,3,e_3,557,577,588,6,1,0,6,4,0,1,20,11,31
p_72,0,3,e_3,562,577,588,5,1,0,5,4,0,1,15,11,26
p_71,0,3,e_3,564,577,588,4,1,0,4,4,0,1,13,11,24
p_70,0,3,e_3,565,577,588,4,1,0,4,4,0,1,12,11,23
p_67,0,3,e_3,568,577,588,3,1,0,3,4,0,1,9,11,20
p_163,0,10,e_2,419,552,594,17,2,2,6,4,0,1,133,42,175
p_75,0,5,e_3,559,577,596,6,1,0,6,4,0,1,18,19,37
p_130,0,1,e_0,472,592,599,3,1,0,2,4,0,1,120,7,127
p_164,0,11,e_2,418,552,599,17,2,2,6,4,0,1,134,47,181
p_162,0,11,e_2,420,552,599,17,2,2,6,4,0,1,132,47,179
p_108,0,6,e_3,496,577,601,26,1,1,4,5,1,0,81,24,105
p_76,0,6,e_3,558,577,601,6,1,0,6,4,0,1,19,24,43
p_166,0,12,e_2,416,552,604,18,2,2,7,4,0,1,136,52,188
p_80,0,7,e_3,552,577,606,8,1,0,8,4,0,1,25,29,54
p_74,0,7,e_3,560,577,606,5,1,0,5,4,0,1,17,29,46
p_136,0,3,e_0,465,592,607,5,1,0,5,4,0,1,127,15,142
p_129,0,3,e_0,473,592,607,2,1,0,2,4,0,1,119,15,134
p_168,0,13,e_2,412,552,609,19,2,2,8,4,0,1,140,57,197
p_190,0,1,e_1,379,607,612,4,1,0,2,4,0,1,228,5,233
p_119,0,1,e_1,483,607,612,30,1,1,4,4,0,1,124,5,129
p_113,0,1,e_1,489,607,612,28,1,1,2,4,0,1,118,5,123
p_157,0,14,e_2,431,552,614,14,1,1,2,4,0,1,121,62,183
p_155,0,14,e_2,435,552,614,12,1,1,1,4,0,1,117,62,179
p_160,0,15,e_2,426,552,619,15,2,2,4,4,0,1,126,67,193
p_156,0,15,e_2,434,552,619,13,1,1,1,4,0,1,118,67,185
p_114,0,3,e_1,488,607,620,29,1,1,2,4,0,1,119,13,132
p_73,0,11,e_3,561,577,620,5,1,0,5,4,0,1,16,43,59
p_124,0,7,e_0,478,592,621,1,1,0,0,4,0,1,114,29,143
p_78,0,12,e_3,556,577,625,7,1,0,7,4,0,1,21,48,69
p_68,0,13,e_3,567,577,630,3,1,0,3,4,0,1,10,53,63
p_135,0,10,e_0,466,592,632,5,1,0,4,4,0,1,126,40,166
p_127,0,10,e_0,475,592,632,2,1,0,1,4,0,1,117,40,157
p_118,0,7,e_1,484,607,634,30,1,1,3,4,0,1,123,27,150
p_79,0,14,e_3,553,577,635,8,1,0,8,4,0,1,24,58,82
p_69,0,14,e_3,566,577,635,3,1,0,3,4,0,1,11,58,69
p_132,0,11,e_0,470,592,637,3,1,0,3,4,0,1,122,45,167
p_128,0,11,e_0,474,592,637,2,1,0,2,4,0,1,118,45,163
p_123,0,11,e_0,479,592,637,0,1,0,0,3,0,0,113,45,158
p_189,0,8,e_1,382,607,639,3,1,0,1,4,0,1,225,32,257
p_111,0,8,e_1,491,607,639,28,1,1,1,4,0,1,116,32,148
p_133,0,12,e_0,469,592,642,4,1,0,3,4,0,1,123,50,173
p_126,0,12,e_0,476,592,642,1,1,0,1,4,0,1,116,50,166
p_115,0,9,e_1,487,607,644,29,1,1,2,4,0,1,120,37,157
p_63,0,13,e_0,577,592,647,28,8,8,5,4,0,1,15,55,70
p_117,0,10,e_1,485,607,649,30,1,1,3,4,0,1,122,42,164
p_116,0,10,e_1,486,607,649,29,1,1,3,4,0,1,121,42,163
p_131,0,14,e_0,471,592,652,3,1,0,3,4,0,1,121,60,181
p_125,0,14,e_0,477,592,652,1,1,0,1,4,0,1,115,60,175
p_121,0,11,e_1,481,607,654,30,2,2,4,4,0,1,126,47,173
p_120,0,11,e_1,482,607,654,30,1,1,4,4,0,1,125,47,172
p_112,0,11,e_1,490,607,654,28,1,1,1,4,0,1,117,47,164
p_110,0,11,e_1,492,607,654,27,1,1,1,4,0,1,115,47,162
p_134,0,15,e_0,467,592,657,4,1,0,4,4,0,1,125,65,190
p_188,0,13,e_1,384,607,662,3,1,0,0,3,0,0,223,55,278
p_96,0,1,e_2,517,666,671,19,2,2,11,4,0,1,149,5,154
p_106,0,3,e_2,500,666,679,25,2,2,14,5,1,1,166,13,179
p_65,0,1,e_3,573,679,684,1,1,0,1,4,0,1,106,5,111
p_99,0,6,e_2,514,666,690,20,2,2,12,4,0,1,152,24,176
p_94,0,6,e_2,519,666,690,18,2,2,11,4,0,1,147,24,171
p_66,0,3,e_3,569,679,692,2,1,0,2,4,0,1,110,13,123
p_30,0,3,e_3,668,679,692,3,1,0,3,4,0,1,11,13,24
p_102,0,7,e_2,509,666,695,22,2,2,14,4,0,1,157,29,186
p_98,0,7,e_2,515,666,695,20,2,2,12,4,0,1,151,29,180
p_97,0,7,e_2,516,666,695,19,2,2,12,4,0,1,150,29,179
p_64,0,4,e_3,574,679,697,1,1,0,1,4,0,1,105,18,123
p_101,0,8,e_2,511,666,700,21,2,2,13,4,0,1,155,34,189
p_29,0,5,e_3,670,679,702,3,1,0,3,4,0,1,9,23,32
p_153,0,9,e_2,437,666,705,12,0,0,0,3,0,0,229,39,268
p_100,0,9,e_2,513,666,705,20,2,2,13,4,0,1,153,39,192
p_31,0,6,e_3,666,679,707,4,1,0,4,4,0,1,13,28,41
p_45,0,2,e_1,595,703,711,23,7,7,4,4,0,1,108,8,116
p_24,0,2,e_1,695,703,711,18,5,5,2,4,0,1,8,8,16
p_107,0,11,e_2,499,666,713,25,2,2,14,2,2,1,167,47,214
p_103,0,11,e_2,508,666,713,22,2,2,14,4,0,1,158,47,205
p_55,0,3,e_0,585,704,715,26,9,9,2,4,0,1,119,11,130
p_54,0,3,e_0,586,704,715,25,9,9,2,4,0,1,118,11,129
p_52,0,3,e_0,588,704,715,25,8,8,1,4,0,1,116,11,127
p_105,0,12,e_2,502,666,718,24,2,2,14,5,1,1,164,52,216
p_48,0,4,e_1,592,703,719,24,8,8,5,4,0,1,111,16,127
p_46,0,4,e_1,594,703,719,23,8,8,4,4,0,1,109,16,125
p_27,0,10,e_3,677,679,721,0,1,0,0,4,0,1,2,42,44
p_61,0,6,e_0,579,704,726,28,8,8,4,4,0,1,125,22,147
p_56,0,6,e_0,584,704,726,26,9,9,2,4,0,1,120,22,142
p_104,0,14,e_2,503,666,726,24,2,2,15,5,1,1,163,60,223
p_95,0,14,e_2,518,666,726,19,2,2,11,4,0,1,148,60,208
p_28,0,11,e_3,676,679,726,1,1,0,1,4,0,1,3,47,50
p_42,0,6,e_1,598,703,727,23,7,7,3,4,0,1,105,24,129
p_50,0,7,e_0,590,704,731,25,8,8,0,4,0,1,114,27,141
p_43,0,7,e_1,597,703,732,23,7,7,3,4,0,1,106,29,135
p_26,0,8,e_0,684,704,736,21,6,6,6,4,0,1,20,32,52
p_44,0,8,e_1,596,703,737,23,7,7,3,4,0,1,107,34,141
p_25,0,8,e_1,686,703,737,21,6,6,5,4,0,1,17,34,51
p_53,0,9,e_0,587,704,741,25,8,8,1,4,0,1,117,37,154
p_51,0,9,e_0,589,704,741,25,8,8,1,4,0,1,115,37,152
p_47,0,9,e_1,593,703,742,24,8,8,4,4,0,1,110,39,149
p_60,0,10,e_0,580,704,746,27,9,9,4,4,0,1,124,42,166
p_41,0,11,e_1,600,703,750,22,6,6,2,4,0,1,103,47,150
p_58,0,11,e_0,582,704,751,27,9,9,3,4,0,1,122,47,169
p_57,0,11,e_0,583,704,751,26,9,9,3,4,0,1,121,47,168
p_40,0,13,e_1,602,703,758,22,6,6,1,4,0,1,101,55,156
p_62,0,13,e_0,578,704,759,28,8,8,4,4,0,1,126,55,181
p_59,0,14,e_0,581,704,764,27,9,9,3,4,0,1,123,60,183
p_49,0,14,e_0,591,704,764,24,8,8,0,3,0,0,113,60,173
p_109,0,15,e_1,493,703,766,27,1,1,0,4,0,1,210,63,273
p_21,0,4,e_3,731,761,775,10,1,0,10,4,0,1,30,14,44
p_86,0,2,e_2,544,770,778,11,1,0,2,4,0,1,226,8,234
p_92,0,4,e_2,525,770,786,16,2,2,9,4,0,1,245,16,261
p_88,0,5,e_2,538,770,791,13,1,0,4,4,0,1,232,21,253
p_19,0,11,e_3,754,761,798,2,1,0,2,4,0,1,7,37,44
p_87,0,8,e_2,539,770,802,12,1,0,4,4,0,1,231,32,263
p_83,0,8,e_2,549,770,802,9,1,0,1,4,0,1,221,32,253
p_23,0,12,e_3,711,761,803,15,2,2,7,5,2,0,50,42,92
p_89,0,9,e_2,535,770,807,14,1,0,5,4,0,1,235,37,272
p_20,0,14,e_3,734,761,811,9,1,0,9,4,0,1,27,50,77
p_91,0,12,e_2,526,770,818,16,2,2,8,4,0,1,244,48,292
p_84,0,12,e_2,546,770,818,10,1,0,2,4,0,1,224,48,272
p_39,0,12,e_2,607,770,818,21,5,5,13,5,3,1,163,48,211
p_93,0,13,e_2,520,770,823,18,2,2,10,4,0,1,250,53,303
p_90,0,13,e_2,527,770,823,16,2,2,8,4,0,1,243,53,296
p_38,0,13,e_2,608,770,823,21,5,5,13,2,3,1,162,53,215
p_82,0,14,e_2,550,770,828,9,1,0,0,4,0,1,220,58,278
p_81,0,14,e_2,551,770,828,8,1,0,0,3,0,0,219,58,277
p_85,0,15,e_2,545,770,833,10,1,0,2,4,0,1,225,63,288
p_14,0,4,e_0,794,821,835,18,3,3,9,4,0,1,27,14,41
p_16,0,2,e_1,780,828,836,23,3,3,15,3,0,0,48,8,56
p_15,0,9,e_0,793,821,852,18,3,3,9,4,0,1,28,31,59
p_11,0,9,e_0,807,821,852,15,1,1,4,4,0,1,14,31,45
p_17,0,10,e_0,776,821,857,24,3,3,14,3,0,0,45,36,81
p_13,0,11,e_0,796,821,862,17,3,3,8,4,0,1,25,41,66
p_12,0,11,e_0,798,821,862,17,2,2,7,4,0,1,23,41,64
p_10,0,8,e_1,835,844,870,14,0,0,2,2,1,0,9,26,35
p_22,0,3,e_2,719,880,891,12,3,3,12,5,1,1,161,11,172
p_6,0,3,e_2,877,880,891,4,1,0,1,4,0,1,3,11,14
p_4,0,1,e_3,886,891,896,1,1,0,1,4,0,1,5,5,10
p_7,0,5,e_2,875,880,899,5,1,0,1,4,0,1,5,19,24
p_9,0,2,e_3,846,891,901,14,0,0,14,3,0,0,45,10,55
p_32,0,6,e_2,650,880,904,9,1,0,5,4,0,1,230,24,254
p_37,0,9,e_2,615,880,915,18,5,5,14,5,1,1,265,35,300
p_35,0,9,e_2,630,880,915,15,2,2,12,4,0,1,250,35,285
p_1,0,5,e_1,894,901,918,15,3,3,2,4,0,1,7,17,24
p_18,0,10,e_2,766,880,920,27,4,4,1,4,0,1,114,40,154
p_5,0,8,e_3,883,891,921,2,1,0,2,4,0,1,8,30,38
p_3,0,8,e_3,888,891,921,1,1,0,1,4,0,1,3,30,33
p_34,0,12,e_2,646,880,928,11,1,0,6,4,0,1,234,48,282
p_36,0,13,e_2,628,880,933,15,3,3,12,4,0,1,252,53,305
p_8,0,11,e_1,874,901,938,5,1,0,8,3,0,0,27,37,64
p_2,0,11,e_1,892,901,938,16,3,3,3,4,0,1,9,37,46
p_33,0,15,e_2,649,880,941,10,1,0,5,4,0,1,231,61,292
p_300,0,4,e_0,8,9,25,0,0,0,0,3,0,0,1,16,17
p_299,0,5,e_1,9,10,29,0,0,0,0,3,0,0,1,19,20
p_297,0,6,e_3,15,16,38,0,0,0,0,3,0,0,1,22,23
p_298,0,9,e_2,11,12,43,0,0,0,0,3,0,0,1,31,32
p_296,0,4,e_0,28,43,57,9,1,1,4,3,0,0,15,14,29
p_286,0,3,e_1,46,47,60,6,0,0,0,3,0,0,1,13,14
p_292,0,6,e_0,38,43,65,6,0,0,1,4,0,1,5,22,27
p_290,0,6,e_0,40,43,65,6,0,0,1,4,0,1,3,22,25
p_289,0,4,e_1,43,47,65,6,0,0,1,4,0,1,4,18,22
p_295,0,5,e_1,29,47,70,9,1,1,5,3,0,0,18,23,41
p_287,0,5,e_1,45,47,70,6,0,0,0,4,0,1,2,23,25
p_288,0,8,e_1,44,47,81,6,0,0,1,4,0,1,3,34,37
p_281,0,1,e_3,73,74,81,0,0,0,0,3,0,0,1,7,8
p_291,0,11,e_0,39,43,82,6,0,0,1,4,0,1,4,39,43
p_294,0,12,e_0,31,43,87,8,1,1,4,4,0,1,12,44,56
p_293,0,12,e_0,33,43,87,7,1,1,3,4,0,1,10,44,54
p_285,0,4,e_3,53,74,92,6,0,0,6,3,0,0,21,18,39
p_284,0,4,e_3,54,74,92,6,1,0,6,4,0,1,20,18,38
p_282,0,7,e_3,66,74,103,2,1,0,2,4,0,1,8,29,37
p_283,0,9,e_3,57,74,111,5,1,0,5,4,0,1,17,37,54
p_278,0,2,e_2,77,105,113,18,4,4,9,4,0,1,28,8,36
p_279,0,5,e_2,76,105,124,18,4,4,9,4,0,1,29,19,48
p_277,0,6,e_1,82,109,129,17,3,3,8,3,0,0,27,20,47
p_274,0,8,e_2,88,105,135,15,3,3,5,4,0,1,17,30,47
p_271,0,1,e_3,121,140,145,6,1,0,6,4,0,1,19,5,24
p_276,0,11,e_2,84,105,146,16,3,3,7,4,0,1,21,41,62
p_273,0,4,e_3,110,140,156,9,0,0,9,2,1,0,30,16,46
p_280,0,14,e_2,75,105,157,18,4,4,9,3,0,0,30,52,82
p_275,0,14,e_2,86,105,157,16,3,3,6,4,0,1,19,52,71
p_267,0,1,e_1,148,165,172,18,3,3,5,4,0,1,17,7,24
p_270,0,9,e_3,122,140,173,6,1,0,6,4,0,1,18,33,51
p_269,0,9,e_3,127,140,173,4,1,0,4,4,0,1,13,33,46
p_268,0,2,e_1,144,165,177,19,3,3,6,3,0,0,21,12,33
p_272,0,10,e_3,113,140,178,9,1,0,9,4,0,1,27,38,65
p_265,0,4,e_1,152,165,185,17,3,3,4,4,0,1,13,20,33
p_262,0,5,e_1,157,165,190,16,2,2,2,4,0,1,8,25,33
p_261,0,5,e_1,164,165,190,14,2,2,0,3,0,0,1,25,26
p_266,0,6,e_1,151,165,195,17,3,3,4,4,0,1,14,30,44
p_263,0,7,e_1,154,165,200,16,3,3,3,4,0,1,11,35,46
p_264,0,11,e_1,153,165,214,17,3,3,4,4,0,1,12,49,61
p_255,0,3,e_0,184,204,215,10,0,0,6,4,0,1,20,11,31
p_254,0,4,e_0,187,204,220,10,0,0,5,4,0,1,17,16,33
p_253,0,5,e_0,190,204,225,10,0,0,4,4,0,1,14,21,35
p_260,0,7,e_0,165,204,233,13,2,2,12,3,0,0,39,29,68
p_258,0,7,e_0,168,204,233,12,2,2,12,4,0,1,36,29,65
p_256,0,10,e_0,182,204,244,10,0,0,7,4,0,1,22,40,62
p_250,0,2,e_3,217,238,246,7,1,0,7,4,0,1,21,8,29
p_252,0,5,e_3,205,238,257,10,0,0,10,3,0,0,33,19,52
p_257,0,14,e_0,169,204,258,12,2,2,11,4,0,1,35,54,89
p_259,0,15,e_0,167,204,263,13,2,2,12,4,0,1,37,59,96
p_251,0,15,e_3,209,238,289,9,1,0,9,4,0,1,29,51,80
p_248,0,5,e_1,246,275,292,28,2,2,9,4,0,1,29,17,46
p_247,0,5,e_1,250,275,292,27,2,2,8,4,0,1,25,17,42
p_249,0,6,e_1,239,275,297,30,3,3,11,3,0,0,36,22,58
p_245,0,7,e_1,269,275,302,21,1,1,2,4,0,1,6,27,33
p_246,0,10,e_1,262,275,313,24,1,1,4,4,0,1,13,38,51
p_244,0,12,e_1,271,275,321,21,1,1,1,4,0,1,4,46,50
p_241,0,1,e_2,283,322,327,17,1,1,13,4,0,1,39,5,44
p_236,0,1,e_2,305,322,327,15,0,0,5,4,0,1,17,5,22
p_233,0,1,e_2,311,322,327,15,0,0,3,4,0,1,11,5,16
p_243,0,15,e_1,272,275,332,20,1,1,1,4,0,1,3,57,60
p_230,0,3,e_2,319,322,335,15,0,0,1,4,0,1,3,13,16
p_232,0,5,e_2,314,322,343,15,0,0,2,4,0,1,8,21,29
p_237,0,7,e_2,304,322,351,15,0,0,6,4,0,1,18,29,47
p_231,0,7,e_2,317,322,351,15,0,0,1,4,0,1,5,29,34
p_242,0,8,e_2,277,322,356,19,1,1,14,3,0,0,45,34,79
p_235,0,8,e_2,308,322,356,15,0,0,4,4,0,1,14,34,48
p_234,0,8,e_2,310,322,356,15,0,0,4,4,0,1,12,34,46
p_240,0,9,e_2,301,322,361,15,0,0,7,4,0,1,21,39,60
p_239,0,11,e_2,302,322,369,15,0,0,6,4,0,1,20,47,67
p_238,0,13,e_2,303,322,377,15,0,0,6,4,0,1,19,55,74
p_229,0,13,e_2,320,322,377,15,0,0,0,4,0,1,2,55,57
p_216,0,1,e_0,347,373,380,9,1,0,8,4,0,1,26,7,33
p_226,0,2,e_0,329,373,385,15,1,0,14,4,0,1,44,12,56
p_223,0,2,e_0,336,373,385,13,1,0,12,4,0,1,37,12,49
p_214,0,3,e_0,349,373,390,8,1,0,8,4,0,1,24,17,41
p_228,0,4,e_0,325,373,395,15,0,0,15,3,0,0,48,22,70
p_224,0,5,e_1,331,379,396,14,1,0,15,2,1,0,48,17,65
p_194,0,6,e_3,373,375,397,0,1,0,0,4,0,1,2,22,24
p_225,0,5,e_0,330,373,400,15,1,0,14,4,0,1,43,27,70
p_222,0,5,e_0,337,373,400,12,1,0,12,4,0,1,36,27,63
p_219,0,5,e_0,342,373,400,11,1,0,10,4,0,1,31,27,58
p_221,0,6,e_0,339,373,405,12,1,0,11,4,0,1,34,32,66
p_220,0,6,e_0,341,373,405,11,1,0,10,4,0,1,32,32,64
p_192,0,8,e_1,375,379,407,24,4,4,1,4,0,1,4,28,32
p_217,0,7,e_0,346,373,410,9,1,0,9,4,0,1,27,37,64
p_212,0,7,e_0,351,373,410,8,1,0,7,4,0,1,22,37,59
p_193,0,11,e_3,374,375,414,0,0,0,0,3,0,0,1,39,40
p_191,0,10,e_1,376,379,415,24,3,3,1,4,0,1,3,36,39
p_227,0,12,e_3,327,375,419,15,0,0,15,3,0,0,48,44,92
p_218,0,11,e_0,343,373,424,10,1,0,10,4,0,1,30,51,81
p_190,0,1,e_2,379,421,428,24,3,3,13,3,0,0,42,7,49
p_183,0,1,e_2,396,421,428,18,2,2,8,4,0,1,25,7,32
p_182,0,2,e_2,397,421,433,18,2,2,8,4,0,1,24,12,36
p_180,0,2,e_2,399,421,433,18,2,2,7,4,0,1,22,12,34
p_215,0,15,e_0,348,373,438,9,1,0,8,4,0,1,25,65,90
p_213,0,15,e_0,350,373,438,8,1,0,7,4,0,1,23,65,88
p_178,0,3,e_2,401,421,438,17,2,2,6,4,0,1,20,17,37
p_186,0,4,e_2,390,421,443,20,3,3,10,4,0,1,31,22,53
p_176,0,4,e_2,403,421,443,16,2,2,6,4,0,1,18,22,40
p_189,0,8,e_2,382,421,457,23,3,3,13,4,0,1,39,36,75
p_179,0,8,e_2,400,421,457,17,2,2,7,4,0,1,21,36,57
p_161,0,1,e_1,421,454,461,12,0,0,10,3,0,0,33,7,40
p_158,0,1,e_1,430,454,461,12,0,0,8,4,0,1,24,7,31
p_177,0,9,e_2,402,421,462,17,2,2,6,4,0,1,19,41,60
p_185,0,10,e_2,391,421,467,20,3,3,10,4,0,1,30,46,76
p_187,0,12,e_2,389,421,475,20,3,3,10,4,0,1,32,54,86
p_184,0,12,e_2,392,421,475,19,3,3,9,4,0,1,29,54,83
p_159,0,6,e_1,429,454,478,12,0,0,8,4,0,1,25,24,49
p_150,0,6,e_1,443,454,478,12,0,0,3,4,0,1,11,24,35
p_188,0,13,e_2,384,421,480,22,3,3,12,4,0,1,37,59,96
p_154,0,7,e_1,436,454,483,12,0,0,6,4,0,1,18,29,47
p_148,0,8,e_1,449,454,488,12,0,0,1,4,0,1,5,34,39
p_181,0,15,e_2,398,421,488,18,2,2,7,4,0,1,23,67,90
p_153,0,9,e_1,437,454,493,12,0,0,5,4,0,1,17,39,56
p_147,0,9,e_1,452,454,493,12,0,0,0,4,0,1,2,39,41
p_209,0,2,e_0,357,485,495,6,1,0,5,4,0,1,128,10,138
p_205,0,2,e_0,362,485,495,4,1,0,3,4,0,1,123,10,133
p_200,0,4,e_0,367,485,503,2,1,0,2,4,0,1,118,18,136
p_201,0,5,e_0,366,485,508,3,1,0,2,4,0,1,119,23,142
p_157,0,14,e_1,431,454,510,12,0,0,7,4,0,1,23,56,79
p_155,0,14,e_1,435,454,510,12,0,0,6,4,0,1,19,56,75
p_210,0,6,e_0,354,485,513,7,1,0,6,4,0,1,131,28,159
p_208,0,6,e_0,358,485,513,5,1,0,5,4,0,1,127,28,155
p_160,0,15,e_1,426,454,515,12,0,0,9,4,0,1,28,61,89
p_156,0,15,e_1,434,454,515,12,0,0,6,4,0,1,20,61,81
p_152,0,15,e_1,441,454,515,12,0,0,4,4,0,1,13,61,74
p_151,0,15,e_1,442,454,515,12,0,0,4,4,0,1,12,61,73
p_149,0,15,e_1,444,454,515,12,0,0,3,4,0,1,10,61,71
p_198,0,9,e_0,369,485,524,2,1,0,1,4,0,1,116,39,155
p_197,0,10,e_0,370,485,529,1,1,0,1,4,0,1,115,44,159
p_113,0,1,e_3,489,524,529,11,1,0,11,4,0,1,35,5,40
p_207,0,11,e_0,359,485,534,5,1,0,4,4,0,1,126,49,175
p_114,0,3,e_3,488,524,537,12,1,0,12,4,0,1,36,13,49
p_106,0,3,e_3,500,524,537,8,1,0,8,4,0,1,24,13,37
p_206,0,12,e_0,361,485,539,4,1,0,4,4,0,1,124,54,178
p_203,0,12,e_0,364,485,539,3,1,0,3,4,0,1,121,54,175
p_167,0,1,e_2,413,535,540,13,1,1,2,4,0,1,122,5,127
p_204,0,14,e_0,363,485,547,4,1,0,3,4,0,1,122,62,184
p_108,0,6,e_3,496,524,548,9,1,0,9,4,0,1,28,24,52
p_165,0,4,e_2,417,535,551,12,1,1,1,4,0,1,118,16,134
p_92,0,4,e_2,525,535,551,30,10,10,3,4,0,1,10,16,26
p_211,0,15,e_0,353,485,552,7,1,0,6,4,0,1,132,67,199
p_202,0,15,e_0,365,485,552,3,1,0,2,4,0,1,120,67,187
p_199,0,15,e_0,368,485,552,2,1,0,1,4,0,1,117,67,184
p_111,0,8,e_3,491,524,556,11,1,0,11,4,0,1,33,32,65
p_115,0,9,e_3,487,524,561,12,1,0,12,4,0,1,37,37,74
p_117,0,10,e_3,485,524,566,12,0,0,12,3,0,0,39,42,81
p_116,0,10,e_3,486,524,566,12,1,0,12,4,0,1,38,42,80
p_169,0,9,e_2,411,535,568,14,2,2,3,4,0,1,124,33,157
p_146,0,1,e_1,453,562,569,12,0,0,0,3,0,0,109,7,116
p_112,0,11,e_3,490,524,571,11,1,0,11,4,0,1,34,47,81
p_110,0,11,e_3,492,524,571,10,1,0,10,4,0,1,32,47,79
p_107,0,11,e_3,499,524,571,8,1,0,8,4,0,1,25,47,72
p_103,0,11,e_3,508,524,571,5,1,0,5,4,0,1,16,47,63
p_163,0,10,e_2,419,535,573,12,0,0,0,4,0,1,116,38,154
p_86,0,2,e_1,544,562,574,25,9,9,6,4,0,1,18,12,30
p_105,0,12,e_3,502,524,576,7,1,0,7,4,0,1,22,52,74
p_173,0,11,e_2,407,535,578,15,2,2,4,4,0,1,128,43,171
p_164,0,11,e_2,418,535,578,12,0,0,1,4,0,1,117,43,160
p_162,0,11,e_2,420,535,578,12,0,0,0,3,0,0,115,43,158
p_77,0,3,e_1,557,562,579,22,7,7,1,4,0,1,5,17,22
p_166,0,12,e_2,416,535,583,13,1,1,1,4,0,1,119,48,167
p_104,0,14,e_3,503,524,584,7,1,0,7,4,0,1,21,60,81
p_88,0,5,e_1,538,562,587,27,9,9,8,4,0,1,24,25,49
p_171,0,13,e_2,409,535,588,14,2,2,4,4,0,1,126,53,179
p_168,0,13,e_2,412,535,588,13,2,2,3,4,0,1,123,53,176
p_109,0,15,e_3,493,524,589,10,1,0,10,4,0,1,31,65,96
p_76,0,6,e_1,558,562,592,22,7,7,1,4,0,1,4,30,34
p_175,0,14,e_2,405,535,593,16,2,2,5,4,0,1,130,58,188
p_174,0,14,e_2,406,535,593,15,2,2,5,4,0,1,129,58,187
p_170,0,14,e_2,410,535,593,14,2,2,3,4,0,1,125,58,183
p_80,0,7,e_1,552,562,597,23,8,8,3,4,0,1,10,35,45
p_172,0,15,e_2,408,535,598,15,2,2,4,4,0,1,127,63,190
p_87,0,8,e_1,539,562,602,27,9,9,7,4,0,1,23,40,63
p_83,0,8,e_1,549,562,602,24,8,8,4,4,0,1,13,40,53
p_89,0,9,e_1,535,562,607,27,10,10,9,4,0,1,27,45,72
p_143,0,3,e_0,456,599,612,12,0,0,9,4,0,1,143,13,156
p_136,0,3,e_0,465,599,612,12,0,0,6,4,0,1,134,13,147
p_196,0,4,e_0,371,599,617,1,1,0,0,4,0,1,228,18,246
p_137,0,4,e_0,464,599,617,12,0,0,7,4,0,1,135,18,153
p_84,0,12,e_1,546,562,618,24,9,9,5,4,0,1,16,56,72
p_78,0,12,e_1,556,562,618,22,7,7,2,4,0,1,6,56,62
p_141,0,6,e_0,458,599,625,12,0,0,9,4,0,1,141,26,167
p_82,0,14,e_1,550,562,626,24,8,8,4,4,0,1,12,64,76
p_81,0,14,e_1,551,562,626,23,8,8,3,4,0,1,11,64,75
p_79,0,14,e_1,553,562,626,23,8,8,3,4,0,1,9,64,73
p_85,0,15,e_1,545,562,631,25,9,9,5,4,0,1,17,69,86
p_140,0,8,e_0,459,599,633,12,0,0,8,4,0,1,140,34,174
p_144,0,9,e_0,455,599,638,12,0,0,10,4,0,1,144,39,183
p_142,0,9,e_0,457,599,638,12,0,0,9,4,0,1,142,39,181
p_96,0,1,e_3,517,636,641,2,1,0,2,4,0,1,119,5,124
p_139,0,10,e_0,461,599,643,12,0,0,8,4,0,1,138,44,182
p_135,0,10,e_0,466,599,643,12,0,0,6,4,0,1,133,44,177
p_145,0,11,e_0,454,599,648,12,0,0,10,4,0,1,145,49,194
p_138,0,11,e_0,463,599,648,12,0,0,7,4,0,1,136,49,185
p_133,0,12,e_0,469,599,653,12,0,0,5,4,0,1,130,54,184
p_99,0,6,e_3,514,636,658,3,1,0,3,4,0,1,122,22,144
p_94,0,6,e_3,519,636,658,1,1,0,1,4,0,1,117,22,139
p_102,0,7,e_3,509,636,663,5,1,0,5,4,0,1,127,27,154
p_98,0,7,e_3,515,636,663,3,1,0,3,4,0,1,121,27,148
p_97,0,7,e_3,516,636,663,2,1,0,2,4,0,1,120,27,147
p_195,0,15,e_0,372,599,664,1,1,0,0,3,0,0,227,65,292
p_134,0,15,e_0,467,599,664,12,0,0,6,4,0,1,132,65,197
p_101,0,8,e_3,511,636,668,4,1,0,4,4,0,1,125,32,157
p_100,0,9,e_3,513,636,673,3,1,0,3,4,0,1,123,37,160
p_37,0,9,e_3,615,636,673,7,1,0,7,4,0,1,21,37,58
p_41,0,11,e_3,600,636,681,12,1,0,12,4,0,1,36,45,81
p_91,0,12,e_2,526,645,683,30,10,10,3,4,0,1,119,38,157
p_39,0,12,e_3,607,636,686,9,1,0,9,4,0,1,29,50,79
p_90,0,13,e_2,527,645,688,29,11,11,2,4,0,1,118,43,161
p_30,0,3,e_1,668,678,691,20,6,6,3,4,0,1,10,13,23
p_93,0,13,e_3,520,636,691,1,1,0,1,4,0,1,116,55,171
p_40,0,13,e_3,602,636,691,11,1,0,11,4,0,1,34,55,89
p_38,0,13,e_3,608,636,691,9,1,0,9,4,0,1,28,55,83
p_95,0,14,e_3,518,636,696,2,1,0,2,4,0,1,118,60,178
p_75,0,5,e_1,559,678,699,21,7,7,1,4,0,1,119,21,140
p_29,0,5,e_1,670,678,699,20,6,6,2,4,0,1,8,21,29
p_32,0,6,e_1,650,678,704,24,9,9,9,4,0,1,28,26,54
p_31,0,6,e_1,666,678,704,20,7,7,4,4,0,1,12,26,38
p_74,0,7,e_1,560,678,709,21,6,6,0,4,0,1,118,31,149
p_130,0,1,e_0,472,711,716,12,0,0,4,4,0,1,239,5,244
p_119,0,1,e_0,483,711,716,12,0,0,0,4,0,1,228,5,233
p_27,0,10,e_1,677,678,720,18,5,5,0,3,0,0,1,42,43
p_129,0,3,e_0,473,711,724,12,0,0,4,4,0,1,238,13,251
p_73,0,11,e_1,561,678,725,21,6,6,0,3,0,0,117,47,164
p_28,0,11,e_1,676,678,725,18,5,5,0,4,0,1,2,47,49
p_34,0,12,e_1,646,678,730,26,9,9,10,4,0,1,32,52,84
p_124,0,7,e_0,478,711,738,12,0,0,2,4,0,1,233,27,260
p_118,0,7,e_0,484,711,738,12,0,0,0,3,0,0,227,27,254
p_33,0,15,e_1,649,678,741,25,9,9,9,4,0,1,29,63,92
p_127,0,10,e_0,475,711,749,12,0,0,3,4,0,1,236,38,274
p_22,0,3,e_3,719,740,751,7,1,0,7,4,0,1,21,11,32
p_132,0,11,e_0,470,711,754,12,0,0,5,4,0,1,241,43,284
p_128,0,11,e_0,474,711,754,12,0,0,3,4,0,1,237,43,280
p_123,0,11,e_0,479,711,754,12,0,0,2,4,0,1,232,43,275
p_121,0,11,e_0,481,711,754,12,0,0,1,4,0,1,230,43,273
p_120,0,11,e_0,482,711,754,12,0,0,1,4,0,1,229,43,272
p_21,0,4,e_3,731,740,756,3,1,0,3,4,0,1,9,16,25
p_126,0,12,e_0,476,711,759,12,0,0,3,4,0,1,235,48,283
p_131,0,14,e_0,471,711,767,12,0,0,4,4,0,1,240,56,296
p_125,0,14,e_0,477,711,767,12,0,0,2,4,0,1,234,56,290
p_122,0,15,e_0,480,711,772,12,0,0,1,4,0,1,231,61,292
p_35,0,9,e_3,630,740,773,2,1,0,2,4,0,1,110,33,143
p_23,0,12,e_3,711,740,784,9,1,0,9,4,0,1,29,44,73
p_36,0,13,e_3,628,740,789,2,1,0,2,4,0,1,112,49,161
p_20,0,14,e_3,734,740,794,2,1,0,2,4,0,1,6,54,60
p_16,0,2,e_2,780,796,804,17,3,3,5,4,0,1,16,8,24
p_14,0,4,e_2,794,796,812,14,0,0,0,4,0,1,2,16,18
p_65,0,1,e_0,573,819,824,19,4,4,8,4,0,1,246,5,251
p_15,0,9,e_2,793,796,829,14,0,0,1,4,0,1,3,33,36
p_72,0,3,e_0,562,819,832,21,6,6,12,4,0,1,257,13,270
p_71,0,3,e_0,564,819,832,20,6,6,11,4,0,1,255,13,268
p_70,0,3,e_0,565,819,832,20,5,5,11,4,0,1,254,13,267
p_67,0,3,e_0,568,819,832,20,5,5,10,4,0,1,251,13,264
p_66,0,3,e_0,569,819,832,19,5,5,10,4,0,1,250,13,263
p_18,0,10,e_2,766,796,834,21,4,4,10,4,0,1,30,38,68
p_17,0,10,e_2,776,796,834,18,3,3,6,4,0,1,20,38,58
p_64,0,4,e_0,574,819,837,18,4,4,8,4,0,1,245,18,263
p_19,0,11,e_2,754,796,839,24,5,5,13,3,0,0,42,43,85
p_61,0,6,e_0,579,819,845,17,3,3,6,4,0,1,240,26,266
p_60,0,10,e_0,580,819,859,17,3,3,6,4,0,1,239,40,279
p_58,0,11,e_0,582,819,864,16,3,3,5,4,0,1,237,45,282
p_68,0,13,e_0,567,819,872,20,5,5,10,4,0,1,252,53,305
p_63,0,13,e_0,577,819,872,18,3,3,7,4,0,1,242,53,295
p_62,0,13,e_0,578,819,872,18,3,3,7,4,0,1,241,53,294
p_69,0,14,e_0,566,819,877,20,5,5,11,4,0,1,253,58,311
p_59,0,14,e_0,581,819,877,17,3,3,6,4,0,1,238,58,296
p_9,0,2,e_2,846,874,882,14,0,0,9,4,0,1,28,8,36
p_10,0,8,e_2,835,874,902,14,0,0,10,5,1,0,39,28,67
p_45,0,2,e_0,595,921,929,13,1,0,1,4,0,1,326,8,334
p_55,0,3,e_0,585,921,934,16,2,2,4,4,0,1,336,13,349
p_54,0,3,e_0,586,921,934,16,2,2,4,4,0,1,335,13,348
p_52,0,3,e_0,588,921,934,15,1,1,3,4,0,1,333,13,346
p_1,0,5,e_3,894,919,936,8,1,0,8,4,0,1,25,17,42
p_48,0,4,e_0,592,921,939,14,1,0,2,4,0,1,329,18,347
p_46,0,4,e_0,594,921,939,14,1,0,1,4,0,1,327,18,345
p_7,0,5,e_1,875,923,940,14,1,0,15,3,0,0,48,17,65
p_56,0,6,e_0,584,921,947,16,2,2,5,4,0,1,337,26,363
p_3,0,8,e_3,888,919,947,10,1,0,10,4,0,1,31,28,59
p_50,0,7,e_0,590,921,952,15,1,0,3,4,0,1,331,31,362
p_43,0,7,e_0,597,921,952,13,1,0,0,4,0,1,324,31,355
p_44,0,8,e_0,596,921,957,13,1,0,1,4,0,1,325,36,361
p_8,0,11,e_3,874,919,958,14,0,0,14,3,0,0,45,39,84
p_53,0,9,e_0,587,921,962,15,2,2,4,4,0,1,334,41,375
p_51,0,9,e_0,589,921,962,15,1,0,3,4,0,1,332,41,373
p_47,0,9,e_0,593,921,962,14,1,0,2,4,0,1,328,41,369
p_57,0,11,e_0,583,921,970,16,2,2,5,4,0,1,338,49,387
p_49,0,14,e_0,591,921,981,15,1,0,2,4,0,1,330,60,390
p_4,0,1,e_0,886,1025,1030,11,1,0,11,4,0,1,139,5,144
p_24,0,2,e_0,695,1025,1035,14,1,1,5,4,0,1,330,10,340
p_6,0,3,e_0,877,1025,1040,14,1,0,14,4,0,1,148,15,163
p_42,0,6,e_0,598,1025,1051,12,1,0,0,3,0,0,427,26,453
p_26,0,8,e_0,684,1025,1059,16,4,4,9,4,0,1,341,34,375
p_25,0,8,e_0,686,1025,1059,16,3,3,8,4,0,1,339,34,373
p_5,0,8,e_0,883,1025,1059,12,1,0,12,4,0,1,142,34,176
p_11,0,9,e_0,807,1025,1064,14,0,0,4,4,0,1,218,39,257
p_13,0,11,e_0,796,1025,1072,14,0,0,7,4,0,1,229,47,276
p_12,0,11,e_0,798,1025,1072,14,0,0,7,4,0,1,227,47,274
p_2,0,11,e_0,892,1025,1072,9,1,0,9,4,0,1,133,47,180
p_300,0,4,e_0,8,9,25,0,0,0,0,3,0,0,1,16,17
p_299,0,5,e_1,9,10,29,0,0,0,0,3,0,0,1,19,20
p_297,0,6,e_3,15,16,38,0,0,0,0,3,0,0,1,22,23
p_298,0,9,e_2,11,12,43,0,0,0,0,3,0,0,1,31,32
p_296,0,4,e_0,28,43,57,9,1,1,4,3,0,0,15,14,29
p_286,0,3,e_1,46,47,60,6,0,0,0,3,0,0,1,13,14
p_292,0,6,e_0,38,43,65,6,0,0,1,4,0,1,5,22,27
p_290,0,6,e_0,40,43,65,6,0,0,1,4,0,1,3,22,25
p_289,0,4,e_1,43,47,65,6,0,0,1,4,0,1,4,18,22
p_295,0,5,e_1,29,47,70,9,1,1,5,3,0,0,18,23,41
p_287,0,5,e_1,45,47,70,6,0,0,0,4,0,1,2,23,25
p_288,0,8,e_1,44,47,81,6,0,0,1,4,0,1,3,34,37
p_281,0,1,e_3,73,74,81,0,0,0,0,3,0,0,1,7,8
p_291,0,11,e_0,39,43,82,6,0,0,1,4,0,1,4,39,43
p_294,0,12,e_0,31,43,87,8,1,1,4,4,0,1,12,44,56
p_293,0,12,e_0,33,43,87,7,1,1,3,4,0,1,10,44,54
p_285,0,4,e_3,53,74,92,6,0,0,6,3,0,0,21,18,39
p_284,0,4,e_3,54,74,92,6,1,0,6,4,0,1,20,18,38
p_282,0,7,e_3,66,74,103,2,1,0,2,4,0,1,8,29,37
p_283,0,9,e_3,57,74,111,5,1,0,5,4,0,1,17,37,54
p_278,0,2,e_2,77,105,113,18,4,4,9,4,0,1,28,8,36
p_279,0,5,e_2,76,105,124,18,4,4,9,4,0,1,29,19,48
p_277,0,6,e_1,82,109,129,17,3,3,8,3,0,0,27,20,47
p_274,0,8,e_2,88,105,135,15,3,3,5,4,0,1,17,30,47
p_271,0,1,e_3,121,140,145,6,1,0,6,4,0,1,19,5,24
p_276,0,11,e_2,84,105,146,16,3,3,7,4,0,1,21,41,62
p_273,0,4,e_3,110,140,156,9,0,0,9,2,1,0,30,16,46
p_280,0,14,e_2,75,105,157,18,4,4,9,3,0,0,30,52,82
p_275,0,14,e_2,86,105,157,16,3,3,6,4,0,1,19,52,71
p_267,0,1,e_1,148,165,172,18,3,3,5,4,0,1,17,7,24
p_270,0,9,e_3,122,140,173,6,1,0,6,4,0,1,18,33,51
p_269,0,9,e_3,127,140,173,4,1,0,4,4,0,1,13,33,46
p_268,0,2,e_1,144,165,177,19,3,3,6,3,0,0,21,12,33
p_272,0,10,e_3,113,140,178,9,1,0,9,4,0,1,27,38,65
p_265,0,4,e_1,152,165,185,17,3,3,4,4,0,1,13,20,33
p_262,0,5,e_1,157,165,190,16,2,2,2,4,0,1,8,25,33
p_261,0,5,e_1,164,165,190,14,2,2,0,3,0,0,1,25,26
p_266,0,6,e_1,151,165,195,17,3,3,4,4,0,1,14,30,44
p_263,0,7,e_1,154,165,200,16,3,3,3,4,0,1,11,35,46
p_264,0,11,e_1,153,165,214,17,3,3,4,4,0,1,12,49,61
p_255,0,3,e_0,184,204,215,10,0,0,6,4,0,1,20,11,31
p_254,0,4,e_0,187,204,220,10,0,0,5,4,0,1,17,16,33
p_253,0,5,e_0,190,204,225,10,0,0,4,4,0,1,14,21,35
p_252,0,5,e_2,205,212,229,10,0,0,2,4,0,1,7,17,24
p_260,0,7,e_0,165,204,233,13,2,2,12,3,0,0,39,29,68
p_258,0,7,e_0,168,204,233,12,2,2,12,4,0,1,36,29,65
p_256,0,10,e_0,182,204,244,10,0,0,7,4,0,1,22,40,62
p_257,0,14,e_0,169,204,258,12,2,2,11,4,0,1,35,54,89
p_250,0,2,e_3,217,250,258,10,0,0,10,3,0,0,33,8,41
p_259,0,15,e_2,167,212,261,13,2,2,14,3,0,0,45,49,94
p_251,0,15,e_2,209,212,261,10,0,0,1,4,0,1,3,49,52
p_248,0,5,e_3,246,250,269,1,1,0,1,4,0,1,4,19,23
p_249,0,6,e_3,239,250,274,3,1,0,3,4,0,1,11,24,35
p_241,0,1,e_1,283,286,291,6,0,0,1,4,0,1,3,5,8
p_247,0,5,e_1,250,286,305,12,3,3,11,3,0,0,36,19,55
p_245,0,7,e_1,269,286,313,7,1,1,5,4,0,1,17,27,44
p_242,0,8,e_1,277,286,318,6,0,0,3,4,0,1,9,32,41
p_246,0,10,e_1,262,286,326,9,2,2,8,4,0,1,24,40,64
p_236,0,1,e_3,305,322,327,5,1,0,5,4,0,1,17,5,22
p_233,0,1,e_3,311,322,327,3,1,0,3,4,0,1,11,5,16
p_244,0,12,e_1,271,286,334,7,1,1,5,4,0,1,15,48,63
p_230,0,3,e_3,319,322,335,1,1,0,1,4,0,1,3,13,16
p_232,0,5,e_3,314,322,343,2,1,0,2,4,0,1,8,21,29
p_243,0,15,e_1,272,286,345,6,1,1,4,4,0,1,14,59,73
p_237,0,7,e_3,304,322,351,6,1,0,6,4,0,1,18,29,47
p_231,0,7,e_3,317,322,351,1,1,0,1,4,0,1,5,29,34
p_235,0,8,e_3,308,322,356,4,1,0,4,4,0,1,14,34,48
p_234,0,8,e_3,310,322,356,4,1,0,4,4,0,1,12,34,46
p_240,0,9,e_3,301,322,361,6,0,0,6,3,0,0,21,39,60
p_239,0,11,e_3,302,322,369,6,1,0,6,4,0,1,20,47,67
p_216,0,1,e_0,347,370,377,20,5,5,7,4,0,1,23,7,30
p_238,0,13,e_3,303,322,377,6,1,0,6,4,0,1,19,55,74
p_229,0,13,e_3,320,322,377,0,1,0,0,4,0,1,2,55,57
p_226,0,2,e_0,329,370,382,25,7,7,13,4,0,1,41,12,53
p_223,0,2,e_0,336,370,382,23,6,6,11,4,0,1,34,12,46
p_214,0,3,e_0,349,370,387,19,5,5,7,4,0,1,21,17,38
p_196,0,4,e_2,371,375,391,15,1,1,1,4,0,1,4,16,20
p_228,0,4,e_0,325,370,392,25,8,8,14,3,0,0,45,22,67
p_225,0,5,e_0,330,370,397,24,7,7,13,4,0,1,40,27,67
p_224,0,5,e_0,331,370,397,24,7,7,13,4,0,1,39,27,66
p_222,0,5,e_0,337,370,397,23,6,6,11,4,0,1,33,27,60
p_219,0,5,e_0,342,370,397,21,5,5,9,4,0,1,28,27,55
p_194,0,6,e_2,373,375,399,14,1,1,0,4,0,1,2,24,26
p_221,0,6,e_0,339,370,402,22,6,6,10,4,0,1,31,32,63
p_220,0,6,e_0,341,370,402,21,6,6,9,4,0,1,29,32,61
p_217,0,7,e_0,346,370,407,20,5,5,8,4,0,1,24,37,61
p_197,0,10,e_2,370,375,413,15,1,1,1,4,0,1,5,38,43
p_193,0,11,e_2,374,375,418,14,1,1,0,3,0,0,1,43,44
p_218,0,11,e_0,343,370,421,21,5,5,9,4,0,1,27,51,78
p_227,0,12,e_2,327,375,423,25,7,7,15,3,0,0,48,48,96
p_190,0,1,e_3,379,418,425,13,1,0,13,4,0,1,39,7,46
p_183,0,1,e_3,396,418,425,7,1,0,7,4,0,1,22,7,29
p_161,0,1,e_1,421,423,428,30,10,10,0,4,0,1,2,5,7
p_182,0,2,e_3,397,418,430,7,1,0,7,4,0,1,21,12,33
p_180,0,2,e_3,399,418,430,6,1,0,6,4,0,1,19,12,31
p_195,0,15,e_2,372,375,434,14,1,1,1,4,0,1,3,59,62
p_215,0,15,e_0,348,370,435,20,5,5,7,4,0,1,22,65,87
p_213,0,15,e_0,350,370,435,19,4,4,6,4,0,1,20,65,85
p_178,0,3,e_3,401,418,435,5,1,0,5,4,0,1,17,17,34
p_186,0,4,e_3,390,418,440,9,1,0,9,4,0,1,28,22,50
p_192,0,8,e_1,375,423,451,13,1,1,15,3,0,0,48,28,76
p_189,0,8,e_3,382,418,454,12,1,0,12,4,0,1,36,36,72
p_179,0,8,e_3,400,418,454,6,1,0,6,4,0,1,18,36,54
p_163,0,10,e_1,419,423,459,30,10,10,1,4,0,1,4,36,40
p_177,0,9,e_3,402,418,459,5,1,0,5,4,0,1,16,41,57
p_164,0,11,e_1,418,423,464,30,11,11,1,4,0,1,5,41,46
p_162,0,11,e_1,420,423,464,30,10,10,1,4,0,1,3,41,44
p_191,0,10,e_3,376,418,464,13,0,0,13,2,1,0,42,46,88
p_185,0,10,e_3,391,418,464,9,1,0,9,4,0,1,27,46,73
p_187,0,12,e_3,389,418,472,9,1,0,9,4,0,1,29,54,83
p_184,0,12,e_3,392,418,472,8,1,0,8,4,0,1,26,54,80
p_188,0,13,e_3,384,418,477,11,1,0,11,4,0,1,34,59,93
p_181,0,15,e_3,398,418,485,6,1,0,6,4,0,1,20,67,87
p_209,0,2,e_0,357,482,492,18,3,3,4,4,0,1,125,10,135
p_205,0,2,e_0,362,482,492,17,2,2,2,4,0,1,120,10,130
p_129,0,3,e_2,473,481,494,18,3,3,2,4,0,1,8,13,21
p_137,0,4,e_2,464,481,499,20,4,4,5,4,0,1,17,18,35
p_200,0,4,e_0,367,482,500,15,2,2,1,4,0,1,115,18,133
p_201,0,5,e_0,366,482,505,16,2,2,1,4,0,1,116,23,139
p_159,0,6,e_2,429,481,507,28,9,9,14,5,1,1,52,26,78
p_150,0,6,e_2,443,481,507,25,7,7,12,4,0,1,38,26,64
p_141,0,6,e_2,458,481,507,21,5,5,7,4,0,1,23,26,49
p_210,0,6,e_0,354,482,510,18,4,4,5,4,0,1,128,28,156
p_208,0,6,e_0,358,482,510,18,3,3,4,4,0,1,124,28,152
p_212,0,7,e_0,351,482,515,19,4,4,6,4,0,1,131,33,164
p_148,0,8,e_2,449,481,515,23,7,7,10,4,0,1,32,34,66
p_153,0,9,e_2,437,481,520,27,8,8,14,4,0,1,44,39,83
p_147,0,9,e_2,452,481,520,22,7,7,9,4,0,1,29,39,68
p_144,0,9,e_2,455,481,520,22,6,6,8,4,0,1,26,39,65
p_198,0,9,e_0,369,482,523,15,1,1,0,3,0,0,113,41,154
p_119,0,1,e_1,483,518,525,15,2,2,11,4,0,1,35,7,42
p_113,0,1,e_1,489,518,525,14,1,0,9,4,0,1,29,7,36
p_139,0,10,e_2,461,481,525,21,5,5,6,4,0,1,20,44,64
p_132,0,11,e_2,470,481,530,18,4,4,3,4,0,1,11,49,60
p_207,0,11,e_0,359,482,531,17,3,3,3,4,0,1,123,49,172
p_114,0,3,e_1,488,518,533,14,1,0,10,4,0,1,30,15,45
p_106,0,3,e_1,500,518,533,10,1,0,6,4,0,1,18,15,33
p_126,0,12,e_2,476,481,535,17,2,2,1,4,0,1,5,54,59
p_206,0,12,e_0,361,482,536,17,2,2,3,4,0,1,121,54,175
p_203,0,12,e_0,364,482,536,16,2,2,2,4,0,1,118,54,172
p_167,0,1,e_3,413,532,537,1,1,0,1,4,0,1,119,5,124
p_204,0,14,e_0,363,482,544,17,2,2,2,4,0,1,119,62,181
p_108,0,6,e_1,496,518,544,12,1,0,7,4,0,1,22,26,48
p_160,0,15,e_2,426,481,546,29,10,10,13,5,1,0,55,65,120
p_156,0,15,e_2,434,481,546,27,8,8,15,4,0,1,47,65,112
p_134,0,15,e_2,467,481,546,19,4,4,4,4,0,1,14,65,79
p_176,0,4,e_3,403,532,548,5,1,0,5,4,0,1,129,16,145
p_165,0,4,e_3,417,532,548,0,0,0,0,3,0,0,115,16,131
p_211,0,15,e_0,353,482,549,19,4,4,5,4,0,1,129,67,196
p_202,0,15,e_0,365,482,549,16,2,2,1,4,0,1,117,67,184
p_199,0,15,e_0,368,482,549,15,1,1,0,4,0,1,114,67,181
p_118,0,7,e_1,484,518,549,15,1,1,11,4,0,1,34,31,65
p_111,0,8,e_1,491,518,554,13,1,0,9,4,0,1,27,36,63
p_94,0,6,e_3,519,532,556,4,1,0,4,4,0,1,13,24,37
p_115,0,9,e_1,487,518,559,15,1,0,10,4,0,1,31,41,72
p_117,0,10,e_1,485,518,564,15,1,0,11,4,0,1,33,46,79
p_116,0,10,e_1,486,518,564,15,1,0,10,4,0,1,32,46,78
p_169,0,9,e_3,411,532,567,2,1,0,2,4,0,1,121,35,156
p_120,0,11,e_1,482,518,569,16,2,2,11,3,0,0,36,51,87
p_112,0,11,e_1,490,518,569,14,1,0,9,4,0,1,28,51,79
p_110,0,11,e_1,492,518,569,13,1,0,8,4,0,1,26,51,77
p_107,0,11,e_1,499,518,569,11,1,0,6,4,0,1,19,51,70
p_173,0,11,e_3,407,532,575,3,1,0,3,4,0,1,125,43,168
p_166,0,12,e_3,416,532,580,0,1,0,0,4,0,1,116,48,164
p_109,0,15,e_1,493,518,583,13,1,0,8,4,0,1,25,65,90
p_171,0,13,e_3,409,532,585,3,1,0,3,4,0,1,123,53,176
p_168,0,13,e_3,412,532,585,2,1,0,2,4,0,1,120,53,173
p_93,0,13,e_3,520,532,585,4,1,0,4,4,0,1,12,53,65
p_175,0,14,e_3,405,532,590,4,1,0,4,4,0,1,127,58,185
p_174,0,14,e_3,406,532,590,4,1,0,4,4,0,1,126,58,184
p_170,0,14,e_3,410,532,590,2,1,0,2,4,0,1,122,58,180
p_95,0,14,e_3,518,532,590,4,1,0,4,4,0,1,14,58,72
p_172,0,15,e_3,408,532,595,3,1,0,3,4,0,1,124,63,187
p_158,0,1,e_0,430,596,603,28,9,9,14,5,1,1,166,7,173
p_146,0,1,e_0,453,596,603,22,6,6,9,4,0,1,143,7,150
p_86,0,2,e_2,544,593,603,27,9,9,15,5,1,1,49,10,59
p_77,0,3,e_2,557,593,608,24,7,7,12,4,0,1,36,15,51
p_143,0,3,e_0,456,596,611,22,6,6,8,4,0,1,140,15,155
p_136,0,3,e_0,465,596,611,20,4,4,5,4,0,1,131,15,146
p_88,0,5,e_2,538,593,616,29,9,9,13,5,1,1,55,23,78
p_80,0,7,e_2,552,593,624,25,8,8,13,4,0,1,41,31,72
p_154,0,7,e_0,436,596,625,27,8,8,15,4,0,1,160,29,189
p_87,0,8,e_2,539,593,629,29,9,9,13,5,1,1,54,36,90
p_83,0,8,e_2,549,593,629,26,8,8,14,4,0,1,44,36,80
p_140,0,8,e_0,459,596,630,21,5,5,7,4,0,1,137,34,171
p_89,0,9,e_2,535,593,634,29,10,10,12,5,1,1,58,41,99
p_142,0,9,e_0,457,596,635,21,6,6,8,4,0,1,139,39,178
p_96,0,1,e_1,517,630,635,5,1,0,0,3,0,0,113,5,118
p_135,0,10,e_0,466,596,640,20,4,4,5,4,0,1,130,44,174
p_123,0,11,e_2,479,593,642,17,2,2,0,4,0,1,114,49,163
p_145,0,11,e_0,454,596,645,22,6,6,9,4,0,1,142,49,191
p_138,0,11,e_0,463,596,645,20,4,4,6,4,0,1,133,49,182
p_84,0,12,e_2,546,593,647,26,9,9,15,4,0,1,47,54,101
p_78,0,12,e_2,556,593,647,24,7,7,12,4,0,1,37,54,91
p_99,0,6,e_1,514,630,652,6,1,0,1,4,0,1,116,22,138
p_42,0,6,e_1,598,630,652,14,1,0,10,4,0,1,32,22,54
p_82,0,14,e_2,550,593,655,26,8,8,14,4,0,1,43,62,105
p_81,0,14,e_2,551,593,655,25,8,8,14,4,0,1,42,62,104
p_79,0,14,e_2,553,593,655,25,8,8,13,4,0,1,40,62,102
p_157,0,14,e_0,431,596,656,28,9,9,14,5,1,1,165,60,225
p_155,0,14,e_0,435,596,656,27,8,8,15,4,0,1,161,60,221
p_92,0,4,e_3,525,642,656,2,1,0,2,4,0,1,117,14,131
p_102,0,7,e_1,509,630,657,7,1,0,3,4,0,1,121,27,148
p_98,0,7,e_1,515,630,657,5,1,0,1,4,0,1,115,27,142
p_97,0,7,e_1,516,630,657,5,1,0,0,4,0,1,114,27,141
p_43,0,7,e_1,597,630,657,15,1,0,11,4,0,1,33,27,60
p_122,0,15,e_2,480,593,660,16,2,2,0,3,0,0,113,67,180
p_85,0,15,e_2,545,593,660,27,9,9,15,2,1,1,48,67,115
p_152,0,15,e_0,441,596,661,26,7,7,13,4,0,1,155,65,220
p_151,0,15,e_0,442,596,661,26,7,7,13,4,0,1,154,65,219
p_149,0,15,e_0,444,596,661,25,7,7,12,4,0,1,152,65,217
p_101,0,8,e_1,511,630,662,7,1,0,2,4,0,1,119,32,151
p_44,0,8,e_1,596,630,662,15,1,0,11,4,0,1,34,32,66
p_100,0,9,e_1,513,630,667,6,1,0,1,4,0,1,117,37,154
p_35,0,9,e_3,630,642,673,4,1,0,4,4,0,1,12,31,43
p_103,0,11,e_1,508,630,675,8,1,0,3,4,0,1,122,45,167
p_41,0,11,e_1,600,630,675,14,1,0,10,4,0,1,30,45,75
p_105,0,12,e_1,502,630,680,10,1,0,5,4,0,1,128,50,178
p_91,0,12,e_3,526,642,684,2,1,0,2,4,0,1,116,42,158
p_40,0,13,e_1,602,630,685,13,1,0,9,4,0,1,28,55,83
p_90,0,13,e_3,527,642,689,1,1,0,1,4,0,1,115,47,162
p_104,0,14,e_1,503,630,690,9,1,0,5,4,0,1,127,60,187
p_65,0,1,e_2,573,707,712,19,6,6,6,4,0,1,134,5,139
p_130,0,1,e_0,472,708,713,18,3,3,3,4,0,1,236,5,241
p_45,0,2,e_0,595,708,718,15,1,0,0,3,0,0,113,10,123
p_72,0,3,e_2,562,707,720,22,7,7,10,4,0,1,145,13,158
p_71,0,3,e_2,564,707,720,22,7,7,9,4,0,1,143,13,156
p_70,0,3,e_2,565,707,720,21,7,7,9,4,0,1,142,13,155
p_67,0,3,e_2,568,707,720,21,6,6,8,4,0,1,139,13,152
p_66,0,3,e_2,569,707,720,21,6,6,8,4,0,1,138,13,151
p_30,0,3,e_0,668,708,723,18,3,3,13,4,0,1,40,15,55
p_64,0,4,e_2,574,707,725,19,5,5,6,4,0,1,133,18,151
p_46,0,4,e_0,594,708,728,15,1,1,0,4,0,1,114,20,134
p_75,0,5,e_2,559,707,730,23,7,7,11,4,0,1,148,23,171
p_29,0,5,e_0,670,708,733,18,3,3,12,4,0,1,38,25,63
p_76,0,6,e_2,558,707,735,24,7,7,11,4,0,1,149,28,177
p_74,0,7,e_2,560,707,740,23,7,7,11,4,0,1,147,33,180
p_124,0,7,e_0,478,708,741,17,2,2,1,4,0,1,230,33,263
p_22,0,3,e_1,719,734,745,13,0,0,5,4,0,1,15,11,26
p_47,0,9,e_0,593,708,749,15,2,2,1,4,0,1,115,41,156
p_21,0,4,e_1,731,734,750,13,0,0,1,4,0,1,3,16,19
p_127,0,10,e_0,475,708,754,17,3,3,2,4,0,1,233,46,279
p_73,0,11,e_2,561,707,754,23,7,7,10,4,0,1,146,47,193
p_128,0,11,e_0,474,708,759,18,3,3,2,4,0,1,234,51,285
p_121,0,11,e_0,481,708,759,16,2,2,0,3,0,0,227,51,278
p_28,0,11,e_0,676,708,759,16,2,2,10,4,0,1,32,51,83
p_68,0,13,e_2,567,707,762,21,6,6,8,4,0,1,140,55,195
p_63,0,13,e_2,577,707,762,19,5,5,5,4,0,1,130,55,185
p_62,0,13,e_2,578,707,762,18,5,5,5,4,0,1,129,55,184
p_133,0,12,e_0,469,708,764,19,4,4,4,4,0,1,239,56,295
p_37,0,9,e_1,615,734,767,9,1,0,5,4,0,1,119,33,152
p_69,0,14,e_2,566,707,767,21,6,6,9,4,0,1,141,60,201
p_131,0,14,e_0,471,708,772,18,3,3,3,4,0,1,237,64,301
p_125,0,14,e_0,477,708,772,17,2,2,1,4,0,1,231,64,295
p_33,0,15,e_0,649,708,777,24,4,4,12,5,2,1,59,69,128
p_39,0,12,e_1,607,734,778,11,1,0,7,4,0,1,127,44,171
p_23,0,12,e_1,711,734,778,13,0,0,7,4,0,1,23,44,67
p_38,0,13,e_1,608,734,783,11,1,0,7,4,0,1,126,49,175
p_36,0,13,e_1,628,734,783,4,1,0,0,4,0,1,106,49,155
p_18,0,10,e_3,766,776,808,3,1,0,3,4,0,1,10,32,42
p_19,0,11,e_3,754,776,813,7,1,0,7,4,0,1,22,37,59
p_55,0,3,e_2,585,811,822,17,3,3,2,4,0,1,226,11,237
p_54,0,3,e_2,586,811,822,17,3,3,2,4,0,1,225,11,236
p_52,0,3,e_2,588,811,822,16,3,3,1,4,0,1,223,11,234
p_20,0,14,e_3,734,776,824,13,0,0,13,3,0,0,42,48,90
p_48,0,4,e_2,592,811,827,16,2,2,0,3,0,0,219,16,235
p_24,0,2,e_0,695,824,832,13,0,0,4,4,0,1,129,8,137
p_61,0,6,e_2,579,811,835,18,4,4,4,4,0,1,232,24,256
p_56,0,6,e_2,584,811,835,17,3,3,3,4,0,1,227,24,251
p_50,0,7,e_2,590,811,840,16,2,2,1,4,0,1,221,29,250
p_53,0,9,e_2,587,811,848,17,3,3,2,4,0,1,224,37,261
p_51,0,9,e_2,589,811,848,16,2,2,1,4,0,1,222,37,259
p_25,0,8,e_0,686,824,852,14,1,1,7,4,0,1,138,28,166
p_60,0,10,e_2,580,811,853,18,4,4,4,4,0,1,231,42,273
p_58,0,11,e_2,582,811,858,18,4,4,3,4,0,1,229,47,276
p_57,0,11,e_2,583,811,858,17,4,4,3,4,0,1,228,47,275
p_27,0,10,e_0,677,824,860,16,2,2,10,4,0,1,147,36,183
p_34,0,12,e_2,646,811,863,25,4,4,12,2,3,1,165,52,217
p_59,0,14,e_2,581,811,871,18,4,4,4,4,0,1,230,60,290
p_49,0,14,e_2,591,811,871,16,2,2,0,4,0,1,220,60,280
p_9,0,2,e_1,846,877,885,14,0,0,10,4,0,1,31,8,39
p_7,0,5,e_1,875,877,896,14,0,0,0,4,0,1,2,19,21
p_10,0,8,e_1,835,877,907,14,0,0,13,3,0,0,42,30,72
p_4,0,1,e_0,886,910,915,14,0,0,8,4,0,1,24,5,29
p_8,0,11,e_1,874,877,918,14,0,0,1,4,0,1,3,41,44
p_6,0,3,e_0,877,910,923,14,0,0,10,3,0,0,33,13,46
p_16,0,2,e_2,780,915,923,27,3,3,10,4,0,1,135,8,143
p_1,0,5,e_0,894,910,931,14,0,0,5,4,0,1,16,21,37
p_14,0,4,e_2,794,915,931,22,3,3,5,4,0,1,121,16,137
p_32,0,6,e_2,650,915,939,24,4,4,13,5,2,1,265,24,289
p_31,0,6,e_2,666,915,939,19,3,3,13,4,0,1,249,24,273
p_5,0,8,e_0,883,910,942,14,0,0,9,4,0,1,27,32,59
p_3,0,8,e_0,888,910,942,14,0,0,7,4,0,1,22,32,54
p_26,0,8,e_2,684,915,947,14,1,1,7,4,0,1,231,32,263
p_15,0,9,e_2,793,915,952,23,3,3,6,4,0,1,122,37,159
p_11,0,9,e_2,807,915,952,18,2,2,1,4,0,1,108,37,145
p_2,0,11,e_0,892,910,953,14,0,0,6,4,0,1,18,43,61
p_17,0,10,e_2,776,915,957,28,3,3,11,4,0,1,139,42,181
p_13,0,11,e_2,796,915,962,22,3,3,5,4,0,1,119,47,166
p_12,0,11,e_2,798,915,962,21,3,3,4,4,0,1,117,47,164
p_300,0,4,e_0,8,9,25,0,0,0,0,3,0,0,1,16,17
p_299,0,5,e_1,9,10,29,0,0,0,0,3,0,0,1,19,20
p_297,0,6,e_3,15,16,38,0,0,0,0,3,0,0,1,22,23
p_298,0,9,e_2,11,12,43,0,0,0,0,3,0,0,1,31,32
p_296,0,4,e_0,28,43,57,9,1,1,4,3,0,0,15,14,29
p_286,0,3,e_1,46,47,60,6,0,0,0,3,0,0,1,13,14
p_292,0,6,e_0,38,43,65,6,0,0,1,4,0,1,5,22,27
p_290,0,6,e_0,40,43,65,6,0,0,1,4,0,1,3,22,25
p_289,0,4,e_1,43,47,65,6,0,0,1,4,0,1,4,18,22
p_295,0,5,e_1,29,47,70,9,1,1,5,3,0,0,18,23,41
p_287,0,5,e_1,45,47,70,6,0,0,0,4,0,1,2,23,25
p_288,0,8,e_1,44,47,81,6,0,0,1,4,0,1,3,34,37
p_281,0,1,e_3,73,74,81,0,0,0,0,3,0,0,1,7,8
p_291,0,11,e_0,39,43,82,6,0,0,1,4,0,1,4,39,43
p_294,0,12,e_0,31,43,87,8,1,1,4,4,0,1,12,44,56
p_293,0,12,e_0,33,43,87,7,1,1,3,4,0,1,10,44,54
p_285,0,4,e_3,53,74,92,6,0,0,6,3,0,0,21,18,39
p_284,0,4,e_3,54,74,92,6,1,0,6,4,0,1,20,18,38
p_282,0,7,e_3,66,74,103,2,1,0,2,4,0,1,8,29,37
p_283,0,9,e_3,57,74,111,5,1,0,5,4,0,1,17,37,54
p_278,0,2,e_2,77,105,113,18,4,4,9,4,0,1,28,8,36
p_279,0,5,e_2,76,105,124,18,4,4,9,4,0,1,29,19,48
p_277,0,6,e_1,82,109,129,17,3,3,8,3,0,0,27,20,47
p_274,0,8,e_2,88,105,135,15,3,3,5,4,0,1,17,30,47
p_271,0,1,e_3,121,140,145,6,1,0,6,4,0,1,19,5,24
p_276,0,11,e_2,84,105,146,16,3,3,7,4,0,1,21,41,62
p_273,0,4,e_3,110,140,156,9,0,0,9,2,1,0,30,16,46
p_280,0,14,e_2,75,105,157,18,4,4,9,3,0,0,30,52,82
p_275,0,14,e_2,86,105,157,16,3,3,6,4,0,1,19,52,71
p_267,0,1,e_1,148,165,172,18,3,3,5,4,0,1,17,7,24
p_270,0,9,e_3,122,140,173,6,1,0,6,4,0,1,18,33,51
p_269,0,9,e_3,127,140,173,4,1,0,4,4,0,1,13,33,46
p_268,0,2,e_1,144,165,177,19,3,3,6,3,0,0,21,12,33
p_272,0,10,e_3,113,140,178,9,1,0,9,4,0,1,27,38,65
p_265,0,4,e_1,152,165,185,17,3,3,4,4,0,1,13,20,33
p_262,0,5,e_1,157,165,190,16,2,2,2,4,0,1,8,25,33
p_261,0,5,e_1,164,165,190,14,2,2,0,3,0,0,1,25,26
p_266,0,6,e_1,151,165,195,17,3,3,4,4,0,1,14,30,44
p_263,0,7,e_1,154,165,200,16,3,3,3,4,0,1,11,35,46
p_264,0,11,e_1,153,165,214,17,3,3,4,4,0,1,12,49,61
p_255,0,3,e_0,184,204,215,10,0,0,6,4,0,1,20,11,31
p_254,0,4,e_0,187,204,220,10,0,0,5,4,0,1,17,16,33
p_253,0,5,e_0,190,204,225,10,0,0,4,4,0,1,14,21,35
p_252,0,5,e_2,205,212,229,10,0,0,2,4,0,1,7,17,24
p_260,0,7,e_0,165,204,233,13,2,2,12,3,0,0,39,29,68
p_258,0,7,e_0,168,204,233,12,2,2,12,4,0,1,36,29,65
p_256,0,10,e_0,182,204,244,10,0,0,7,4,0,1,22,40,62
p_257,0,14,e_0,169,204,258,12,2,2,11,4,0,1,35,54,89
p_250,0,2,e_3,217,250,258,10,0,0,10,3,0,0,33,8,41
p_259,0,15,e_2,167,212,261,13,2,2,14,3,0,0,45,49,94
p_251,0,15,e_2,209,212,261,10,0,0,1,4,0,1,3,49,52
p_248,0,5,e_3,246,250,269,1,1,0,1,4,0,1,4,19,23
p_249,0,6,e_3,239,250,274,3,1,0,3,4,0,1,11,24,35
p_241,0,1,e_1,283,286,291,6,0,0,1,4,0,1,3,5,8
p_247,0,5,e_1,250,286,305,12,3,3,11,3,0,0,36,19,55
p_245,0,7,e_1,269,286,313,7,1,1,5,4,0,1,17,27,44
p_242,0,8,e_1,277,286,318,6,0,0,3,4,0,1,9,32,41
p_246,0,10,e_1,262,286,326,9,2,2,8,4,0,1,24,40,64
p_236,0,1,e_3,305,322,327,5,1,0,5,4,0,1,17,5,22
p_233,0,1,e_3,311,322,327,3,1,0,3,4,0,1,11,5,16
p_244,0,12,e_1,271,286,334,7,1,1,5,4,0,1,15,48,63
p_230,0,3,e_3,319,322,335,1,1,0,1,4,0,1,3,13,16
p_232,0,5,e_3,314,322,343,2,1,0,2,4,0,1,8,21,29
p_243,0,15,e_1,272,286,345,6,1,1,4,4,0,1,14,59,73
p_237,0,7,e_3,304,322,351,6,1,0,6,4,0,1,18,29,47
p_231,0,7,e_3,317,322,351,1,1,0,1,4,0,1,5,29,34
p_235,0,8,e_3,308,322,356,4,1,0,4,4,0,1,14,34,48
p_234,0,8,e_3,310,322,356,4,1,0,4,4,0,1,12,34,46
p_240,0,9,e_3,301,322,361,6,0,0,6,3,0,0,21,39,60
p_239,0,11,e_3,302,322,369,6,1,0,6,4,0,1,20,47,67
p_216,0,1,e_0,347,370,377,20,5,5,7,4,0,1,23,7,30
p_238,0,13,e_3,303,322,377,6,1,0,6,4,0,1,19,55,74
p_229,0,13,e_3,320,322,377,0,1,0,0,4,0,1,2,55,57
p_226,0,2,e_0,329,370,382,25,7,7,13,4,0,1,41,12,53
p_223,0,2,e_0,336,370,382,23,6,6,11,4,0,1,34,12,46
p_214,0,3,e_0,349,370,387,19,5,5,7,4,0,1,21,17,38
p_196,0,4,e_2,371,375,391,15,1,1,1,4,0,1,4,16,20
p_228,0,4,e_0,325,370,392,25,8,8,14,3,0,0,45,22,67
p_225,0,5,e_0,330,370,397,24,7,7,13,4,0,1,40,27,67
p_224,0,5,e_0,331,370,397,24,7,7,13,4,0,1,39,27,66
p_222,0,5,e_0,337,370,397,23,6,6,11,4,0,1,33,27,60
p_219,0,5,e_0,342,370,397,21,5,5,9,4,0,1,28,27,55
p_194,0,6,e_2,373,375,399,14,1,1,0,4,0,1,2,24,26
p_221,0,6,e_0,339,370,402,22,6,6,10,4,0,1,31,32,63
p_220,0,6,e_0,341,370,402,21,6,6,9,4,0,1,29,32,61
p_217,0,7,e_0,346,370,407,20,5,5,8,4,0,1,24,37,61
p_197,0,10,e_2,370,375,413,15,1,1,1,4,0,1,5,38,43
p_193,0,11,e_2,374,375,418,14,1,1,0,3,0,0,1,43,44
p_218,0,11,e_0,343,370,421,21,5,5,9,4,0,1,27,51,78
p_227,0,12,e_2,327,375,423,25,7,7,15,3,0,0,48,48,96
p_190,0,1,e_3,379,418,425,13,1,0,13,4,0,1,39,7,46
p_183,0,1,e_3,396,418,425,7,1,0,7,4,0,1,22,7,29
p_161,0,1,e_1,421,423,428,30,10,10,0,4,0,1,2,5,7
p_182,0,2,e_3,397,418,430,7,1,0,7,4,0,1,21,12,33
p_180,0,2,e_3,399,418,430,6,1,0,6,4,0,1,19,12,31
p_195,0,15,e_2,372,375,434,14,1,1,1,4,0,1,3,59,62
p_215,0,15,e_0,348,370,435,20,5,5,7,4,0,1,22,65,87
p_213,0,15,e_0,350,370,435,19,4,4,6,4,0,1,20,65,85
p_178,0,3,e_3,401,418,435,5,1,0,5,4,0,1,17,17,34
p_186,0,4,e_3,390,418,440,9,1,0,9,4,0,1,28,22,50
p_192,0,8,e_1,375,423,451,13,1,1,15,3,0,0,48,28,76
p_189,0,8,e_3,382,418,454,12,1,0,12,4,0,1,36,36,72
p_179,0,8,e_3,400,418,454,6,1,0,6,4,0,1,18,36,54
p_163,0,10,e_1,419,423,459,30,10,10,1,4,0,1,4,36,40
p_177,0,9,e_3,402,418,459,5,1,0,5,4,0,1,16,41,57
p_164,0,11,e_1,418,423,464,30,11,11,1,4,0,1,5,41,46
p_162,0,11,e_1,420,423,464,30,10,10,1,4,0,1,3,41,44
p_191,0,10,e_3,376,418,464,13,0,0,13,2,1,0,42,46,88
p_185,0,10,e_3,391,418,464,9,1,0,9,4,0,1,27,46,73
p_187,0,12,e_3,389,418,472,9,1,0,9,4,0,1,29,54,83
p_184,0,12,e_3,392,418,472,8,1,0,8,4,0,1,26,54,80
p_188,0,13,e_3,384,418,477,11,1,0,11,4,0,1,34,59,93
p_181,0,15,e_3,398,418,485,6,1,0,6,4,0,1,20,67,87
p_209,0,2,e_0,357,482,492,18,3,3,4,4,0,1,125,10,135
p_205,0,2,e_0,362,482,492,17,2,2,2,4,0,1,120,10,130
p_129,0,3,e_2,473,481,494,18,3,3,2,4,0,1,8,13,21
p_137,0,4,e_2,464,481,499,20,4,4,5,4,0,1,17,18,35
p_200,0,4,e_0,367,482,500,15,2,2,1,4,0,1,115,18,133
p_201,0,5,e_0,366,482,505,16,2,2,1,4,0,1,116,23,139
p_159,0,6,e_2,429,481,507,28,9,9,14,5,1,1,52,26,78
p_150,0,6,e_2,443,481,507,25,7,7,12,4,0,1,38,26,64
p_141,0,6,e_2,458,481,507,21,5,5,7,4,0,1,23,26,49
p_210,0,6,e_0,354,482,510,18,4,4,5,4,0,1,128,28,156
p_208,0,6,e_0,358,482,510,18,3,3,4,4,0,1,124,28,152
p_212,0,7,e_0,351,482,515,19,4,4,6,4,0,1,131,33,164
p_148,0,8,e_2,449,481,515,23,7,7,10,4,0,1,32,34,66
p_153,0,9,e_2,437,481,520,27,8,8,14,4,0,1,44,39,83
p_147,0,9,e_2,452,481,520,22,7,7,9,4,0,1,29,39,68
p_144,0,9,e_2,455,481,520,22,6,6,8,4,0,1,26,39,65
p_198,0,9,e_0,369,482,523,15,1,1,0,3,0,0,113,41,154
p_119,0,1,e_1,483,518,525,15,2,2,11,4,0,1,35,7,42
p_113,0,1,e_1,489,518,525,14,1,0,9,4,0,1,29,7,36
p_139,0,10,e_2,461,481,525,21,5,5,6,4,0,1,20,44,64
p_132,0,11,e_2,470,481,530,18,4,4,3,4,0,1,11,49,60
p_207,0,11,e_0,359,482,531,17,3,3,3,4,0,1,123,49,172
p_114,0,3,e_1,488,518,533,14,1,0,10,4,0,1,30,15,45
p_106,0,3,e_1,500,518,533,10,1,0,6,4,0,1,18,15,33
p_126,0,12,e_2,476,481,535,17,2,2,1,4,0,1,5,54,59
p_206,0,12,e_0,361,482,536,17,2,2,3,4,0,1,121,54,175
p_203,0,12,e_0,364,482,536,16,2,2,2,4,0,1,118,54,172
p_167,0,1,e_3,413,532,537,1,1,0,1,4,0,1,119,5,124
p_204,0,14,e_0,363,482,544,17,2,2,2,4,0,1,119,62,181
p_108,0,6,e_1,496,518,544,12,1,0,7,4,0,1,22,26,48
p_160,0,15,e_2,426,481,546,29,10,10,13,5,1,0,55,65,120
p_156,0,15,e_2,434,481,546,27,8,8,15,4,0,1,47,65,112
p_134,0,15,e_2,467,481,546,19,4,4,4,4,0,1,14,65,79
p_176,0,4,e_3,403,532,548,5,1,0,5,4,0,1,129,16,145
p_165,0,4,e_3,417,532,548,0,0,0,0,3,0,0,115,16,131
p_211,0,15,e_0,353,482,549,19,4,4,5,4,0,1,129,67,196
p_202,0,15,e_0,365,482,549,16,2,2,1,4,0,1,117,67,184
p_199,0,15,e_0,368,482,549,15,1,1,0,4,0,1,114,67,181
p_118,0,7,e_1,484,518,549,15,1,1,11,4,0,1,34,31,65
p_111,0,8,e_1,491,518,554,13,1,0,9,4,0,1,27,36,63
p_94,0,6,e_3,519,532,556,4,1,0,4,4,0,1,13,24,37
p_115,0,9,e_1,487,518,559,15,1,0,10,4,0,1,31,41,72
p_117,0,10,e_1,485,518,564,15,1,0,11,4,0,1,33,46,79
p_116,0,10,e_1,486,518,564,15,1,0,10,4,0,1,32,46,78
p_169,0,9,e_3,411,532,567,2,1,0,2,4,0,1,121,35,156
p_120,0,11,e_1,482,518,569,16,2,2,11,3,0,0,36,51,87
p_112,0,11,e_1,490,518,569,14,1,0,9,4,0,1,28,51,79
p_110,0,11,e_1,492,518,569,13,1,0,8,4,0,1,26,51,77
p_107,0,11,e_1,499,518,569,11,1,0,6,4,0,1,19,51,70
p_173,0,11,e_3,407,532,575,3,1,0,3,4,0,1,125,43,168
p_166,0,12,e_3,416,532,580,0,1,0,0,4,0,1,116,48,164
p_109,0,15,e_1,493,518,583,13,1,0,8,4,0,1,25,65,90
p_171,0,13,e_3,409,532,585,3,1,0,3,4,0,1,123,53,176
p_168,0,13,e_3,412,532,585,2,1,0,2,4,0,1,120,53,173
p_93,0,13,e_3,520,532,585,4,1,0,4,4,0,1,12,53,65
p_175,0,14,e_3,405,532,590,4,1,0,4,4,0,1,127,58,185
p_174,0,14,e_3,406,532,590,4,1,0,4,4,0,1,126,58,184
p_170,0,14,e_3,410,532,590,2,1,0,2,4,0,1,122,58,180
p_95,0,14,e_3,518,532,590,4,1,0,4,4,0,1,14,58,72
p_172,0,15,e_3,408,532,595,3,1,0,3,4,0,1,124,63,187
p_158,0,1,e_0,430,596,603,28,9,9,14,5,1,1,166,7,173
p_146,0,1,e_0,453,596,603,22,6,6,9,4,0,1,143,7,150
p_86,0,2,e_2,544,593,603,27,9,9,15,5,1,1,49,10,59
p_77,0,3,e_2,557,593,608,24,7,7,12,4,0,1,36,15,51
p_143,0,3,e_0,456,596,611,22,6,6,8,4,0,1,140,15,155
p_136,0,3,e_0,465,596,611,20,4,4,5,4,0,1,131,15,146
p_88,0,5,e_2,538,593,616,29,9,9,13,5,1,1,55,23,78
p_80,0,7,e_2,552,593,624,25,8,8,13,4,0,1,41,31,72
p_154,0,7,e_0,436,596,625,27,8,8,15,4,0,1,160,29,189
p_87,0,8,e_2,539,593,629,29,9,9,13,5,1,1,54,36,90
p_83,0,8,e_2,549,593,629,26,8,8,14,4,0,1,44,36,80
p_140,0,8,e_0,459,596,630,21,5,5,7,4,0,1,137,34,171
p_89,0,9,e_2,535,593,634,29,10,10,12,5,1,1,58,41,99
p_142,0,9,e_0,457,596,635,21,6,6,8,4,0,1,139,39,178
p_96,0,1,e_1,517,630,635,5,1,0,0,3,0,0,113,5,118
p_135,0,10,e_0,466,596,640,20,4,4,5,4,0,1,130,44,174
p_123,0,11,e_2,479,593,642,17,2,2,0,4,0,1,114,49,163
p_145,0,11,e_0,454,596,645,22,6,6,9,4,0,1,142,49,191
p_138,0,11,e_0,463,596,645,20,4,4,6,4,0,1,133,49,182
p_84,0,12,e_2,546,593,647,26,9,9,15,4,0,1,47,54,101
p_78,0,12,e_2,556,593,647,24,7,7,12,4,0,1,37,54,91
p_99,0,6,e_1,514,630,652,6,1,0,1,4,0,1,116,22,138
p_42,0,6,e_1,598,630,652,14,1,0,10,4,0,1,32,22,54
p_82,0,14,e_2,550,593,655,26,8,8,14,4,0,1,43,62,105
p_81,0,14,e_2,551,593,655,25,8,8,14,4,0,1,42,62,104
p_79,0,14,e_2,553,593,655,25,8,8,13,4,0,1,40,62,102
p_157,0,14,e_0,431,596,656,28,9,9,14,5,1,1,165,60,225
p_155,0,14,e_0,435,596,656,27,8,8,15,4,0,1,161,60,221
p_92,0,4,e_3,525,642,656,2,1,0,2,4,0,1,117,14,131
p_102,0,7,e_1,509,630,657,7,1,0,3,4,0,1,121,27,148
p_98,0,7,e_1,515,630,657,5,1,0,1,4,0,1,115,27,142
p_97,0,7,e_1,516,630,657,5,1,0,0,4,0,1,114,27,141
p_43,0,7,e_1,597,630,657,15,1,0,11,4,0,1,33,27,60
p_122,0,15,e_2,480,593,660,16,2,2,0,3,0,0,113,67,180
p_85,0,15,e_2,545,593,660,27,9,9,15,2,1,1,48,67,115
p_152,0,15,e_0,441,596,661,26,7,7,13,4,0,1,155,65,220
p_151,0,15,e_0,442,596,661,26,7,7,13,4,0,1,154,65,219
p_149,0,15,e_0,444,596,661,25,7,7,12,4,0,1,152,65,217
p_101,0,8,e_1,511,630,662,7,1,0,2,4,0,1,119,32,151
p_44,0,8,e_1,596,630,662,15,1,0,11,4,0,1,34,32,66
p_100,0,9,e_1,513,630,667,6,1,0,1,4,0,1,117,37,154
p_35,0,9,e_3,630,642,673,4,1,0,4,4,0,1,12,31,43
p_103,0,11,e_1,508,630,675,8,1,0,3,4,0,1,122,45,167
p_41,0,11,e_1,600,630,675,14,1,0,10,4,0,1,30,45,75
p_105,0,12,e_1,502,630,680,10,1,0,5,4,0,1,128,50,178
p_91,0,12,e_3,526,642,684,2,1,0,2,4,0,1,116,42,158
p_40,0,13,e_1,602,630,685,13,1,0,9,4,0,1,28,55,83
p_90,0,13,e_3,527,642,689,1,1,0,1,4,0,1,115,47,162
p_104,0,14,e_1,503,630,690,9,1,0,5,4,0,1,127,60,187
p_65,0,1,e_2,573,707,712,19,6,6,6,4,0,1,134,5,139
p_130,0,1,e_0,472,708,713,18,3,3,3,4,0,1,236,5,241
p_45,0,2,e_0,595,708,718,15,1,0,0,3,0,0,113,10,123
p_72,0,3,e_2,562,707,720,22,7,7,10,4,0,1,145,13,158
p_71,0,3,e_2,564,707,720,22,7,7,9,4,0,1,143,13,156
p_70,0,3,e_2,565,707,720,21,7,7,9,4,0,1,142,13,155
p_67,0,3,e_2,568,707,720,21,6,6,8,4,0,1,139,13,152
p_66,0,3,e_2,569,707,720,21,6,6,8,4,0,1,138,13,151
p_30,0,3,e_0,668,708,723,18,3,3,13,4,0,1,40,15,55
p_64,0,4,e_2,574,707,725,19,5,5,6,4,0,1,133,18,151
p_46,0,4,e_0,594,708,728,15,1,1,0,4,0,1,114,20,134
p_75,0,5,e_2,559,707,730,23,7,7,11,4,0,1,148,23,171
p_29,0,5,e_0,670,708,733,18,3,3,12,4,0,1,38,25,63
p_76,0,6,e_2,558,707,735,24,7,7,11,4,0,1,149,28,177
p_74,0,7,e_2,560,707,740,23,7,7,11,4,0,1,147,33,180
p_124,0,7,e_0,478,708,741,17,2,2,1,4,0,1,230,33,263
p_22,0,3,e_1,719,734,745,13,0,0,5,4,0,1,15,11,26
p_47,0,9,e_0,593,708,749,15,2,2,1,4,0,1,115,41,156
p_21,0,4,e_1,731,734,750,13,0,0,1,4,0,1,3,16,19
p_127,0,10,e_0,475,708,754,17,3,3,2,4,0,1,233,46,279
p_73,0,11,e_2,561,707,754,23,7,7,10,4,0,1,146,47,193
p_128,0,11,e_0,474,708,759,18,3,3,2,4,0,1,234,51,285
p_121,0,11,e_0,481,708,759,16,2,2,0,3,0,0,227,51,278
p_28,0,11,e_0,676,708,759,16,2,2,10,4,0,1,32,51,83
p_68,0,13,e_2,567,707,762,21,6,6,8,4,0,1,140,55,195
p_63,0,13,e_2,577,707,762,19,5,5,5,4,0,1,130,55,185
p_62,0,13,e_2,578,707,762,18,5,5,5,4,0,1,129,55,184
p_133,0,12,e_0,469,708,764,19,4,4,4,4,0,1,239,56,295
p_37,0,9,e_1,615,734,767,9,1,0,5,4,0,1,119,33,152
p_69,0,14,e_2,566,707,767,21,6,6,9,4,0,1,141,60,201
p_131,0,14,e_0,471,708,772,18,3,3,3,4,0,1,237,64,301
p_125,0,14,e_0,477,708,772,17,2,2,1,4,0,1,231,64,295
p_33,0,15,e_0,649,708,777,24,4,4,12,5,2,1,59,69,128
p_39,0,12,e_1,607,734,778,11,1,0,7,4,0,1,127,44,171
p_23,0,12,e_1,711,734,778,13,0,0,7,4,0,1,23,44,67
p_38,0,13,e_1,608,734,783,11,1,0,7,4,0,1,126,49,175
p_36,0,13,e_1,628,734,783,4,1,0,0,4,0,1,106,49,155
p_18,0,10,e_3,766,776,808,3,1,0,3,4,0,1,10,32,42
p_19,0,11,e_3,754,776,813,7,1,0,7,4,0,1,22,37,59
p_55,0,3,e_2,585,811,822,17,3,3,2,4,0,1,226,11,237
p_54,0,3,e_2,586,811,822,17,3,3,2,4,0,1,225,11,236
p_52,0,3,e_2,588,811,822,16,3,3,1,4,0,1,223,11,234
p_20,0,14,e_3,734,776,824,13,0,0,13,3,0,0,42,48,90
p_48,0,4,e_2,592,811,827,16,2,2,0,3,0,0,219,16,235
p_24,0,2,e_0,695,824,832,13,0,0,4,4,0,1,129,8,137
p_61,0,6,e_2,579,811,835,18,4,4,4,4,0,1,232,24,256
p_56,0,6,e_2,584,811,835,17,3,3,3,4,0,1,227,24,251
p_50,0,7,e_2,590,811,840,16,2,2,1,4,0,1,221,29,250
p_53,0,9,e_2,587,811,848,17,3,3,2,4,0,1,224,37,261
p_51,0,9,e_2,589,811,848,16,2,2,1,4,0,1,222,37,259
p_25,0,8,e_0,686,824,852,14,1,1,7,4,0,1,138,28,166
p_60,0,10,e_2,580,811,853,18,4,4,4,4,0,1,231,42,273
p_58,0,11,e_2,582,811,858,18,4,4,3,4,0,1,229,47,276
p_57,0,11,e_2,583,811,858,17,4,4,3,4,0,1,228,47,275
p_27,0,10,e_0,677,824,860,16,2,2,10,4,0,1,147,36,183
p_34,0,12,e_2,646,811,863,25,4,4,12,2,3,1,165,52,217
p_59,0,14,e_2,581,811,871,18,4,4,4,4,0,1,230,60,290
p_49,0,14,e_2,591,811,871,16,2,2,0,4,0,1,220,60,280
p_9,0,2,e_1,846,877,885,14,0,0,10,4,0,1,31,8,39
p_7,0,5,e_1,875,877,896,14,0,0,0,4,0,1,2,19,21
p_10,0,8,e_1,835,877,907,14,0,0,13,3,0,0,42,30,72
p_4,0,1,e_0,886,910,915,14,0,0,8,4,0,1,24,5,29
p_8,0,11,e_1,874,877,918,14,0,0,1,4,0,1,3,41,44
p_6,0,3,e_0,877,910,923,14,0,0,10,3,0,0,33,13,46
p_16,0,2,e_2,780,915,923,27,3,3,10,4,0,1,135,8,143
p_1,0,5,e_0,894,910,931,14,0,0,5,4,0,1,16,21,37
p_14,0,4,e_2,794,915,931,22,3,3,5,4,0,1,121,16,137
p_32,0,6,e_2,650,915,939,24,4,4,13,5,2,1,265,24,289
p_31,0,6,e_2,666,915,939,19,3,3,13,4,0,1,249,24,273
p_5,0,8,e_0,883,910,942,14,0,0,9,4,0,1,27,32,59
p_3,0,8,e_0,888,910,942,14,0,0,7,4,0,1,22,32,54
p_26,0,8,e_2,684,915,947,14,1,1,7,4,0,1,231,32,263
p_15,0,9,e_2,793,915,952,23,3,3,6,4,0,1,122,37,159
p_11,0,9,e_2,807,915,952,18,2,2,1,4,0,1,108,37,145
p_2,0,11,e_0,892,910,953,14,0,0,6,4,0,1,18,43,61
p_17,0,10,e_2,776,915,957,28,3,3,11,4,0,1,139,42,181
p_13,0,11,e_2,796,915,962,22,3,3,5,4,0,1,119,47,166
p_12,0,11,e_2,798,915,962,21,3,3,4,4,0,1,117,47,164
p_300,0,4,e_0,8,9,25,0,0,0,0,3,0,0,1,16,17
p_299,0,5,e_1,9,10,29,0,0,0,0,3,0,0,1,19,20
p_297,0,6,e_3,15,16,38,0,0,0,0,3,0,0,1,22,23
p_298,0,9,e_2,11,12,43,0,0,0,0,3,0,0,1,31,32
p_296,0,4,e_0,28,43,57,9,1,1,4,3,0,0,15,14,29
p_295,0,5,e_0,29,43,62,9,1,1,4,4,0,1,14,19,33
p_292,0,6,e_0,38,43,67,6,0,0,1,4,0,1,5,24,29
p_290,0,6,e_0,40,43,67,6,0,0,1,4,0,1,3,24,27
p_286,0,3,e_1,46,61,72,6,0,0,5,4,0,1,15,11,26
p_289,0,4,e_1,43,61,77,6,0,0,5,3,0,0,18,16,34
p_285,0,4,e_1,53,61,77,6,0,0,2,4,0,1,8,16,24
p_284,0,4,e_1,54,61,77,6,0,0,2,4,0,1,7,16,23
p_287,0,5,e_1,45,61,82,6,0,0,5,4,0,1,16,21,37
p_291,0,11,e_0,39,43,84,6,0,0,1,4,0,1,4,41,45
p_294,0,12,e_0,31,43,89,8,1,1,4,4,0,1,12,46,58
p_293,0,12,e_0,33,43,89,7,1,1,3,4,0,1,10,46,56
p_288,0,8,e_1,44,61,93,6,0,0,5,4,0,1,17,32,49
p_281,0,1,e_3,73,87,94,4,1,0,4,4,0,1,14,7,21
p_283,0,9,e_1,57,61,98,6,0,0,1,4,0,1,4,37,41
p_278,0,2,e_3,77,87,99,3,1,0,3,4,0,1,10,12,22
p_279,0,5,e_3,76,87,110,3,1,0,3,4,0,1,11,23,34
p_277,0,6,e_3,82,87,115,1,1,0,1,4,0,1,5,28,33
p_282,0,7,e_3,66,87,120,6,0,0,6,3,0,0,21,33,54
p_273,0,4,e_2,110,118,132,23,4,4,2,4,0,1,8,14,22
p_276,0,11,e_3,84,87,134,1,1,0,1,4,0,1,3,47,50
p_280,0,14,e_3,75,87,145,4,1,0,4,4,0,1,12,58,70
p_275,0,14,e_3,86,87,145,0,0,0,0,3,0,0,1,58,59
p_274,0,8,e_2,88,118,146,28,7,7,9,3,0,0,30,28,58
p_272,0,10,e_2,113,118,154,22,4,4,1,4,0,1,5,36,41
p_271,0,1,e_1,121,151,156,21,2,2,9,3,0,0,30,5,35
p_267,0,1,e_1,148,151,156,14,0,0,1,4,0,1,3,5,8
p_268,0,2,e_1,144,151,161,14,0,0,2,4,0,1,7,10,17
p_270,0,9,e_1,122,151,184,21,2,2,9,4,0,1,29,33,62
p_269,0,9,e_1,127,151,184,19,2,2,8,4,0,1,24,33,57
p_255,0,3,e_2,184,186,197,14,0,0,0,4,0,1,2,11,13
p_265,0,4,e_2,152,186,202,14,0,0,10,5,1,1,34,16,50
p_262,0,5,e_2,157,186,207,14,0,0,9,4,0,1,29,21,50
p_261,0,5,e_2,164,186,207,14,0,0,7,4,0,1,22,21,43
p_266,0,6,e_2,151,186,212,14,0,0,9,5,1,0,35,26,61
p_263,0,7,e_2,154,186,217,14,0,0,10,4,0,1,32,31,63
p_260,0,7,e_2,165,186,217,14,0,0,7,4,0,1,21,31,52
p_258,0,7,e_2,168,186,217,14,0,0,6,4,0,1,18,31,49
p_256,0,10,e_2,182,186,228,14,0,0,1,4,0,1,4,42,46
p_254,0,4,e_1,187,217,231,14,0,0,9,3,0,0,30,14,44
p_264,0,11,e_2,153,186,233,14,0,0,10,2,1,1,33,47,80
p_253,0,5,e_1,190,217,236,14,0,0,9,4,0,1,27,19,46
p_252,0,5,e_1,205,217,236,14,0,0,4,4,0,1,12,19,31
p_257,0,14,e_2,169,186,244,14,0,0,5,4,0,1,17,58,75
p_259,0,15,e_2,167,186,249,14,0,0,6,4,0,1,19,63,82
p_250,0,2,e_0,217,256,264,14,0,0,12,3,0,0,39,8,47
p_251,0,15,e_1,209,217,268,14,0,0,2,4,0,1,8,51,59
p_248,0,5,e_0,246,256,275,14,0,0,3,4,0,1,10,19,29
p_247,0,5,e_0,250,256,275,14,0,0,2,4,0,1,6,19,25
p_249,0,6,e_0,239,256,280,14,0,0,5,4,0,1,17,24,41
p_241,0,1,e_0,283,300,305,14,0,0,5,4,0,1,17,5,22
p_245,0,7,e_0,269,300,325,14,0,0,3,5,2,1,31,25,56
p_242,0,8,e_0,277,300,330,14,0,0,5,5,1,1,23,30,53
p_246,0,10,e_0,262,300,338,14,0,0,2,5,3,0,38,38,76
p_244,0,12,e_0,271,300,346,14,0,0,4,5,2,1,29,46,75
p_236,0,1,e_3,305,346,351,13,1,0,13,4,0,1,41,5,46
p_233,0,1,e_3,311,346,351,11,1,0,11,4,0,1,35,5,40
p_226,0,2,e_3,329,346,356,5,1,0,5,4,0,1,17,10,27
p_243,0,15,e_0,272,300,357,14,0,0,4,5,2,1,28,57,85
p_230,0,3,e_3,319,346,361,9,1,0,9,4,0,1,27,15,42
p_228,0,4,e_3,325,346,366,7,1,0,7,4,0,1,21,20,41
p_232,0,5,e_3,314,346,371,10,1,0,10,4,0,1,32,25,57
p_237,0,7,e_3,304,346,379,14,1,0,14,4,0,1,42,33,75
p_231,0,7,e_3,317,346,379,9,1,0,9,4,0,1,29,33,62
p_235,0,8,e_3,308,346,384,12,1,0,12,4,0,1,38,38,76
p_234,0,8,e_3,310,346,384,12,1,0,12,4,0,1,36,38,74
p_240,0,9,e_3,301,346,389,14,0,0,14,3,0,0,45,43,88
p_239,0,11,e_3,302,346,397,14,1,0,14,4,0,1,44,51,95
p_216,0,1,e_2,347,395,400,26,11,11,15,3,0,0,48,5,53
p_209,0,2,e_1,357,394,402,24,10,10,12,4,0,1,37,8,45
p_205,0,2,e_1,362,394,402,23,9,9,10,4,0,1,32,8,40
p_227,0,12,e_3,327,346,402,6,1,0,6,4,0,1,19,56,75
p_214,0,3,e_1,349,394,407,25,12,12,15,4,0,1,45,13,58
p_238,0,13,e_3,303,346,407,14,1,0,14,4,0,1,43,61,104
p_229,0,13,e_3,320,346,407,8,1,0,8,4,0,1,26,61,87
p_183,0,1,e_2,396,405,410,15,3,3,0,5,1,0,9,5,14
p_201,0,5,e_1,366,394,415,22,8,8,9,4,0,1,28,21,49
p_182,0,2,e_2,397,405,415,15,3,3,0,5,1,1,8,10,18
p_180,0,2,e_2,399,405,415,15,3,3,1,2,1,1,6,10,16
p_210,0,6,e_1,354,394,420,24,11,11,13,4,0,1,40,26,66
p_208,0,6,e_1,358,394,420,24,10,10,12,4,0,1,36,26,62
p_178,0,3,e_2,401,405,420,14,2,2,1,4,0,1,4,15,19
p_217,0,7,e_1,346,394,425,26,11,11,15,3,0,0,48,31,79
p_212,0,7,e_1,351,394,425,25,11,11,14,4,0,1,43,31,74
p_176,0,4,e_2,403,405,425,14,2,2,0,4,0,1,2,20,22
p_207,0,11,e_1,359,394,439,23,10,10,11,4,0,1,35,45,80
p_179,0,8,e_2,400,405,439,14,3,3,1,4,0,1,5,34,39
p_206,0,12,e_1,361,394,444,23,9,9,11,4,0,1,33,50,83
p_203,0,12,e_1,364,394,444,22,9,9,10,4,0,1,30,50,80
p_177,0,9,e_2,402,405,444,14,2,2,1,4,0,1,3,39,42
p_204,0,14,e_1,363,394,452,23,9,9,10,4,0,1,31,58,89
p_223,0,2,e_3,336,448,456,3,1,0,3,4,0,1,112,8,120
p_215,0,15,e_1,348,394,457,26,11,11,15,4,0,1,46,63,109
p_213,0,15,e_1,350,394,457,25,11,11,14,4,0,1,44,63,107
p_211,0,15,e_1,353,394,457,25,11,11,13,4,0,1,41,63,104
p_181,0,15,e_2,398,405,464,15,3,3,1,5,1,1,7,59,66
p_225,0,5,e_3,330,448,467,5,1,0,5,4,0,1,118,19,137
p_224,0,5,e_3,331,448,467,5,1,0,5,4,0,1,117,19,136
p_222,0,5,e_3,337,448,467,3,1,0,3,4,0,1,111,19,130
p_219,0,5,e_3,342,448,467,1,1,0,1,4,0,1,106,19,125
p_221,0,6,e_3,339,448,472,2,1,0,2,4,0,1,109,24,133
p_220,0,6,e_3,341,448,472,1,1,0,1,4,0,1,107,24,131
p_218,0,11,e_3,343,448,489,1,1,0,1,4,0,1,105,41,146
p_173,0,11,e_3,407,448,489,13,1,0,13,4,0,1,41,41,82
p_171,0,13,e_3,409,448,497,13,1,0,13,4,0,1,39,49,88
p_175,0,14,e_3,405,448,502,13,2,2,13,5,1,1,43,54,97
p_174,0,14,e_3,406,448,502,13,1,1,13,2,1,1,42,54,96
p_170,0,14,e_3,410,448,502,12,1,0,12,4,0,1,38,54,92
p_146,0,1,e_0,453,497,504,29,8,8,14,4,0,1,44,7,51
p_202,0,15,e_3,365,448,507,4,8,8,4,3,8,1,83,59,142
p_172,0,15,e_3,408,448,507,13,1,0,13,4,0,1,40,59,99
p_190,0,1,e_1,379,504,511,19,6,6,5,4,0,1,125,7,132
p_143,0,3,e_0,456,497,512,28,7,7,13,4,0,1,41,15,56
p_136,0,3,e_0,465,497,512,25,7,7,10,4,0,1,32,15,47
p_137,0,4,e_0,464,497,517,26,7,7,11,4,0,1,33,20,53
p_200,0,4,e_1,367,504,522,22,8,8,9,4,0,1,137,18,155
p_196,0,4,e_1,371,504,522,21,7,7,7,4,0,1,133,18,151
p_186,0,4,e_1,390,504,522,17,4,4,1,4,0,1,114,18,132
p_141,0,6,e_0,458,497,525,28,7,7,13,4,0,1,39,28,67
p_194,0,6,e_1,373,504,530,21,7,7,7,4,0,1,131,26,157
p_148,0,8,e_0,449,497,533,30,7,7,15,3,0,0,48,36,84
p_140,0,8,e_0,459,497,533,27,7,7,12,4,0,1,38,36,74
p_147,0,9,e_0,452,497,538,29,8,8,15,4,0,1,45,41,86
p_144,0,9,e_0,455,497,538,28,7,7,14,4,0,1,42,41,83
p_142,0,9,e_0,457,497,538,28,7,7,13,4,0,1,40,41,81
p_192,0,8,e_1,375,504,538,20,7,7,6,4,0,1,129,34,163
p_189,0,8,e_1,382,504,538,18,6,6,4,4,0,1,122,34,156
p_139,0,10,e_0,461,497,543,27,7,7,12,4,0,1,36,46,82
p_135,0,10,e_0,466,497,543,25,6,6,10,4,0,1,31,46,77
p_198,0,9,e_1,369,504,543,21,8,8,8,4,0,1,135,39,174
p_145,0,11,e_0,454,497,548,28,8,8,14,4,0,1,43,51,94
p_138,0,11,e_0,463,497,548,26,7,7,11,4,0,1,34,51,85
p_197,0,10,e_1,370,504,548,21,7,7,8,4,0,1,134,44,178
p_191,0,10,e_1,376,504,548,20,7,7,6,4,0,1,128,44,172
p_193,0,11,e_1,374,504,553,20,7,7,6,4,0,1,130,49,179
p_187,0,12,e_1,389,504,558,17,4,4,1,4,0,1,115,54,169
p_167,0,1,e_3,413,554,561,11,1,0,11,4,0,1,141,7,148
p_161,0,1,e_3,421,554,561,9,1,0,9,4,0,1,133,7,140
p_158,0,1,e_3,430,554,561,6,1,0,6,4,0,1,124,7,131
p_134,0,15,e_0,467,497,562,25,6,6,10,4,0,1,30,65,95
p_188,0,13,e_1,384,504,563,18,5,5,3,4,0,1,120,59,179
p_199,0,15,e_1,368,504,571,22,8,8,8,4,0,1,136,67,203
p_195,0,15,e_1,372,504,571,21,7,7,7,4,0,1,132,67,199
p_165,0,4,e_3,417,554,572,10,1,0,10,4,0,1,137,18,155
p_102,0,7,e_2,509,556,579,15,1,0,15,4,0,1,47,23,70
p_98,0,7,e_2,515,556,579,13,1,0,13,4,0,1,41,23,64
p_159,0,6,e_3,429,554,580,6,1,0,6,4,0,1,125,26,151
p_87,0,8,e_2,539,556,584,5,1,0,5,4,0,1,17,28,45
p_169,0,9,e_3,411,554,591,12,1,0,12,4,0,1,143,37,180
p_103,0,11,e_2,508,556,595,15,1,0,15,3,0,0,48,39,87
p_163,0,10,e_3,419,554,596,9,1,0,9,4,0,1,135,42,177
p_164,0,11,e_3,418,554,601,10,1,0,10,4,0,1,136,47,183
p_162,0,11,e_3,420,554,601,9,1,0,9,4,0,1,134,47,181
p_90,0,13,e_2,527,556,603,9,1,0,9,4,0,1,29,47,76
p_166,0,12,e_3,416,554,606,10,1,0,10,4,0,1,138,52,190
p_95,0,14,e_2,518,556,608,12,1,0,12,4,0,1,38,52,90
p_81,0,14,e_2,551,556,608,1,1,0,1,4,0,1,5,52,57
p_168,0,13,e_3,412,554,611,12,1,0,12,4,0,1,142,57,199
p_85,0,15,e_2,545,556,613,3,1,0,3,4,0,1,11,57,68
p_130,0,1,e_0,472,609,616,24,5,5,8,4,0,1,137,7,144
p_119,0,1,e_0,483,609,616,21,5,5,4,4,0,1,126,7,133
p_157,0,14,e_3,431,554,616,5,1,0,5,4,0,1,123,62,185
p_155,0,14,e_3,435,554,616,4,1,0,4,4,0,1,119,62,181
p_160,0,15,e_3,426,554,621,7,1,0,7,4,0,1,128,67,195
p_156,0,15,e_3,434,554,621,4,1,0,4,4,0,1,120,67,187
p_129,0,3,e_0,473,609,624,24,5,5,8,4,0,1,136,15,151
p_106,0,3,e_1,500,618,629,16,3,3,1,4,0,1,118,11,129
p_124,0,7,e_0,478,609,638,22,5,5,6,4,0,1,131,29,160
p_127,0,10,e_0,475,609,649,23,5,5,7,4,0,1,134,40,174
p_37,0,9,e_1,615,618,649,16,2,2,1,4,0,1,3,31,34
p_132,0,11,e_0,470,609,654,24,6,6,9,4,0,1,139,45,184
p_128,0,11,e_0,474,609,654,24,5,5,7,4,0,1,135,45,180
p_123,0,11,e_0,479,609,654,22,5,5,6,4,0,1,130,45,175
p_121,0,11,e_0,481,609,654,21,5,5,5,4,0,1,128,45,173
p_120,0,11,e_0,482,609,654,21,5,5,5,4,0,1,127,45,172
p_185,0,10,e_1,391,618,654,17,4,4,1,4,0,1,227,36,263
p_133,0,12,e_0,469,609,659,25,6,6,9,4,0,1,140,50,190
p_126,0,12,e_0,476,609,659,23,5,5,7,4,0,1,133,50,183
p_107,0,11,e_1,499,618,659,17,3,3,1,4,0,1,119,41,160
p_184,0,12,e_1,392,618,664,16,4,4,0,4,0,1,226,46,272
p_105,0,12,e_1,502,618,664,16,2,2,0,4,0,1,116,46,162
p_131,0,14,e_0,471,609,667,24,5,5,8,4,0,1,138,58,196
p_125,0,14,e_0,477,609,667,23,5,5,6,4,0,1,132,58,190
p_122,0,15,e_0,480,609,672,22,5,5,5,4,0,1,129,63,192
p_104,0,14,e_1,503,618,672,16,2,2,0,3,0,0,115,54,169
p_96,0,1,e_3,517,668,673,12,1,0,12,4,0,1,151,5,156
p_92,0,4,e_3,525,668,684,9,1,0,9,4,0,1,143,16,159
p_150,0,6,e_3,443,668,692,1,1,0,1,4,0,1,225,24,249
p_99,0,6,e_3,514,668,692,13,1,0,13,4,0,1,154,24,178
p_94,0,6,e_3,519,668,692,11,1,0,11,4,0,1,149,24,173
p_154,0,7,e_3,436,668,697,4,1,0,4,4,0,1,232,29,261
p_101,0,8,e_3,511,668,702,14,1,0,14,4,0,1,157,34,191
p_153,0,9,e_3,437,668,707,3,1,0,3,4,0,1,231,39,270
p_100,0,9,e_3,513,668,707,13,1,0,13,4,0,1,155,39,194
p_89,0,9,e_3,535,668,707,6,1,0,6,4,0,1,133,39,172
p_91,0,12,e_3,526,668,718,9,1,0,9,4,0,1,142,50,192
p_93,0,13,e_3,520,668,723,11,1,0,11,4,0,1,148,55,203
p_113,0,1,e_0,489,719,724,19,4,4,2,4,0,1,230,5,235
p_24,0,2,e_1,695,716,724,23,7,7,7,4,0,1,21,8,29
p_30,0,3,e_2,668,716,727,30,9,9,15,3,0,0,48,11,59
p_152,0,15,e_3,441,668,731,2,1,0,2,4,0,1,227,63,290
p_151,0,15,e_3,442,668,731,2,1,0,2,4,0,1,226,63,289
p_149,0,15,e_3,444,668,731,1,1,0,1,4,0,1,224,63,287
p_114,0,3,e_0,488,719,732,19,4,4,3,4,0,1,231,13,244
p_77,0,3,e_0,557,719,732,30,10,10,14,5,1,1,162,13,175
p_29,0,5,e_1,670,716,735,30,9,9,14,5,1,0,46,19,65
p_108,0,6,e_0,496,719,743,17,3,3,0,3,0,0,223,24,247
p_76,0,6,e_0,558,719,743,30,10,10,14,5,1,1,161,24,185
p_26,0,8,e_1,684,716,746,26,8,8,10,4,0,1,32,30,62
p_25,0,8,e_1,686,716,746,26,8,8,10,4,0,1,30,30,60
p_118,0,7,e_0,484,719,748,20,5,5,4,4,0,1,235,29,264
p_97,0,7,e_0,516,719,748,12,1,0,4,3,7,1,203,29,232
p_22,0,3,e_2,719,738,749,18,3,3,1,5,1,0,19,11,30
p_111,0,8,e_0,491,719,753,19,4,4,2,4,0,1,228,34,262
p_27,0,10,e_1,677,716,754,28,9,9,13,4,0,1,39,38,77
p_21,0,4,e_2,731,738,754,15,1,0,2,4,0,1,7,16,23
p_115,0,9,e_0,487,719,758,19,5,5,3,4,0,1,232,39,271
p_28,0,11,e_1,676,716,759,28,9,9,13,4,0,1,40,43,83
p_117,0,10,e_0,485,719,763,20,5,5,4,4,0,1,234,44,278
p_116,0,10,e_0,486,719,763,20,5,5,3,4,0,1,233,44,277
p_23,0,12,e_1,711,716,764,20,4,4,1,4,0,1,5,48,53
p_112,0,11,e_0,490,719,768,19,4,4,2,4,0,1,229,49,278
p_110,0,11,e_0,492,719,768,18,4,4,1,4,0,1,227,49,276
p_78,0,12,e_0,556,719,773,30,10,10,13,5,1,1,163,54,217
p_109,0,15,e_0,493,719,784,18,4,4,1,4,0,1,226,65,291
p_20,0,14,e_2,734,738,786,14,1,0,1,4,0,1,4,48,52
p_86,0,2,e_3,544,778,786,3,1,0,3,4,0,1,234,8,242
p_88,0,5,e_3,538,778,797,5,1,0,5,4,0,1,240,19,259
p_32,0,6,e_3,650,778,802,6,1,0,6,4,0,1,128,24,152
p_31,0,6,e_3,666,778,802,0,1,0,0,4,0,1,112,24,136
p_80,0,7,e_3,552,778,807,0,1,0,0,4,0,1,226,29,255
p_83,0,8,e_3,549,778,812,1,1,0,1,4,0,1,229,34,263
p_35,0,9,e_3,630,778,817,12,1,0,12,4,0,1,148,39,187
p_18,0,10,e_3,766,778,822,4,1,0,4,4,0,1,12,44,56
p_16,0,2,e_1,780,819,827,30,12,12,12,3,0,0,39,8,47
p_19,0,11,e_3,754,778,827,8,1,0,8,4,0,1,24,49,73
p_84,0,12,e_3,546,778,832,2,1,0,2,4,0,1,232,54,286
p_34,0,12,e_3,646,778,832,7,1,0,7,4,0,1,132,54,186
p_14,0,4,e_1,794,819,835,26,12,12,8,4,0,1,25,16,41
p_65,0,1,e_0,573,831,836,26,9,9,12,4,0,1,258,5,263
p_36,0,13,e_3,628,778,837,13,1,0,13,4,0,1,150,59,209
p_82,0,14,e_3,550,778,842,1,1,0,1,4,0,1,228,64,292
p_79,0,14,e_3,553,778,842,0,0,0,0,3,0,0,225,64,289
p_72,0,3,e_0,562,831,844,29,10,10,15,4,0,1,269,13,282
p_71,0,3,e_0,564,831,844,28,10,10,15,4,0,1,267,13,280
p_70,0,3,e_0,565,831,844,28,10,10,14,4,0,1,266,13,279
p_67,0,3,e_0,568,831,844,27,10,10,13,4,0,1,263,13,276
p_66,0,3,e_0,569,831,844,27,10,10,13,4,0,1,262,13,275
p_33,0,15,e_3,649,778,847,6,1,0,6,4,0,1,129,69,198
p_64,0,4,e_0,574,831,849,26,9,9,11,4,0,1,257,18,275
p_15,0,9,e_1,793,819,852,26,12,12,8,4,0,1,26,33,59
p_11,0,9,e_1,807,819,852,23,9,9,4,4,0,1,12,33,45
p_75,0,5,e_0,559,831,854,29,11,11,14,5,1,1,272,23,295
p_61,0,6,e_0,579,831,859,24,8,8,10,4,0,1,252,28,280
p_13,0,11,e_1,796,819,860,25,11,11,7,4,0,1,23,41,64
p_12,0,11,e_1,798,819,860,25,11,11,7,4,0,1,21,41,62
p_74,0,7,e_0,560,831,864,29,10,10,15,5,1,1,271,33,304
p_73,0,11,e_0,561,831,878,29,10,10,15,2,1,1,270,47,317
p_68,0,13,e_0,567,831,886,27,10,10,14,4,0,1,264,55,319
p_63,0,13,e_0,577,831,886,25,9,9,10,4,0,1,254,55,309
p_62,0,13,e_0,578,831,886,24,9,9,10,4,0,1,253,55,308
p_9,0,2,e_2,846,880,888,15,1,1,11,4,0,1,34,8,42
p_69,0,14,e_0,566,831,891,28,10,10,14,4,0,1,265,60,325
p_6,0,3,e_2,877,880,893,5,1,0,1,4,0,1,3,13,16
p_4,0,1,e_3,886,894,899,2,1,0,2,4,0,1,8,5,13
p_7,0,5,e_2,875,880,901,6,1,0,1,4,0,1,5,21,26
p_10,0,8,e_2,835,880,912,17,4,4,14,3,0,0,45,32,77
p_5,0,8,e_3,883,894,922,3,1,0,3,4,0,1,11,28,39
p_3,0,8,e_3,888,894,922,2,1,0,2,4,0,1,6,28,34
p_8,0,11,e_2,874,880,923,6,1,0,2,4,0,1,6,43,49
p_17,0,10,e_3,776,894,930,0,1,0,0,4,0,1,118,36,154
p_2,0,11,e_3,892,894,935,0,1,0,0,4,0,1,2,41,43
p_55,0,3,e_0,585,935,946,23,8,8,8,4,0,1,350,11,361
p_54,0,3,e_0,586,935,946,22,8,8,7,4,0,1,349,11,360
p_52,0,3,e_0,588,935,946,22,8,8,7,4,0,1,347,11,358
p_1,0,5,e_1,894,930,947,22,4,4,11,3,0,0,36,17,53
p_48,0,4,e_0,592,935,951,21,7,7,5,4,0,1,343,16,359
p_46,0,4,e_0,594,935,951,20,7,7,5,4,0,1,341,16,357
p_56,0,6,e_0,584,935,959,23,8,8,8,4,0,1,351,24,375
p_50,0,7,e_0,590,935,964,21,7,7,6,4,0,1,345,29,374
p_53,0,9,e_0,587,935,972,22,8,8,7,4,0,1,348,37,385
p_51,0,9,e_0,589,935,972,21,8,8,6,4,0,1,346,37,383
p_47,0,9,e_0,593,935,972,21,7,7,5,4,0,1,342,37,379
p_60,0,10,e_0,580,935,977,24,8,8,9,4,0,1,355,42,397
p_58,0,11,e_0,582,935,982,24,8,8,9,4,0,1,353,47,400
p_57,0,11,e_0,583,935,982,23,8,8,8,4,0,1,352,47,399
p_59,0,14,e_0,581,935,993,24,8,8,9,4,0,1,354,58,412
p_49,0,14,e_0,591,935,993,21,7,7,6,4,0,1,344,58,402
p_45,0,2,e_0,595,1037,1045,20,6,6,4,4,0,1,442,8,450
p_42,0,6,e_0,598,1037,1059,20,6,6,3,4,0,1,439,22,461
p_43,0,7,e_0,597,1037,1064,20,6,6,4,4,0,1,440,27,467
p_44,0,8,e_0,596,1037,1069,20,6,6,4,4,0,1,441,32,473
p_41,0,11,e_0,600,1037,1080,19,5,5,3,4,0,1,437,43,480
p_39,0,12,e_0,607,1037,1085,18,4,4,0,4,0,1,430,48,478
p_40,0,13,e_0,602,1037,1090,19,5,5,2,4,0,1,435,53,488
p_38,0,13,e_0,608,1037,1090,18,4,4,0,3,0,0,429,53,482
p_300,0,4,e_0,8,9,25,0,0,0,0,3,0,0,1,16,17
p_299,0,5,e_1,9,10,29,0,0,0,0,3,0,0,1,19,20
p_297,0,6,e_3,15,16,38,0,0,0,0,3,0,0,1,22,23
p_298,0,9,e_2,11,12,43,0,0,0,0,3,0,0,1,31,32
p_296,0,4,e_0,28,43,57,9,1,1,4,3,0,0,15,14,29
p_286,0,3,e_1,46,47,60,6,0,0,0,3,0,0,1,13,14
p_292,0,6,e_0,38,43,65,6,0,0,1,4,0,1,5,22,27
p_290,0,6,e_0,40,43,65,6,0,0,1,4,0,1,3,22,25
p_289,0,4,e_1,43,47,65,6,0,0,1,4,0,1,4,18,22
p_295,0,5,e_1,29,47,70,9,1,1,5,3,0,0,18,23,41
p_287,0,5,e_1,45,47,70,6,0,0,0,4,0,1,2,23,25
p_288,0,8,e_1,44,47,81,6,0,0,1,4,0,1,3,34,37
p_281,0,1,e_3,73,74,81,0,0,0,0,3,0,0,1,7,8
p_291,0,11,e_0,39,43,82,6,0,0,1,4,0,1,4,39,43
p_294,0,12,e_0,31,43,87,8,1,1,4,4,0,1,12,44,56
p_293,0,12,e_0,33,43,87,7,1,1,3,4,0,1,10,44,54
p_285,0,4,e_3,53,74,92,6,0,0,6,3,0,0,21,18,39
p_284,0,4,e_3,54,74,92,6,1,0,6,4,0,1,20,18,38
p_282,0,7,e_3,66,74,103,2,1,0,2,4,0,1,8,29,37
p_283,0,9,e_3,57,74,111,5,1,0,5,4,0,1,17,37,54
p_278,0,2,e_2,77,105,113,18,4,4,9,4,0,1,28,8,36
p_279,0,5,e_2,76,105,124,18,4,4,9,4,0,1,29,19,48
p_277,0,6,e_1,82,109,129,17,3,3,8,3,0,0,27,20,47
p_274,0,8,e_2,88,105,135,15,3,3,5,4,0,1,17,30,47
p_271,0,1,e_3,121,140,145,6,1,0,6,4,0,1,19,5,24
p_276,0,11,e_2,84,105,146,16,3,3,7,4,0,1,21,41,62
p_273,0,4,e_3,110,140,156,9,0,0,9,2,1,0,30,16,46
p_280,0,14,e_2,75,105,157,18,4,4,9,3,0,0,30,52,82
p_275,0,14,e_2,86,105,157,16,3,3,6,4,0,1,19,52,71
p_267,0,1,e_1,148,165,172,18,3,3,5,4,0,1,17,7,24
p_270,0,9,e_3,122,140,173,6,1,0,6,4,0,1,18,33,51
p_269,0,9,e_3,127,140,173,4,1,0,4,4,0,1,13,33,46
p_268,0,2,e_1,144,165,177,19,3,3,6,3,0,0,21,12,33
p_272,0,10,e_3,113,140,178,9,1,0,9,4,0,1,27,38,65
p_265,0,4,e_1,152,165,185,17,3,3,4,4,0,1,13,20,33
p_262,0,5,e_1,157,165,190,16,2,2,2,4,0,1,8,25,33
p_261,0,5,e_1,164,165,190,14,2,2,0,3,0,0,1,25,26
p_266,0,6,e_1,151,165,195,17,3,3,4,4,0,1,14,30,44
p_263,0,7,e_1,154,165,200,16,3,3,3,4,0,1,11,35,46
p_264,0,11,e_1,153,165,214,17,3,3,4,4,0,1,12,49,61
p_255,0,3,e_0,184,204,215,10,0,0,6,4,0,1,20,11,31
p_254,0,4,e_0,187,204,220,10,0,0,5,4,0,1,17,16,33
p_253,0,5,e_0,190,204,225,10,0,0,4,4,0,1,14,21,35
p_260,0,7,e_0,165,204,233,13,2,2,12,3,0,0,39,29,68
p_258,0,7,e_0,168,204,233,12,2,2,12,4,0,1,36,29,65
p_256,0,10,e_0,182,204,244,10,0,0,7,4,0,1,22,40,62
p_250,0,2,e_3,217,238,246,7,1,0,7,4,0,1,21,8,29
p_252,0,5,e_3,205,238,257,10,0,0,10,3,0,0,33,19,52
p_257,0,14,e_0,169,204,258,12,2,2,11,4,0,1,35,54,89
p_259,0,15,e_0,167,204,263,13,2,2,12,4,0,1,37,59,96
p_251,0,15,e_3,209,238,289,9,1,0,9,4,0,1,29,51,80
p_248,0,5,e_1,246,275,292,28,2,2,9,4,0,1,29,17,46
p_247,0,5,e_1,250,275,292,27,2,2,8,4,0,1,25,17,42
p_249,0,6,e_1,239,275,297,30,3,3,11,3,0,0,36,22,58
p_245,0,7,e_1,269,275,302,21,1,1,2,4,0,1,6,27,33
p_246,0,10,e_1,262,275,313,24,1,1,4,4,0,1,13,38,51
p_244,0,12,e_1,271,275,321,21,1,1,1,4,0,1,4,46,50
p_241,0,1,e_2,283,322,327,17,1,1,13,4,0,1,39,5,44
p_236,0,1,e_2,305,322,327,15,0,0,5,4,0,1,17,5,22
p_233,0,1,e_2,311,322,327,15,0,0,3,4,0,1,11,5,16
p_243,0,15,e_1,272,275,332,20,1,1,1,4,0,1,3,57,60
p_230,0,3,e_2,319,322,335,15,0,0,1,4,0,1,3,13,16
p_232,0,5,e_2,314,322,343,15,0,0,2,4,0,1,8,21,29
p_237,0,7,e_2,304,322,351,15,0,0,6,4,0,1,18,29,47
p_231,0,7,e_2,317,322,351,15,0,0,1,4,0,1,5,29,34
p_242,0,8,e_2,277,322,356,19,1,1,14,3,0,0,45,34,79
p_235,0,8,e_2,308,322,356,15,0,0,4,4,0,1,14,34,48
p_234,0,8,e_2,310,322,356,15,0,0,4,4,0,1,12,34,46
p_240,0,9,e_2,301,322,361,15,0,0,7,4,0,1,21,39,60
p_239,0,11,e_2,302,322,369,15,0,0,6,4,0,1,20,47,67
p_238,0,13,e_2,303,322,377,15,0,0,6,4,0,1,19,55,74
p_229,0,13,e_2,320,322,377,15,0,0,0,4,0,1,2,55,57
p_216,0,1,e_0,347,373,380,9,1,0,8,4,0,1,26,7,33
p_226,0,2,e_0,329,373,385,15,1,0,14,4,0,1,44,12,56
p_223,0,2,e_0,336,373,385,13,1,0,12,4,0,1,37,12,49
p_214,0,3,e_0,349,373,390,8,1,0,8,4,0,1,24,17,41
p_228,0,4,e_0,325,373,395,15,0,0,15,3,0,0,48,22,70
p_224,0,5,e_1,331,379,396,14,1,0,15,2,1,0,48,17,65
p_194,0,6,e_3,373,375,397,0,1,0,0,4,0,1,2,22,24
p_225,0,5,e_0,330,373,400,15,1,0,14,4,0,1,43,27,70
p_222,0,5,e_0,337,373,400,12,1,0,12,4,0,1,36,27,63
p_219,0,5,e_0,342,373,400,11,1,0,10,4,0,1,31,27,58
p_221,0,6,e_0,339,373,405,12,1,0,11,4,0,1,34,32,66
p_220,0,6,e_0,341,373,405,11,1,0,10,4,0,1,32,32,64
p_192,0,8,e_1,375,379,407,24,4,4,1,4,0,1,4,28,32
p_217,0,7,e_0,346,373,410,9,1,0,9,4,0,1,27,37,64
p_212,0,7,e_0,351,373,410,8,1,0,7,4,0,1,22,37,59
p_193,0,11,e_3,374,375,414,0,0,0,0,3,0,0,1,39,40
p_191,0,10,e_1,376,379,415,24,3,3,1,4,0,1,3,36,39
p_227,0,12,e_3,327,375,419,15,0,0,15,3,0,0,48,44,92
p_218,0,11,e_0,343,373,424,10,1,0,10,4,0,1,30,51,81
p_190,0,1,e_2,379,421,428,24,3,3,13,3,0,0,42,7,49
p_183,0,1,e_2,396,421,428,18,2,2,8,4,0,1,25,7,32
p_182,0,2,e_2,397,421,433,18,2,2,8,4,0,1,24,12,36
p_180,0,2,e_2,399,421,433,18,2,2,7,4,0,1,22,12,34
p_215,0,15,e_0,348,373,438,9,1,0,8,4,0,1,25,65,90
p_213,0,15,e_0,350,373,438,8,1,0,7,4,0,1,23,65,88
p_178,0,3,e_2,401,421,438,17,2,2,6,4,0,1,20,17,37
p_186,0,4,e_2,390,421,443,20,3,3,10,4,0,1,31,22,53
p_176,0,4,e_2,403,421,443,16,2,2,6,4,0,1,18,22,40
p_189,0,8,e_2,382,421,457,23,3,3,13,4,0,1,39,36,75
p_179,0,8,e_2,400,421,457,17,2,2,7,4,0,1,21,36,57
p_161,0,1,e_1,421,454,461,12,0,0,10,3,0,0,33,7,40
p_158,0,1,e_1,430,454,461,12,0,0,8,4,0,1,24,7,31
p_177,0,9,e_2,402,421,462,17,2,2,6,4,0,1,19,41,60
p_185,0,10,e_2,391,421,467,20,3,3,10,4,0,1,30,46,76
p_187,0,12,e_2,389,421,475,20,3,3,10,4,0,1,32,54,86
p_184,0,12,e_2,392,421,475,19,3,3,9,4,0,1,29,54,83
p_159,0,6,e_1,429,454,478,12,0,0,8,4,0,1,25,24,49
p_150,0,6,e_1,443,454,478,12,0,0,3,4,0,1,11,24,35
p_188,0,13,e_2,384,421,480,22,3,3,12,4,0,1,37,59,96
p_154,0,7,e_1,436,454,483,12,0,0,6,4,0,1,18,29,47
p_148,0,8,e_1,449,454,488,12,0,0,1,4,0,1,5,34,39
p_181,0,15,e_2,398,421,488,18,2,2,7,4,0,1,23,67,90
p_153,0,9,e_1,437,454,493,12,0,0,5,4,0,1,17,39,56
p_147,0,9,e_1,452,454,493,12,0,0,0,4,0,1,2,39,41
p_209,0,2,e_0,357,485,495,6,1,0,5,4,0,1,128,10,138
p_205,0,2,e_0,362,485,495,4,1,0,3,4,0,1,123,10,133
p_200,0,4,e_0,367,485,503,2,1,0,2,4,0,1,118,18,136
p_201,0,5,e_0,366,485,508,3,1,0,2,4,0,1,119,23,142
p_157,0,14,e_1,431,454,510,12,0,0,7,4,0,1,23,56,79
p_155,0,14,e_1,435,454,510,12,0,0,6,4,0,1,19,56,75
p_210,0,6,e_0,354,485,513,7,1,0,6,4,0,1,131,28,159
p_208,0,6,e_0,358,485,513,5,1,0,5,4,0,1,127,28,155
p_160,0,15,e_1,426,454,515,12,0,0,9,4,0,1,28,61,89
p_156,0,15,e_1,434,454,515,12,0,0,6,4,0,1,20,61,81
p_152,0,15,e_1,441,454,515,12,0,0,4,4,0,1,13,61,74
p_151,0,15,e_1,442,454,515,12,0,0,4,4,0,1,12,61,73
p_149,0,15,e_1,444,454,515,12,0,0,3,4,0,1,10,61,71
p_198,0,9,e_0,369,485,524,2,1,0,1,4,0,1,116,39,155
p_197,0,10,e_0,370,485,529,1,1,0,1,4,0,1,115,44,159
p_113,0,1,e_3,489,524,529,11,1,0,11,4,0,1,35,5,40
p_207,0,11,e_0,359,485,534,5,1,0,4,4,0,1,126,49,175
p_114,0,3,e_3,488,524,537,12,1,0,12,4,0,1,36,13,49
p_106,0,3,e_3,500,524,537,8,1,0,8,4,0,1,24,13,37
p_206,0,12,e_0,361,485,539,4,1,0,4,4,0,1,124,54,178
p_203,0,12,e_0,364,485,539,3,1,0,3,4,0,1,121,54,175
p_167,0,1,e_2,413,535,540,13,1,1,2,4,0,1,122,5,127
p_204,0,14,e_0,363,485,547,4,1,0,3,4,0,1,122,62,184
p_108,0,6,e_3,496,524,548,9,1,0,9,4,0,1,28,24,52
p_165,0,4,e_2,417,535,551,12,1,1,1,4,0,1,118,16,134
p_92,0,4,e_2,525,535,551,30,10,10,3,4,0,1,10,16,26
p_211,0,15,e_0,353,485,552,7,1,0,6,4,0,1,132,67,199
p_202,0,15,e_0,365,485,552,3,1,0,2,4,0,1,120,67,187
p_199,0,15,e_0,368,485,552,2,1,0,1,4,0,1,117,67,184
p_111,0,8,e_3,491,524,556,11,1,0,11,4,0,1,33,32,65
p_115,0,9,e_3,487,524,561,12,1,0,12,4,0,1,37,37,74
p_117,0,10,e_3,485,524,566,12,0,0,12,3,0,0,39,42,81
p_116,0,10,e_3,486,524,566,12,1,0,12,4,0,1,38,42,80
p_169,0,9,e_2,411,535,568,14,2,2,3,4,0,1,124,33,157
p_146,0,1,e_1,453,562,569,12,0,0,0,3,0,0,109,7,116
p_112,0,11,e_3,490,524,571,11,1,0,11,4,0,1,34,47,81
p_110,0,11,e_3,492,524,571,10,1,0,10,4,0,1,32,47,79
p_107,0,11,e_3,499,524,571,8,1,0,8,4,0,1,25,47,72
p_103,0,11,e_3,508,524,571,5,1,0,5,4,0,1,16,47,63
p_163,0,10,e_2,419,535,573,12,0,0,0,4,0,1,116,38,154
p_86,0,2,e_1,544,562,574,25,9,9,6,4,0,1,18,12,30
p_105,0,12,e_3,502,524,576,7,1,0,7,4,0,1,22,52,74
p_173,0,11,e_2,407,535,578,15,2,2,4,4,0,1,128,43,171
p_164,0,11,e_2,418,535,578,12,0,0,1,4,0,1,117,43,160
p_162,0,11,e_2,420,535,578,12,0,0,0,3,0,0,115,43,158
p_77,0,3,e_1,557,562,579,22,7,7,1,4,0,1,5,17,22
p_166,0,12,e_2,416,535,583,13,1,1,1,4,0,1,119,48,167
p_104,0,14,e_3,503,524,584,7,1,0,7,4,0,1,21,60,81
p_88,0,5,e_1,538,562,587,27,9,9,8,4,0,1,24,25,49
p_171,0,13,e_2,409,535,588,14,2,2,4,4,0,1,126,53,179
p_168,0,13,e_2,412,535,588,13,2,2,3,4,0,1,123,53,176
p_109,0,15,e_3,493,524,589,10,1,0,10,4,0,1,31,65,96
p_76,0,6,e_1,558,562,592,22,7,7,1,4,0,1,4,30,34
p_175,0,14,e_2,405,535,593,16,2,2,5,4,0,1,130,58,188
p_174,0,14,e_2,406,535,593,15,2,2,5,4,0,1,129,58,187
p_170,0,14,e_2,410,535,593,14,2,2,3,4,0,1,125,58,183
p_80,0,7,e_1,552,562,597,23,8,8,3,4,0,1,10,35,45
p_172,0,15,e_2,408,535,598,15,2,2,4,4,0,1,127,63,190
p_87,0,8,e_1,539,562,602,27,9,9,7,4,0,1,23,40,63
p_83,0,8,e_1,549,562,602,24,8,8,4,4,0,1,13,40,53
p_89,0,9,e_1,535,562,607,27,10,10,9,4,0,1,27,45,72
p_143,0,3,e_0,456,599,612,12,0,0,9,4,0,1,143,13,156
p_136,0,3,e_0,465,599,612,12,0,0,6,4,0,1,134,13,147
p_196,0,4,e_0,371,599,617,1,1,0,0,4,0,1,228,18,246
p_137,0,4,e_0,464,599,617,12,0,0,7,4,0,1,135,18,153
p_84,0,12,e_1,546,562,618,24,9,9,5,4,0,1,16,56,72
p_78,0,12,e_1,556,562,618,22,7,7,2,4,0,1,6,56,62
p_141,0,6,e_0,458,599,625,12,0,0,9,4,0,1,141,26,167
p_82,0,14,e_1,550,562,626,24,8,8,4,4,0,1,12,64,76
p_81,0,14,e_1,551,562,626,23,8,8,3,4,0,1,11,64,75
p_79,0,14,e_1,553,562,626,23,8,8,3,4,0,1,9,64,73
p_85,0,15,e_1,545,562,631,25,9,9,5,4,0,1,17,69,86
p_140,0,8,e_0,459,599,633,12,0,0,8,4,0,1,140,34,174
p_144,0,9,e_0,455,599,638,12,0,0,10,4,0,1,144,39,183
p_142,0,9,e_0,457,599,638,12,0,0,9,4,0,1,142,39,181
p_96,0,1,e_3,517,636,641,2,1,0,2,4,0,1,119,5,124
p_139,0,10,e_0,461,599,643,12,0,0,8,4,0,1,138,44,182
p_135,0,10,e_0,466,599,643,12,0,0,6,4,0,1,133,44,177
p_145,0,11,e_0,454,599,648,12,0,0,10,4,0,1,145,49,194
p_138,0,11,e_0,463,599,648,12,0,0,7,4,0,1,136,49,185
p_133,0,12,e_0,469,599,653,12,0,0,5,4,0,1,130,54,184
p_99,0,6,e_3,514,636,658,3,1,0,3,4,0,1,122,22,144
p_94,0,6,e_3,519,636,658,1,1,0,1,4,0,1,117,22,139
p_102,0,7,e_3,509,636,663,5,1,0,5,4,0,1,127,27,154
p_98,0,7,e_3,515,636,663,3,1,0,3,4,0,1,121,27,148
p_97,0,7,e_3,516,636,663,2,1,0,2,4,0,1,120,27,147
p_195,0,15,e_0,372,599,664,1,1,0,0,3,0,0,227,65,292
p_134,0,15,e_0,467,599,664,12,0,0,6,4,0,1,132,65,197
p_101,0,8,e_3,511,636,668,4,1,0,4,4,0,1,125,32,157
p_100,0,9,e_3,513,636,673,3,1,0,3,4,0,1,123,37,160
p_37,0,9,e_3,615,636,673,7,1,0,7,4,0,1,21,37,58
p_41,0,11,e_3,600,636,681,12,1,0,12,4,0,1,36,45,81
p_91,0,12,e_2,526,645,683,30,10,10,3,4,0,1,119,38,157
p_39,0,12,e_3,607,636,686,9,1,0,9,4,0,1,29,50,79
p_90,0,13,e_2,527,645,688,29,11,11,2,4,0,1,118,43,161
p_30,0,3,e_1,668,678,691,20,6,6,3,4,0,1,10,13,23
p_93,0,13,e_3,520,636,691,1,1,0,1,4,0,1,116,55,171
p_40,0,13,e_3,602,636,691,11,1,0,11,4,0,1,34,55,89
p_38,0,13,e_3,608,636,691,9,1,0,9,4,0,1,28,55,83
p_95,0,14,e_3,518,636,696,2,1,0,2,4,0,1,118,60,178
p_75,0,5,e_1,559,678,699,21,7,7,1,4,0,1,119,21,140
p_29,0,5,e_1,670,678,699,20,6,6,2,4,0,1,8,21,29
p_32,0,6,e_1,650,678,704,24,9,9,9,4,0,1,28,26,54
p_31,0,6,e_1,666,678,704,20,7,7,4,4,0,1,12,26,38
p_74,0,7,e_1,560,678,709,21,6,6,0,4,0,1,118,31,149
p_130,0,1,e_0,472,711,716,12,0,0,4,4,0,1,239,5,244
p_119,0,1,e_0,483,711,716,12,0,0,0,4,0,1,228,5,233
p_27,0,10,e_1,677,678,720,18,5,5,0,3,0,0,1,42,43
p_129,0,3,e_0,473,711,724,12,0,0,4,4,0,1,238,13,251
p_73,0,11,e_1,561,678,725,21,6,6,0,3,0,0,117,47,164
p_28,0,11,e_1,676,678,725,18,5,5,0,4,0,1,2,47,49
p_34,0,12,e_1,646,678,730,26,9,9,10,4,0,1,32,52,84
p_124,0,7,e_0,478,711,738,12,0,0,2,4,0,1,233,27,260
p_118,0,7,e_0,484,711,738,12,0,0,0,3,0,0,227,27,254
p_33,0,15,e_1,649,678,741,25,9,9,9,4,0,1,29,63,92
p_127,0,10,e_0,475,711,749,12,0,0,3,4,0,1,236,38,274
p_22,0,3,e_3,719,740,751,7,1,0,7,4,0,1,21,11,32
p_132,0,11,e_0,470,711,754,12,0,0,5,4,0,1,241,43,284
p_128,0,11,e_0,474,711,754,12,0,0,3,4,0,1,237,43,280
p_123,0,11,e_0,479,711,754,12,0,0,2,4,0,1,232,43,275
p_121,0,11,e_0,481,711,754,12,0,0,1,4,0,1,230,43,273
p_120,0,11,e_0,482,711,754,12,0,0,1,4,0,1,229,43,272
p_21,0,4,e_3,731,740,756,3,1,0,3,4,0,1,9,16,25
p_126,0,12,e_0,476,711,759,12,0,0,3,4,0,1,235,48,283
p_131,0,14,e_0,471,711,767,12,0,0,4,4,0,1,240,56,296
p_125,0,14,e_0,477,711,767,12,0,0,2,4,0,1,234,56,290
p_122,0,15,e_0,480,711,772,12,0,0,1,4,0,1,231,61,292
p_35,0,9,e_3,630,740,773,2,1,0,2,4,0,1,110,33,143
p_23,0,12,e_3,711,740,784,9,1,0,9,4,0,1,29,44,73
p_36,0,13,e_3,628,740,789,2,1,0,2,4,0,1,112,49,161
p_20,0,14,e_3,734,740,794,2,1,0,2,4,0,1,6,54,60
p_16,0,2,e_2,780,796,804,17,3,3,5,4,0,1,16,8,24
p_14,0,4,e_2,794,796,812,14,0,0,0,4,0,1,2,16,18
p_65,0,1,e_0,573,819,824,19,4,4,8,4,0,1,246,5,251
p_15,0,9,e_2,793,796,829,14,0,0,1,4,0,1,3,33,36
p_72,0,3,e_0,562,819,832,21,6,6,12,4,0,1,257,13,270
p_71,0,3,e_0,564,819,832,20,6,6,11,4,0,1,255,13,268
p_70,0,3,e_0,565,819,832,20,5,5,11,4,0,1,254,13,267
p_67,0,3,e_0,568,819,832,20,5,5,10,4,0,1,251,13,264
p_66,0,3,e_0,569,819,832,19,5,5,10,4,0,1,250,13,263
p_18,0,10,e_2,766,796,834,21,4,4,10,4,0,1,30,38,68
p_17,0,10,e_2,776,796,834,18,3,3,6,4,0,1,20,38,58
p_64,0,4,e_0,574,819,837,18,4,4,8,4,0,1,245,18,263
p_19,0,11,e_2,754,796,839,24,5,5,13,3,0,0,42,43,85
p_61,0,6,e_0,579,819,845,17,3,3,6,4,0,1,240,26,266
p_60,0,10,e_0,580,819,859,17,3,3,6,4,0,1,239,40,279
p_58,0,11,e_0,582,819,864,16,3,3,5,4,0,1,237,45,282
p_68,0,13,e_0,567,819,872,20,5,5,10,4,0,1,252,53,305
p_63,0,13,e_0,577,819,872,18,3,3,7,4,0,1,242,53,295
p_62,0,13,e_0,578,819,872,18,3,3,7,4,0,1,241,53,294
p_69,0,14,e_0,566,819,877,20,5,5,11,4,0,1,253,58,311
p_59,0,14,e_0,581,819,877,17,3,3,6,4,0,1,238,58,296
p_9,0,2,e_2,846,874,882,14,0,0,9,4,0,1,28,8,36
p_10,0,8,e_2,835,874,902,14,0,0,10,5,1,0,39,28,67
p_45,0,2,e_0,595,921,929,13,1,0,1,4,0,1,326,8,334
p_55,0,3,e_0,585,921,934,16,2,2,4,4,0,1,336,13,349
p_54,0,3,e_0,586,921,934,16,2,2,4,4,0,1,335,13,348
p_52,0,3,e_0,588,921,934,15,1,1,3,4,0,1,333,13,346
p_1,0,5,e_3,894,919,936,8,1,0,8,4,0,1,25,17,42
p_48,0,4,e_0,592,921,939,14,1,0,2,4,0,1,329,18,347
p_46,0,4,e_0,594,921,939,14,1,0,1,4,0,1,327,18,345
p_7,0,5,e_1,875,923,940,14,1,0,15,3,0,0,48,17,65
p_56,0,6,e_0,584,921,947,16,2,2,5,4,0,1,337,26,363
p_3,0,8,e_3,888,919,947,10,1,0,10,4,0,1,31,28,59
p_50,0,7,e_0,590,921,952,15,1,0,3,4,0,1,331,31,362
p_43,0,7,e_0,597,921,952,13,1,0,0,4,0,1,324,31,355
p_44,0,8,e_0,596,921,957,13,1,0,1,4,0,1,325,36,361
p_8,0,11,e_3,874,919,958,14,0,0,14,3,0,0,45,39,84
p_53,0,9,e_0,587,921,962,15,2,2,4,4,0,1,334,41,375
p_51,0,9,e_0,589,921,962,15,1,0,3,4,0,1,332,41,373
p_47,0,9,e_0,593,921,962,14,1,0,2,4,0,1,328,41,369
p_57,0,11,e_0,583,921,970,16,2,2,5,4,0,1,338,49,387
p_49,0,14,e_0,591,921,981,15,1,0,2,4,0,1,330,60,390
p_4,0,1,e_0,886,1025,1030,11,1,0,11,4,0,1,139,5,144
p_24,0,2,e_0,695,1025,1035,14,1,1,5,4,0,1,330,10,340
p_6,0,3,e_0,877,1025,1040,14,1,0,14,4,0,1,148,15,163
p_42,0,6,e_0,598,1025,1051,12,1,0,0,3,0,0,427,26,453
p_26,0,8,e_0,684,1025,1059,16,4,4,9,4,0,1,341,34,375
p_25,0,8,e_0,686,1025,1059,16,3,3,8,4,0,1,339,34,373
p_5,0,8,e_0,883,1025,1059,12,1,0,12,4,0,1,142,34,176
p_11,0,9,e_0,807,1025,1064,14,0,0,4,4,0,1,218,39,257
p_13,0,11,e_0,796,1025,1072,14,0,0,7,4,0,1,229,47,276
p_12,0,11,e_0,798,1025,1072,14,0,0,7,4,0,1,227,47,274
p_2,0,11,e_0,892,1025,1072,9,1,0,9,4,0,1,133,47,180
p_300,0,4,e_0,8,9,25,0,0,0,0,3,0,0,1,16,17
p_299,0,5,e_1,9,10,29,0,0,0,0,3,0,0,1,19,20
p_297,0,6,e_3,15,16,38,0,0,0,0,3,0,0,1,22,23
p_298,0,9,e_2,11,12,43,0,0,0,0,3,0,0,1,31,32
p_296,0,4,e_0,28,43,57,9,1,1,4,3,0,0,15,14,29
p_286,0,3,e_1,46,47,60,6,0,0,0,3,0,0,1,13,14
p_292,0,6,e_0,38,43,65,6,0,0,1,4,0,1,5,22,27
p_290,0,6,e_0,40,43,65,6,0,0,1,4,0,1,3,22,25
p_289,0,4,e_1,43,47,65,6,0,0,1,4,0,1,4,18,22
p_295,0,5,e_1,29,47,70,9,1,1,5,3,0,0,18,23,41
p_287,0,5,e_1,45,47,70,6,0,0,0,4,0,1,2,23,25
p_288,0,8,e_1,44,47,81,6,0,0,1,4,0,1,3,34,37
p_281,0,1,e_3,73,74,81,0,0,0,0,3,0,0,1,7,8
p_291,0,11,e_0,39,43,82,6,0,0,1,4,0,1,4,39,43
p_294,0,12,e_0,31,43,87,8,1,1,4,4,0,1,12,44,56
p_293,0,12,e_0,33,43,87,7,1,1,3,4,0,1,10,44,54
p_285,0,4,e_3,53,74,92,6,0,0,6,3,0,0,21,18,39
p_284,0,4,e_3,54,74,92,6,1,0,6,4,0,1,20,18,38
p_282,0,7,e_3,66,74,103,2,1,0,2,4,0,1,8,29,37
p_283,0,9,e_3,57,74,111,5,1,0,5,4,0,1,17,37,54
p_278,0,2,e_2,77,105,113,18,4,4,9,4,0,1,28,8,36
p_279,0,5,e_2,76,105,124,18,4,4,9,4,0,1,29,19,48
p_277,0,6,e_1,82,109,129,17,3,3,8,3,0,0,27,20,47
p_274,0,8,e_2,88,105,135,15,3,3,5,4,0,1,17,30,47
p_271,0,1,e_3,121,140,145,6,1,0,6,4,0,1,19,5,24
p_276,0,11,e_2,84,105,146,16,3,3,7,4,0,1,21,41,62
p_273,0,4,e_3,110,140,156,9,0,0,9,2,1,0,30,16,46
p_280,0,14,e_2,75,105,157,18,4,4,9,3,0,0,30,52,82
p_275,0,14,e_2,86,105,157,16,3,3,6,4,0,1,19,52,71
p_267,0,1,e_1,148,165,172,18,3,3,5,4,0,1,17,7,24
p_270,0,9,e_3,122,140,173,6,1,0,6,4,0,1,18,33,51
p_269,0,9,e_3,127,140,173,4,1,0,4,4,0,1,13,33,46
p_268,0,2,e_1,144,165,177,19,3,3,6,3,0,0,21,12,33
p_272,0,10,e_3,113,140,178,9,1,0,9,4,0,1,27,38,65
p_265,0,4,e_1,152,165,185,17,3,3,4,4,0,1,13,20,33
p_262,0,5,e_1,157,165,190,16,2,2,2,4,0,1,8,25,33
p_261,0,5,e_1,164,165,190,14,2,2,0,3,0,0,1,25,26
p_266,0,6,e_1,151,165,195,17,3,3,4,4,0,1,14,30,44
p_263,0,7,e_1,154,165,200,16,3,3,3,4,0,1,11,35,46
p_264,0,11,e_1,153,165,214,17,3,3,4,4,0,1,12,49,61
p_255,0,3,e_0,184,204,215,10,0,0,6,4,0,1,20,11,31
p_254,0,4,e_0,187,204,220,10,0,0,5,4,0,1,17,16,33
p_253,0,5,e_0,190,204,225,10,0,0,4,4,0,1,14,21,35
p_252,0,5,e_2,205,212,229,10,0,0,2,4,0,1,7,17,24
p_260,0,7,e_0,165,204,233,13,2,2,12,3,0,0,39,29,68
p_258,0,7,e_0,168,204,233,12,2,2,12,4,0,1,36,29,65
p_256,0,10,e_0,182,204,244,10,0,0,7,4,0,1,22,40,62
p_257,0,14,e_0,169,204,258,12,2,2,11,4,0,1,35,54,89
p_250,0,2,e_3,217,250,258,10,0,0,10,3,0,0,33,8,41
p_259,0,15,e_2,167,212,261,13,2,2,14,3,0,0,45,49,94
p_251,0,15,e_2,209,212,261,10,0,0,1,4,0,1,3,49,52
p_248,0,5,e_3,246,250,269,1,1,0,1,4,0,1,4,19,23
p_249,0,6,e_3,239,250,274,3,1,0,3,4,0,1,11,24,35
p_241,0,1,e_1,283,286,291,6,0,0,1,4,0,1,3,5,8
p_247,0,5,e_1,250,286,305,12,3,3,11,3,0,0,36,19,55
p_245,0,7,e_1,269,286,313,7,1,1,5,4,0,1,17,27,44
p_242,0,8,e_1,277,286,318,6,0,0,3,4,0,1,9,32,41
p_246,0,10,e_1,262,286,326,9,2,2,8,4,0,1,24,40,64
p_236,0,1,e_3,305,322,327,5,1,0,5,4,0,1,17,5,22
p_233,0,1,e_3,311,322,327,3,1,0,3,4,0,1,11,5,16
p_244,0,12,e_1,271,286,334,7,1,1,5,4,0,1,15,48,63
p_230,0,3,e_3,319,322,335,1,1,0,1,4,0,1,3,13,16
p_232,0,5,e_3,314,322,343,2,1,0,2,4,0,1,8,21,29
p_243,0,15,e_1,272,286,345,6,1,1,4,4,0,1,14,59,73
p_237,0,7,e_3,304,322,351,6,1,0,6,4,0,1,18,29,47
p_231,0,7,e_3,317,322,351,1,1,0,1,4,0,1,5,29,34
p_235,0,8,e_3,308,322,356,4,1,0,4,4,0,1,14,34,48
p_234,0,8,e_3,310,322,356,4,1,0,4,4,0,1,12,34,46
p_240,0,9,e_3,301,322,361,6,0,0,6,3,0,0,21,39,60
p_239,0,11,e_3,302,322,369,6,1,0,6,4,0,1,20,47,67
p_216,0,1,e_0,347,370,377,20,5,5,7,4,0,1,23,7,30
p_238,0,13,e_3,303,322,377,6,1,0,6,4,0,1,19,55,74
p_229,0,13,e_3,320,322,377,0,1,0,0,4,0,1,2,55,57
p_226,0,2,e_0,329,370,382,25,7,7,13,4,0,1,41,12,53
p_223,0,2,e_0,336,370,382,23,6,6,11,4,0,1,34,12,46
p_214,0,3,e_0,349,370,387,19,5,5,7,4,0,1,21,17,38
p_196,0,4,e_2,371,375,391,15,1,1,1,4,0,1,4,16,20
p_228,0,4,e_0,325,370,392,25,8,8,14,3,0,0,45,22,67
p_225,0,5,e_0,330,370,397,24,7,7,13,4,0,1,40,27,67
p_224,0,5,e_0,331,370,397,24,7,7,13,4,0,1,39,27,66
p_222,0,5,e_0,337,370,397,23,6,6,11,4,0,1,33,27,60
p_219,0,5,e_0,342,370,397,21,5,5,9,4,0,1,28,27,55
p_194,0,6,e_2,373,375,399,14,1,1,0,4,0,1,2,24,26
p_221,0,6,e_0,339,370,402,22,6,6,10,4,0,1,31,32,63
p_220,0,6,e_0,341,370,402,21,6,6,9,4,0,1,29,32,61
p_217,0,7,e_0,346,370,407,20,5,5,8,4,0,1,24,37,61
p_197,0,10,e_2,370,375,413,15,1,1,1,4,0,1,5,38,43
p_193,0,11,e_2,374,375,418,14,1,1,0,3,0,0,1,43,44
p_218,0,11,e_0,343,370,421,21,5,5,9,4,0,1,27,51,78
p_227,0,12,e_2,327,375,423,25,7,7,15,3,0,0,48,48,96
p_190,0,1,e_3,379,418,425,13,1,0,13,4,0,1,39,7,46
p_183,0,1,e_3,396,418,425,7,1,0,7,4,0,1,22,7,29
p_161,0,1,e_1,421,423,428,30,10,10,0,4,0,1,2,5,7
p_182,0,2,e_3,397,418,430,7,1,0,7,4,0,1,21,12,33
p_180,0,2,e_3,399,418,430,6,1,0,6,4,0,1,19,12,31
p_195,0,15,e_2,372,375,434,14,1,1,1,4,0,1,3,59,62
p_215,0,15,e_0,348,370,435,20,5,5,7,4,0,1,22,65,87
p_213,0,15,e_0,350,370,435,19,4,4,6,4,0,1,20,65,85
p_178,0,3,e_3,401,418,435,5,1,0,5,4,0,1,17,17,34
p_186,0,4,e_3,390,418,440,9,1,0,9,4,0,1,28,22,50
p_192,0,8,e_1,375,423,451,13,1,1,15,3,0,0,48,28,76
p_189,0,8,e_3,382,418,454,12,1,0,12,4,0,1,36,36,72
p_179,0,8,e_3,400,418,454,6,1,0,6,4,0,1,18,36,54
p_163,0,10,e_1,419,423,459,30,10,10,1,4,0,1,4,36,40
p_177,0,9,e_3,402,418,459,5,1,0,5,4,0,1,16,41,57
p_164,0,11,e_1,418,423,464,30,11,11,1,4,0,1,5,41,46
p_162,0,11,e_1,420,423,464,30,10,10,1,4,0,1,3,41,44
p_191,0,10,e_3,376,418,464,13,0,0,13,2,1,0,42,46,88
p_185,0,10,e_3,391,418,464,9,1,0,9,4,0,1,27,46,73
p_187,0,12,e_3,389,418,472,9,1,0,9,4,0,1,29,54,83
p_184,0,12,e_3,392,418,472,8,1,0,8,4,0,1,26,54,80
p_188,0,13,e_3,384,418,477,11,1,0,11,4,0,1,34,59,93
p_181,0,15,e_3,398,418,485,6,1,0,6,4,0,1,20,67,87
p_209,0,2,e_0,357,482,492,18,3,3,4,4,0,1,125,10,135
p_205,0,2,e_0,362,482,492,17,2,2,2,4,0,1,120,10,130
p_129,0,3,e_2,473,481,494,18,3,3,2,4,0,1,8,13,21
p_137,0,4,e_2,464,481,499,20,4,4,5,4,0,1,17,18,35
p_200,0,4,e_0,367,482,500,15,2,2,1,4,0,1,115,18,133
p_201,0,5,e_0,366,482,505,16,2,2,1,4,0,1,116,23,139
p_159,0,6,e_2,429,481,507,28,9,9,14,5,1,1,52,26,78
p_150,0,6,e_2,443,481,507,25,7,7,12,4,0,1,38,26,64
p_141,0,6,e_2,458,481,507,21,5,5,7,4,0,1,23,26,49
p_210,0,6,e_0,354,482,510,18,4,4,5,4,0,1,128,28,156
p_208,0,6,e_0,358,482,510,18,3,3,4,4,0,1,124,28,152
p_212,0,7,e_0,351,482,515,19,4,4,6,4,0,1,131,33,164
p_148,0,8,e_2,449,481,515,23,7,7,10,4,0,1,32,34,66
p_153,0,9,e_2,437,481,520,27,8,8,14,4,0,1,44,39,83
p_147,0,9,e_2,452,481,520,22,7,7,9,4,0,1,29,39,68
p_144,0,9,e_2,455,481,520,22,6,6,8,4,0,1,26,39,65
p_198,0,9,e_0,369,482,523,15,1,1,0,3,0,0,113,41,154
p_119,0,1,e_1,483,518,525,15,2,2,11,4,0,1,35,7,42
p_113,0,1,e_1,489,518,525,14,1,0,9,4,0,1,29,7,36
p_139,0,10,e_2,461,481,525,21,5,5,6,4,0,1,20,44,64
p_132,0,11,e_2,470,481,530,18,4,4,3,4,0,1,11,49,60
p_207,0,11,e_0,359,482,531,17,3,3,3,4,0,1,123,49,172
p_114,0,3,e_1,488,518,533,14,1,0,10,4,0,1,30,15,45
p_106,0,3,e_1,500,518,533,10,1,0,6,4,0,1,18,15,33
p_126,0,12,e_2,476,481,535,17,2,2,1,4,0,1,5,54,59
p_206,0,12,e_0,361,482,536,17,2,2,3,4,0,1,121,54,175
p_203,0,12,e_0,364,482,536,16,2,2,2,4,0,1,118,54,172
p_167,0,1,e_3,413,532,537,1,1,0,1,4,0,1,119,5,124
p_204,0,14,e_0,363,482,544,17,2,2,2,4,0,1,119,62,181
p_108,0,6,e_1,496,518,544,12,1,0,7,4,0,1,22,26,48
p_160,0,15,e_2,426,481,546,29,10,10,13,5,1,0,55,65,120
p_156,0,15,e_2,434,481,546,27,8,8,15,4,0,1,47,65,112
p_134,0,15,e_2,467,481,546,19,4,4,4,4,0,1,14,65,79
p_176,0,4,e_3,403,532,548,5,1,0,5,4,0,1,129,16,145
p_165,0,4,e_3,417,532,548,0,0,0,0,3,0,0,115,16,131
p_211,0,15,e_0,353,482,549,19,4,4,5,4,0,1,129,67,196
p_202,0,15,e_0,365,482,549,16,2,2,1,4,0,1,117,67,184
p_199,0,15,e_0,368,482,549,15,1,1,0,4,0,1,114,67,181
p_118,0,7,e_1,484,518,549,15,1,1,11,4,0,1,34,31,65
p_111,0,8,e_1,491,518,554,13,1,0,9,4,0,1,27,36,63
p_94,0,6,e_3,519,532,556,4,1,0,4,4,0,1,13,24,37
p_115,0,9,e_1,487,518,559,15,1,0,10,4,0,1,31,41,72
p_117,0,10,e_1,485,518,564,15,1,0,11,4,0,1,33,46,79
p_116,0,10,e_1,486,518,564,15,1,0,10,4,0,1,32,46,78
p_169,0,9,e_3,411,532,567,2,1,0,2,4,0,1,121,35,156
p_120,0,11,e_1,482,518,569,16,2,2,11,3,0,0,36,51,87
p_112,0,11,e_1,490,518,569,14,1,0,9,4,0,1,28,51,79
p_110,0,11,e_1,492,518,569,13,1,0,8,4,0,1,26,51,77
p_107,0,11,e_1,499,518,569,11,1,0,6,4,0,1,19,51,70
p_173,0,11,e_3,407,532,575,3,1,0,3,4,0,1,125,43,168
p_166,0,12,e_3,416,532,580,0,1,0,0,4,0,1,116,48,164
p_109,0,15,e_1,493,518,583,13,1,0,8,4,0,1,25,65,90
p_171,0,13,e_3,409,532,585,3,1,0,3,4,0,1,123,53,176
p_168,0,13,e_3,412,532,585,2,1,0,2,4,0,1,120,53,173
p_93,0,13,e_3,520,532,585,4,1,0,4,4,0,1,12,53,65
p_175,0,14,e_3,405,532,590,4,1,0,4,4,0,1,127,58,185
p_174,0,14,e_3,406,532,590,4,1,0,4,4,0,1,126,58,184
p_170,0,14,e_3,410,532,590,2,1,0,2,4,0,1,122,58,180
p_95,0,14,e_3,518,532,590,4,1,0,4,4,0,1,14,58,72
p_172,0,15,e_3,408,532,595,3,1,0,3,4,0,1,124,63,187
p_158,0,1,e_0,430,596,603,28,9,9,14,5,1,1,166,7,173
p_146,0,1,e_0,453,596,603,22,6,6,9,4,0,1,143,7,150
p_86,0,2,e_2,544,593,603,27,9,9,15,5,1,1,49,10,59
p_77,0,3,e_2,557,593,608,24,7,7,12,4,0,1,36,15,51
p_143,0,3,e_0,456,596,611,22,6,6,8,4,0,1,140,15,155
p_136,0,3,e_0,465,596,611,20,4,4,5,4,0,1,131,15,146
p_88,0,5,e_2,538,593,616,29,9,9,13,5,1,1,55,23,78
p_80,0,7,e_2,552,593,624,25,8,8,13,4,0,1,41,31,72
p_154,0,7,e_0,436,596,625,27,8,8,15,4,0,1,160,29,189
p_87,0,8,e_2,539,593,629,29,9,9,13,5,1,1,54,36,90
p_83,0,8,e_2,549,593,629,26,8,8,14,4,0,1,44,36,80
p_140,0,8,e_0,459,596,630,21,5,5,7,4,0,1,137,34,171
p_89,0,9,e_2,535,593,634,29,10,10,12,5,1,1,58,41,99
p_142,0,9,e_0,457,596,635,21,6,6,8,4,0,1,139,39,178
p_96,0,1,e_1,517,630,635,5,1,0,0,3,0,0,113,5,118
p_135,0,10,e_0,466,596,640,20,4,4,5,4,0,1,130,44,174
p_123,0,11,e_2,479,593,642,17,2,2,0,4,0,1,114,49,163
p_145,0,11,e_0,454,596,645,22,6,6,9,4,0,1,142,49,191
p_138,0,11,e_0,463,596,645,20,4,4,6,4,0,1,133,49,182
p_84,0,12,e_2,546,593,647,26,9,9,15,4,0,1,47,54,101
p_78,0,12,e_2,556,593,647,24,7,7,12,4,0,1,37,54,91
p_99,0,6,e_1,514,630,652,6,1,0,1,4,0,1,116,22,138
p_42,0,6,e_1,598,630,652,14,1,0,10,4,0,1,32,22,54
p_82,0,14,e_2,550,593,655,26,8,8,14,4,0,1,43,62,105
p_81,0,14,e_2,551,593,655,25,8,8,14,4,0,1,42,62,104
p_79,0,14,e_2,553,593,655,25,8,8,13,4,0,1,40,62,102
p_157,0,14,e_0,431,596,656,28,9,9,14,5,1,1,165,60,225
p_155,0,14,e_0,435,596,656,27,8,8,15,4,0,1,161,60,221
p_92,0,4,e_3,525,642,656,2,1,0,2,4,0,1,117,14,131
p_102,0,7,e_1,509,630,657,7,1,0,3,4,0,1,121,27,148
p_98,0,7,e_1,515,630,657,5,1,0,1,4,0,1,115,27,142
p_97,0,7,e_1,516,630,657,5,1,0,0,4,0,1,114,27,141
p_43,0,7,e_1,597,630,657,15,1,0,11,4,0,1,33,27,60
p_122,0,15,e_2,480,593,660,16,2,2,0,3,0,0,113,67,180
p_85,0,15,e_2,545,593,660,27,9,9,15,2,1,1,48,67,115
p_152,0,15,e_0,441,596,661,26,7,7,13,4,0,1,155,65,220
p_151,0,15,e_0,442,596,661,26,7,7,13,4,0,1,154,65,219
p_149,0,15,e_0,444,596,661,25,7,7,12,4,0,1,152,65,217
p_101,0,8,e_1,511,630,662,7,1,0,2,4,0,1,119,32,151
p_44,0,8,e_1,596,630,662,15,1,0,11,4,0,1,34,32,66
p_100,0,9,e_1,513,630,667,6,1,0,1,4,0,1,117,37,154
p_35,0,9,e_3,630,642,673,4,1,0,4,4,0,1,12,31,43
p_103,0,11,e_1,508,630,675,8,1,0,3,4,0,1,122,45,167
p_41,0,11,e_1,600,630,675,14,1,0,10,4,0,1,30,45,75
p_105,0,12,e_1,502,630,680,10,1,0,5,4,0,1,128,50,178
p_91,0,12,e_3,526,642,684,2,1,0,2,4,0,1,116,42,158
p_40,0,13,e_1,602,630,685,13,1,0,9,4,0,1,28,55,83
p_90,0,13,e_3,527,642,689,1,1,0,1,4,0,1,115,47,162
p_104,0,14,e_1,503,630,690,9,1,0,5,4,0,1,127,60,187
p_65,0,1,e_2,573,707,712,19,6,6,6,4,0,1,134,5,139
p_130,0,1,e_0,472,708,713,18,3,3,3,4,0,1,236,5,241
p_45,0,2,e_0,595,708,718,15,1,0,0,3,0,0,113,10,123
p_72,0,3,e_2,562,707,720,22,7,7,10,4,0,1,145,13,158
p_71,0,3,e_2,564,707,720,22,7,7,9,4,0,1,143,13,156
p_70,0,3,e_2,565,707,720,21,7,7,9,4,0,1,142,13,155
p_67,0,3,e_2,568,707,720,21,6,6,8,4,0,1,139,13,152
p_66,0,3,e_2,569,707,720,21,6,6,8,4,0,1,138,13,151
p_30,0,3,e_0,668,708,723,18,3,3,13,4,0,1,40,15,55
p_64,0,4,e_2,574,707,725,19,5,5,6,4,0,1,133,18,151
p_46,0,4,e_0,594,708,728,15,1,1,0,4,0,1,114,20,134
p_75,0,5,e_2,559,707,730,23,7,7,11,4,0,1,148,23,171
p_29,0,5,e_0,670,708,733,18,3,3,12,4,0,1,38,25,63
p_76,0,6,e_2,558,707,735,24,7,7,11,4,0,1,149,28,177
p_74,0,7,e_2,560,707,740,23,7,7,11,4,0,1,147,33,180
p_124,0,7,e_0,478,708,741,17,2,2,1,4,0,1,230,33,263
p_22,0,3,e_1,719,734,745,13,0,0,5,4,0,1,15,11,26
p_47,0,9,e_0,593,708,749,15,2,2,1,4,0,1,115,41,156
p_21,0,4,e_1,731,734,750,13,0,0,1,4,0,1,3,16,19
p_127,0,10,e_0,475,708,754,17,3,3,2,4,0,1,233,46,279
p_73,0,11,e_2,561,707,754,23,7,7,10,4,0,1,146,47,193
p_128,0,11,e_0,474,708,759,18,3,3,2,4,0,1,234,51,285
p_121,0,11,e_0,481,708,759,16,2,2,0,3,0,0,227,51,278
p_28,0,11,e_0,676,708,759,16,2,2,10,4,0,1,32,51,83
p_68,0,13,e_2,567,707,762,21,6,6,8,4,0,1,140,55,195
p_63,0,13,e_2,577,707,762,19,5,5,5,4,0,1,130,55,185
p_62,0,13,e_2,578,707,762,18,5,5,5,4,0,1,129,55,184
p_133,0,12,e_0,469,708,764,19,4,4,4,4,0,1,239,56,295
p_37,0,9,e_1,615,734,767,9,1,0,5,4,0,1,119,33,152
p_69,0,14,e_2,566,707,767,21,6,6,9,4,0,1,141,60,201
p_131,0,14,e_0,471,708,772,18,3,3,3,4,0,1,237,64,301
p_125,0,14,e_0,477,708,772,17,2,2,1,4,0,1,231,64,295
p_33,0,15,e_0,649,708,777,24,4,4,12,5,2,1,59,69,128
p_39,0,12,e_1,607,734,778,11,1,0,7,4,0,1,127,44,171
p_23,0,12,e_1,711,734,778,13,0,0,7,4,0,1,23,44,67
p_38,0,13,e_1,608,734,783,11,1,0,7,4,0,1,126,49,175
p_36,0,13,e_1,628,734,783,4,1,0,0,4,0,1,106,49,155
p_18,0,10,e_3,766,776,808,3,1,0,3,4,0,1,10,32,42
p_19,0,11,e_3,754,776,813,7,1,0,7,4,0,1,22,37,59
p_55,0,3,e_2,585,811,822,17,3,3,2,4,0,1,226,11,237
p_54,0,3,e_2,586,811,822,17,3,3,2,4,0,1,225,11,236
p_52,0,3,e_2,588,811,822,16,3,3,1,4,0,1,223,11,234
p_20,0,14,e_3,734,776,824,13,0,0,13,3,0,0,42,48,90
p_48,0,4,e_2,592,811,827,16,2,2,0,3,0,0,219,16,235
p_24,0,2,e_0,695,824,832,13,0,0,4,4,0,1,129,8,137
p_61,0,6,e_2,579,811,835,18,4,4,4,4,0,1,232,24,256
p_56,0,6,e_2,584,811,835,17,3,3,3,4,0,1,227,24,251
p_50,0,7,e_2,590,811,840,16,2,2,1,4,0,1,221,29,250
p_53,0,9,e_2,587,811,848,17,3,3,2,4,0,1,224,37,261
p_51,0,9,e_2,589,811,848,16,2,2,1,4,0,1,222,37,259
p_25,0,8,e_0,686,824,852,14,1,1,7,4,0,1,138,28,166
p_60,0,10,e_2,580,811,853,18,4,4,4,4,0,1,231,42,273
p_58,0,11,e_2,582,811,858,18,4,4,3,4,0,1,229,47,276
p_57,0,11,e_2,583,811,858,17,4,4,3,4,0,1,228,47,275
p_27,0,10,e_0,677,824,860,16,2,2,10,4,0,1,147,36,183
p_34,0,12,e_2,646,811,863,25,4,4,12,2,3,1,165,52,217
p_59,0,14,e_2,581,811,871,18,4,4,4,4,0,1,230,60,290
p_49,0,14,e_2,591,811,871,16,2,2,0,4,0,1,220,60,280
p_9,0,2,e_1,846,877,885,14,0,0,10,4,0,1,31,8,39
p_7,0,5,e_1,875,877,896,14,0,0,0,4,0,1,2,19,21
p_10,0,8,e_1,835,877,907,14,0,0,13,3,0,0,42,30,72
p_4,0,1,e_0,886,910,915,14,0,0,8,4,0,1,24,5,29
p_8,0,11,e_1,874,877,918,14,0,0,1,4,0,1,3,41,44
p_6,0,3,e_0,877,910,923,14,0,0,10,3,0,0,33,13,46
p_16,0,2,e_2,780,915,923,27,3,3,10,4,0,1,135,8,143
p_1,0,5,e_0,894,910,931,14,0,0,5,4,0,1,16,21,37
p_14,0,4,e_2,794,915,931,22,3,3,5,4,0,1,121,16,137
p_32,0,6,e_2,650,915,939,24,4,4,13,5,2,1,265,24,289
p_31,0,6,e_2,666,915,939,19,3,3,13,4,0,1,249,24,273
p_5,0,8,e_0,883,910,942,14,0,0,9,4,0,1,27,32,59
p_3,0,8,e_0,888,910,942,14,0,0,7,4,0,1,22,32,54
p_26,0,8,e_2,684,915,947,14,1,1,7,4,0,1,231,32,263
p_15,0,9,e_2,793,915,952,23,3,3,6,4,0,1,122,37,159
p_11,0,9,e_2,807,915,952,18,2,2,1,4,0,1,108,37,145
p_2,0,11,e_0,892,910,953,14,0,0,6,4,0,1,18,43,61
p_17,0,10,e_2,776,915,957,28,3,3,11,4,0,1,139,42,181
p_13,0,11,e_2,796,915,962,22,3,3,5,4,0,1,119,47,166
p_12,0,11,e_2,798,915,962,21,3,3,4,4,0,1,117,47,164
p_300,0,4,e_0,8,9,25,0,0,0,0,3,0,0,1,16,17
p_299,0,5,e_1,9,10,29,0,0,0,0,3,0,0,1,19,20
p_297,0,6,e_3,15,16,38,0,0,0,0,3,0,0,1,22,23
p_298,0,9,e_2,11,12,43,0,0,0,0,3,0,0,1,31,32
p_296,0,4,e_0,28,43,57,9,1,1,4,3,0,0,15,14,29
p_295,0,5,e_0,29,43,62,9,1,1,4,4,0,1,14,19,33
p_292,0,6,e_0,38,43,67,6,0,0,1,4,0,1,5,24,29
p_290,0,6,e_0,40,43,67,6,0,0,1,4,0,1,3,24,27
p_286,0,3,e_1,46,61,72,6,0,0,5,4,0,1,15,11,26
p_289,0,4,e_1,43,61,77,6,0,0,5,3,0,0,18,16,34
p_285,0,4,e_1,53,61,77,6,0,0,2,4,0,1,8,16,24
p_284,0,4,e_1,54,61,77,6,0,0,2,4,0,1,7,16,23
p_287,0,5,e_1,45,61,82,6,0,0,5,4,0,1,16,21,37
p_291,0,11,e_0,39,43,84,6,0,0,1,4,0,1,4,41,45
p_294,0,12,e_0,31,43,89,8,1,1,4,4,0,1,12,46,58
p_293,0,12,e_0,33,43,89,7,1,1,3,4,0,1,10,46,56
p_288,0,8,e_1,44,61,93,6,0,0,5,4,0,1,17,32,49
p_281,0,1,e_3,73,87,94,4,1,0,4,4,0,1,14,7,21
p_283,0,9,e_1,57,61,98,6,0,0,1,4,0,1,4,37,41
p_278,0,2,e_3,77,87,99,3,1,0,3,4,0,1,10,12,22
p_279,0,5,e_3,76,87,110,3,1,0,3,4,0,1,11,23,34
p_277,0,6,e_3,82,87,115,1,1,0,1,4,0,1,5,28,33
p_282,0,7,e_3,66,87,120,6,0,0,6,3,0,0,21,33,54
p_273,0,4,e_2,110,118,132,23,4,4,2,4,0,1,8,14,22
p_276,0,11,e_3,84,87,134,1,1,0,1,4,0,1,3,47,50
p_280,0,14,e_3,75,87,145,4,1,0,4,4,0,1,12,58,70
p_275,0,14,e_3,86,87,145,0,0,0,0,3,0,0,1,58,59
p_274,0,8,e_2,88,118,146,28,7,7,9,3,0,0,30,28,58
p_272,0,10,e_2,113,118,154,22,4,4,1,4,0,1,5,36,41
p_271,0,1,e_1,121,151,156,21,2,2,9,3,0,0,30,5,35
p_267,0,1,e_1,148,151,156,14,0,0,1,4,0,1,3,5,8
p_268,0,2,e_1,144,151,161,14,0,0,2,4,0,1,7,10,17
p_270,0,9,e_1,122,151,184,21,2,2,9,4,0,1,29,33,62
p_269,0,9,e_1,127,151,184,19,2,2,8,4,0,1,24,33,57
p_255,0,3,e_2,184,186,197,14,0,0,0,4,0,1,2,11,13
p_265,0,4,e_2,152,186,202,14,0,0,10,5,1,1,34,16,50
p_262,0,5,e_2,157,186,207,14,0,0,9,4,0,1,29,21,50
p_261,0,5,e_2,164,186,207,14,0,0,7,4,0,1,22,21,43
p_266,0,6,e_2,151,186,212,14,0,0,9,5,1,0,35,26,61
p_263,0,7,e_2,154,186,217,14,0,0,10,4,0,1,32,31,63
p_260,0,7,e_2,165,186,217,14,0,0,7,4,0,1,21,31,52
p_258,0,7,e_2,168,186,217,14,0,0,6,4,0,1,18,31,49
p_256,0,10,e_2,182,186,228,14,0,0,1,4,0,1,4,42,46
p_254,0,4,e_1,187,217,231,14,0,0,9,3,0,0,30,14,44
p_264,0,11,e_2,153,186,233,14,0,0,10,2,1,1,33,47,80
p_253,0,5,e_1,190,217,236,14,0,0,9,4,0,1,27,19,46
p_252,0,5,e_1,205,217,236,14,0,0,4,4,0,1,12,19,31
p_257,0,14,e_2,169,186,244,14,0,0,5,4,0,1,17,58,75
p_259,0,15,e_2,167,186,249,14,0,0,6,4,0,1,19,63,82
p_250,0,2,e_0,217,256,264,14,0,0,12,3,0,0,39,8,47
p_251,0,15,e_1,209,217,268,14,0,0,2,4,0,1,8,51,59
p_248,0,5,e_0,246,256,275,14,0,0,3,4,0,1,10,19,29
p_247,0,5,e_0,250,256,275,14,0,0,2,4,0,1,6,19,25
p_249,0,6,e_0,239,256,280,14,0,0,5,4,0,1,17,24,41
p_241,0,1,e_0,283,300,305,14,0,0,5,4,0,1,17,5,22
p_245,0,7,e_0,269,300,325,14,0,0,3,5,2,1,31,25,56
p_242,0,8,e_0,277,300,330,14,0,0,5,5,1,1,23,30,53
p_246,0,10,e_0,262,300,338,14,0,0,2,5,3,0,38,38,76
p_244,0,12,e_0,271,300,346,14,0,0,4,5,2,1,29,46,75
p_236,0,1,e_3,305,346,351,13,1,0,13,4,0,1,41,5,46
p_233,0,1,e_3,311,346,351,11,1,0,11,4,0,1,35,5,40
p_226,0,2,e_3,329,346,356,5,1,0,5,4,0,1,17,10,27
p_243,0,15,e_0,272,300,357,14,0,0,4,5,2,1,28,57,85
p_230,0,3,e_3,319,346,361,9,1,0,9,4,0,1,27,15,42
p_228,0,4,e_3,325,346,366,7,1,0,7,4,0,1,21,20,41
p_232,0,5,e_3,314,346,371,10,1,0,10,4,0,1,32,25,57
p_237,0,7,e_3,304,346,379,14,1,0,14,4,0,1,42,33,75
p_231,0,7,e_3,317,346,379,9,1,0,9,4,0,1,29,33,62
p_235,0,8,e_3,308,346,384,12,1,0,12,4,0,1,38,38,76
p_234,0,8,e_3,310,346,384,12,1,0,12,4,0,1,36,38,74
p_240,0,9,e_3,301,346,389,14,0,0,14,3,0,0,45,43,88
p_239,0,11,e_3,302,346,397,14,1,0,14,4,0,1,44,51,95
p_216,0,1,e_2,347,395,400,26,11,11,15,3,0,0,48,5,53
p_209,0,2,e_1,357,394,402,24,10,10,12,4,0,1,37,8,45
p_205,0,2,e_1,362,394,402,23,9,9,10,4,0,1,32,8,40
p_227,0,12,e_3,327,346,402,6,1,0,6,4,0,1,19,56,75
p_214,0,3,e_1,349,394,407,25,12,12,15,4,0,1,45,13,58
p_238,0,13,e_3,303,346,407,14,1,0,14,4,0,1,43,61,104
p_229,0,13,e_3,320,346,407,8,1,0,8,4,0,1,26,61,87
p_183,0,1,e_2,396,405,410,15,3,3,0,5,1,0,9,5,14
p_182,0,2,e_2,397,405,415,15,3,3,0,5,1,1,8,10,18
p_180,0,2,e_2,399,405,415,15,3,3,1,2,1,1,6,10,16
p_210,0,6,e_1,354,394,418,24,11,11,13,4,0,1,40,24,64
p_208,0,6,e_1,358,394,418,24,10,10,12,4,0,1,36,24,60
p_178,0,3,e_2,401,405,420,14,2,2,1,4,0,1,4,15,19
p_217,0,7,e_1,346,394,423,26,11,11,15,3,0,0,48,29,77
p_212,0,7,e_1,351,394,423,25,11,11,14,4,0,1,43,29,72
p_176,0,4,e_2,403,405,425,14,2,2,0,4,0,1,2,20,22
p_207,0,11,e_1,359,394,437,23,10,10,11,4,0,1,35,43,78
p_179,0,8,e_2,400,405,439,14,3,3,1,4,0,1,5,34,39
p_206,0,12,e_1,361,394,442,23,9,9,11,4,0,1,33,48,81
p_203,0,12,e_1,364,394,442,22,9,9,10,4,0,1,30,48,78
p_177,0,9,e_2,402,405,444,14,2,2,1,4,0,1,3,39,42
p_204,0,14,e_1,363,394,450,23,9,9,10,4,0,1,31,56,87
p_215,0,15,e_1,348,394,455,26,11,11,15,4,0,1,46,61,107
p_213,0,15,e_1,350,394,455,25,11,11,14,4,0,1,44,61,105
p_211,0,15,e_1,353,394,455,25,11,11,13,4,0,1,41,61,102
p_202,0,15,e_1,365,394,455,4,8,8,9,4,0,1,29,61,90
p_223,0,2,e_3,336,448,456,3,1,0,3,4,0,1,112,8,120
p_181,0,15,e_2,398,405,464,15,3,3,1,5,1,1,7,59,66
p_225,0,5,e_3,330,448,467,5,1,0,5,4,0,1,118,19,137
p_224,0,5,e_3,331,448,467,5,1,0,5,4,0,1,117,19,136
p_222,0,5,e_3,337,448,467,3,1,0,3,4,0,1,111,19,130
p_219,0,5,e_3,342,448,467,1,1,0,1,4,0,1,106,19,125
p_221,0,6,e_3,339,448,472,2,1,0,2,4,0,1,109,24,133
p_220,0,6,e_3,341,448,472,1,1,0,1,4,0,1,107,24,131
p_169,0,9,e_3,411,448,483,12,1,0,12,4,0,1,37,35,72
p_218,0,11,e_3,343,448,491,1,1,0,1,4,0,1,105,43,148
p_173,0,11,e_3,407,448,491,13,1,0,13,4,0,1,41,43,84
p_171,0,13,e_3,409,448,499,13,1,0,13,4,0,1,39,51,90
p_146,0,1,e_0,453,497,504,29,9,9,14,4,0,1,44,7,51
p_175,0,14,e_3,405,448,504,13,2,2,13,5,1,1,43,56,99
p_174,0,14,e_3,406,448,504,13,1,1,13,2,1,1,42,56,98
p_170,0,14,e_3,410,448,504,12,1,0,12,4,0,1,38,56,94
p_190,0,1,e_1,379,502,507,19,6,6,5,4,0,1,123,5,128
p_172,0,15,e_3,408,448,509,13,1,0,13,4,0,1,40,61,101
p_143,0,3,e_0,456,497,512,28,8,8,13,4,0,1,41,15,56
p_136,0,3,e_0,465,497,512,25,8,8,10,4,0,1,32,15,47
p_137,0,4,e_0,464,497,517,26,8,8,11,4,0,1,33,20,53
p_200,0,4,e_1,367,502,518,22,8,8,9,4,0,1,135,16,151
p_196,0,4,e_1,371,502,518,21,7,7,7,4,0,1,131,16,147
p_201,0,5,e_1,366,502,523,22,8,8,9,4,0,1,136,21,157
p_141,0,6,e_0,458,497,525,28,8,8,13,4,0,1,39,28,67
p_194,0,6,e_1,373,502,528,21,7,7,7,4,0,1,129,26,155
p_148,0,8,e_0,449,497,533,30,8,8,15,3,0,0,48,36,84
p_140,0,8,e_0,459,497,533,27,8,8,12,4,0,1,38,36,74
p_192,0,8,e_1,375,502,536,20,7,7,6,4,0,1,127,34,161
p_189,0,8,e_1,382,502,536,18,6,6,4,4,0,1,120,34,154
p_147,0,9,e_0,452,497,538,29,9,9,15,4,0,1,45,41,86
p_144,0,9,e_0,455,497,538,28,8,8,14,4,0,1,42,41,83
p_142,0,9,e_0,457,497,538,28,8,8,13,4,0,1,40,41,81
p_198,0,9,e_1,369,502,541,21,8,8,8,4,0,1,133,39,172
p_139,0,10,e_0,461,497,543,27,8,8,12,4,0,1,36,46,82
p_135,0,10,e_0,466,497,543,25,7,7,10,4,0,1,31,46,77
p_197,0,10,e_1,370,502,546,21,7,7,8,4,0,1,132,44,176
p_191,0,10,e_1,376,502,546,20,7,7,6,4,0,1,126,44,170
p_145,0,11,e_0,454,497,548,28,9,9,14,4,0,1,43,51,94
p_138,0,11,e_0,463,497,548,26,8,8,11,4,0,1,34,51,85
p_193,0,11,e_1,374,502,551,20,7,7,6,4,0,1,128,49,177
p_187,0,12,e_1,389,502,556,17,4,4,1,4,0,1,113,54,167
p_96,0,1,e_2,517,550,557,13,1,0,11,4,0,1,33,7,40
p_188,0,13,e_1,384,502,561,18,5,5,3,4,0,1,118,59,177
p_167,0,1,e_3,413,556,561,11,1,0,11,4,0,1,143,5,148
p_161,0,1,e_3,421,556,561,9,1,0,9,4,0,1,135,5,140
p_158,0,1,e_3,430,556,561,6,1,0,6,4,0,1,126,5,131
p_134,0,15,e_0,467,497,562,25,7,7,10,4,0,1,30,65,95
p_92,0,4,e_2,525,550,568,10,1,0,8,4,0,1,25,18,43
p_199,0,15,e_1,368,502,569,22,8,8,8,4,0,1,134,67,201
p_195,0,15,e_1,372,502,569,21,7,7,7,4,0,1,130,67,197
p_165,0,4,e_3,417,556,572,10,1,0,10,4,0,1,139,16,155
p_99,0,6,e_2,514,550,576,14,1,0,12,4,0,1,36,26,62
p_94,0,6,e_2,519,550,576,12,1,0,10,4,0,1,31,26,57
p_159,0,6,e_3,429,556,580,6,1,0,6,4,0,1,127,24,151
p_102,0,7,e_2,509,550,581,15,1,0,13,4,0,1,41,31,72
p_98,0,7,e_2,515,550,581,13,1,0,11,4,0,1,35,31,66
p_154,0,7,e_3,436,556,585,4,1,0,4,4,0,1,120,29,149
p_101,0,8,e_2,511,550,586,15,1,0,13,4,0,1,39,36,75
p_100,0,9,e_2,513,550,591,14,1,0,12,4,0,1,37,41,78
p_163,0,10,e_3,419,556,596,9,1,0,9,4,0,1,137,40,177
p_103,0,11,e_2,508,550,599,15,1,1,14,4,0,1,42,49,91
p_164,0,11,e_3,418,556,601,10,1,0,10,4,0,1,138,45,183
p_162,0,11,e_3,420,556,601,9,1,0,9,4,0,1,136,45,181
p_105,0,12,e_2,502,550,604,16,3,3,15,3,0,0,48,54,102
p_91,0,12,e_2,526,550,604,10,1,0,8,4,0,1,24,54,78
p_166,0,12,e_3,416,556,606,10,1,0,10,4,0,1,140,50,190
p_93,0,13,e_2,520,550,609,12,1,0,10,4,0,1,30,59,89
p_90,0,13,e_2,527,550,609,9,1,0,7,4,0,1,23,59,82
p_168,0,13,e_3,412,556,611,12,1,0,12,4,0,1,144,55,199
p_104,0,14,e_2,503,550,614,16,2,2,15,4,0,1,47,64,111
p_95,0,14,e_2,518,550,614,12,1,0,10,4,0,1,32,64,96
p_130,0,1,e_0,472,609,616,24,6,6,8,4,0,1,137,7,144
p_119,0,1,e_0,483,609,616,21,5,5,4,4,0,1,126,7,133
p_157,0,14,e_3,431,556,616,5,1,0,5,4,0,1,125,60,185
p_155,0,14,e_3,435,556,616,4,1,0,4,4,0,1,121,60,181
p_160,0,15,e_3,426,556,621,7,1,0,7,4,0,1,130,65,195
p_156,0,15,e_3,434,556,621,4,1,0,4,4,0,1,122,65,187
p_129,0,3,e_0,473,609,624,24,6,6,8,4,0,1,136,15,151
p_106,0,3,e_1,500,616,629,17,3,3,0,4,0,1,116,13,129
p_186,0,4,e_1,390,616,634,17,4,4,1,4,0,1,226,18,244
p_124,0,7,e_0,478,609,638,22,6,6,6,4,0,1,131,29,160
p_127,0,10,e_0,475,609,649,23,6,6,7,4,0,1,134,40,174
p_37,0,9,e_1,615,616,651,16,2,2,0,3,0,0,1,35,36
p_132,0,11,e_0,470,609,654,24,7,7,9,4,0,1,139,45,184
p_128,0,11,e_0,474,609,654,24,6,6,7,4,0,1,135,45,180
p_123,0,11,e_0,479,609,654,22,6,6,6,4,0,1,130,45,175
p_121,0,11,e_0,481,609,654,21,6,6,5,4,0,1,128,45,173
p_120,0,11,e_0,482,609,654,21,5,5,5,4,0,1,127,45,172
p_185,0,10,e_1,391,616,656,17,4,4,1,4,0,1,225,40,265
p_133,0,12,e_0,469,609,659,25,7,7,9,4,0,1,140,50,190
p_126,0,12,e_0,476,609,659,23,6,6,7,4,0,1,133,50,183
p_107,0,11,e_1,499,616,661,17,3,3,1,4,0,1,117,45,162
p_184,0,12,e_1,392,616,666,16,4,4,0,4,0,1,224,50,274
p_86,0,2,e_2,544,658,666,4,1,0,2,4,0,1,114,8,122
p_131,0,14,e_0,471,609,667,24,6,6,8,4,0,1,138,58,196
p_125,0,14,e_0,477,609,667,23,6,6,6,4,0,1,132,58,190
p_122,0,15,e_0,480,609,672,22,6,6,5,4,0,1,129,63,192
p_88,0,5,e_2,538,658,677,6,1,0,4,4,0,1,120,19,139
p_32,0,6,e_2,650,658,682,6,1,0,2,4,0,1,8,24,32
p_150,0,6,e_3,443,668,688,1,1,0,1,4,0,1,225,20,245
p_31,0,6,e_3,666,668,688,0,1,0,0,4,0,1,2,20,22
p_87,0,8,e_2,539,658,690,5,1,0,3,4,0,1,119,32,151
p_83,0,8,e_2,549,658,690,2,1,0,0,3,0,0,109,32,141
p_80,0,7,e_3,552,668,693,1,1,0,1,4,0,1,116,25,141
p_89,0,9,e_2,535,658,695,7,1,0,5,4,0,1,123,37,160
p_35,0,9,e_2,630,658,695,12,1,0,9,4,0,1,28,37,65
p_153,0,9,e_3,437,668,701,3,1,0,3,4,0,1,231,33,264
p_84,0,12,e_2,546,658,706,3,1,0,1,4,0,1,112,48,160
p_34,0,12,e_2,646,658,706,7,1,0,4,4,0,1,12,48,60
p_68,0,13,e_2,567,658,711,27,10,10,4,3,9,1,91,53,144
p_36,0,13,e_2,628,658,711,13,1,0,10,4,0,1,30,53,83
p_24,0,2,e_1,695,707,715,23,3,3,4,4,0,1,12,8,20
p_82,0,14,e_3,550,668,718,2,1,0,2,4,0,1,118,50,168
p_81,0,14,e_3,551,668,718,1,1,0,1,4,0,1,117,50,167
p_79,0,14,e_3,553,668,718,1,1,0,1,4,0,1,115,50,165
p_85,0,15,e_2,545,658,719,3,1,0,1,4,0,1,113,61,174
p_33,0,15,e_2,649,658,719,6,1,0,3,4,0,1,9,61,70
p_30,0,3,e_1,668,707,720,30,5,5,12,3,0,0,39,13,52
p_152,0,15,e_3,441,668,723,2,1,0,2,4,0,1,227,55,282
p_151,0,15,e_3,442,668,723,2,1,0,2,4,0,1,226,55,281
p_149,0,15,e_3,444,668,723,1,1,0,1,4,0,1,224,55,279
p_113,0,1,e_0,489,719,724,19,5,5,2,4,0,1,230,5,235
p_29,0,5,e_1,670,707,728,30,5,5,12,4,0,1,37,21,58
p_114,0,3,e_0,488,719,732,20,5,5,3,4,0,1,231,13,244
p_77,0,3,e_0,557,719,732,30,10,10,14,5,1,1,162,13,175
p_26,0,8,e_1,684,707,739,25,5,5,7,4,0,1,23,32,55
p_25,0,8,e_1,686,707,739,24,5,5,7,4,0,1,21,32,53
p_108,0,6,e_0,496,719,743,18,4,4,0,3,0,0,223,24,247
p_76,0,6,e_0,558,719,743,30,10,10,14,5,1,1,161,24,185
p_27,0,10,e_1,677,707,747,27,5,5,10,4,0,1,30,40,70
p_118,0,7,e_0,484,719,748,21,5,5,4,4,0,1,235,29,264
p_97,0,7,e_0,516,719,748,13,1,0,4,3,7,1,203,29,232
p_28,0,11,e_1,676,707,752,28,5,5,10,4,0,1,31,45,76
p_111,0,8,e_0,491,719,753,19,4,4,2,4,0,1,228,34,262
p_115,0,9,e_0,487,719,758,20,5,5,3,4,0,1,232,39,271
p_117,0,10,e_0,485,719,763,21,5,5,4,4,0,1,234,44,278
p_116,0,10,e_0,486,719,763,20,5,5,3,4,0,1,233,44,277
p_112,0,11,e_0,490,719,768,19,4,4,2,4,0,1,229,49,278
p_110,0,11,e_0,492,719,768,19,4,4,1,4,0,1,227,49,276
p_78,0,12,e_0,556,719,773,30,10,10,13,5,1,1,163,54,217
p_22,0,3,e_2,719,767,780,16,1,1,15,3,0,0,48,13,61
p_109,0,15,e_0,493,719,784,19,4,4,1,4,0,1,226,65,291
p_21,0,4,e_2,731,767,785,15,0,0,12,4,0,1,36,18,54
p_18,0,10,e_2,766,767,805,15,0,0,0,3,0,0,1,38,39
p_19,0,11,e_2,754,767,810,15,0,0,4,4,0,1,13,43,56
p_16,0,2,e_1,780,812,820,15,0,0,10,4,0,1,32,8,40
p_20,0,14,e_2,734,767,821,15,0,0,11,4,0,1,33,54,87
p_14,0,4,e_1,794,812,828,15,0,0,6,4,0,1,18,16,34
p_65,0,1,e_0,573,831,836,26,9,9,12,4,0,1,258,5,263
p_72,0,3,e_0,562,831,844,29,10,10,15,4,0,1,269,13,282
p_71,0,3,e_0,564,831,844,28,10,10,15,4,0,1,267,13,280
p_70,0,3,e_0,565,831,844,28,10,10,14,4,0,1,266,13,279
p_67,0,3,e_0,568,831,844,27,10,10,13,4,0,1,263,13,276
p_66,0,3,e_0,569,831,844,27,10,10,13,4,0,1,262,13,275
p_15,0,9,e_1,793,812,845,15,0,0,6,4,0,1,19,33,52
p_11,0,9,e_1,807,812,845,15,0,0,1,4,0,1,5,33,38
p_64,0,4,e_0,574,831,849,26,9,9,11,4,0,1,257,18,275
p_17,0,10,e_1,776,812,850,15,0,0,11,3,0,0,36,38,74
p_75,0,5,e_0,559,831,854,29,11,11,14,5,1,1,272,23,295
p_13,0,11,e_1,796,812,855,15,0,0,5,4,0,1,16,43,59
p_12,0,11,e_1,798,812,855,15,0,0,4,4,0,1,14,43,57
p_61,0,6,e_0,579,831,859,24,8,8,10,4,0,1,252,28,280
p_74,0,7,e_0,560,831,864,29,10,10,15,5,1,1,271,33,304
p_60,0,10,e_0,580,831,875,24,8,8,9,4,0,1,251,44,295
p_73,0,11,e_0,561,831,880,29,10,10,15,2,1,1,270,49,319
p_63,0,13,e_0,577,831,888,25,9,9,10,4,0,1,254,57,311
p_62,0,13,e_0,578,831,888,24,9,9,10,4,0,1,253,57,310
p_9,0,2,e_2,846,880,888,15,0,0,11,4,0,1,34,8,42
p_69,0,14,e_0,566,831,893,28,10,10,14,4,0,1,265,62,327
p_6,0,3,e_2,877,880,893,15,0,0,1,4,0,1,3,13,16
p_7,0,5,e_2,875,880,901,15,0,0,1,4,0,1,5,21,26
p_10,0,8,e_2,835,880,912,15,0,0,14,3,0,0,45,32,77
p_8,0,11,e_2,874,880,923,15,0,0,2,4,0,1,6,43,49
p_4,0,1,e_1,886,919,924,15,0,0,11,4,0,1,33,5,38
p_1,0,5,e_1,894,919,938,15,0,0,8,4,0,1,25,19,44
p_45,0,2,e_0,595,937,945,20,6,6,4,4,0,1,342,8,350
p_5,0,8,e_1,883,919,949,15,0,0,11,3,0,0,36,30,66
p_3,0,8,e_1,888,919,949,15,0,0,10,4,0,1,31,30,61
p_55,0,3,e_0,585,937,950,23,7,7,8,4,0,1,352,13,365
p_54,0,3,e_0,586,937,950,23,7,7,7,4,0,1,351,13,364
p_52,0,3,e_0,588,937,950,22,7,7,7,4,0,1,349,13,362
p_48,0,4,e_0,592,937,955,21,7,7,5,4,0,1,345,18,363
p_46,0,4,e_0,594,937,955,20,7,7,5,4,0,1,343,18,361
p_2,0,11,e_1,892,919,960,15,0,0,9,4,0,1,27,41,68
p_56,0,6,e_0,584,937,963,23,7,7,8,4,0,1,353,26,379
p_50,0,7,e_0,590,937,968,22,7,7,6,4,0,1,347,31,378
p_53,0,9,e_0,587,937,976,23,7,7,7,4,0,1,350,39,389
p_51,0,9,e_0,589,937,976,22,7,7,6,4,0,1,348,39,387
p_47,0,9,e_0,593,937,976,21,7,7,5,4,0,1,344,39,383
p_58,0,11,e_0,582,937,984,24,8,8,9,4,0,1,355,47,402
p_57,0,11,e_0,583,937,984,23,8,8,8,4,0,1,354,47,401
p_59,0,14,e_0,581,937,995,24,8,8,9,4,0,1,356,58,414
p_49,0,14,e_0,591,937,995,21,7,7,6,4,0,1,346,58,404
p_42,0,6,e_0,598,1039,1059,20,6,6,3,4,0,1,441,20,461
p_43,0,7,e_0,597,1039,1064,20,6,6,4,4,0,1,442,25,467
p_44,0,8,e_0,596,1039,1069,20,6,6,4,4,0,1,443,30,473
p_41,0,11,e_0,600,1039,1080,19,5,5,3,4,0,1,439,41,480
p_39,0,12,e_0,607,1039,1085,18,4,4,0,4,0,1,432,46,478
p_23,0,12,e_0,711,1039,1085,18,2,2,2,4,0,1,328,46,374
p_40,0,13,e_0,602,1039,1090,19,5,5,2,4,0,1,437,51,488
p_38,0,13,e_0,608,1039,1090,18,4,4,0,3,0,0,431,51,482
p_300,0,4,e_0,8,9,25,0,0,0,0,3,0,0,1,16,17
p_299,0,5,e_1,9,10,29,0,0,0,0,3,0,0,1,19,20
p_297,0,6,e_3,15,16,38,0,0,0,0,3,0,0,1,22,23
p_298,0,9,e_2,11,12,43,0,0,0,0,3,0,0,1,31,32
p_296,0,4,e_0,28,43,57,9,1,1,4,3,0,0,15,14,29
p_295,0,5,e_0,29,43,62,9,1,1,4,4,0,1,14,19,33
p_292,0,6,e_0,38,43,67,6,0,0,1,4,0,1,5,24,29
p_290,0,6,e_0,40,43,67,6,0,0,1,4,0,1,3,24,27
p_286,0,3,e_1,46,61,72,6,0,0,5,4,0,1,15,11,26
p_289,0,4,e_1,43,61,77,6,0,0,5,3,0,0,18,16,34
p_285,0,4,e_1,53,61,77,6,0,0,2,4,0,1,8,16,24
p_284,0,4,e_1,54,61,77,6,0,0,2,4,0,1,7,16,23
p_287,0,5,e_1,45,61,82,6,0,0,5,4,0,1,16,21,37
p_291,0,11,e_0,39,43,84,6,0,0,1,4,0,1,4,41,45
p_294,0,12,e_0,31,43,89,8,1,1,4,4,0,1,12,46,58
p_293,0,12,e_0,33,43,89,7,1,1,3,4,0,1,10,46,56
p_288,0,8,e_1,44,61,93,6,0,0,5,4,0,1,17,32,49
p_281,0,1,e_3,73,87,94,4,1,0,4,4,0,1,14,7,21
p_283,0,9,e_1,57,61,98,6,0,0,1,4,0,1,4,37,41
p_278,0,2,e_3,77,87,99,3,1,0,3,4,0,1,10,12,22
p_279,0,5,e_3,76,87,110,3,1,0,3,4,0,1,11,23,34
p_277,0,6,e_3,82,87,115,1,1,0,1,4,0,1,5,28,33
p_282,0,7,e_3,66,87,120,6,0,0,6,3,0,0,21,33,54
p_273,0,4,e_2,110,118,132,23,4,4,2,4,0,1,8,14,22
p_276,0,11,e_3,84,87,134,1,1,0,1,4,0,1,3,47,50
p_280,0,14,e_3,75,87,145,4,1,0,4,4,0,1,12,58,70
p_275,0,14,e_3,86,87,145,0,0,0,0,3,0,0,1,58,59
p_274,0,8,e_2,88,118,146,28,7,7,9,3,0,0,30,28,58
p_272,0,10,e_2,113,118,154,22,4,4,1,4,0,1,5,36,41
p_271,0,1,e_1,121,151,156,21,2,2,9,3,0,0,30,5,35
p_267,0,1,e_1,148,151,156,14,0,0,1,4,0,1,3,5,8
p_268,0,2,e_1,144,151,161,14,0,0,2,4,0,1,7,10,17
p_270,0,9,e_1,122,151,184,21,2,2,9,4,0,1,29,33,62
p_269,0,9,e_1,127,151,184,19,2,2,8,4,0,1,24,33,57
p_255,0,3,e_2,184,186,197,14,0,0,0,4,0,1,2,11,13
p_265,0,4,e_2,152,186,202,14,0,0,10,5,1,0,34,16,50
p_254,0,4,e_0,187,190,204,14,0,0,1,4,0,1,3,14,17
p_262,0,5,e_2,157,186,207,14,0,0,9,4,0,1,29,21,50
p_261,0,5,e_2,164,186,207,14,0,0,7,4,0,1,22,21,43
p_266,0,6,e_0,151,190,212,14,0,0,12,3,0,0,39,22,61
p_263,0,7,e_2,154,186,215,14,0,0,10,4,0,1,32,29,61
p_260,0,7,e_2,165,186,215,14,0,0,7,4,0,1,21,29,50
p_258,0,7,e_2,168,186,215,14,0,0,6,4,0,1,18,29,47
p_256,0,10,e_2,182,186,226,14,0,0,1,4,0,1,4,40,44
p_250,0,2,e_1,217,220,228,14,0,0,1,4,0,1,3,8,11
p_264,0,11,e_2,153,186,231,14,0,0,10,2,1,1,33,45,78
p_253,0,5,e_1,190,220,239,14,0,0,9,3,0,0,30,19,49
p_252,0,5,e_1,205,220,239,14,0,0,5,4,0,1,15,19,34
p_257,0,14,e_2,169,186,242,14,0,0,5,4,0,1,17,56,73
p_259,0,15,e_2,167,186,247,14,0,0,6,4,0,1,19,61,80
p_251,0,15,e_1,209,220,271,14,0,0,3,4,0,1,11,51,62
p_248,0,5,e_0,246,260,277,14,0,0,4,4,0,1,14,17,31
p_247,0,5,e_0,250,260,277,14,0,0,3,4,0,1,10,17,27
p_249,0,6,e_0,239,260,282,14,0,0,6,3,0,0,21,22,43
p_241,0,1,e_0,283,302,309,8,1,0,6,4,0,1,19,7,26
p_236,0,1,e_3,305,307,312,0,1,0,0,4,0,1,2,5,7
p_245,0,7,e_0,269,302,329,12,1,0,3,5,2,0,33,27,60
p_237,0,7,e_3,304,307,332,1,1,0,1,4,0,1,3,25,28
p_242,0,8,e_0,277,302,334,10,1,0,5,5,1,1,25,32,57
p_240,0,9,e_0,301,302,339,2,1,0,0,3,0,0,1,37,38
p_246,0,10,e_3,262,307,343,14,0,0,14,3,0,0,45,36,81
p_239,0,11,e_3,302,307,348,1,1,0,1,4,0,1,5,41,46
p_244,0,12,e_3,271,307,353,12,1,0,12,4,0,1,36,46,82
p_238,0,13,e_3,303,307,358,1,1,0,1,4,0,1,4,51,55
p_233,0,1,e_1,311,356,361,29,6,6,15,4,0,1,45,5,50
p_226,0,2,e_1,329,356,366,24,6,6,9,4,0,1,27,10,37
p_223,0,2,e_1,336,356,366,22,5,5,6,4,0,1,20,10,30
p_243,0,15,e_3,272,307,366,11,1,0,11,4,0,1,35,59,94
p_209,0,2,e_2,357,358,368,17,1,1,0,3,0,0,1,10,11
p_230,0,3,e_1,319,356,371,27,6,6,12,4,0,1,37,15,52
p_228,0,4,e_1,325,356,376,25,6,6,10,4,0,1,31,20,51
p_232,0,5,e_1,314,356,381,29,6,6,14,4,0,1,42,25,67
p_225,0,5,e_1,330,356,381,23,6,6,8,4,0,1,26,25,51
p_224,0,5,e_1,331,356,381,23,5,5,8,4,0,1,25,25,50
p_222,0,5,e_1,337,356,381,22,5,5,6,4,0,1,19,25,44
p_221,0,6,e_1,339,356,386,21,5,5,5,4,0,1,17,30,47
p_220,0,6,e_1,341,356,386,20,5,5,5,4,0,1,15,30,45
p_234,0,8,e_2,310,358,388,29,7,7,15,3,0,0,48,30,78
p_231,0,7,e_1,317,356,391,28,6,6,13,4,0,1,39,35,74
p_205,0,2,e_0,362,388,396,16,1,1,8,4,0,1,26,8,34
p_235,0,8,e_1,308,356,396,30,7,7,15,3,0,0,48,40,88
p_200,0,4,e_0,367,388,404,15,0,0,7,4,0,1,21,16,37
p_196,0,4,e_0,371,388,404,15,0,0,5,4,0,1,17,16,33
p_201,0,5,e_0,366,388,409,15,0,0,7,4,0,1,22,21,43
p_227,0,12,e_1,327,356,410,24,6,6,9,4,0,1,29,54,83
p_208,0,6,e_0,358,388,414,17,1,1,9,3,0,0,30,26,56
p_194,0,6,e_0,373,388,414,15,0,0,5,4,0,1,15,26,41
p_229,0,13,e_1,320,356,415,27,6,6,12,4,0,1,36,59,95
p_183,0,1,e_2,396,416,421,15,0,0,6,4,0,1,20,5,25
p_198,0,9,e_0,369,388,425,15,0,0,6,4,0,1,19,37,56
p_182,0,2,e_2,397,416,426,15,0,0,6,4,0,1,19,10,29
p_180,0,2,e_2,399,416,426,15,0,0,5,4,0,1,17,10,27
p_197,0,10,e_0,370,388,430,15,0,0,6,4,0,1,18,42,60
p_178,0,3,e_2,401,416,431,15,0,0,5,4,0,1,15,15,30
p_207,0,11,e_0,359,388,435,17,1,1,9,4,0,1,29,47,76
p_186,0,4,e_2,390,416,436,15,0,0,8,4,0,1,26,20,46
p_176,0,4,e_2,403,416,436,15,0,0,4,4,0,1,13,20,33
p_206,0,12,e_0,361,388,440,16,1,1,9,4,0,1,27,52,79
p_203,0,12,e_0,364,388,440,15,1,1,8,4,0,1,24,52,76
p_204,0,14,e_0,363,388,448,16,1,1,8,4,0,1,25,60,85
p_179,0,8,e_2,400,416,450,15,0,0,5,4,0,1,16,34,50
p_202,0,15,e_0,365,388,453,15,0,0,7,4,0,1,23,65,88
p_199,0,15,e_0,368,388,453,15,0,0,6,4,0,1,20,65,85
p_195,0,15,e_0,372,388,453,15,0,0,5,4,0,1,16,65,81
p_177,0,9,e_2,402,416,455,15,0,0,4,4,0,1,14,39,53
p_185,0,10,e_2,391,416,460,15,0,0,8,4,0,1,25,44,69
p_216,0,1,e_1,347,456,463,19,3,3,3,4,0,1,109,7,116
p_173,0,11,e_2,407,416,465,15,0,0,3,4,0,1,9,49,58
p_187,0,12,e_2,389,416,470,15,0,0,8,3,0,0,27,54,81
p_184,0,12,e_2,392,416,470,15,0,0,8,4,0,1,24,54,78
p_214,0,3,e_1,349,456,471,19,3,3,2,4,0,1,107,15,122
p_165,0,4,e_1,417,456,476,15,0,0,13,4,0,1,39,20,59
p_175,0,14,e_2,405,416,478,15,0,0,3,4,0,1,11,62,73
p_174,0,14,e_2,406,416,478,15,0,0,3,4,0,1,10,62,72
p_219,0,5,e_1,342,456,481,20,4,4,4,4,0,1,114,25,139
p_181,0,15,e_2,398,416,483,15,0,0,6,4,0,1,18,67,85
p_210,0,6,e_1,354,456,486,18,2,2,0,4,0,1,102,30,132
p_217,0,7,e_1,346,456,491,19,4,4,3,4,0,1,110,35,145
p_212,0,7,e_1,351,456,491,18,3,3,1,4,0,1,105,35,140
p_163,0,10,e_1,419,456,502,15,0,0,12,4,0,1,37,46,83
p_190,0,1,e_0,379,500,507,15,0,0,3,4,0,1,121,7,128
p_218,0,11,e_1,343,456,507,20,4,4,4,4,0,1,113,51,164
p_164,0,11,e_1,418,456,507,15,0,0,12,4,0,1,38,51,89
p_162,0,11,e_1,420,456,507,15,0,0,12,4,0,1,36,51,87
p_166,0,12,e_1,416,456,512,15,0,0,13,4,0,1,40,56,96
p_143,0,3,e_0,456,500,515,15,0,0,14,4,0,1,44,15,59
p_136,0,3,e_0,465,500,515,15,0,0,11,4,0,1,35,15,50
p_137,0,4,e_0,464,500,520,15,0,0,12,4,0,1,36,20,56
p_215,0,15,e_1,348,456,523,19,3,3,2,4,0,1,108,67,175
p_213,0,15,e_1,350,456,523,19,3,3,2,4,0,1,106,67,173
p_211,0,15,e_1,353,456,523,18,2,2,1,4,0,1,103,67,170
p_141,0,6,e_0,458,500,528,15,0,0,14,4,0,1,42,28,70
p_167,0,1,e_2,413,530,535,15,0,0,1,4,0,1,117,5,122
p_192,0,8,e_0,375,500,536,15,0,0,4,4,0,1,125,36,161
p_189,0,8,e_0,382,500,536,15,0,0,2,4,0,1,118,36,154
p_140,0,8,e_0,459,500,536,15,0,0,13,4,0,1,41,36,77
p_142,0,9,e_0,457,500,541,15,0,0,14,4,0,1,43,41,84
p_106,0,3,e_2,500,530,543,15,0,0,10,4,0,1,30,13,43
p_191,0,10,e_0,376,500,546,15,0,0,4,4,0,1,124,46,170
p_139,0,10,e_0,461,500,546,15,0,0,13,4,0,1,39,46,85
p_135,0,10,e_0,466,500,546,15,0,0,11,4,0,1,34,46,80
p_193,0,11,e_0,374,500,551,15,0,0,4,4,0,1,126,51,177
p_138,0,11,e_0,463,500,551,15,0,0,12,4,0,1,37,51,88
p_99,0,6,e_2,514,530,554,15,0,0,5,4,0,1,16,24,40
p_188,0,13,e_0,384,500,559,15,0,0,1,4,0,1,116,59,175
p_102,0,7,e_2,509,530,559,15,0,0,7,4,0,1,21,29,50
p_98,0,7,e_2,515,530,559,15,0,0,5,4,0,1,15,29,44
p_101,0,8,e_2,511,530,564,15,0,0,6,4,0,1,19,34,53
p_169,0,9,e_2,411,530,569,15,0,0,1,4,0,1,119,39,158
p_100,0,9,e_2,513,530,569,15,0,0,5,4,0,1,17,39,56
p_161,0,1,e_1,421,570,577,15,0,0,11,4,0,1,149,7,156
p_158,0,1,e_1,430,570,577,15,0,0,8,4,0,1,140,7,147
p_103,0,11,e_2,508,530,577,15,0,0,7,4,0,1,22,47,69
p_105,0,12,e_2,502,530,582,15,0,0,9,4,0,1,28,52,80
p_171,0,13,e_2,409,530,587,15,0,0,2,4,0,1,121,57,178
p_168,0,13,e_2,412,530,587,15,0,0,1,4,0,1,118,57,175
p_170,0,14,e_2,410,530,592,15,0,0,2,4,0,1,120,62,182
p_104,0,14,e_2,503,530,592,15,0,0,9,4,0,1,27,62,89
p_159,0,6,e_1,429,570,594,15,0,0,9,4,0,1,141,24,165
p_150,0,6,e_1,443,570,594,15,0,0,4,4,0,1,127,24,151
p_172,0,15,e_2,408,530,597,15,0,0,2,4,0,1,122,67,189
p_154,0,7,e_1,436,570,599,15,0,0,6,4,0,1,134,29,163
p_148,0,8,e_1,449,570,604,15,0,0,2,4,0,1,121,34,155
p_130,0,1,e_0,472,600,605,15,0,0,9,4,0,1,128,5,133
p_153,0,9,e_1,437,570,609,15,0,0,6,4,0,1,133,39,172
p_147,0,9,e_1,452,570,609,15,0,0,1,4,0,1,118,39,157
p_129,0,3,e_0,473,600,613,15,0,0,9,4,0,1,127,13,140
p_157,0,14,e_1,431,570,626,15,0,0,8,4,0,1,139,56,195
p_155,0,14,e_1,435,570,626,15,0,0,7,4,0,1,135,56,191
p_124,0,7,e_0,478,600,627,15,0,0,7,4,0,1,122,27,149
p_160,0,15,e_1,426,570,631,15,0,0,10,4,0,1,144,61,205
p_156,0,15,e_1,434,570,631,15,0,0,7,4,0,1,136,61,197
p_152,0,15,e_1,441,570,631,15,0,0,5,4,0,1,129,61,190
p_151,0,15,e_1,442,570,631,15,0,0,4,4,0,1,128,61,189
p_149,0,15,e_1,444,570,631,15,0,0,4,4,0,1,126,61,187
p_127,0,10,e_0,475,600,638,15,0,0,8,4,0,1,125,38,163
p_132,0,11,e_0,470,600,643,15,0,0,10,4,0,1,130,43,173
p_128,0,11,e_0,474,600,643,15,0,0,8,4,0,1,126,43,169
p_123,0,11,e_0,479,600,643,15,0,0,7,4,0,1,121,43,164
p_121,0,11,e_0,481,600,643,15,0,0,6,4,0,1,119,43,162
p_120,0,11,e_0,482,600,643,15,0,0,6,4,0,1,118,43,161
p_133,0,12,e_0,469,600,648,15,0,0,10,4,0,1,131,48,179
p_126,0,12,e_0,476,600,648,15,0,0,8,4,0,1,124,48,172
p_96,0,1,e_2,517,644,649,15,0,0,4,4,0,1,127,5,132
p_131,0,14,e_0,471,600,656,15,0,0,9,4,0,1,129,56,185
p_125,0,14,e_0,477,600,656,15,0,0,7,4,0,1,123,56,179
p_92,0,4,e_2,525,644,660,15,0,0,1,4,0,1,119,16,135
p_134,0,15,e_0,467,600,661,15,0,0,11,4,0,1,133,61,194
p_122,0,15,e_0,480,600,661,15,0,0,6,4,0,1,120,61,181
p_94,0,6,e_2,519,644,668,15,0,0,3,4,0,1,125,24,149
p_97,0,7,e_2,516,644,673,15,0,0,4,4,0,1,128,29,157
p_37,0,9,e_2,615,644,681,15,0,0,9,4,0,1,29,37,66
p_35,0,9,e_2,630,644,681,15,0,0,4,4,0,1,14,37,51
p_146,0,1,e_1,453,678,685,15,0,0,1,4,0,1,225,7,232
p_41,0,11,e_2,600,644,689,15,0,0,14,4,0,1,44,45,89
p_86,0,2,e_1,544,678,690,15,0,0,8,4,0,1,134,12,146
p_91,0,12,e_2,526,644,694,15,0,0,1,4,0,1,118,50,168
p_39,0,12,e_2,607,644,694,15,0,0,12,4,0,1,37,50,87
p_93,0,13,e_2,520,644,699,15,0,0,3,4,0,1,124,55,179
p_90,0,13,e_2,527,644,699,15,0,0,1,4,0,1,117,55,172
p_40,0,13,e_2,602,644,699,15,0,0,14,4,0,1,42,55,97
p_38,0,13,e_2,608,644,699,15,0,0,12,4,0,1,36,55,91
p_36,0,13,e_2,628,644,699,15,0,0,5,4,0,1,16,55,71
p_88,0,5,e_1,538,678,701,15,0,0,10,4,0,1,140,23,163
p_95,0,14,e_2,518,644,704,15,0,0,4,4,0,1,126,60,186
p_80,0,7,e_1,552,678,709,15,0,0,6,4,0,1,126,31,157
p_119,0,1,e_0,483,708,713,15,0,0,5,4,0,1,225,5,230
p_113,0,1,e_0,489,708,713,15,0,0,3,4,0,1,219,5,224
p_65,0,1,e_0,573,708,713,15,0,0,9,4,0,1,135,5,140
p_87,0,8,e_1,539,678,714,15,0,0,10,4,0,1,139,36,175
p_83,0,8,e_1,549,678,714,15,0,0,7,4,0,1,129,36,165
p_144,0,9,e_1,455,678,719,15,0,0,0,3,0,0,223,41,264
p_89,0,9,e_1,535,678,719,15,0,0,11,4,0,1,143,41,184
p_114,0,3,e_0,488,708,721,15,0,0,4,4,0,1,220,13,233
p_64,0,4,e_0,574,708,726,15,0,0,8,4,0,1,134,18,152
p_145,0,11,e_1,454,678,727,15,0,0,0,4,0,1,224,49,273
p_84,0,12,e_1,546,678,732,15,0,0,8,4,0,1,132,54,186
p_78,0,12,e_1,556,678,732,15,0,0,4,4,0,1,122,54,176
p_108,0,6,e_0,496,708,734,15,0,0,1,4,0,1,212,26,238
p_118,0,7,e_0,484,708,739,15,0,0,5,4,0,1,224,31,255
p_82,0,14,e_1,550,678,740,15,0,0,6,4,0,1,128,62,190
p_81,0,14,e_1,551,678,740,15,0,0,6,4,0,1,127,62,189
p_79,0,14,e_1,553,678,740,15,0,0,5,4,0,1,125,62,187
p_111,0,8,e_0,491,708,744,15,0,0,3,4,0,1,217,36,253
p_85,0,15,e_1,545,678,745,15,0,0,8,4,0,1,133,67,200
p_115,0,9,e_0,487,708,749,15,0,0,4,4,0,1,221,41,262
p_117,0,10,e_0,485,708,754,15,0,0,5,4,0,1,223,46,269
p_116,0,10,e_0,486,708,754,15,0,0,4,4,0,1,222,46,268
p_112,0,11,e_0,490,708,759,15,0,0,3,4,0,1,218,51,269
p_110,0,11,e_0,492,708,759,15,0,0,2,4,0,1,216,51,267
p_107,0,11,e_0,499,708,759,15,0,0,0,3,0,0,209,51,260
p_22,0,3,e_2,719,756,767,15,0,0,12,4,0,1,37,11,48
p_21,0,4,e_2,731,756,772,15,0,0,8,4,0,1,25,16,41
p_109,0,15,e_0,493,708,773,15,0,0,2,4,0,1,215,65,280
p_19,0,11,e_2,754,756,795,15,0,0,0,4,0,1,2,39,41
p_23,0,12,e_2,711,756,800,15,0,0,14,3,0,0,45,44,89
p_77,0,3,e_1,557,792,803,15,0,0,4,4,0,1,235,11,246
p_72,0,3,e_1,562,792,803,15,0,0,2,4,0,1,230,11,241
p_71,0,3,e_1,564,792,803,15,0,0,2,4,0,1,228,11,239
p_70,0,3,e_1,565,792,803,15,0,0,1,4,0,1,227,11,238
p_67,0,3,e_1,568,792,803,15,0,0,0,4,0,1,224,11,235
p_66,0,3,e_1,569,792,803,15,0,0,0,3,0,0,223,11,234
p_20,0,14,e_2,734,756,808,15,0,0,7,4,0,1,22,52,74
p_75,0,5,e_1,559,792,811,15,0,0,3,4,0,1,233,19,252
p_76,0,6,e_1,558,792,816,15,0,0,4,4,0,1,234,24,258
p_32,0,6,e_1,650,792,816,15,0,0,9,4,0,1,142,24,166
p_74,0,7,e_1,560,792,821,15,0,0,3,4,0,1,232,29,261
p_55,0,3,e_0,585,820,831,15,0,0,5,4,0,1,235,11,246
p_54,0,3,e_0,586,820,831,15,0,0,4,4,0,1,234,11,245
p_52,0,3,e_0,588,820,831,15,0,0,4,4,0,1,232,11,243
p_73,0,11,e_1,561,792,835,15,0,0,3,4,0,1,231,43,274
p_34,0,12,e_1,646,792,840,15,0,0,10,4,0,1,146,48,194
p_61,0,6,e_0,579,820,842,15,0,0,7,4,0,1,241,22,263
p_56,0,6,e_0,584,820,842,15,0,0,5,4,0,1,236,22,258
p_68,0,13,e_1,567,792,845,15,0,0,1,4,0,1,225,53,278
p_50,0,7,e_0,590,820,847,15,0,0,3,4,0,1,230,27,257
p_69,0,14,e_1,566,792,850,15,0,0,1,4,0,1,226,58,284
p_53,0,9,e_0,587,820,855,15,0,0,4,4,0,1,233,35,268
p_51,0,9,e_0,589,820,855,15,0,0,3,4,0,1,231,35,266
p_33,0,15,e_1,649,792,855,15,0,0,9,4,0,1,143,63,206
p_60,0,10,e_0,580,820,860,15,0,0,6,4,0,1,240,40,280
p_58,0,11,e_0,582,820,865,15,0,0,6,4,0,1,238,45,283
p_57,0,11,e_0,583,820,865,15,0,0,5,4,0,1,237,45,282
p_63,0,13,e_0,577,820,873,15,0,0,7,4,0,1,243,53,296
p_62,0,13,e_0,578,820,873,15,0,0,7,4,0,1,242,53,295
p_59,0,14,e_0,581,820,878,15,0,0,6,4,0,1,239,58,297
p_49,0,14,e_0,591,820,878,15,0,0,3,4,0,1,229,58,287
p_9,0,2,e_2,846,880,888,15,0,0,11,4,0,1,34,8,42
p_6,0,3,e_2,877,880,893,15,0,0,1,4,0,1,3,13,16
p_7,0,5,e_2,875,880,901,15,0,0,1,4,0,1,5,21,26
p_4,0,1,e_1,886,902,907,15,0,0,5,4,0,1,16,5,21
p_16,0,2,e_1,780,902,912,15,0,0,4,4,0,1,122,10,132
p_10,0,8,e_2,835,880,912,15,0,0,14,3,0,0,45,32,77
p_30,0,3,e_1,668,902,917,15,0,0,3,4,0,1,234,15,249
p_8,0,11,e_2,874,880,923,15,0,0,2,4,0,1,6,43,49
p_29,0,5,e_1,670,902,925,15,0,0,2,4,0,1,232,23,255
p_1,0,5,e_1,894,902,925,15,0,0,2,4,0,1,8,23,31
p_45,0,2,e_0,595,922,930,15,0,0,1,4,0,1,327,8,335
p_24,0,2,e_0,695,922,930,15,0,0,4,4,0,1,227,8,235
p_31,0,6,e_1,666,902,930,15,0,0,4,4,0,1,236,28,264
p_48,0,4,e_0,592,922,938,15,0,0,2,4,0,1,330,16,346
p_46,0,4,e_0,594,922,938,15,0,0,2,4,0,1,328,16,344
p_14,0,4,e_0,794,922,938,15,0,0,8,4,0,1,128,16,144
p_5,0,8,e_1,883,902,938,15,0,0,6,4,0,1,19,36,55
p_3,0,8,e_1,888,902,938,15,0,0,4,4,0,1,14,36,50
p_42,0,6,e_0,598,922,946,15,0,0,0,4,0,1,324,24,348
p_27,0,10,e_1,677,902,946,15,0,0,0,3,0,0,225,44,269
p_18,0,10,e_1,766,902,946,15,0,0,8,4,0,1,136,44,180
p_17,0,10,e_1,776,902,946,15,0,0,5,4,0,1,126,44,170
p_43,0,7,e_0,597,922,951,15,0,0,1,4,0,1,325,29,354
p_28,0,11,e_1,676,902,951,15,0,0,0,4,0,1,226,49,275
p_2,0,11,e_1,892,902,951,15,0,0,3,4,0,1,10,49,59
p_44,0,8,e_0,596,922,956,15,0,0,1,4,0,1,326,34,360
p_26,0,8,e_0,684,922,956,15,0,0,8,4,0,1,238,34,272
p_25,0,8,e_0,686,922,956,15,0,0,7,4,0,1,236,34,270
p_47,0,9,e_0,593,922,961,15,0,0,2,4,0,1,329,39,368
p_15,0,9,e_0,793,922,961,15,0,0,9,4,0,1,129,39,168
p_11,0,9,e_0,807,922,961,15,0,0,4,4,0,1,115,39,154
p_13,0,11,e_0,796,922,969,15,0,0,8,4,0,1,126,47,173
p_12,0,11,e_0,798,922,969,15,0,0,7,4,0,1,124,47,171
p_300,0,4,e_0,8,9,25,0,0,0,0,3,0,0,1,16,17
p_299,0,5,e_1,9,10,29,0,0,0,0,3,0,0,1,19,20
p_297,0,6,e_3,15,16,38,0,0,0,0,3,0,0,1,22,23
p_298,0,9,e_2,11,12,43,0,0,0,0,3,0,0,1,31,32
p_296,0,4,e_0,28,43,57,9,1,1,4,3,0,0,15,14,29
p_286,0,3,e_1,46,47,60,6,0,0,0,3,0,0,1,13,14
p_292,0,6,e_0,38,43,65,6,0,0,1,4,0,1,5,22,27
p_290,0,6,e_0,40,43,65,6,0,0,1,4,0,1,3,22,25
p_289,0,4,e_1,43,47,65,6,0,0,1,4,0,1,4,18,22
p_295,0,5,e_1,29,47,70,9,1,1,5,3,0,0,18,23,41
p_287,0,5,e_1,45,47,70,6,0,0,0,4,0,1,2,23,25
p_288,0,8,e_1,44,47,81,6,0,0,1,4,0,1,3,34,37
p_281,0,1,e_3,73,74,81,0,0,0,0,3,0,0,1,7,8
p_291,0,11,e_0,39,43,82,6,0,0,1,4,0,1,4,39,43
p_294,0,12,e_0,31,43,87,8,1,1,4,4,0,1,12,44,56
p_293,0,12,e_0,33,43,87,7,1,1,3,4,0,1,10,44,54
p_285,0,4,e_3,53,74,92,6,0,0,6,3,0,0,21,18,39
p_284,0,4,e_3,54,74,92,6,1,0,6,4,0,1,20,18,38
p_282,0,7,e_3,66,74,103,2,1,0,2,4,0,1,8,29,37
p_283,0,9,e_3,57,74,111,5,1,0,5,4,0,1,17,37,54
p_278,0,2,e_2,77,105,113,18,4,4,9,4,0,1,28,8,36
p_279,0,5,e_2,76,105,124,18,4,4,9,4,0,1,29,19,48
p_277,0,6,e_1,82,109,129,17,3,3,8,3,0,0,27,20,47
p_274,0,8,e_2,88,105,135,15,3,3,5,4,0,1,17,30,47
p_271,0,1,e_3,121,140,145,6,1,0,6,4,0,1,19,5,24
p_276,0,11,e_2,84,105,146,16,3,3,7,4,0,1,21,41,62
p_273,0,4,e_3,110,140,156,9,0,0,9,2,1,0,30,16,46
p_280,0,14,e_2,75,105,157,18,4,4,9,3,0,0,30,52,82
p_275,0,14,e_2,86,105,157,16,3,3,6,4,0,1,19,52,71
p_267,0,1,e_1,148,165,172,18,3,3,5,4,0,1,17,7,24
p_270,0,9,e_3,122,140,173,6,1,0,6,4,0,1,18,33,51
p_269,0,9,e_3,127,140,173,4,1,0,4,4,0,1,13,33,46
p_268,0,2,e_1,144,165,177,19,3,3,6,3,0,0,21,12,33
p_272,0,10,e_3,113,140,178,9,1,0,9,4,0,1,27,38,65
p_265,0,4,e_1,152,165,185,17,3,3,4,4,0,1,13,20,33
p_262,0,5,e_1,157,165,190,16,2,2,2,4,0,1,8,25,33
p_261,0,5,e_1,164,165,190,14,2,2,0,3,0,0,1,25,26
p_266,0,6,e_1,151,165,195,17,3,3,4,4,0,1,14,30,44
p_263,0,7,e_1,154,165,200,16,3,3,3,4,0,1,11,35,46
p_264,0,11,e_1,153,165,214,17,3,3,4,4,0,1,12,49,61
p_255,0,3,e_0,184,204,215,10,0,0,6,4,0,1,20,11,31
p_254,0,4,e_0,187,204,220,10,0,0,5,4,0,1,17,16,33
p_253,0,5,e_0,190,204,225,10,0,0,4,4,0,1,14,21,35
p_260,0,7,e_0,165,204,233,13,2,2,12,3,0,0,39,29,68
p_258,0,7,e_0,168,204,233,12,2,2,12,4,0,1,36,29,65
p_256,0,10,e_0,182,204,244,10,0,0,7,4,0,1,22,40,62
p_250,0,2,e_3,217,238,246,7,1,0,7,4,0,1,21,8,29
p_252,0,5,e_3,205,238,257,10,0,0,10,3,0,0,33,19,52
p_257,0,14,e_0,169,204,258,12,2,2,11,4,0,1,35,54,89
p_259,0,15,e_0,167,204,263,13,2,2,12,4,0,1,37,59,96
p_251,0,15,e_3,209,238,289,9,1,0,9,4,0,1,29,51,80
p_248,0,5,e_1,246,275,292,28,2,2,9,4,0,1,29,17,46
p_247,0,5,e_1,250,275,292,27,2,2,8,4,0,1,25,17,42
p_249,0,6,e_1,239,275,297,30,3,3,11,3,0,0,36,22,58
p_245,0,7,e_1,269,275,302,21,1,1,2,4,0,1,6,27,33
p_246,0,10,e_1,262,275,313,24,1,1,4,4,0,1,13,38,51
p_244,0,12,e_1,271,275,321,21,1,1,1,4,0,1,4,46,50
p_241,0,1,e_2,283,322,327,17,1,1,13,4,0,1,39,5,44
p_236,0,1,e_2,305,322,327,15,0,0,5,4,0,1,17,5,22
p_233,0,1,e_2,311,322,327,15,0,0,3,4,0,1,11,5,16
p_243,0,15,e_1,272,275,332,20,1,1,1,4,0,1,3,57,60
p_230,0,3,e_2,319,322,335,15,0,0,1,4,0,1,3,13,16
p_232,0,5,e_2,314,322,343,15,0,0,2,4,0,1,8,21,29
p_237,0,7,e_2,304,322,351,15,0,0,6,4,0,1,18,29,47
p_231,0,7,e_2,317,322,351,15,0,0,1,4,0,1,5,29,34
p_242,0,8,e_2,277,322,356,19,1,1,14,3,0,0,45,34,79
p_235,0,8,e_2,308,322,356,15,0,0,4,4,0,1,14,34,48
p_234,0,8,e_2,310,322,356,15,0,0,4,4,0,1,12,34,46
p_240,0,9,e_2,301,322,361,15,0,0,7,4,0,1,21,39,60
p_239,0,11,e_2,302,322,369,15,0,0,6,4,0,1,20,47,67
p_238,0,13,e_2,303,322,377,15,0,0,6,4,0,1,19,55,74
p_229,0,13,e_2,320,322,377,15,0,0,0,4,0,1,2,55,57
p_216,0,1,e_0,347,373,380,9,1,0,8,4,0,1,26,7,33
p_226,0,2,e_0,329,373,385,15,1,0,14,4,0,1,44,12,56
p_223,0,2,e_0,336,373,385,13,1,0,12,4,0,1,37,12,49
p_214,0,3,e_0,349,373,390,8,1,0,8,4,0,1,24,17,41
p_228,0,4,e_0,325,373,395,15,0,0,15,3,0,0,48,22,70
p_224,0,5,e_1,331,379,396,14,1,0,15,2,1,0,48,17,65
p_194,0,6,e_3,373,375,397,0,1,0,0,4,0,1,2,22,24
p_225,0,5,e_0,330,373,400,15,1,0,14,4,0,1,43,27,70
p_222,0,5,e_0,337,373,400,12,1,0,12,4,0,1,36,27,63
p_219,0,5,e_0,342,373,400,11,1,0,10,4,0,1,31,27,58
p_221,0,6,e_0,339,373,405,12,1,0,11,4,0,1,34,32,66
p_220,0,6,e_0,341,373,405,11,1,0,10,4,0,1,32,32,64
p_192,0,8,e_1,375,379,407,24,4,4,1,4,0,1,4,28,32
p_217,0,7,e_0,346,373,410,9,1,0,9,4,0,1,27,37,64
p_212,0,7,e_0,351,373,410,8,1,0,7,4,0,1,22,37,59
p_193,0,11,e_3,374,375,414,0,0,0,0,3,0,0,1,39,40
p_191,0,10,e_1,376,379,415,24,3,3,1,4,0,1,3,36,39
p_227,0,12,e_3,327,375,419,15,0,0,15,3,0,0,48,44,92
p_218,0,11,e_0,343,373,424,10,1,0,10,4,0,1,30,51,81
p_190,0,1,e_2,379,421,428,24,3,3,13,3,0,0,42,7,49
p_183,0,1,e_2,396,421,428,18,2,2,8,4,0,1,25,7,32
p_182,0,2,e_2,397,421,433,18,2,2,8,4,0,1,24,12,36
p_180,0,2,e_2,399,421,433,18,2,2,7,4,0,1,22,12,34
p_215,0,15,e_0,348,373,438,9,1,0,8,4,0,1,25,65,90
p_213,0,15,e_0,350,373,438,8,1,0,7,4,0,1,23,65,88
p_178,0,3,e_2,401,421,438,17,2,2,6,4,0,1,20,17,37
p_186,0,4,e_2,390,421,443,20,3,3,10,4,0,1,31,22,53
p_176,0,4,e_2,403,421,443,16,2,2,6,4,0,1,18,22,40
p_189,0,8,e_2,382,421,457,23,3,3,13,4,0,1,39,36,75
p_179,0,8,e_2,400,421,457,17,2,2,7,4,0,1,21,36,57
p_161,0,1,e_1,421,454,461,12,0,0,10,3,0,0,33,7,40
p_158,0,1,e_1,430,454,461,12,0,0,8,4,0,1,24,7,31
p_177,0,9,e_2,402,421,462,17,2,2,6,4,0,1,19,41,60
p_185,0,10,e_2,391,421,467,20,3,3,10,4,0,1,30,46,76
p_187,0,12,e_2,389,421,475,20,3,3,10,4,0,1,32,54,86
p_184,0,12,e_2,392,421,475,19,3,3,9,4,0,1,29,54,83
p_159,0,6,e_1,429,454,478,12,0,0,8,4,0,1,25,24,49
p_150,0,6,e_1,443,454,478,12,0,0,3,4,0,1,11,24,35
p_188,0,13,e_2,384,421,480,22,3,3,12,4,0,1,37,59,96
p_154,0,7,e_1,436,454,483,12,0,0,6,4,0,1,18,29,47
p_148,0,8,e_1,449,454,488,12,0,0,1,4,0,1,5,34,39
p_181,0,15,e_2,398,421,488,18,2,2,7,4,0,1,23,67,90
p_153,0,9,e_1,437,454,493,12,0,0,5,4,0,1,17,39,56
p_147,0,9,e_1,452,454,493,12,0,0,0,4,0,1,2,39,41
p_209,0,2,e_0,357,485,495,6,1,0,5,4,0,1,128,10,138
p_205,0,2,e_0,362,485,495,4,1,0,3,4,0,1,123,10,133
p_200,0,4,e_0,367,485,503,2,1,0,2,4,0,1,118,18,136
p_201,0,5,e_0,366,485,508,3,1,0,2,4,0,1,119,23,142
p_157,0,14,e_1,431,454,510,12,0,0,7,4,0,1,23,56,79
p_155,0,14,e_1,435,454,510,12,0,0,6,4,0,1,19,56,75
p_210,0,6,e_0,354,485,513,7,1,0,6,4,0,1,131,28,159
p_208,0,6,e_0,358,485,513,5,1,0,5,4,0,1,127,28,155
p_160,0,15,e_1,426,454,515,12,0,0,9,4,0,1,28,61,89
p_156,0,15,e_1,434,454,515,12,0,0,6,4,0,1,20,61,81
p_152,0,15,e_1,441,454,515,12,0,0,4,4,0,1,13,61,74
p_151,0,15,e_1,442,454,515,12,0,0,4,4,0,1,12,61,73
p_149,0,15,e_1,444,454,515,12,0,0,3,4,0,1,10,61,71
p_198,0,9,e_0,369,485,524,2,1,0,1,4,0,1,116,39,155
p_197,0,10,e_0,370,485,529,1,1,0,1,4,0,1,115,44,159
p_113,0,1,e_3,489,524,529,11,1,0,11,4,0,1,35,5,40
p_207,0,11,e_0,359,485,534,5,1,0,4,4,0,1,126,49,175
p_114,0,3,e_3,488,524,537,12,1,0,12,4,0,1,36,13,49
p_106,0,3,e_3,500,524,537,8,1,0,8,4,0,1,24,13,37
p_206,0,12,e_0,361,485,539,4,1,0,4,4,0,1,124,54,178
p_203,0,12,e_0,364,485,539,3,1,0,3,4,0,1,121,54,175
p_167,0,1,e_2,413,535,540,13,1,1,2,4,0,1,122,5,127
p_204,0,14,e_0,363,485,547,4,1,0,3,4,0,1,122,62,184
p_108,0,6,e_3,496,524,548,9,1,0,9,4,0,1,28,24,52
p_165,0,4,e_2,417,535,551,12,1,1,1,4,0,1,118,16,134
p_92,0,4,e_2,525,535,551,30,10,10,3,4,0,1,10,16,26
p_211,0,15,e_0,353,485,552,7,1,0,6,4,0,1,132,67,199
p_202,0,15,e_0,365,485,552,3,1,0,2,4,0,1,120,67,187
p_199,0,15,e_0,368,485,552,2,1,0,1,4,0,1,117,67,184
p_111,0,8,e_3,491,524,556,11,1,0,11,4,0,1,33,32,65
p_115,0,9,e_3,487,524,561,12,1,0,12,4,0,1,37,37,74
p_117,0,10,e_3,485,524,566,12,0,0,12,3,0,0,39,42,81
p_116,0,10,e_3,486,524,566,12,1,0,12,4,0,1,38,42,80
p_169,0,9,e_2,411,535,568,14,2,2,3,4,0,1,124,33,157
p_146,0,1,e_1,453,562,569,12,0,0,0,3,0,0,109,7,116
p_112,0,11,e_3,490,524,571,11,1,0,11,4,0,1,34,47,81
p_110,0,11,e_3,492,524,571,10,1,0,10,4,0,1,32,47,79
p_107,0,11,e_3,499,524,571,8,1,0,8,4,0,1,25,47,72
p_103,0,11,e_3,508,524,571,5,1,0,5,4,0,1,16,47,63
p_163,0,10,e_2,419,535,573,12,0,0,0,4,0,1,116,38,154
p_86,0,2,e_1,544,562,574,25,9,9,6,4,0,1,18,12,30
p_105,0,12,e_3,502,524,576,7,1,0,7,4,0,1,22,52,74
p_173,0,11,e_2,407,535,578,15,2,2,4,4,0,1,128,43,171
p_164,0,11,e_2,418,535,578,12,0,0,1,4,0,1,117,43,160
p_162,0,11,e_2,420,535,578,12,0,0,0,3,0,0,115,43,158
p_77,0,3,e_1,557,562,579,22,7,7,1,4,0,1,5,17,22
p_166,0,12,e_2,416,535,583,13,1,1,1,4,0,1,119,48,167
p_104,0,14,e_3,503,524,584,7,1,0,7,4,0,1,21,60,81
p_88,0,5,e_1,538,562,587,27,9,9,8,4,0,1,24,25,49
p_171,0,13,e_2,409,535,588,14,2,2,4,4,0,1,126,53,179
p_168,0,13,e_2,412,535,588,13,2,2,3,4,0,1,123,53,176
p_109,0,15,e_3,493,524,589,10,1,0,10,4,0,1,31,65,96
p_76,0,6,e_1,558,562,592,22,7,7,1,4,0,1,4,30,34
p_175,0,14,e_2,405,535,593,16,2,2,5,4,0,1,130,58,188
p_174,0,14,e_2,406,535,593,15,2,2,5,4,0,1,129,58,187
p_170,0,14,e_2,410,535,593,14,2,2,3,4,0,1,125,58,183
p_80,0,7,e_1,552,562,597,23,8,8,3,4,0,1,10,35,45
p_172,0,15,e_2,408,535,598,15,2,2,4,4,0,1,127,63,190
p_87,0,8,e_1,539,562,602,27,9,9,7,4,0,1,23,40,63
p_83,0,8,e_1,549,562,602,24,8,8,4,4,0,1,13,40,53
p_89,0,9,e_1,535,562,607,27,10,10,9,4,0,1,27,45,72
p_143,0,3,e_0,456,599,612,12,0,0,9,4,0,1,143,13,156
p_136,0,3,e_0,465,599,612,12,0,0,6,4,0,1,134,13,147
p_196,0,4,e_0,371,599,617,1,1,0,0,4,0,1,228,18,246
p_137,0,4,e_0,464,599,617,12,0,0,7,4,0,1,135,18,153
p_84,0,12,e_1,546,562,618,24,9,9,5,4,0,1,16,56,72
p_78,0,12,e_1,556,562,618,22,7,7,2,4,0,1,6,56,62
p_141,0,6,e_0,458,599,625,12,0,0,9,4,0,1,141,26,167
p_82,0,14,e_1,550,562,626,24,8,8,4,4,0,1,12,64,76
p_81,0,14,e_1,551,562,626,23,8,8,3,4,0,1,11,64,75
p_79,0,14,e_1,553,562,626,23,8,8,3,4,0,1,9,64,73
p_85,0,15,e_1,545,562,631,25,9,9,5,4,0,1,17,69,86
p_140,0,8,e_0,459,599,633,12,0,0,8,4,0,1,140,34,174
p_144,0,9,e_0,455,599,638,12,0,0,10,4,0,1,144,39,183
p_142,0,9,e_0,457,599,638,12,0,0,9,4,0,1,142,39,181
p_96,0,1,e_3,517,636,641,2,1,0,2,4,0,1,119,5,124
p_139,0,10,e_0,461,599,643,12,0,0,8,4,0,1,138,44,182
p_135,0,10,e_0,466,599,643,12,0,0,6,4,0,1,133,44,177
p_145,0,11,e_0,454,599,648,12,0,0,10,4,0,1,145,49,194
p_138,0,11,e_0,463,599,648,12,0,0,7,4,0,1,136,49,185
p_133,0,12,e_0,469,599,653,12,0,0,5,4,0,1,130,54,184
p_99,0,6,e_3,514,636,658,3,1,0,3,4,0,1,122,22,144
p_94,0,6,e_3,519,636,658,1,1,0,1,4,0,1,117,22,139
p_102,0,7,e_3,509,636,663,5,1,0,5,4,0,1,127,27,154
p_98,0,7,e_3,515,636,663,3,1,0,3,4,0,1,121,27,148
p_97,0,7,e_3,516,636,663,2,1,0,2,4,0,1,120,27,147
p_195,0,15,e_0,372,599,664,1,1,0,0,3,0,0,227,65,292
p_134,0,15,e_0,467,599,664,12,0,0,6,4,0,1,132,65,197
p_101,0,8,e_3,511,636,668,4,1,0,4,4,0,1,125,32,157
p_100,0,9,e_3,513,636,673,3,1,0,3,4,0,1,123,37,160
p_37,0,9,e_3,615,636,673,7,1,0,7,4,0,1,21,37,58
p_41,0,11,e_3,600,636,681,12,1,0,12,4,0,1,36,45,81
p_91,0,12,e_2,526,645,683,30,10,10,3,4,0,1,119,38,157
p_39,0,12,e_3,607,636,686,9,1,0,9,4,0,1,29,50,79
p_90,0,13,e_2,527,645,688,29,11,11,2,4,0,1,118,43,161
p_30,0,3,e_1,668,678,691,20,6,6,3,4,0,1,10,13,23
p_93,0,13,e_3,520,636,691,1,1,0,1,4,0,1,116,55,171
p_40,0,13,e_3,602,636,691,11,1,0,11,4,0,1,34,55,89
p_38,0,13,e_3,608,636,691,9,1,0,9,4,0,1,28,55,83
p_95,0,14,e_3,518,636,696,2,1,0,2,4,0,1,118,60,178
p_75,0,5,e_1,559,678,699,21,7,7,1,4,0,1,119,21,140
p_29,0,5,e_1,670,678,699,20,6,6,2,4,0,1,8,21,29
p_32,0,6,e_1,650,678,704,24,9,9,9,4,0,1,28,26,54
p_31,0,6,e_1,666,678,704,20,7,7,4,4,0,1,12,26,38
p_74,0,7,e_1,560,678,709,21,6,6,0,4,0,1,118,31,149
p_130,0,1,e_0,472,711,716,12,0,0,4,4,0,1,239,5,244
p_119,0,1,e_0,483,711,716,12,0,0,0,4,0,1,228,5,233
p_27,0,10,e_1,677,678,720,18,5,5,0,3,0,0,1,42,43
p_129,0,3,e_0,473,711,724,12,0,0,4,4,0,1,238,13,251
p_73,0,11,e_1,561,678,725,21,6,6,0,3,0,0,117,47,164
p_28,0,11,e_1,676,678,725,18,5,5,0,4,0,1,2,47,49
p_34,0,12,e_1,646,678,730,26,9,9,10,4,0,1,32,52,84
p_124,0,7,e_0,478,711,738,12,0,0,2,4,0,1,233,27,260
p_118,0,7,e_0,484,711,738,12,0,0,0,3,0,0,227,27,254
p_33,0,15,e_1,649,678,741,25,9,9,9,4,0,1,29,63,92
p_127,0,10,e_0,475,711,749,12,0,0,3,4,0,1,236,38,274
p_22,0,3,e_3,719,740,751,7,1,0,7,4,0,1,21,11,32
p_132,0,11,e_0,470,711,754,12,0,0,5,4,0,1,241,43,284
p_128,0,11,e_0,474,711,754,12,0,0,3,4,0,1,237,43,280
p_123,0,11,e_0,479,711,754,12,0,0,2,4,0,1,232,43,275
p_121,0,11,e_0,481,711,754,12,0,0,1,4,0,1,230,43,273
p_120,0,11,e_0,482,711,754,12,0,0,1,4,0,1,229,43,272
p_21,0,4,e_3,731,740,756,3,1,0,3,4,0,1,9,16,25
p_126,0,12,e_0,476,711,759,12,0,0,3,4,0,1,235,48,283
p_131,0,14,e_0,471,711,767,12,0,0,4,4,0,1,240,56,296
p_125,0,14,e_0,477,711,767,12,0,0,2,4,0,1,234,56,290
p_122,0,15,e_0,480,711,772,12,0,0,1,4,0,1,231,61,292
p_35,0,9,e_3,630,740,773,2,1,0,2,4,0,1,110,33,143
p_23,0,12,e_3,711,740,784,9,1,0,9,4,0,1,29,44,73
p_36,0,13,e_3,628,740,789,2,1,0,2,4,0,1,112,49,161
p_20,0,14,e_3,734,740,794,2,1,0,2,4,0,1,6,54,60
p_16,0,2,e_2,780,796,804,17,3,3,5,4,0,1,16,8,24
p_14,0,4,e_2,794,796,812,14,0,0,0,4,0,1,2,16,18
p_65,0,1,e_0,573,819,824,19,4,4,8,4,0,1,246,5,251
p_15,0,9,e_2,793,796,829,14,0,0,1,4,0,1,3,33,36
p_72,0,3,e_0,562,819,832,21,6,6,12,4,0,1,257,13,270
p_71,0,3,e_0,564,819,832,20,6,6,11,4,0,1,255,13,268
p_70,0,3,e_0,565,819,832,20,5,5,11,4,0,1,254,13,267
p_67,0,3,e_0,568,819,832,20,5,5,10,4,0,1,251,13,264
p_66,0,3,e_0,569,819,832,19,5,5,10,4,0,1,250,13,263
p_18,0,10,e_2,766,796,834,21,4,4,10,4,0,1,30,38,68
p_17,0,10,e_2,776,796,834,18,3,3,6,4,0,1,20,38,58
p_64,0,4,e_0,574,819,837,18,4,4,8,4,0,1,245,18,263
p_19,0,11,e_2,754,796,839,24,5,5,13,3,0,0,42,43,85
p_61,0,6,e_0,579,819,845,17,3,3,6,4,0,1,240,26,266
p_60,0,10,e_0,580,819,859,17,3,3,6,4,0,1,239,40,279
p_58,0,11,e_0,582,819,864,16,3,3,5,4,0,1,237,45,282
p_68,0,13,e_0,567,819,872,20,5,5,10,4,0,1,252,53,305
p_63,0,13,e_0,577,819,872,18,3,3,7,4,0,1,242,53,295
p_62,0,13,e_0,578,819,872,18,3,3,7,4,0,1,241,53,294
p_69,0,14,e_0,566,819,877,20,5,5,11,4,0,1,253,58,311
p_59,0,14,e_0,581,819,877,17,3,3,6,4,0,1,238,58,296
p_9,0,2,e_2,846,882,890,11,1,0,11,3,0,0,36,8,44
p_6,0,3,e_2,877,882,895,1,1,0,1,4,0,1,5,13,18
p_7,0,5,e_3,875,880,897,1,1,0,1,4,0,1,5,17,22
p_10,0,8,e_3,835,880,908,14,0,0,14,3,0,0,45,28,73
p_8,0,11,e_2,874,882,921,2,1,0,2,4,0,1,8,39,47
p_45,0,2,e_0,595,921,929,13,1,0,1,4,0,1,326,8,334
p_55,0,3,e_0,585,921,934,16,2,2,4,4,0,1,336,13,349
p_54,0,3,e_0,586,921,934,16,2,2,4,4,0,1,335,13,348
p_52,0,3,e_0,588,921,934,15,1,1,3,4,0,1,333,13,346
p_48,0,4,e_0,592,921,939,14,1,0,2,4,0,1,329,18,347
p_46,0,4,e_0,594,921,939,14,1,0,1,4,0,1,327,18,345
p_56,0,6,e_0,584,921,947,16,2,2,5,4,0,1,337,26,363
p_50,0,7,e_0,590,921,952,15,1,0,3,4,0,1,331,31,362
p_43,0,7,e_0,597,921,952,13,1,0,0,4,0,1,324,31,355
p_44,0,8,e_0,596,921,957,13,1,0,1,4,0,1,325,36,361
p_53,0,9,e_0,587,921,962,15,2,2,4,4,0,1,334,41,375
p_51,0,9,e_0,589,921,962,15,1,0,3,4,0,1,332,41,373
p_47,0,9,e_0,593,921,962,14,1,0,2,4,0,1,328,41,369
p_57,0,11,e_0,583,921,970,16,2,2,5,4,0,1,338,49,387
p_49,0,14,e_0,591,921,981,15,1,0,2,4,0,1,330,60,390
p_4,0,1,e_0,886,1025,1030,14,2,2,11,4,0,1,139,5,144
p_24,0,2,e_0,695,1025,1035,14,1,1,5,4,0,1,330,10,340
p_1,0,5,e_0,894,1025,1046,12,2,2,9,4,0,1,131,21,152
p_42,0,6,e_0,598,1025,1051,12,1,0,0,3,0,0,427,26,453
p_26,0,8,e_0,684,1025,1059,16,4,4,9,4,0,1,341,34,375
p_25,0,8,e_0,686,1025,1059,16,3,3,8,4,0,1,339,34,373
p_5,0,8,e_0,883,1025,1059,15,2,2,12,4,0,1,142,34,176
p_3,0,8,e_0,888,1025,1059,14,2,2,11,4,0,1,137,34,171
p_11,0,9,e_0,807,1025,1064,14,0,0,4,4,0,1,218,39,257
p_13,0,11,e_0,796,1025,1072,14,0,0,7,4,0,1,229,47,276
p_12,0,11,e_0,798,1025,1072,14,0,0,7,4,0,1,227,47,274
p_2,0,11,e_0,892,1025,1072,12,2,2,9,4,0,1,133,47,180
p_300,0,4,e_0,8,9,25,0,0,0,0,3,0,0,1,16,17
p_299,0,5,e_1,9,10,29,0,0,0,0,3,0,0,1,19,20
p_297,0,6,e_3,15,16,38,0,0,0,0,3,0,0,1,22,23
p_298,0,9,e_2,11,12,43,0,0,0,0,3,0,0,1,31,32
p_296,0,4,e_0,28,43,57,9,1,1,4,3,0,0,15,14,29
p_286,0,3,e_1,46,47,60,6,0,0,0,3,0,0,1,13,14
p_292,0,6,e_0,38,43,65,6,0,0,1,4,0,1,5,22,27
p_290,0,6,e_0,40,43,65,6,0,0,1,4,0,1,3,22,25
p_289,0,4,e_1,43,47,65,6,0,0,1,4,0,1,4,18,22
p_295,0,5,e_1,29,47,70,9,1,1,5,3,0,0,18,23,41
p_287,0,5,e_1,45,47,70,6,0,0,0,4,0,1,2,23,25
p_288,0,8,e_1,44,47,81,6,0,0,1,4,0,1,3,34,37
p_281,0,1,e_3,73,74,81,0,0,0,0,3,0,0,1,7,8
p_291,0,11,e_0,39,43,82,6,0,0,1,4,0,1,4,39,43
p_294,0,12,e_0,31,43,87,8,1,1,4,4,0,1,12,44,56
p_293,0,12,e_0,33,43,87,7,1,1,3,4,0,1,10,44,54
p_285,0,4,e_3,53,74,92,6,0,0,6,3,0,0,21,18,39
p_284,0,4,e_3,54,74,92,6,1,0,6,4,0,1,20,18,38
p_282,0,7,e_3,66,74,103,2,1,0,2,4,0,1,8,29,37
p_283,0,9,e_3,57,74,111,5,1,0,5,4,0,1,17,37,54
p_278,0,2,e_2,77,105,113,18,4,4,9,4,0,1,28,8,36
p_279,0,5,e_2,76,105,124,18,4,4,9,4,0,1,29,19,48
p_277,0,6,e_1,82,109,129,17,3,3,8,3,0,0,27,20,47
p_274,0,8,e_2,88,105,135,15,3,3,5,4,0,1,17,30,47
p_271,0,1,e_3,121,140,145,6,1,0,6,4,0,1,19,5,24
p_276,0,11,e_2,84,105,146,16,3,3,7,4,0,1,21,41,62
p_273,0,4,e_3,110,140,156,9,0,0,9,2,1,0,30,16,46
p_280,0,14,e_2,75,105,157,18,4,4,9,3,0,0,30,52,82
p_275,0,14,e_2,86,105,157,16,3,3,6,4,0,1,19,52,71
p_267,0,1,e_1,148,165,172,18,3,3,5,4,0,1,17,7,24
p_270,0,9,e_3,122,140,173,6,1,0,6,4,0,1,18,33,51
p_269,0,9,e_3,127,140,173,4,1,0,4,4,0,1,13,33,46
p_268,0,2,e_1,144,165,177,19,3,3,6,3,0,0,21,12,33
p_272,0,10,e_3,113,140,178,9,1,0,9,4,0,1,27,38,65
p_265,0,4,e_1,152,165,185,17,3,3,4,4,0,1,13,20,33
p_262,0,5,e_1,157,165,190,16,2,2,2,4,0,1,8,25,33
p_261,0,5,e_1,164,165,190,14,2,2,0,3,0,0,1,25,26
p_266,0,6,e_1,151,165,195,17,3,3,4,4,0,1,14,30,44
p_263,0,7,e_1,154,165,200,16,3,3,3,4,0,1,11,35,46
p_264,0,11,e_1,153,165,214,17,3,3,4,4,0,1,12,49,61
p_255,0,3,e_0,184,204,215,10,0,0,6,4,0,1,20,11,31
p_254,0,4,e_0,187,204,220,10,0,0,5,4,0,1,17,16,33
p_253,0,5,e_0,190,204,225,10,0,0,4,4,0,1,14,21,35
p_260,0,7,e_0,165,204,233,13,2,2,12,3,0,0,39,29,68
p_258,0,7,e_0,168,204,233,12,2,2,12,4,0,1,36,29,65
p_256,0,10,e_0,182,204,244,10,0,0,7,4,0,1,22,40,62
p_250,0,2,e_3,217,238,246,7,1,0,7,4,0,1,21,8,29
p_252,0,5,e_3,205,238,257,10,0,0,10,3,0,0,33,19,52
p_257,0,14,e_0,169,204,258,12,2,2,11,4,0,1,35,54,89
p_259,0,15,e_0,167,204,263,13,2,2,12,4,0,1,37,59,96
p_251,0,15,e_3,209,238,289,9,1,0,9,4,0,1,29,51,80
p_248,0,5,e_1,246,275,292,28,2,2,9,4,0,1,29,17,46
p_247,0,5,e_1,250,275,292,27,2,2,8,4,0,1,25,17,42
p_249,0,6,e_1,239,275,297,30,3,3,11,3,0,0,36,22,58
p_245,0,7,e_1,269,275,302,21,1,1,2,4,0,1,6,27,33
p_246,0,10,e_1,262,275,313,24,1,1,4,4,0,1,13,38,51
p_244,0,12,e_1,271,275,321,21,1,1,1,4,0,1,4,46,50
p_241,0,1,e_2,283,322,327,17,1,1,13,4,0,1,39,5,44
p_236,0,1,e_2,305,322,327,15,0,0,5,4,0,1,17,5,22
p_233,0,1,e_2,311,322,327,15,0,0,3,4,0,1,11,5,16
p_243,0,15,e_1,272,275,332,20,1,1,1,4,0,1,3,57,60
p_230,0,3,e_2,319,322,335,15,0,0,1,4,0,1,3,13,16
p_232,0,5,e_2,314,322,343,15,0,0,2,4,0,1,8,21,29
p_237,0,7,e_2,304,322,351,15,0,0,6,4,0,1,18,29,47
p_231,0,7,e_2,317,322,351,15,0,0,1,4,0,1,5,29,34
p_242,0,8,e_2,277,322,356,19,1,1,14,3,0,0,45,34,79
p_235,0,8,e_2,308,322,356,15,0,0,4,4,0,1,14,34,48
p_234,0,8,e_2,310,322,356,15,0,0,4,4,0,1,12,34,46
p_240,0,9,e_2,301,322,361,15,0,0,7,4,0,1,21,39,60
p_239,0,11,e_2,302,322,369,15,0,0,6,4,0,1,20,47,67
p_238,0,13,e_2,303,322,377,15,0,0,6,4,0,1,19,55,74
p_229,0,13,e_2,320,322,377,15,0,0,0,4,0,1,2,55,57
p_216,0,1,e_0,347,373,380,9,1,0,8,4,0,1,26,7,33
p_226,0,2,e_0,329,373,385,15,1,0,14,4,0,1,44,12,56
p_223,0,2,e_0,336,373,385,13,1,0,12,4,0,1,37,12,49
p_214,0,3,e_0,349,373,390,8,1,0,8,4,0,1,24,17,41
p_228,0,4,e_0,325,373,395,15,0,0,15,3,0,0,48,22,70
p_224,0,5,e_1,331,379,396,14,1,0,15,2,1,0,48,17,65
p_194,0,6,e_3,373,375,397,0,1,0,0,4,0,1,2,22,24
p_225,0,5,e_0,330,373,400,15,1,0,14,4,0,1,43,27,70
p_222,0,5,e_0,337,373,400,12,1,0,12,4,0,1,36,27,63
p_219,0,5,e_0,342,373,400,11,1,0,10,4,0,1,31,27,58
p_221,0,6,e_0,339,373,405,12,1,0,11,4,0,1,34,32,66
p_220,0,6,e_0,341,373,405,11,1,0,10,4,0,1,32,32,64
p_192,0,8,e_1,375,379,407,24,4,4,1,4,0,1,4,28,32
p_217,0,7,e_0,346,373,410,9,1,0,9,4,0,1,27,37,64
p_212,0,7,e_0,351,373,410,8,1,0,7,4,0,1,22,37,59
p_193,0,11,e_3,374,375,414,0,0,0,0,3,0,0,1,39,40
p_191,0,10,e_1,376,379,415,24,3,3,1,4,0,1,3,36,39
p_227,0,12,e_3,327,375,419,15,0,0,15,3,0,0,48,44,92
p_218,0,11,e_0,343,373,424,10,1,0,10,4,0,1,30,51,81
p_190,0,1,e_2,379,421,428,24,3,3,13,3,0,0,42,7,49
p_183,0,1,e_2,396,421,428,18,2,2,8,4,0,1,25,7,32
p_182,0,2,e_2,397,421,433,18,2,2,8,4,0,1,24,12,36
p_180,0,2,e_2,399,421,433,18,2,2,7,4,0,1,22,12,34
p_215,0,15,e_0,348,373,438,9,1,0,8,4,0,1,25,65,90
p_213,0,15,e_0,350,373,438,8,1,0,7,4,0,1,23,65,88
p_178,0,3,e_2,401,421,438,17,2,2,6,4,0,1,20,17,37
p_186,0,4,e_2,390,421,443,20,3,3,10,4,0,1,31,22,53
p_176,0,4,e_2,403,421,443,16,2,2,6,4,0,1,18,22,40
p_189,0,8,e_2,382,421,457,23,3,3,13,4,0,1,39,36,75
p_179,0,8,e_2,400,421,457,17,2,2,7,4,0,1,21,36,57
p_161,0,1,e_1,421,454,461,12,0,0,10,3,0,0,33,7,40
p_158,0,1,e_1,430,454,461,12,0,0,8,4,0,1,24,7,31
p_177,0,9,e_2,402,421,462,17,2,2,6,4,0,1,19,41,60
p_185,0,10,e_2,391,421,467,20,3,3,10,4,0,1,30,46,76
p_187,0,12,e_2,389,421,475,20,3,3,10,4,0,1,32,54,86
p_184,0,12,e_2,392,421,475,19,3,3,9,4,0,1,29,54,83
p_159,0,6,e_1,429,454,478,12,0,0,8,4,0,1,25,24,49
p_150,0,6,e_1,443,454,478,12,0,0,3,4,0,1,11,24,35
p_188,0,13,e_2,384,421,480,22,3,3,12,4,0,1,37,59,96
p_154,0,7,e_1,436,454,483,12,0,0,6,4,0,1,18,29,47
p_148,0,8,e_1,449,454,488,12,0,0,1,4,0,1,5,34,39
p_181,0,15,e_2,398,421,488,18,2,2,7,4,0,1,23,67,90
p_153,0,9,e_1,437,454,493,12,0,0,5,4,0,1,17,39,56
p_147,0,9,e_1,452,454,493,12,0,0,0,4,0,1,2,39,41
p_209,0,2,e_0,357,485,495,6,1,0,5,4,0,1,128,10,138
p_205,0,2,e_0,362,485,495,4,1,0,3,4,0,1,123,10,133
p_200,0,4,e_0,367,485,503,2,1,0,2,4,0,1,118,18,136
p_201,0,5,e_0,366,485,508,3,1,0,2,4,0,1,119,23,142
p_157,0,14,e_1,431,454,510,12,0,0,7,4,0,1,23,56,79
p_155,0,14,e_1,435,454,510,12,0,0,6,4,0,1,19,56,75
p_210,0,6,e_0,354,485,513,7,1,0,6,4,0,1,131,28,159
p_208,0,6,e_0,358,485,513,5,1,0,5,4,0,1,127,28,155
p_160,0,15,e_1,426,454,515,12,0,0,9,4,0,1,28,61,89
p_156,0,15,e_1,434,454,515,12,0,0,6,4,0,1,20,61,81
p_152,0,15,e_1,441,454,515,12,0,0,4,4,0,1,13,61,74
p_151,0,15,e_1,442,454,515,12,0,0,4,4,0,1,12,61,73
p_149,0,15,e_1,444,454,515,12,0,0,3,4,0,1,10,61,71
p_198,0,9,e_0,369,485,524,2,1,0,1,4,0,1,116,39,155
p_197,0,10,e_0,370,485,529,1,1,0,1,4,0,1,115,44,159
p_113,0,1,e_3,489,524,529,11,1,0,11,4,0,1,35,5,40
p_207,0,11,e_0,359,485,534,5,1,0,4,4,0,1,126,49,175
p_114,0,3,e_3,488,524,537,12,1,0,12,4,0,1,36,13,49
p_106,0,3,e_3,500,524,537,8,1,0,8,4,0,1,24,13,37
p_206,0,12,e_0,361,485,539,4,1,0,4,4,0,1,124,54,178
p_203,0,12,e_0,364,485,539,3,1,0,3,4,0,1,121,54,175
p_167,0,1,e_2,413,535,540,13,1,1,2,4,0,1,122,5,127
p_204,0,14,e_0,363,485,547,4,1,0,3,4,0,1,122,62,184
p_108,0,6,e_3,496,524,548,9,1,0,9,4,0,1,28,24,52
p_165,0,4,e_2,417,535,551,12,1,1,1,4,0,1,118,16,134
p_92,0,4,e_2,525,535,551,30,10,10,3,4,0,1,10,16,26
p_211,0,15,e_0,353,485,552,7,1,0,6,4,0,1,132,67,199
p_202,0,15,e_0,365,485,552,3,1,0,2,4,0,1,120,67,187
p_199,0,15,e_0,368,485,552,2,1,0,1,4,0,1,117,67,184
p_111,0,8,e_3,491,524,556,11,1,0,11,4,0,1,33,32,65
p_115,0,9,e_3,487,524,561,12,1,0,12,4,0,1,37,37,74
p_117,0,10,e_3,485,524,566,12,0,0,12,3,0,0,39,42,81
p_116,0,10,e_3,486,524,566,12,1,0,12,4,0,1,38,42,80
p_169,0,9,e_2,411,535,568,14,2,2,3,4,0,1,124,33,157
p_146,0,1,e_1,453,562,569,12,0,0,0,3,0,0,109,7,116
p_112,0,11,e_3,490,524,571,11,1,0,11,4,0,1,34,47,81
p_110,0,11,e_3,492,524,571,10,1,0,10,4,0,1,32,47,79
p_107,0,11,e_3,499,524,571,8,1,0,8,4,0,1,25,47,72
p_103,0,11,e_3,508,524,571,5,1,0,5,4,0,1,16,47,63
p_163,0,10,e_2,419,535,573,12,0,0,0,4,0,1,116,38,154
p_86,0,2,e_1,544,562,574,25,9,9,6,4,0,1,18,12,30
p_105,0,12,e_3,502,524,576,7,1,0,7,4,0,1,22,52,74
p_173,0,11,e_2,407,535,578,15,2,2,4,4,0,1,128,43,171
p_164,0,11,e_2,418,535,578,12,0,0,1,4,0,1,117,43,160
p_162,0,11,e_2,420,535,578,12,0,0,0,3,0,0,115,43,158
p_77,0,3,e_1,557,562,579,22,7,7,1,4,0,1,5,17,22
p_166,0,12,e_2,416,535,583,13,1,1,1,4,0,1,119,48,167
p_104,0,14,e_3,503,524,584,7,1,0,7,4,0,1,21,60,81
p_88,0,5,e_1,538,562,587,27,9,9,8,4,0,1,24,25,49
p_171,0,13,e_2,409,535,588,14,2,2,4,4,0,1,126,53,179
p_168,0,13,e_2,412,535,588,13,2,2,3,4,0,1,123,53,176
p_109,0,15,e_3,493,524,589,10,1,0,10,4,0,1,31,65,96
p_76,0,6,e_1,558,562,592,22,7,7,1,4,0,1,4,30,34
p_175,0,14,e_2,405,535,593,16,2,2,5,4,0,1,130,58,188
p_174,0,14,e_2,406,535,593,15,2,2,5,4,0,1,129,58,187
p_170,0,14,e_2,410,535,593,14,2,2,3,4,0,1,125,58,183
p_80,0,7,e_1,552,562,597,23,8,8,3,4,0,1,10,35,45
p_172,0,15,e_2,408,535,598,15,2,2,4,4,0,1,127,63,190
p_87,0,8,e_1,539,562,602,27,9,9,7,4,0,1,23,40,63
p_83,0,8,e_1,549,562,602,24,8,8,4,4,0,1,13,40,53
p_89,0,9,e_1,535,562,607,27,10,10,9,4,0,1,27,45,72
p_143,0,3,e_0,456,599,612,12,0,0,9,4,0,1,143,13,156
p_136,0,3,e_0,465,599,612,12,0,0,6,4,0,1,134,13,147
p_196,0,4,e_0,371,599,617,1,1,0,0,4,0,1,228,18,246
p_137,0,4,e_0,464,599,617,12,0,0,7,4,0,1,135,18,153
p_84,0,12,e_1,546,562,618,24,9,9,5,4,0,1,16,56,72
p_78,0,12,e_1,556,562,618,22,7,7,2,4,0,1,6,56,62
p_141,0,6,e_0,458,599,625,12,0,0,9,4,0,1,141,26,167
p_82,0,14,e_1,550,562,626,24,8,8,4,4,0,1,12,64,76
p_81,0,14,e_1,551,562,626,23,8,8,3,4,0,1,11,64,75
p_79,0,14,e_1,553,562,626,23,8,8,3,4,0,1,9,64,73
p_85,0,15,e_1,545,562,631,25,9,9,5,4,0,1,17,69,86
p_140,0,8,e_0,459,599,633,12,0,0,8,4,0,1,140,34,174
p_144,0,9,e_0,455,599,638,12,0,0,10,4,0,1,144,39,183
p_142,0,9,e_0,457,599,638,12,0,0,9,4,0,1,142,39,181
p_96,0,1,e_3,517,636,641,2,1,0,2,4,0,1,119,5,124
p_139,0,10,e_0,461,599,643,12,0,0,8,4,0,1,138,44,182
p_135,0,10,e_0,466,599,643,12,0,0,6,4,0,1,133,44,177
p_145,0,11,e_0,454,599,648,12,0,0,10,4,0,1,145,49,194
p_138,0,11,e_0,463,599,648,12,0,0,7,4,0,1,136,49,185
p_133,0,12,e_0,469,599,653,12,0,0,5,4,0,1,130,54,184
p_99,0,6,e_3,514,636,658,3,1,0,3,4,0,1,122,22,144
p_94,0,6,e_3,519,636,658,1,1,0,1,4,0,1,117,22,139
p_102,0,7,e_3,509,636,663,5,1,0,5,4,0,1,127,27,154
p_98,0,7,e_3,515,636,663,3,1,0,3,4,0,1,121,27,148
p_97,0,7,e_3,516,636,663,2,1,0,2,4,0,1,120,27,147
p_195,0,15,e_0,372,599,664,1,1,0,0,3,0,0,227,65,292
p_134,0,15,e_0,467,599,664,12,0,0,6,4,0,1,132,65,197
p_101,0,8,e_3,511,636,668,4,1,0,4,4,0,1,125,32,157
p_100,0,9,e_3,513,636,673,3,1,0,3,4,0,1,123,37,160
p_37,0,9,e_3,615,636,673,7,1,0,7,4,0,1,21,37,58
p_41,0,11,e_3,600,636,681,12,1,0,12,4,0,1,36,45,81
p_91,0,12,e_2,526,645,683,30,10,10,3,4,0,1,119,38,157
p_39,0,12,e_3,607,636,686,9,1,0,9,4,0,1,29,50,79
p_90,0,13,e_2,527,645,688,29,11,11,2,4,0,1,118,43,161
p_30,0,3,e_1,668,678,691,20,6,6,3,4,0,1,10,13,23
p_93,0,13,e_3,520,636,691,1,1,0,1,4,0,1,116,55,171
p_40,0,13,e_3,602,636,691,11,1,0,11,4,0,1,34,55,89
p_38,0,13,e_3,608,636,691,9,1,0,9,4,0,1,28,55,83
p_95,0,14,e_3,518,636,696,2,1,0,2,4,0,1,118,60,178
p_75,0,5,e_1,559,678,699,21,7,7,1,4,0,1,119,21,140
p_29,0,5,e_1,670,678,699,20,6,6,2,4,0,1,8,21,29
p_32,0,6,e_1,650,678,704,24,9,9,9,4,0,1,28,26,54
p_31,0,6,e_1,666,678,704,20,7,7,4,4,0,1,12,26,38
p_74,0,7,e_1,560,678,709,21,6,6,0,4,0,1,118,31,149
p_130,0,1,e_0,472,711,716,12,0,0,4,4,0,1,239,5,244
p_119,0,1,e_0,483,711,716,12,0,0,0,4,0,1,228,5,233
p_27,0,10,e_1,677,678,720,18,5,5,0,3,0,0,1,42,43
p_129,0,3,e_0,473,711,724,12,0,0,4,4,0,1,238,13,251
p_73,0,11,e_1,561,678,725,21,6,6,0,3,0,0,117,47,164
p_28,0,11,e_1,676,678,725,18,5,5,0,4,0,1,2,47,49
p_34,0,12,e_1,646,678,730,26,9,9,10,4,0,1,32,52,84
p_124,0,7,e_0,478,711,738,12,0,0,2,4,0,1,233,27,260
p_118,0,7,e_0,484,711,738,12,0,0,0,3,0,0,227,27,254
p_33,0,15,e_1,649,678,741,25,9,9,9,4,0,1,29,63,92
p_127,0,10,e_0,475,711,749,12,0,0,3,4,0,1,236,38,274
p_22,0,3,e_3,719,740,751,7,1,0,7,4,0,1,21,11,32
p_132,0,11,e_0,470,711,754,12,0,0,5,4,0,1,241,43,284
p_128,0,11,e_0,474,711,754,12,0,0,3,4,0,1,237,43,280
p_123,0,11,e_0,479,711,754,12,0,0,2,4,0,1,232,43,275
p_121,0,11,e_0,481,711,754,12,0,0,1,4,0,1,230,43,273
p_120,0,11,e_0,482,711,754,12,0,0,1,4,0,1,229,43,272
p_21,0,4,e_3,731,740,756,3,1,0,3,4,0,1,9,16,25
p_126,0,12,e_0,476,711,759,12,0,0,3,4,0,1,235,48,283
p_131,0,14,e_0,471,711,767,12,0,0,4,4,0,1,240,56,296
p_125,0,14,e_0,477,711,767,12,0,0,2,4,0,1,234,56,290
p_122,0,15,e_0,480,711,772,12,0,0,1,4,0,1,231,61,292
p_35,0,9,e_3,630,740,773,2,1,0,2,4,0,1,110,33,143
p_23,0,12,e_3,711,740,784,9,1,0,9,4,0,1,29,44,73
p_36,0,13,e_3,628,740,789,2,1,0,2,4,0,1,112,49,161
p_20,0,14,e_3,734,740,794,2,1,0,2,4,0,1,6,54,60
p_16,0,2,e_2,780,796,804,17,3,3,5,4,0,1,16,8,24
p_14,0,4,e_2,794,796,812,14,0,0,0,4,0,1,2,16,18
p_65,0,1,e_0,573,819,824,19,4,4,8,4,0,1,246,5,251
p_15,0,9,e_2,793,796,829,14,0,0,1,4,0,1,3,33,36
p_72,0,3,e_0,562,819,832,21,6,6,12,4,0,1,257,13,270
p_71,0,3,e_0,564,819,832,20,6,6,11,4,0,1,255,13,268
p_70,0,3,e_0,565,819,832,20,5,5,11,4,0,1,254,13,267
p_67,0,3,e_0,568,819,832,20,5,5,10,4,0,1,251,13,264
p_66,0,3,e_0,569,819,832,19,5,5,10,4,0,1,250,13,263
p_18,0,10,e_2,766,796,834,21,4,4,10,4,0,1,30,38,68
p_17,0,10,e_2,776,796,834,18,3,3,6,4,0,1,20,38,58
p_64,0,4,e_0,574,819,837,18,4,4,8,4,0,1,245,18,263
p_19,0,11,e_2,754,796,839,24,5,5,13,3,0,0,42,43,85
p_61,0,6,e_0,579,819,845,17,3,3,6,4,0,1,240,26,266
p_60,0,10,e_0,580,819,859,17,3,3,6,4,0,1,239,40,279
p_58,0,11,e_0,582,819,864,16,3,3,5,4,0,1,237,45,282
p_68,0,13,e_0,567,819,872,20,5,5,10,4,0,1,252,53,305
p_63,0,13,e_0,577,819,872,18,3,3,7,4,0,1,242,53,295
p_62,0,13,e_0,578,819,872,18,3,3,7,4,0,1,241,53,294
p_69,0,14,e_0,566,819,877,20,5,5,11,4,0,1,253,58,311
p_59,0,14,e_0,581,819,877,17,3,3,6,4,0,1,238,58,296
p_9,0,2,e_2,846,882,890,11,1,0,11,3,0,0,36,8,44
p_6,0,3,e_2,877,882,895,1,1,0,1,4,0,1,5,13,18
p_7,0,5,e_3,875,880,897,1,1,0,1,4,0,1,5,17,22
p_10,0,8,e_3,835,880,908,14,0,0,14,3,0,0,45,28,73
p_8,0,11,e_2,874,882,921,2,1,0,2,4,0,1,8,39,47
p_45,0,2,e_0,595,921,929,13,1,0,1,4,0,1,326,8,334
p_55,0,3,e_0,585,921,934,16,2,2,4,4,0,1,336,13,349
p_54,0,3,e_0,586,921,934,16,2,2,4,4,0,1,335,13,348
p_52,0,3,e_0,588,921,934,15,1,1,3,4,0,1,333,13,346
p_48,0,4,e_0,592,921,939,14,1,0,2,4,0,1,329,18,347
p_46,0,4,e_0,594,921,939,14,1,0,1,4,0,1,327,18,345
p_56,0,6,e_0,584,921,947,16,2,2,5,4,0,1,337,26,363
p_50,0,7,e_0,590,921,952,15,1,0,3,4,0,1,331,31,362
p_43,0,7,e_0,597,921,952,13,1,0,0,4,0,1,324,31,355
p_44,0,8,e_0,596,921,957,13,1,0,1,4,0,1,325,36,361
p_53,0,9,e_0,587,921,962,15,2,2,4,4,0,1,334,41,375
p_51,0,9,e_0,589,921,962,15,1,0,3,4,0,1,332,41,373
p_47,0,9,e_0,593,921,962,14,1,0,2,4,0,1,328,41,369
p_57,0,11,e_0,583,921,970,16,2,2,5,4,0,1,338,49,387
p_49,0,14,e_0,591,921,981,15,1,0,2,4,0,1,330,60,390
p_4,0,1,e_0,886,1025,1030,14,2,2,11,4,0,1,139,5,144
p_24,0,2,e_0,695,1025,1035,14,1,1,5,4,0,1,330,10,340
p_1,0,5,e_0,894,1025,1046,12,2,2,9,4,0,1,131,21,152
p_42,0,6,e_0,598,1025,1051,12,1,0,0,3,0,0,427,26,453
p_26,0,8,e_0,684,1025,1059,16,4,4,9,4,0,1,341,34,375
p_25,0,8,e_0,686,1025,1059,16,3,3,8,4,0,1,339,34,373
p_5,0,8,e_0,883,1025,1059,15,2,2,12,4,0,1,142,34,176
p_3,0,8,e_0,888,1025,1059,14,2,2,11,4,0,1,137,34,171
p_11,0,9,e_0,807,1025,1064,14,0,0,4,4,0,1,218,39,257
p_13,0,11,e_0,796,1025,1072,14,0,0,7,4,0,1,229,47,276
p_12,0,11,e_0,798,1025,1072,14,0,0,7,4,0,1,227,47,274
p_2,0,11,e_0,892,1025,1072,12,2,2,9,4,0,1,133,47,180
p_300,0,4,e_0,8,9,25,0,0,0,0,3,0,0,1,16,17
p_299,0,5,e_1,9,10,29,0,0,0,0,3,0,0,1,19,20
p_297,0,6,e_3,15,16,38,0,0,0,0,3,0,0,1,22,23
p_298,0,9,e_2,11,12,43,0,0,0,0,3,0,0,1,31,32
p_296,0,4,e_0,28,43,57,9,1,1,4,3,0,0,15,14,29
p_295,0,5,e_0,29,43,62,9,1,1,4,4,0,1,14,19,33
p_292,0,6,e_0,38,43,67,6,0,0,1,4,0,1,5,24,29
p_290,0,6,e_0,40,43,67,6,0,0,1,4,0,1,3,24,27
p_286,0,3,e_1,46,61,72,6,0,0,5,4,0,1,15,11,26
p_289,0,4,e_1,43,61,77,6,0,0,5,3,0,0,18,16,34
p_285,0,4,e_1,53,61,77,6,0,0,2,4,0,1,8,16,24
p_284,0,4,e_1,54,61,77,6,0,0,2,4,0,1,7,16,23
p_287,0,5,e_1,45,61,82,6,0,0,5,4,0,1,16,21,37
p_291,0,11,e_0,39,43,84,6,0,0,1,4,0,1,4,41,45
p_294,0,12,e_0,31,43,89,8,1,1,4,4,0,1,12,46,58
p_293,0,12,e_0,33,43,89,7,1,1,3,4,0,1,10,46,56
p_288,0,8,e_1,44,61,93,6,0,0,5,4,0,1,17,32,49
p_281,0,1,e_3,73,87,94,4,1,0,4,4,0,1,14,7,21
p_283,0,9,e_1,57,61,98,6,0,0,1,4,0,1,4,37,41
p_278,0,2,e_3,77,87,99,3,1,0,3,4,0,1,10,12,22
p_279,0,5,e_3,76,87,110,3,1,0,3,4,0,1,11,23,34
p_277,0,6,e_3,82,87,115,1,1,0,1,4,0,1,5,28,33
p_282,0,7,e_3,66,87,120,6,0,0,6,3,0,0,21,33,54
p_273,0,4,e_2,110,118,132,23,4,4,2,4,0,1,8,14,22
p_276,0,11,e_3,84,87,134,1,1,0,1,4,0,1,3,47,50
p_280,0,14,e_3,75,87,145,4,1,0,4,4,0,1,12,58,70
p_275,0,14,e_3,86,87,145,0,0,0,0,3,0,0,1,58,59
p_274,0,8,e_2,88,118,146,28,7,7,9,3,0,0,30,28,58
p_272,0,10,e_2,113,118,154,22,4,4,1,4,0,1,5,36,41
p_271,0,1,e_1,121,151,156,21,2,2,9,3,0,0,30,5,35
p_267,0,1,e_1,148,151,156,14,0,0,1,4,0,1,3,5,8
p_268,0,2,e_1,144,151,161,14,0,0,2,4,0,1,7,10,17
p_270,0,9,e_1,122,151,184,21,2,2,9,4,0,1,29,33,62
p_269,0,9,e_1,127,151,184,19,2,2,8,4,0,1,24,33,57
p_255,0,3,e_2,184,186,197,14,0,0,0,4,0,1,2,11,13
p_265,0,4,e_0,152,190,204,14,0,0,12,4,0,1,38,14,52
p_254,0,4,e_0,187,190,204,14,0,0,1,4,0,1,3,14,17
p_262,0,5,e_2,157,186,205,14,0,0,9,4,0,1,29,19,48
p_261,0,5,e_2,164,186,205,14,0,0,7,4,0,1,22,19,41
p_266,0,6,e_0,151,190,212,14,0,0,12,3,0,0,39,22,61
p_263,0,7,e_2,154,186,213,14,0,0,10,4,0,1,32,27,59
p_260,0,7,e_2,165,186,213,14,0,0,7,4,0,1,21,27,48
p_258,0,7,e_2,168,186,213,14,0,0,6,4,0,1,18,27,45
p_256,0,10,e_2,182,186,224,14,0,0,1,4,0,1,4,38,42
p_250,0,2,e_1,217,220,228,14,0,0,1,4,0,1,3,8,11
p_264,0,11,e_2,153,186,229,14,0,0,10,2,1,0,33,43,76
p_253,0,5,e_1,190,220,239,14,0,0,9,3,0,0,30,19,49
p_252,0,5,e_1,205,220,239,14,0,0,5,4,0,1,15,19,34
p_257,0,14,e_2,169,186,240,14,0,0,5,4,0,1,17,54,71
p_259,0,15,e_2,167,186,245,14,0,0,6,4,0,1,19,59,78
p_251,0,15,e_1,209,220,271,14,0,0,3,4,0,1,11,51,62
p_248,0,5,e_0,246,260,277,14,0,0,4,4,0,1,14,17,31
p_247,0,5,e_0,250,260,277,14,0,0,3,4,0,1,10,17,27
p_249,0,6,e_0,239,260,282,14,0,0,6,3,0,0,21,22,43
p_241,0,1,e_0,283,304,311,8,1,0,6,3,0,0,21,7,28
p_236,0,1,e_3,305,307,312,0,1,0,0,4,0,1,2,5,7
p_245,0,7,e_3,269,307,332,12,1,0,12,4,0,1,38,25,63
p_237,0,7,e_3,304,307,332,1,1,0,1,4,0,1,3,25,28
p_240,0,9,e_0,301,304,337,2,1,0,1,4,0,1,3,33,36
p_242,0,8,e_3,277,307,337,10,1,0,10,4,0,1,30,30,60
p_239,0,11,e_0,302,304,345,1,1,0,0,4,0,1,2,41,43
p_246,0,10,e_3,262,307,345,14,0,0,14,3,0,0,45,38,83
p_238,0,13,e_0,303,304,353,1,1,0,0,3,0,0,1,49,50
p_244,0,12,e_3,271,307,353,12,1,0,12,4,0,1,36,46,82
p_233,0,1,e_1,311,356,361,29,5,5,15,4,0,1,45,5,50
p_243,0,15,e_3,272,307,364,11,1,0,11,4,0,1,35,57,92
p_226,0,2,e_1,329,356,366,24,5,5,9,4,0,1,27,10,37
p_223,0,2,e_1,336,356,366,22,3,3,6,4,0,1,20,10,30
p_209,0,2,e_2,357,358,368,17,1,1,0,3,0,0,1,10,11
p_230,0,3,e_1,319,356,371,27,5,5,12,4,0,1,37,15,52
p_228,0,4,e_1,325,356,376,25,5,5,10,4,0,1,31,20,51
p_232,0,5,e_1,314,356,381,29,5,5,14,4,0,1,42,25,67
p_225,0,5,e_1,330,356,381,23,5,5,8,4,0,1,26,25,51
p_224,0,5,e_1,331,356,381,23,4,4,8,4,0,1,25,25,50
p_222,0,5,e_1,337,356,381,22,3,3,6,4,0,1,19,25,44
p_221,0,6,e_1,339,356,386,22,3,3,5,4,0,1,17,30,47
p_220,0,6,e_1,341,356,386,21,3,3,5,4,0,1,15,30,45
p_234,0,8,e_2,310,358,388,29,6,6,15,3,0,0,48,30,78
p_231,0,7,e_1,317,356,391,28,5,5,13,4,0,1,39,35,74
p_235,0,8,e_1,308,356,396,30,6,6,15,3,0,0,48,40,88
p_205,0,2,e_0,362,400,410,15,1,1,12,4,0,1,38,10,48
p_227,0,12,e_1,327,356,410,24,5,5,9,4,0,1,29,54,83
p_229,0,13,e_1,320,356,415,27,5,5,12,4,0,1,36,59,95
p_200,0,4,e_0,367,400,418,15,0,0,11,4,0,1,33,18,51
p_196,0,4,e_0,371,400,418,15,0,0,9,4,0,1,29,18,47
p_201,0,5,e_0,366,400,423,15,0,0,11,4,0,1,34,23,57
p_208,0,6,e_0,358,400,428,17,1,1,13,3,0,0,42,28,70
p_194,0,6,e_0,373,400,428,15,0,0,9,4,0,1,27,28,55
p_167,0,1,e_2,413,427,434,15,0,0,4,4,0,1,14,7,21
p_198,0,9,e_0,369,400,439,15,0,0,10,4,0,1,31,39,70
p_178,0,3,e_2,401,427,442,15,0,0,8,4,0,1,26,15,41
p_197,0,10,e_0,370,400,444,15,0,0,10,4,0,1,30,44,74
p_176,0,4,e_2,403,427,447,15,0,0,8,4,0,1,24,20,44
p_165,0,4,e_2,417,427,447,15,0,0,3,4,0,1,10,20,30
p_207,0,11,e_0,359,400,449,16,1,1,13,4,0,1,41,49,90
p_206,0,12,e_0,361,400,454,16,1,1,13,4,0,1,39,54,93
p_203,0,12,e_0,364,400,454,15,0,0,12,4,0,1,36,54,90
p_179,0,8,e_2,400,427,461,15,0,0,8,3,0,0,27,34,61
p_204,0,14,e_0,363,400,462,15,0,0,12,4,0,1,37,62,99
p_216,0,1,e_1,347,456,463,20,2,2,3,4,0,1,109,7,116
p_158,0,1,e_1,430,456,463,15,0,0,8,4,0,1,26,7,33
p_177,0,9,e_2,402,427,466,15,0,0,8,4,0,1,25,39,64
p_169,0,9,e_2,411,427,466,15,0,0,5,4,0,1,16,39,55
p_202,0,15,e_0,365,400,467,15,0,0,11,4,0,1,35,67,102
p_199,0,15,e_0,368,400,467,15,0,0,10,4,0,1,32,67,99
p_195,0,15,e_0,372,400,467,15,0,0,9,4,0,1,28,67,95
p_214,0,3,e_1,349,456,471,19,2,2,2,4,0,1,107,15,122
p_173,0,11,e_2,407,427,474,15,0,0,6,4,0,1,20,47,67
p_219,0,5,e_1,342,456,479,21,3,3,4,4,0,1,114,23,137
p_166,0,12,e_2,416,427,479,15,0,0,3,4,0,1,11,52,63
p_210,0,6,e_1,354,456,484,18,1,1,0,4,0,1,102,28,130
p_159,0,6,e_1,429,456,484,15,0,0,9,4,0,1,27,28,55
p_171,0,13,e_2,409,427,484,15,0,0,6,4,0,1,18,57,75
p_168,0,13,e_2,412,427,484,15,0,0,5,4,0,1,15,57,72
p_217,0,7,e_1,346,456,489,20,2,2,3,4,0,1,110,33,143
p_212,0,7,e_1,351,456,489,18,2,2,1,4,0,1,105,33,138
p_175,0,14,e_2,405,427,489,15,0,0,7,4,0,1,22,62,84
p_174,0,14,e_2,406,427,489,15,0,0,7,4,0,1,21,62,83
p_170,0,14,e_2,410,427,489,15,0,0,5,4,0,1,17,62,79
p_172,0,15,e_2,408,427,494,15,0,0,6,4,0,1,19,67,86
p_218,0,11,e_1,343,456,503,20,3,3,4,4,0,1,113,47,160
p_130,0,1,e_3,472,504,511,10,1,0,10,4,0,1,32,7,39
p_157,0,14,e_1,431,456,514,15,0,0,8,4,0,1,25,58,83
p_155,0,14,e_1,435,456,514,15,0,0,7,4,0,1,21,58,79
p_215,0,15,e_1,348,456,519,19,2,2,2,4,0,1,108,63,171
p_213,0,15,e_1,350,456,519,19,2,2,2,4,0,1,106,63,169
p_211,0,15,e_1,353,456,519,18,1,1,1,4,0,1,103,63,166
p_156,0,15,e_1,434,456,519,15,0,0,7,4,0,1,22,63,85
p_143,0,3,e_3,456,504,519,15,0,0,15,3,0,0,48,15,63
p_136,0,3,e_3,465,504,519,13,1,0,13,4,0,1,39,15,54
p_129,0,3,e_3,473,504,519,10,1,0,10,4,0,1,31,15,46
p_190,0,1,e_0,379,514,521,15,0,0,7,4,0,1,135,7,142
p_183,0,1,e_0,396,514,521,15,0,0,1,4,0,1,118,7,125
p_137,0,4,e_3,464,504,524,13,1,0,13,4,0,1,40,20,60
p_182,0,2,e_0,397,514,526,15,0,0,1,4,0,1,117,12,129
p_180,0,2,e_0,399,514,526,15,0,0,0,3,0,0,115,12,127
p_141,0,6,e_3,458,504,532,15,1,0,15,4,0,1,46,28,74
p_186,0,4,e_0,390,514,534,15,0,0,3,4,0,1,124,20,144
p_140,0,8,e_3,459,504,540,15,1,0,15,4,0,1,45,36,81
p_142,0,9,e_3,457,504,545,15,1,0,15,4,0,1,47,41,88
p_161,0,1,e_2,421,541,546,15,0,0,2,4,0,1,120,5,125
p_96,0,1,e_2,517,541,546,27,11,11,8,4,0,1,24,5,29
p_192,0,8,e_0,375,514,548,15,0,0,8,4,0,1,139,34,173
p_189,0,8,e_0,382,514,548,15,0,0,6,4,0,1,132,34,166
p_139,0,10,e_3,461,504,550,14,1,0,14,4,0,1,43,46,89
p_135,0,10,e_3,466,504,550,12,1,0,12,4,0,1,38,46,84
p_138,0,11,e_3,463,504,555,13,1,0,13,4,0,1,41,51,92
p_132,0,11,e_3,470,504,555,11,1,0,11,4,0,1,34,51,85
p_191,0,10,e_0,376,514,556,15,0,0,8,4,0,1,138,42,180
p_185,0,10,e_0,391,514,556,15,0,0,3,4,0,1,123,42,165
p_92,0,4,e_2,525,541,557,26,9,9,5,4,0,1,16,16,32
p_133,0,12,e_3,469,504,560,11,1,0,11,4,0,1,35,56,91
p_193,0,11,e_0,374,514,561,15,0,0,8,4,0,1,140,47,187
p_103,0,11,e_0,508,514,561,30,11,11,2,4,0,1,6,47,53
p_99,0,6,e_2,514,541,565,28,11,11,9,4,0,1,27,24,51
p_94,0,6,e_2,519,541,565,27,10,10,7,4,0,1,22,24,46
p_187,0,12,e_0,389,514,566,15,0,0,3,4,0,1,125,52,177
p_184,0,12,e_0,392,514,566,15,0,0,2,4,0,1,122,52,174
p_131,0,14,e_3,471,504,568,11,1,0,11,4,0,1,33,64,97
p_98,0,7,e_2,515,541,570,28,11,11,8,4,0,1,26,29,55
p_97,0,7,e_2,516,541,570,28,11,11,8,4,0,1,25,29,54
p_188,0,13,e_0,384,514,571,15,0,0,5,4,0,1,130,57,187
p_146,0,1,e_1,453,566,573,15,0,0,1,4,0,1,113,7,120
p_134,0,15,e_3,467,504,573,12,1,0,12,4,0,1,37,69,106
p_86,0,2,e_1,544,566,578,21,6,6,7,4,0,1,22,12,34
p_181,0,15,e_0,398,514,579,15,0,0,0,4,0,1,116,65,181
p_163,0,10,e_2,419,541,581,15,0,0,2,4,0,1,122,40,162
p_164,0,11,e_2,418,541,586,15,0,0,3,4,0,1,123,45,168
p_162,0,11,e_2,420,541,586,15,0,0,2,4,0,1,121,45,166
p_91,0,12,e_2,526,541,591,26,9,9,5,4,0,1,15,50,65
p_150,0,6,e_1,443,566,592,15,0,0,4,4,0,1,123,26,149
p_93,0,13,e_2,520,541,596,27,10,10,7,4,0,1,21,55,76
p_90,0,13,e_2,527,541,596,25,9,9,4,4,0,1,14,55,69
p_154,0,7,e_1,436,566,597,15,0,0,6,4,0,1,130,31,161
p_95,0,14,e_2,518,541,601,27,10,10,7,4,0,1,23,60,83
p_148,0,8,e_1,449,566,602,15,0,0,2,4,0,1,117,36,153
p_83,0,8,e_1,549,566,602,20,5,5,5,4,0,1,17,36,53
p_160,0,15,e_2,426,541,606,15,0,0,0,3,0,0,115,65,180
p_153,0,9,e_1,437,566,607,15,0,0,6,4,0,1,129,41,170
p_147,0,9,e_1,452,566,607,15,0,0,1,4,0,1,114,41,155
p_144,0,9,e_1,455,566,607,15,0,0,0,3,0,0,111,41,152
p_145,0,11,e_1,454,566,615,15,0,0,0,4,0,1,112,49,161
p_84,0,12,e_1,546,566,620,21,6,6,6,4,0,1,20,54,74
p_119,0,1,e_3,483,620,625,7,1,0,7,4,0,1,137,5,142
p_152,0,15,e_1,441,566,631,15,0,0,5,4,0,1,125,65,190
p_151,0,15,e_1,442,566,631,15,0,0,4,4,0,1,124,65,189
p_149,0,15,e_1,444,566,631,15,0,0,4,4,0,1,122,65,187
p_85,0,15,e_1,545,566,631,21,6,6,7,4,0,1,21,65,86
p_114,0,3,e_3,488,620,633,5,1,0,5,4,0,1,132,13,145
p_124,0,7,e_3,478,620,647,8,1,0,8,4,0,1,142,27,169
p_118,0,7,e_3,484,620,647,6,1,0,6,4,0,1,136,27,163
p_102,0,7,e_0,509,626,649,29,12,12,1,4,0,1,117,23,140
p_101,0,8,e_0,511,626,654,29,11,11,1,4,0,1,115,28,143
p_115,0,9,e_3,487,620,655,5,1,0,5,4,0,1,133,35,168
p_100,0,9,e_0,513,626,659,29,11,11,0,3,0,0,113,33,146
p_127,0,10,e_3,475,620,660,9,1,0,9,4,0,1,145,40,185
p_117,0,10,e_3,485,620,660,6,1,0,6,4,0,1,135,40,175
p_116,0,10,e_3,486,620,660,6,1,0,6,4,0,1,134,40,174
p_128,0,11,e_3,474,620,665,10,1,0,10,4,0,1,146,45,191
p_123,0,11,e_3,479,620,665,8,1,0,8,4,0,1,141,45,186
p_121,0,11,e_3,481,620,665,7,1,0,7,4,0,1,139,45,184
p_120,0,11,e_3,482,620,665,7,1,0,7,4,0,1,138,45,183
p_88,0,5,e_2,538,653,670,22,8,8,1,4,0,1,115,17,132
p_126,0,12,e_3,476,620,670,9,1,0,9,4,0,1,144,50,194
p_32,0,6,e_2,650,653,675,22,7,7,1,4,0,1,3,22,25
p_125,0,14,e_3,477,620,678,9,1,0,9,4,0,1,143,58,201
p_87,0,8,e_2,539,653,683,22,7,7,0,4,0,1,114,30,144
p_122,0,15,e_3,480,620,683,8,1,0,8,4,0,1,140,63,203
p_89,0,9,e_2,535,653,688,23,8,8,2,4,0,1,118,35,153
p_35,0,9,e_2,630,653,688,28,9,9,7,4,0,1,23,35,58
p_77,0,3,e_1,557,678,691,19,4,4,3,4,0,1,121,13,134
p_72,0,3,e_1,562,678,691,18,3,3,1,4,0,1,116,13,129
p_71,0,3,e_1,564,678,691,17,3,3,0,4,0,1,114,13,127
p_70,0,3,e_1,565,678,691,17,3,3,0,3,0,0,113,13,126
p_30,0,3,e_1,668,678,691,18,4,4,3,4,0,1,10,13,23
p_75,0,5,e_1,559,678,699,18,3,3,2,4,0,1,119,21,140
p_34,0,12,e_2,646,653,699,23,7,7,2,4,0,1,7,46,53
p_76,0,6,e_1,558,678,704,18,4,4,2,4,0,1,120,26,146
p_31,0,6,e_1,666,678,704,19,4,4,4,4,0,1,12,26,38
p_36,0,13,e_2,628,653,704,28,9,9,8,4,0,1,25,51,76
p_80,0,7,e_1,552,678,709,20,5,5,4,4,0,1,126,31,157
p_74,0,7,e_1,560,678,709,18,3,3,2,4,0,1,118,31,149
p_33,0,15,e_2,649,653,712,23,7,7,1,4,0,1,4,59,63
p_24,0,2,e_0,695,714,722,11,1,0,6,4,0,1,19,8,27
p_73,0,11,e_1,561,678,723,18,3,3,1,4,0,1,117,45,162
p_78,0,12,e_1,556,678,728,19,4,4,3,4,0,1,122,50,172
p_113,0,1,e_3,489,730,735,5,1,0,5,4,0,1,241,5,246
p_65,0,1,e_3,573,730,735,15,1,0,15,4,0,1,157,5,162
p_82,0,14,e_1,550,678,736,20,5,5,5,4,0,1,128,58,186
p_81,0,14,e_1,551,678,736,20,5,5,5,4,0,1,127,58,185
p_79,0,14,e_1,553,678,736,19,5,5,4,4,0,1,125,58,183
p_26,0,8,e_0,684,714,742,15,1,0,9,3,0,0,30,28,58
p_25,0,8,e_0,686,714,742,14,1,0,9,4,0,1,28,28,56
p_106,0,3,e_3,500,730,743,1,1,0,1,4,0,1,230,13,243
p_67,0,3,e_3,568,730,743,16,2,2,14,5,1,1,162,13,175
p_66,0,3,e_3,569,730,743,16,2,2,14,5,1,1,161,13,174
p_108,0,6,e_3,496,730,754,2,1,0,2,4,0,1,234,24,258
p_23,0,12,e_0,711,714,756,6,1,0,1,4,0,1,3,42,45
p_111,0,8,e_3,491,730,762,4,1,0,4,4,0,1,239,32,271
p_112,0,11,e_3,490,730,773,4,1,0,4,4,0,1,240,43,283
p_110,0,11,e_3,492,730,773,4,1,0,4,4,0,1,238,43,281
p_107,0,11,e_3,499,730,773,1,1,0,1,4,0,1,231,43,274
p_105,0,12,e_3,502,730,778,0,1,0,0,4,0,1,228,48,276
p_68,0,13,e_3,567,730,783,16,2,2,14,2,2,1,163,53,216
p_104,0,14,e_3,503,730,788,0,0,0,0,3,0,0,227,58,285
p_69,0,14,e_3,566,730,788,16,3,3,14,5,2,1,164,58,222
p_21,0,4,e_2,731,779,793,30,9,9,15,3,0,0,48,14,62
p_109,0,15,e_3,493,730,793,3,1,0,3,4,0,1,237,63,300
p_29,0,5,e_1,670,780,797,18,3,3,2,4,0,1,110,17,127
p_27,0,10,e_1,677,780,814,16,2,2,0,3,0,0,103,34,137
p_18,0,10,e_1,766,780,814,21,6,6,4,4,0,1,14,34,48
p_17,0,10,e_1,776,780,814,18,5,5,1,4,0,1,4,34,38
p_28,0,11,e_1,676,780,819,16,3,3,0,4,0,1,104,39,143
p_19,0,11,e_1,754,780,819,24,7,7,8,4,0,1,26,39,65
p_20,0,14,e_2,734,779,825,29,9,9,15,4,0,1,45,46,91
p_16,0,2,e_0,780,819,827,18,4,4,12,3,0,0,39,8,47
p_14,0,4,e_0,794,819,835,15,1,0,8,4,0,1,25,16,41
p_55,0,3,e_3,585,840,851,11,1,0,11,4,0,1,255,11,266
p_54,0,3,e_3,586,840,851,11,1,0,11,4,0,1,254,11,265
p_52,0,3,e_3,588,840,851,10,1,0,10,4,0,1,252,11,263
p_15,0,9,e_0,793,819,852,15,1,0,8,4,0,1,26,33,59
p_11,0,9,e_0,807,819,852,11,1,0,4,4,0,1,12,33,45
p_64,0,4,e_3,574,840,856,15,1,0,15,4,0,1,266,16,282
p_13,0,11,e_0,796,819,860,14,1,0,7,4,0,1,23,41,64
p_12,0,11,e_0,798,819,860,14,1,0,7,4,0,1,21,41,62
p_61,0,6,e_3,579,840,864,13,1,0,13,4,0,1,261,24,285
p_56,0,6,e_3,584,840,864,12,1,0,12,4,0,1,256,24,280
p_50,0,7,e_3,590,840,869,10,1,0,10,4,0,1,250,29,279
p_53,0,9,e_3,587,840,877,11,1,0,11,4,0,1,253,37,290
p_51,0,9,e_3,589,840,877,10,1,0,10,4,0,1,251,37,288
p_60,0,10,e_3,580,840,882,13,1,0,13,4,0,1,260,42,302
p_58,0,11,e_3,582,840,887,12,1,0,12,4,0,1,258,47,305
p_57,0,11,e_3,583,840,887,12,1,0,12,4,0,1,257,47,304
p_9,0,2,e_1,846,882,890,26,10,10,11,3,0,0,36,8,44
p_6,0,3,e_1,877,882,895,19,5,5,1,4,0,1,5,13,18
p_63,0,13,e_3,577,840,895,14,1,0,14,4,0,1,263,55,318
p_62,0,13,e_3,578,840,895,14,1,0,14,4,0,1,262,55,317
p_59,0,14,e_3,581,840,900,13,1,0,13,4,0,1,259,60,319
p_7,0,5,e_1,875,882,903,19,6,6,2,4,0,1,7,21,28
p_8,0,11,e_1,874,882,923,20,6,6,2,4,0,1,8,41,49
p_4,0,1,e_0,886,919,924,17,3,3,11,4,0,1,33,5,38
p_1,0,5,e_0,894,919,938,15,2,2,8,4,0,1,25,19,44
p_5,0,8,e_0,883,919,949,18,4,4,11,3,0,0,36,30,66
p_3,0,8,e_0,888,919,949,17,3,3,10,4,0,1,31,30,61
p_45,0,2,e_3,595,944,952,8,1,0,8,4,0,1,349,8,357
p_22,0,3,e_3,719,944,957,3,1,0,3,4,0,1,225,13,238
p_2,0,11,e_0,892,919,960,16,3,3,9,4,0,1,27,41,68
p_48,0,4,e_3,592,944,962,9,1,0,9,4,0,1,352,18,370
p_46,0,4,e_3,594,944,962,8,1,0,8,4,0,1,350,18,368
p_42,0,6,e_3,598,944,970,7,1,0,7,4,0,1,346,26,372
p_43,0,7,e_3,597,944,975,7,1,0,7,4,0,1,347,31,378
p_44,0,8,e_3,596,944,980,8,1,0,8,4,0,1,348,36,384
p_10,0,8,e_3,835,944,980,1,1,0,1,4,0,1,109,36,145
p_47,0,9,e_3,593,944,985,9,1,0,9,4,0,1,351,41,392
p_37,0,9,e_3,615,944,985,1,1,0,1,4,0,1,329,41,370
p_41,0,11,e_3,600,944,993,6,1,0,6,4,0,1,344,49,393
p_39,0,12,e_3,607,944,998,4,1,0,4,4,0,1,337,54,391
p_40,0,13,e_3,602,944,1003,6,1,0,6,4,0,1,342,59,401
p_38,0,13,e_3,608,944,1003,4,1,0,4,4,0,1,336,59,395
p_49,0,14,e_3,591,944,1008,9,1,0,9,4,0,1,353,64,417
p_300,0,4,e_0,8,9,25,0,0,0,0,3,0,0,1,16,17
p_299,0,5,e_1,9,10,29,0,0,0,0,3,0,0,1,19,20
p_297,0,6,e_3,15,16,38,0,0,0,0,3,0,0,1,22,23
p_298,0,9,e_2,11,12,43,0,0,0,0,3,0,0,1,31,32
p_296,0,4,e_0,28,43,57,9,1,1,4,3,0,0,15,14,29
p_295,0,5,e_0,29,43,62,9,1,1,4,4,0,1,14,19,33
p_292,0,6,e_0,38,43,67,6,0,0,1,4,0,1,5,24,29
p_290,0,6,e_0,40,43,67,6,0,0,1,4,0,1,3,24,27
p_286,0,3,e_1,46,61,72,6,0,0,5,4,0,1,15,11,26
p_289,0,4,e_1,43,61,77,6,0,0,5,3,0,0,18,16,34
p_285,0,4,e_1,53,61,77,6,0,0,2,4,0,1,8,16,24
p_284,0,4,e_1,54,61,77,6,0,0,2,4,0,1,7,16,23
p_287,0,5,e_1,45,61,82,6,0,0,5,4,0,1,16,21,37
p_291,0,11,e_0,39,43,84,6,0,0,1,4,0,1,4,41,45
p_294,0,12,e_0,31,43,89,8,1,1,4,4,0,1,12,46,58
p_293,0,12,e_0,33,43,89,7,1,1,3,4,0,1,10,46,56
p_288,0,8,e_1,44,61,93,6,0,0,5,4,0,1,17,32,49
p_281,0,1,e_3,73,87,94,4,1,0,4,4,0,1,14,7,21
p_283,0,9,e_1,57,61,98,6,0,0,1,4,0,1,4,37,41
p_278,0,2,e_3,77,87,99,3,1,0,3,4,0,1,10,12,22
p_279,0,5,e_3,76,87,110,3,1,0,3,4,0,1,11,23,34
p_277,0,6,e_3,82,87,115,1,1,0,1,4,0,1,5,28,33
p_282,0,7,e_3,66,87,120,6,0,0,6,3,0,0,21,33,54
p_273,0,4,e_2,110,118,132,23,4,4,2,4,0,1,8,14,22
p_276,0,11,e_3,84,87,134,1,1,0,1,4,0,1,3,47,50
p_280,0,14,e_3,75,87,145,4,1,0,4,4,0,1,12,58,70
p_275,0,14,e_3,86,87,145,0,0,0,0,3,0,0,1,58,59
p_274,0,8,e_2,88,118,146,28,7,7,9,3,0,0,30,28,58
p_272,0,10,e_2,113,118,154,22,4,4,1,4,0,1,5,36,41
p_271,0,1,e_1,121,151,156,21,2,2,9,3,0,0,30,5,35
p_267,0,1,e_1,148,151,156,14,0,0,1,4,0,1,3,5,8
p_268,0,2,e_1,144,151,161,14,0,0,2,4,0,1,7,10,17
p_270,0,9,e_1,122,151,184,21,2,2,9,4,0,1,29,33,62
p_269,0,9,e_1,127,151,184,19,2,2,8,4,0,1,24,33,57
p_255,0,3,e_2,184,186,197,14,0,0,0,4,0,1,2,11,13
p_265,0,4,e_2,152,186,202,14,0,0,10,5,1,0,34,16,50
p_254,0,4,e_0,187,190,204,14,0,0,1,4,0,1,3,14,17
p_262,0,5,e_2,157,186,207,14,0,0,9,4,0,1,29,21,50
p_261,0,5,e_2,164,186,207,14,0,0,7,4,0,1,22,21,43
p_266,0,6,e_0,151,190,212,14,0,0,12,3,0,0,39,22,61
p_263,0,7,e_2,154,186,215,14,0,0,10,4,0,1,32,29,61
p_260,0,7,e_2,165,186,215,14,0,0,7,4,0,1,21,29,50
p_258,0,7,e_2,168,186,215,14,0,0,6,4,0,1,18,29,47
p_256,0,10,e_2,182,186,226,14,0,0,1,4,0,1,4,40,44
p_250,0,2,e_1,217,220,228,14,0,0,1,4,0,1,3,8,11
p_264,0,11,e_2,153,186,231,14,0,0,10,2,1,1,33,45,78
p_253,0,5,e_1,190,220,239,14,0,0,9,3,0,0,30,19,49
p_252,0,5,e_1,205,220,239,14,0,0,5,4,0,1,15,19,34
p_257,0,14,e_2,169,186,242,14,0,0,5,4,0,1,17,56,73
p_259,0,15,e_2,167,186,247,14,0,0,6,4,0,1,19,61,80
p_251,0,15,e_1,209,220,271,14,0,0,3,4,0,1,11,51,62
p_248,0,5,e_0,246,260,277,14,0,0,4,4,0,1,14,17,31
p_247,0,5,e_0,250,260,277,14,0,0,3,4,0,1,10,17,27
p_249,0,6,e_0,239,260,282,14,0,0,6,3,0,0,21,22,43
p_241,0,1,e_0,283,302,309,8,1,0,6,4,0,1,19,7,26
p_236,0,1,e_3,305,307,312,0,1,0,0,4,0,1,2,5,7
p_245,0,7,e_0,269,302,329,12,1,0,3,5,2,0,33,27,60
p_237,0,7,e_3,304,307,332,1,1,0,1,4,0,1,3,25,28
p_242,0,8,e_0,277,302,334,10,1,0,5,5,1,1,25,32,57
p_240,0,9,e_0,301,302,339,2,1,0,0,3,0,0,1,37,38
p_246,0,10,e_3,262,307,343,14,0,0,14,3,0,0,45,36,81
p_239,0,11,e_3,302,307,348,1,1,0,1,4,0,1,5,41,46
p_244,0,12,e_3,271,307,353,12,1,0,12,4,0,1,36,46,82
p_238,0,13,e_3,303,307,358,1,1,0,1,4,0,1,4,51,55
p_233,0,1,e_1,311,356,361,29,6,6,15,4,0,1,45,5,50
p_226,0,2,e_1,329,356,366,24,6,6,9,4,0,1,27,10,37
p_223,0,2,e_1,336,356,366,22,5,5,6,4,0,1,20,10,30
p_243,0,15,e_3,272,307,366,11,1,0,11,4,0,1,35,59,94
p_209,0,2,e_2,357,358,368,17,1,1,0,3,0,0,1,10,11
p_230,0,3,e_1,319,356,371,27,6,6,12,4,0,1,37,15,52
p_228,0,4,e_1,325,356,376,25,6,6,10,4,0,1,31,20,51
p_232,0,5,e_1,314,356,381,29,6,6,14,4,0,1,42,25,67
p_225,0,5,e_1,330,356,381,23,6,6,8,4,0,1,26,25,51
p_224,0,5,e_1,331,356,381,23,5,5,8,4,0,1,25,25,50
p_222,0,5,e_1,337,356,381,22,5,5,6,4,0,1,19,25,44
p_221,0,6,e_1,339,356,386,21,5,5,5,4,0,1,17,30,47
p_220,0,6,e_1,341,356,386,20,5,5,5,4,0,1,15,30,45
p_234,0,8,e_2,310,358,388,29,7,7,15,3,0,0,48,30,78
p_231,0,7,e_1,317,356,391,28,6,6,13,4,0,1,39,35,74
p_205,0,2,e_0,362,388,396,16,1,1,8,4,0,1,26,8,34
p_235,0,8,e_1,308,356,396,30,7,7,15,3,0,0,48,40,88
p_200,0,4,e_0,367,388,404,15,0,0,7,4,0,1,21,16,37
p_196,0,4,e_0,371,388,404,15,0,0,5,4,0,1,17,16,33
p_201,0,5,e_0,366,388,409,15,0,0,7,4,0,1,22,21,43
p_227,0,12,e_1,327,356,410,24,6,6,9,4,0,1,29,54,83
p_208,0,6,e_0,358,388,414,17,1,1,9,3,0,0,30,26,56
p_194,0,6,e_0,373,388,414,15,0,0,5,4,0,1,15,26,41
p_229,0,13,e_1,320,356,415,27,6,6,12,4,0,1,36,59,95
p_183,0,1,e_2,396,416,421,15,0,0,6,4,0,1,20,5,25
p_198,0,9,e_0,369,388,425,15,0,0,6,4,0,1,19,37,56
p_182,0,2,e_2,397,416,426,15,0,0,6,4,0,1,19,10,29
p_180,0,2,e_2,399,416,426,15,0,0,5,4,0,1,17,10,27
p_197,0,10,e_0,370,388,430,15,0,0,6,4,0,1,18,42,60
p_178,0,3,e_2,401,416,431,15,0,0,5,4,0,1,15,15,30
p_207,0,11,e_0,359,388,435,17,1,1,9,4,0,1,29,47,76
p_186,0,4,e_2,390,416,436,15,0,0,8,4,0,1,26,20,46
p_176,0,4,e_2,403,416,436,15,0,0,4,4,0,1,13,20,33
p_206,0,12,e_0,361,388,440,16,1,1,9,4,0,1,27,52,79
p_203,0,12,e_0,364,388,440,15,1,1,8,4,0,1,24,52,76
p_204,0,14,e_0,363,388,448,16,1,1,8,4,0,1,25,60,85
p_179,0,8,e_2,400,416,450,15,0,0,5,4,0,1,16,34,50
p_202,0,15,e_0,365,388,453,15,0,0,7,4,0,1,23,65,88
p_199,0,15,e_0,368,388,453,15,0,0,6,4,0,1,20,65,85
p_195,0,15,e_0,372,388,453,15,0,0,5,4,0,1,16,65,81
p_177,0,9,e_2,402,416,455,15,0,0,4,4,0,1,14,39,53
p_185,0,10,e_2,391,416,460,15,0,0,8,4,0,1,25,44,69
p_216,0,1,e_1,347,456,463,19,3,3,3,4,0,1,109,7,116
p_173,0,11,e_2,407,416,465,15,0,0,3,4,0,1,9,49,58
p_187,0,12,e_2,389,416,470,15,0,0,8,3,0,0,27,54,81
p_184,0,12,e_2,392,416,470,15,0,0,8,4,0,1,24,54,78
p_214,0,3,e_1,349,456,471,19,3,3,2,4,0,1,107,15,122
p_165,0,4,e_1,417,456,476,15,0,0,13,4,0,1,39,20,59
p_175,0,14,e_2,405,416,478,15,0,0,3,4,0,1,11,62,73
p_174,0,14,e_2,406,416,478,15,0,0,3,4,0,1,10,62,72
p_219,0,5,e_1,342,456,481,20,4,4,4,4,0,1,114,25,139
p_181,0,15,e_2,398,416,483,15,0,0,6,4,0,1,18,67,85
p_210,0,6,e_1,354,456,486,18,2,2,0,4,0,1,102,30,132
p_217,0,7,e_1,346,456,491,19,4,4,3,4,0,1,110,35,145
p_212,0,7,e_1,351,456,491,18,3,3,1,4,0,1,105,35,140
p_163,0,10,e_1,419,456,502,15,0,0,12,4,0,1,37,46,83
p_190,0,1,e_0,379,500,507,15,0,0,3,4,0,1,121,7,128
p_218,0,11,e_1,343,456,507,20,4,4,4,4,0,1,113,51,164
p_164,0,11,e_1,418,456,507,15,0,0,12,4,0,1,38,51,89
p_162,0,11,e_1,420,456,507,15,0,0,12,4,0,1,36,51,87
p_166,0,12,e_1,416,456,512,15,0,0,13,4,0,1,40,56,96
p_143,0,3,e_0,456,500,515,15,0,0,14,4,0,1,44,15,59
p_136,0,3,e_0,465,500,515,15,0,0,11,4,0,1,35,15,50
p_137,0,4,e_0,464,500,520,15,0,0,12,4,0,1,36,20,56
p_215,0,15,e_1,348,456,523,19,3,3,2,4,0,1,108,67,175
p_213,0,15,e_1,350,456,523,19,3,3,2,4,0,1,106,67,173
p_211,0,15,e_1,353,456,523,18,2,2,1,4,0,1,103,67,170
p_141,0,6,e_0,458,500,528,15,0,0,14,4,0,1,42,28,70
p_167,0,1,e_2,413,530,535,15,0,0,1,4,0,1,117,5,122
p_192,0,8,e_0,375,500,536,15,0,0,4,4,0,1,125,36,161
p_189,0,8,e_0,382,500,536,15,0,0,2,4,0,1,118,36,154
p_140,0,8,e_0,459,500,536,15,0,0,13,4,0,1,41,36,77
p_142,0,9,e_0,457,500,541,15,0,0,14,4,0,1,43,41,84
p_106,0,3,e_2,500,530,543,15,0,0,10,4,0,1,30,13,43
p_191,0,10,e_0,376,500,546,15,0,0,4,4,0,1,124,46,170
p_139,0,10,e_0,461,500,546,15,0,0,13,4,0,1,39,46,85
p_135,0,10,e_0,466,500,546,15,0,0,11,4,0,1,34,46,80
p_193,0,11,e_0,374,500,551,15,0,0,4,4,0,1,126,51,177
p_138,0,11,e_0,463,500,551,15,0,0,12,4,0,1,37,51,88
p_99,0,6,e_2,514,530,554,15,0,0,5,4,0,1,16,24,40
p_188,0,13,e_0,384,500,559,15,0,0,1,4,0,1,116,59,175
p_102,0,7,e_2,509,530,559,15,0,0,7,4,0,1,21,29,50
p_98,0,7,e_2,515,530,559,15,0,0,5,4,0,1,15,29,44
p_101,0,8,e_2,511,530,564,15,0,0,6,4,0,1,19,34,53
p_169,0,9,e_2,411,530,569,15,0,0,1,4,0,1,119,39,158
p_100,0,9,e_2,513,530,569,15,0,0,5,4,0,1,17,39,56
p_161,0,1,e_1,421,570,577,15,0,0,11,4,0,1,149,7,156
p_158,0,1,e_1,430,570,577,15,0,0,8,4,0,1,140,7,147
p_103,0,11,e_2,508,530,577,15,0,0,7,4,0,1,22,47,69
p_105,0,12,e_2,502,530,582,15,0,0,9,4,0,1,28,52,80
p_171,0,13,e_2,409,530,587,15,0,0,2,4,0,1,121,57,178
p_168,0,13,e_2,412,530,587,15,0,0,1,4,0,1,118,57,175
p_170,0,14,e_2,410,530,592,15,0,0,2,4,0,1,120,62,182
p_104,0,14,e_2,503,530,592,15,0,0,9,4,0,1,27,62,89
p_159,0,6,e_1,429,570,594,15,0,0,9,4,0,1,141,24,165
p_150,0,6,e_1,443,570,594,15,0,0,4,4,0,1,127,24,151
p_172,0,15,e_2,408,530,597,15,0,0,2,4,0,1,122,67,189
p_154,0,7,e_1,436,570,599,15,0,0,6,4,0,1,134,29,163
p_148,0,8,e_1,449,570,604,15,0,0,2,4,0,1,121,34,155
p_130,0,1,e_0,472,600,605,15,0,0,9,4,0,1,128,5,133
p_153,0,9,e_1,437,570,609,15,0,0,6,4,0,1,133,39,172
p_147,0,9,e_1,452,570,609,15,0,0,1,4,0,1,118,39,157
p_129,0,3,e_0,473,600,613,15,0,0,9,4,0,1,127,13,140
p_157,0,14,e_1,431,570,626,15,0,0,8,4,0,1,139,56,195
p_155,0,14,e_1,435,570,626,15,0,0,7,4,0,1,135,56,191
p_124,0,7,e_0,478,600,627,15,0,0,7,4,0,1,122,27,149
p_160,0,15,e_1,426,570,631,15,0,0,10,4,0,1,144,61,205
p_156,0,15,e_1,434,570,631,15,0,0,7,4,0,1,136,61,197
p_152,0,15,e_1,441,570,631,15,0,0,5,4,0,1,129,61,190
p_151,0,15,e_1,442,570,631,15,0,0,4,4,0,1,128,61,189
p_149,0,15,e_1,444,570,631,15,0,0,4,4,0,1,126,61,187
p_127,0,10,e_0,475,600,638,15,0,0,8,4,0,1,125,38,163
p_132,0,11,e_0,470,600,643,15,0,0,10,4,0,1,130,43,173
p_128,0,11,e_0,474,600,643,15,0,0,8,4,0,1,126,43,169
p_123,0,11,e_0,479,600,643,15,0,0,7,4,0,1,121,43,164
p_121,0,11,e_0,481,600,643,15,0,0,6,4,0,1,119,43,162
p_120,0,11,e_0,482,600,643,15,0,0,6,4,0,1,118,43,161
p_133,0,12,e_0,469,600,648,15,0,0,10,4,0,1,131,48,179
p_126,0,12,e_0,476,600,648,15,0,0,8,4,0,1,124,48,172
p_96,0,1,e_2,517,644,649,15,0,0,4,4,0,1,127,5,132
p_131,0,14,e_0,471,600,656,15,0,0,9,4,0,1,129,56,185
p_125,0,14,e_0,477,600,656,15,0,0,7,4,0,1,123,56,179
p_92,0,4,e_2,525,644,660,15,0,0,1,4,0,1,119,16,135
p_134,0,15,e_0,467,600,661,15,0,0,11,4,0,1,133,61,194
p_122,0,15,e_0,480,600,661,15,0,0,6,4,0,1,120,61,181
p_94,0,6,e_2,519,644,668,15,0,0,3,4,0,1,125,24,149
p_97,0,7,e_2,516,644,673,15,0,0,4,4,0,1,128,29,157
p_37,0,9,e_2,615,644,681,15,0,0,9,4,0,1,29,37,66
p_35,0,9,e_2,630,644,681,15,0,0,4,4,0,1,14,37,51
p_146,0,1,e_1,453,678,685,15,0,0,1,4,0,1,225,7,232
p_41,0,11,e_2,600,644,689,15,0,0,14,4,0,1,44,45,89
p_86,0,2,e_1,544,678,690,15,0,0,8,4,0,1,134,12,146
p_91,0,12,e_2,526,644,694,15,0,0,1,4,0,1,118,50,168
p_39,0,12,e_2,607,644,694,15,0,0,12,4,0,1,37,50,87
p_93,0,13,e_2,520,644,699,15,0,0,3,4,0,1,124,55,179
p_90,0,13,e_2,527,644,699,15,0,0,1,4,0,1,117,55,172
p_40,0,13,e_2,602,644,699,15,0,0,14,4,0,1,42,55,97
p_38,0,13,e_2,608,644,699,15,0,0,12,4,0,1,36,55,91
p_36,0,13,e_2,628,644,699,15,0,0,5,4,0,1,16,55,71
p_88,0,5,e_1,538,678,701,15,0,0,10,4,0,1,140,23,163
p_95,0,14,e_2,518,644,704,15,0,0,4,4,0,1,126,60,186
p_80,0,7,e_1,552,678,709,15,0,0,6,4,0,1,126,31,157
p_119,0,1,e_0,483,708,713,15,0,0,5,4,0,1,225,5,230
p_113,0,1,e_0,489,708,713,15,0,0,3,4,0,1,219,5,224
p_65,0,1,e_0,573,708,713,15,0,0,9,4,0,1,135,5,140
p_87,0,8,e_1,539,678,714,15,0,0,10,4,0,1,139,36,175
p_83,0,8,e_1,549,678,714,15,0,0,7,4,0,1,129,36,165
p_144,0,9,e_1,455,678,719,15,0,0,0,3,0,0,223,41,264
p_89,0,9,e_1,535,678,719,15,0,0,11,4,0,1,143,41,184
p_114,0,3,e_0,488,708,721,15,0,0,4,4,0,1,220,13,233
p_64,0,4,e_0,574,708,726,15,0,0,8,4,0,1,134,18,152
p_145,0,11,e_1,454,678,727,15,0,0,0,4,0,1,224,49,273
p_84,0,12,e_1,546,678,732,15,0,0,8,4,0,1,132,54,186
p_78,0,12,e_1,556,678,732,15,0,0,4,4,0,1,122,54,176
p_108,0,6,e_0,496,708,734,15,0,0,1,4,0,1,212,26,238
p_118,0,7,e_0,484,708,739,15,0,0,5,4,0,1,224,31,255
p_82,0,14,e_1,550,678,740,15,0,0,6,4,0,1,128,62,190
p_81,0,14,e_1,551,678,740,15,0,0,6,4,0,1,127,62,189
p_79,0,14,e_1,553,678,740,15,0,0,5,4,0,1,125,62,187
p_111,0,8,e_0,491,708,744,15,0,0,3,4,0,1,217,36,253
p_85,0,15,e_1,545,678,745,15,0,0,8,4,0,1,133,67,200
p_115,0,9,e_0,487,708,749,15,0,0,4,4,0,1,221,41,262
p_117,0,10,e_0,485,708,754,15,0,0,5,4,0,1,223,46,269
p_116,0,10,e_0,486,708,754,15,0,0,4,4,0,1,222,46,268
p_112,0,11,e_0,490,708,759,15,0,0,3,4,0,1,218,51,269
p_110,0,11,e_0,492,708,759,15,0,0,2,4,0,1,216,51,267
p_107,0,11,e_0,499,708,759,15,0,0,0,3,0,0,209,51,260
p_22,0,3,e_2,719,756,767,15,0,0,12,4,0,1,37,11,48
p_21,0,4,e_2,731,756,772,15,0,0,8,4,0,1,25,16,41
p_109,0,15,e_0,493,708,773,15,0,0,2,4,0,1,215,65,280
p_19,0,11,e_2,754,756,795,15,0,0,0,4,0,1,2,39,41
p_23,0,12,e_2,711,756,800,15,0,0,14,3,0,0,45,44,89
p_77,0,3,e_1,557,792,803,15,0,0,4,4,0,1,235,11,246
p_72,0,3,e_1,562,792,803,15,0,0,2,4,0,1,230,11,241
p_71,0,3,e_1,564,792,803,15,0,0,2,4,0,1,228,11,239
p_70,0,3,e_1,565,792,803,15,0,0,1,4,0,1,227,11,238
p_67,0,3,e_1,568,792,803,15,0,0,0,4,0,1,224,11,235
p_66,0,3,e_1,569,792,803,15,0,0,0,3,0,0,223,11,234
p_20,0,14,e_2,734,756,808,15,0,0,7,4,0,1,22,52,74
p_75,0,5,e_1,559,792,811,15,0,0,3,4,0,1,233,19,252
p_76,0,6,e_1,558,792,816,15,0,0,4,4,0,1,234,24,258
p_32,0,6,e_1,650,792,816,15,0,0,9,4,0,1,142,24,166
p_74,0,7,e_1,560,792,821,15,0,0,3,4,0,1,232,29,261
p_55,0,3,e_0,585,820,831,15,0,0,5,4,0,1,235,11,246
p_54,0,3,e_0,586,820,831,15,0,0,4,4,0,1,234,11,245
p_52,0,3,e_0,588,820,831,15,0,0,4,4,0,1,232,11,243
p_73,0,11,e_1,561,792,835,15,0,0,3,4,0,1,231,43,274
p_34,0,12,e_1,646,792,840,15,0,0,10,4,0,1,146,48,194
p_61,0,6,e_0,579,820,842,15,0,0,7,4,0,1,241,22,263
p_56,0,6,e_0,584,820,842,15,0,0,5,4,0,1,236,22,258
p_68,0,13,e_1,567,792,845,15,0,0,1,4,0,1,225,53,278
p_50,0,7,e_0,590,820,847,15,0,0,3,4,0,1,230,27,257
p_69,0,14,e_1,566,792,850,15,0,0,1,4,0,1,226,58,284
p_53,0,9,e_0,587,820,855,15,0,0,4,4,0,1,233,35,268
p_51,0,9,e_0,589,820,855,15,0,0,3,4,0,1,231,35,266
p_33,0,15,e_1,649,792,855,15,0,0,9,4,0,1,143,63,206
p_60,0,10,e_0,580,820,860,15,0,0,6,4,0,1,240,40,280
p_58,0,11,e_0,582,820,865,15,0,0,6,4,0,1,238,45,283
p_57,0,11,e_0,583,820,865,15,0,0,5,4,0,1,237,45,282
p_63,0,13,e_0,577,820,873,15,0,0,7,4,0,1,243,53,296
p_62,0,13,e_0,578,820,873,15,0,0,7,4,0,1,242,53,295
p_59,0,14,e_0,581,820,878,15,0,0,6,4,0,1,239,58,297
p_49,0,14,e_0,591,820,878,15,0,0,3,4,0,1,229,58,287
p_9,0,2,e_2,846,880,888,15,0,0,11,4,0,1,34,8,42
p_6,0,3,e_2,877,880,893,15,0,0,1,4,0,1,3,13,16
p_7,0,5,e_2,875,880,901,15,0,0,1,4,0,1,5,21,26
p_4,0,1,e_1,886,902,907,15,0,0,5,4,0,1,16,5,21
p_16,0,2,e_1,780,902,912,15,0,0,4,4,0,1,122,10,132
p_10,0,8,e_2,835,880,912,15,0,0,14,3,0,0,45,32,77
p_30,0,3,e_1,668,902,917,15,0,0,3,4,0,1,234,15,249
p_8,0,11,e_2,874,880,923,15,0,0,2,4,0,1,6,43,49
p_29,0,5,e_1,670,902,925,15,0,0,2,4,0,1,232,23,255
p_1,0,5,e_1,894,902,925,15,0,0,2,4,0,1,8,23,31
p_45,0,2,e_0,595,922,930,15,0,0,1,4,0,1,327,8,335
p_24,0,2,e_0,695,922,930,15,0,0,4,4,0,1,227,8,235
p_31,0,6,e_1,666,902,930,15,0,0,4,4,0,1,236,28,264
p_48,0,4,e_0,592,922,938,15,0,0,2,4,0,1,330,16,346
p_46,0,4,e_0,594,922,938,15,0,0,2,4,0,1,328,16,344
p_14,0,4,e_0,794,922,938,15,0,0,8,4,0,1,128,16,144
p_5,0,8,e_1,883,902,938,15,0,0,6,4,0,1,19,36,55
p_3,0,8,e_1,888,902,938,15,0,0,4,4,0,1,14,36,50
p_42,0,6,e_0,598,922,946,15,0,0,0,4,0,1,324,24,348
p_27,0,10,e_1,677,902,946,15,0,0,0,3,0,0,225,44,269
p_18,0,10,e_1,766,902,946,15,0,0,8,4,0,1,136,44,180
p_17,0,10,e_1,776,902,946,15,0,0,5,4,0,1,126,44,170
p_43,0,7,e_0,597,922,951,15,0,0,1,4,0,1,325,29,354
p_28,0,11,e_1,676,902,951,15,0,0,0,4,0,1,226,49,275
p_2,0,11,e_1,892,902,951,15,0,0,3,4,0,1,10,49,59
p_44,0,8,e_0,596,922,956,15,0,0,1,4,0,1,326,34,360
p_26,0,8,e_0,684,922,956,15,0,0,8,4,0,1,238,34,272
p_25,0,8,e_0,686,922,956,15,0,0,7,4,0,1,236,34,270
p_47,0,9,e_0,593,922,961,15,0,0,2,4,0,1,329,39,368
p_15,0,9,e_0,793,922,961,15,0,0,9,4,0,1,129,39,168
p_11,0,9,e_0,807,922,961,15,0,0,4,4,0,1,115,39,154
p_13,0,11,e_0,796,922,969,15,0,0,8,4,0,1,126,47,173
p_12,0,11,e_0,798,922,969,15,0,0,7,4,0,1,124,47,171
p_300,0,4,e_0,8,9,25,0,0,0,0,3,0,0,1,16,17
p_299,0,5,e_1,9,10,29,0,0,0,0,3,0,0,1,19,20
p_297,0,6,e_3,15,16,38,0,0,0,0,3,0,0,1,22,23
p_298,0,9,e_2,11,12,43,0,0,0,0,3,0,0,1,31,32
p_296,0,4,e_0,28,43,57,9,1,1,4,3,0,0,15,14,29
p_286,0,3,e_1,46,47,60,4,1,0,0,3,0,0,1,13,14
p_290,0,6,e_0,40,43,65,6,1,0,1,4,0,1,3,22,25
p_295,0,5,e_1,29,47,68,9,1,1,5,3,0,0,18,21,39
p_287,0,5,e_1,45,47,68,4,1,0,0,4,0,1,2,21,23
p_285,0,4,e_3,53,59,73,2,1,0,2,4,0,1,6,14,20
p_284,0,4,e_3,54,59,73,1,1,0,1,4,0,1,5,14,19
p_288,0,8,e_1,44,47,79,5,1,0,1,4,0,1,3,32,35
p_292,0,6,e_3,38,59,81,6,0,0,6,3,0,0,21,22,43
p_291,0,11,e_0,39,43,82,6,1,0,1,4,0,1,4,39,43
p_294,0,12,e_0,31,43,87,8,1,1,4,4,0,1,12,44,56
p_293,0,12,e_0,33,43,87,7,1,1,3,4,0,1,10,44,54
p_289,0,4,e_2,43,73,87,5,1,0,9,3,0,0,30,14,44
p_283,0,9,e_3,57,59,92,0,1,0,0,4,0,1,2,33,35
p_282,0,7,e_2,66,73,98,16,3,3,2,4,0,1,7,25,32
p_281,0,1,e_1,73,105,110,14,2,2,6,5,1,0,32,5,37
p_278,0,2,e_1,77,105,115,13,2,2,8,5,1,1,28,10,38
p_279,0,5,e_1,76,105,126,13,2,2,7,5,1,1,29,21,50
p_271,0,1,e_0,121,125,130,7,1,0,1,4,0,1,4,5,9
p_277,0,6,e_1,82,105,131,12,1,1,7,4,0,1,23,26,49
p_274,0,8,e_1,88,105,139,10,1,1,5,4,0,1,17,34,51
p_273,0,4,e_2,110,134,148,9,0,0,7,3,0,0,24,14,38
p_276,0,11,e_1,84,105,150,11,1,1,7,4,0,1,21,45,66
p_270,0,9,e_0,122,125,156,7,1,0,1,4,0,1,3,31,34
p_280,0,14,e_1,75,105,161,14,2,2,7,5,1,1,30,56,86
p_269,0,9,e_2,127,134,165,5,1,0,2,4,0,1,7,31,38
p_275,0,14,e_0,86,125,173,11,1,1,12,2,1,0,39,48,87
p_272,0,10,e_3,113,143,175,9,0,0,9,3,0,0,30,32,62
p_267,0,1,e_2,148,194,199,19,2,2,4,5,1,0,46,5,51
p_255,0,3,e_2,184,194,207,7,1,0,3,4,0,1,10,13,23
p_265,0,4,e_2,152,194,212,17,2,2,5,5,1,1,42,18,60
p_254,0,4,e_2,187,194,212,6,1,0,2,4,0,1,7,18,25
p_268,0,2,e_3,144,207,215,20,1,1,0,5,1,0,63,8,71
p_253,0,5,e_2,190,194,217,5,1,0,1,4,0,1,4,23,27
p_261,0,5,e_1,164,205,222,13,2,2,13,4,0,1,41,17,58
p_263,0,7,e_2,154,194,225,17,2,2,6,5,1,1,40,31,71
p_260,0,7,e_2,165,194,225,13,2,2,9,4,0,1,29,31,60
p_258,0,7,e_2,168,194,225,12,2,2,8,4,0,1,26,31,57
p_252,0,5,e_3,205,207,226,0,1,0,0,4,0,1,2,19,21
p_266,0,6,e_1,151,205,227,18,2,2,11,5,1,0,54,22,76
p_262,0,5,e_0,157,217,234,16,2,2,9,5,1,0,60,17,77
p_256,0,10,e_2,182,194,236,8,1,0,4,4,0,1,12,42,54
p_264,0,11,e_2,153,194,241,17,2,2,5,5,1,1,41,47,88
p_250,0,2,e_3,217,243,251,8,1,1,2,5,1,0,26,8,34
p_257,0,14,e_2,169,194,252,12,2,2,8,4,0,1,25,58,83
p_259,0,15,e_2,167,194,257,12,2,2,9,4,0,1,27,63,90
p_251,0,15,e_0,209,217,266,10,2,2,2,4,0,1,8,49,57
p_247,0,5,e_3,250,259,276,2,0,0,2,2,1,0,9,17,26
p_248,0,5,e_1,246,260,277,3,1,1,4,4,0,1,14,17,31
p_249,0,6,e_1,239,260,282,1,1,0,6,3,0,0,21,22,43
p_241,0,1,e_1,283,304,311,4,1,0,6,3,0,0,21,7,28
p_236,0,1,e_2,305,310,315,13,1,1,1,4,0,1,5,5,10
p_242,0,8,e_3,277,295,321,5,0,0,5,3,0,0,18,26,44
p_233,0,1,e_0,311,317,322,11,1,1,2,4,0,1,6,5,11
p_237,0,7,e_2,304,310,335,13,1,1,2,4,0,1,6,25,31
p_232,0,5,e_0,314,317,336,10,1,1,1,4,0,1,3,19,22
p_240,0,9,e_1,301,304,337,14,1,1,1,4,0,1,3,33,36
p_235,0,8,e_2,308,310,340,12,1,1,0,4,0,1,2,30,32
p_245,0,7,e_0,269,317,344,7,1,1,15,3,0,0,48,27,75
p_239,0,11,e_1,302,304,345,14,1,1,0,4,0,1,2,41,43
p_246,0,10,e_2,262,310,348,9,1,1,15,3,0,0,48,38,86
p_234,0,8,e_0,310,317,349,11,1,1,2,4,0,1,7,32,39
p_238,0,13,e_1,303,304,353,14,1,1,0,3,0,0,1,49,50
p_244,0,12,e_2,271,310,356,6,1,1,13,4,0,1,39,46,85
p_226,0,2,e_3,329,347,357,6,1,0,6,4,0,1,18,10,28
p_223,0,2,e_3,336,347,357,3,1,0,3,4,0,1,11,10,21
p_230,0,3,e_3,319,347,362,8,2,2,8,5,1,1,28,15,43
p_243,0,15,e_2,272,310,367,6,1,1,12,4,0,1,38,57,95
p_228,0,4,e_3,325,347,367,7,1,0,7,4,0,1,22,20,42
p_225,0,5,e_3,330,347,372,5,1,0,5,4,0,1,17,25,42
p_224,0,5,e_3,331,347,372,5,1,0,5,4,0,1,16,25,41
p_222,0,5,e_3,337,347,372,3,1,0,3,4,0,1,10,25,35
p_219,0,5,e_3,342,347,372,1,1,0,1,4,0,1,5,25,30
p_221,0,6,e_3,339,347,377,2,1,0,2,4,0,1,8,30,38
p_220,0,6,e_3,341,347,377,2,1,0,2,4,0,1,6,30,36
p_216,0,1,e_0,347,375,382,26,10,10,8,5,1,0,28,7,35
p_231,0,7,e_3,317,347,382,9,1,1,7,5,1,0,30,35,65
p_217,0,7,e_3,346,347,382,0,0,0,0,3,0,0,1,35,36
p_209,0,2,e_0,357,375,387,24,8,8,6,4,0,1,18,12,30
p_205,0,2,e_0,362,375,387,23,7,7,4,4,0,1,13,12,25
p_214,0,3,e_0,349,375,392,26,9,9,8,4,0,1,26,17,43
p_218,0,11,e_3,343,347,396,1,1,0,1,4,0,1,4,49,53
p_200,0,4,e_0,367,375,397,22,6,6,2,4,0,1,8,22,30
p_190,0,1,e_1,379,395,400,20,4,4,5,4,0,1,16,5,21
p_227,0,12,e_3,327,347,401,6,1,0,6,4,0,1,20,54,74
p_210,0,6,e_0,354,375,405,25,9,9,7,4,0,1,21,30,51
p_208,0,6,e_0,358,375,405,24,8,8,5,4,0,1,17,30,47
p_229,0,13,e_3,320,347,406,8,1,1,8,2,1,1,27,59,86
p_212,0,7,e_0,351,375,410,26,9,9,8,4,0,1,24,35,59
p_186,0,4,e_1,390,395,411,17,3,3,1,4,0,1,5,16,21
p_183,0,1,e_2,396,414,421,15,2,2,6,4,0,1,18,7,25
p_207,0,11,e_0,359,375,424,24,8,8,5,4,0,1,16,49,65
p_192,0,8,e_1,375,395,425,20,5,5,6,4,0,1,20,30,50
p_189,0,8,e_1,382,395,425,19,3,3,4,4,0,1,13,30,43
p_182,0,2,e_2,397,414,426,15,2,2,5,4,0,1,17,12,29
p_180,0,2,e_2,399,414,426,14,2,2,5,4,0,1,15,12,27
p_206,0,12,e_0,361,375,429,23,7,7,4,4,0,1,14,54,68
p_203,0,12,e_0,364,375,429,23,7,7,3,4,0,1,11,54,65
p_178,0,3,e_2,401,414,431,14,1,1,4,4,0,1,13,17,30
p_191,0,10,e_1,376,395,433,20,4,4,6,4,0,1,19,38,57
p_185,0,10,e_1,391,395,433,16,3,3,1,4,0,1,4,38,42
p_176,0,4,e_2,403,414,436,14,1,1,3,4,0,1,11,22,33
p_204,0,14,e_0,363,375,437,23,7,7,4,4,0,1,12,62,74
p_187,0,12,e_1,389,395,441,17,3,3,2,4,0,1,6,46,52
p_184,0,12,e_1,392,395,441,16,3,3,1,4,0,1,3,46,49
p_201,0,5,e_2,366,414,441,4,6,6,15,2,1,0,48,27,75
p_215,0,15,e_0,348,375,442,26,9,9,8,2,1,1,27,67,94
p_213,0,15,e_0,350,375,442,26,9,9,8,4,0,1,25,67,92
p_202,0,15,e_0,365,375,442,22,7,7,3,4,0,1,10,67,77
p_188,0,13,e_1,384,395,446,19,3,3,3,4,0,1,11,51,62
p_179,0,8,e_2,400,414,452,14,1,1,4,4,0,1,14,38,52
p_161,0,1,e_3,421,447,452,8,1,0,8,4,0,1,26,5,31
p_158,0,1,e_3,430,447,452,5,1,0,5,4,0,1,17,5,22
p_211,0,15,e_1,353,395,454,25,9,9,13,3,0,0,42,59,101
p_177,0,9,e_2,402,414,457,14,1,1,4,4,0,1,12,43,55
p_169,0,9,e_2,411,414,457,12,1,0,1,4,0,1,3,43,46
p_165,0,4,e_3,417,447,463,10,1,0,10,4,0,1,30,16,46
p_173,0,11,e_2,407,414,465,13,1,0,2,4,0,1,7,51,58
p_159,0,6,e_3,429,447,471,6,1,0,6,4,0,1,18,24,42
p_171,0,13,e_2,409,414,473,12,1,0,1,4,0,1,5,59,64
p_154,0,7,e_3,436,447,476,3,1,0,3,4,0,1,11,29,40
p_174,0,14,e_2,406,414,478,13,1,0,2,4,0,1,8,64,72
p_170,0,14,e_2,410,414,478,12,1,0,1,4,0,1,4,64,68
p_181,0,15,e_2,398,414,483,15,2,2,5,4,0,1,16,69,85
p_172,0,15,e_2,408,414,483,13,1,0,2,4,0,1,6,69,75
p_153,0,9,e_3,437,447,484,3,1,0,3,4,0,1,10,37,47
p_163,0,10,e_3,419,447,489,9,1,0,9,4,0,1,28,42,70
p_164,0,11,e_3,418,447,494,9,1,0,9,4,0,1,29,47,76
p_162,0,11,e_3,420,447,494,9,1,0,9,4,0,1,27,47,74
p_166,0,12,e_3,416,447,499,10,1,0,10,4,0,1,31,52,83
p_143,0,3,e_0,456,489,502,28,10,10,11,4,0,1,33,13,46
p_196,0,4,e_0,371,489,507,21,5,5,1,4,0,1,118,18,136
p_175,0,14,e_3,405,447,507,13,0,0,13,2,1,0,42,60,102
p_157,0,14,e_3,431,447,507,5,1,0,5,4,0,1,16,60,76
p_155,0,14,e_3,435,447,507,4,1,0,4,4,0,1,12,60,72
p_146,0,1,e_1,453,501,508,29,10,10,15,2,1,0,48,7,55
p_113,0,1,e_1,489,501,508,20,5,5,4,4,0,1,12,7,19
p_160,0,15,e_3,426,447,512,7,1,0,7,4,0,1,21,65,86
p_156,0,15,e_3,434,447,512,4,1,0,4,4,0,1,13,65,78
p_194,0,6,e_0,373,489,515,21,5,5,0,4,0,1,116,26,142
p_141,0,6,e_0,458,489,515,27,10,10,10,4,0,1,31,26,57
p_106,0,3,e_1,500,501,516,18,3,3,0,3,0,0,1,15,16
p_148,0,8,e_0,449,489,523,30,10,10,13,4,0,1,40,34,74
p_140,0,8,e_0,459,489,523,27,10,10,10,4,0,1,30,34,64
p_108,0,6,e_1,496,501,527,19,4,4,1,4,0,1,5,26,31
p_198,0,9,e_0,369,489,528,22,6,6,2,4,0,1,120,39,159
p_147,0,9,e_0,452,489,528,29,10,10,12,4,0,1,37,39,76
p_144,0,9,e_0,455,489,528,28,10,10,11,4,0,1,34,39,73
p_142,0,9,e_0,457,489,528,28,10,10,10,4,0,1,32,39,71
p_197,0,10,e_0,370,489,533,21,6,6,1,4,0,1,119,44,163
p_111,0,8,e_1,491,501,535,20,5,5,3,4,0,1,10,34,44
p_167,0,1,e_2,413,530,535,11,1,0,0,3,0,0,117,5,122
p_96,0,1,e_2,517,530,535,14,1,0,4,4,0,1,13,5,18
p_193,0,11,e_0,374,489,538,21,5,5,0,3,0,0,115,49,164
p_145,0,11,e_0,454,489,538,29,10,10,11,4,0,1,35,49,84
p_112,0,11,e_1,490,501,546,20,5,5,3,4,0,1,11,45,56
p_110,0,11,e_1,492,501,546,19,5,5,3,4,0,1,9,45,54
p_107,0,11,e_1,499,501,546,18,3,3,0,4,0,1,2,45,47
p_199,0,15,e_0,368,489,552,22,6,6,2,4,0,1,121,63,184
p_195,0,15,e_0,372,489,552,21,5,5,1,4,0,1,117,63,180
p_99,0,6,e_2,514,530,552,15,1,0,5,4,0,1,16,22,38
p_94,0,6,e_2,519,530,552,13,1,0,3,4,0,1,11,22,33
p_102,0,7,e_2,509,530,557,16,2,2,7,4,0,1,21,27,48
p_98,0,7,e_2,515,530,557,14,1,0,5,4,0,1,15,27,42
p_97,0,7,e_2,516,530,557,14,1,0,4,4,0,1,14,27,41
p_109,0,15,e_1,493,501,560,19,4,4,2,4,0,1,8,59,67
p_101,0,8,e_2,511,530,562,15,1,1,6,4,0,1,19,32,51
p_100,0,9,e_2,513,530,567,15,1,0,5,4,0,1,17,37,54
p_86,0,2,e_3,544,559,569,5,1,0,5,4,0,1,15,10,25
p_103,0,11,e_2,508,530,575,16,2,2,7,4,0,1,22,45,67
p_105,0,12,e_2,502,530,580,17,3,3,9,4,0,1,28,50,78
p_88,0,5,e_3,538,559,580,7,1,0,7,4,0,1,21,21,42
p_168,0,13,e_2,412,530,585,11,1,0,0,4,0,1,118,55,173
p_93,0,13,e_2,520,530,585,13,1,0,3,4,0,1,10,55,65
p_150,0,6,e_3,443,559,585,1,1,0,1,4,0,1,116,26,142
p_104,0,14,e_2,503,530,590,17,3,3,9,4,0,1,27,60,87
p_95,0,14,e_2,518,530,590,13,1,0,4,4,0,1,12,60,72
p_80,0,7,e_3,552,559,590,2,1,0,2,4,0,1,7,31,38
p_87,0,8,e_3,539,559,595,6,1,0,6,4,0,1,20,36,56
p_83,0,8,e_3,549,559,595,3,1,0,3,4,0,1,10,36,46
p_89,0,9,e_3,535,559,600,8,1,0,8,4,0,1,24,41,65
p_130,0,1,e_0,472,599,606,24,8,8,5,4,0,1,127,7,134
p_84,0,12,e_3,546,559,611,4,1,0,4,4,0,1,13,52,65
p_136,0,3,e_0,465,599,614,26,9,9,8,4,0,1,134,15,149
p_129,0,3,e_0,473,599,614,24,8,8,5,4,0,1,126,15,141
p_137,0,4,e_0,464,599,619,26,9,9,8,4,0,1,135,20,155
p_82,0,14,e_3,550,559,619,3,1,0,3,4,0,1,9,60,69
p_81,0,14,e_3,551,559,619,2,1,0,2,4,0,1,8,60,68
p_79,0,14,e_3,553,559,619,2,1,0,2,4,0,1,6,60,66
p_75,0,5,e_1,559,607,624,30,10,10,15,2,1,0,48,17,65
p_152,0,15,e_3,441,559,624,2,1,0,2,4,0,1,118,65,183
p_151,0,15,e_3,442,559,624,1,1,0,1,4,0,1,117,65,182
p_149,0,15,e_3,444,559,624,1,1,0,1,4,0,1,115,65,180
p_85,0,15,e_3,545,559,624,4,1,0,4,4,0,1,14,65,79
p_139,0,10,e_0,461,599,639,26,10,10,9,4,0,1,138,40,178
p_135,0,10,e_0,466,599,639,25,9,9,7,4,0,1,133,40,173
p_127,0,10,e_0,475,599,639,23,7,7,4,4,0,1,124,40,164
p_138,0,11,e_0,463,599,644,26,9,9,8,4,0,1,136,45,181
p_132,0,11,e_0,470,599,644,24,8,8,6,4,0,1,129,45,174
p_128,0,11,e_0,474,599,644,23,8,8,5,4,0,1,125,45,170
p_41,0,11,e_1,600,607,644,21,4,4,2,4,0,1,7,37,44
p_92,0,4,e_2,525,634,648,11,1,0,1,4,0,1,109,14,123
p_133,0,12,e_0,469,599,649,24,9,9,6,4,0,1,130,50,180
p_126,0,12,e_0,476,599,649,23,7,7,4,4,0,1,123,50,173
p_40,0,13,e_1,602,607,652,21,4,4,1,4,0,1,5,45,50
p_131,0,14,e_0,471,599,657,24,8,8,6,4,0,1,128,58,186
p_125,0,14,e_0,477,599,657,23,7,7,4,4,0,1,122,58,180
p_134,0,15,e_0,467,599,662,25,9,9,7,4,0,1,132,63,195
p_37,0,9,e_2,615,634,665,17,3,3,6,4,0,1,19,31,50
p_35,0,9,e_2,630,634,665,13,1,0,1,4,0,1,4,31,35
p_91,0,12,e_2,526,634,676,11,1,0,1,4,0,1,108,42,150
p_39,0,12,e_2,607,634,676,19,4,4,9,4,0,1,27,42,69
p_90,0,13,e_2,527,634,681,10,1,0,1,4,0,1,107,47,154
p_38,0,13,e_2,608,634,681,19,4,4,8,4,0,1,26,47,73
p_36,0,13,e_2,628,634,681,14,1,0,2,4,0,1,6,47,53
p_77,0,3,e_3,557,671,684,0,1,0,0,4,0,1,114,13,127
p_30,0,3,e_3,668,671,684,1,1,0,1,4,0,1,3,13,16
p_29,0,5,e_3,670,671,692,0,0,0,0,3,0,0,1,21,22
p_76,0,6,e_3,558,671,697,0,0,0,0,3,0,0,113,26,139
p_32,0,6,e_3,650,671,697,7,1,0,7,4,0,1,21,26,47
p_119,0,1,e_0,483,709,714,21,6,6,2,4,0,1,226,5,231
p_78,0,12,e_3,556,671,717,1,1,0,1,4,0,1,115,46,161
p_34,0,12,e_3,646,671,717,8,1,0,8,4,0,1,25,46,71
p_114,0,3,e_0,488,709,722,20,5,5,0,3,0,0,221,13,234
p_72,0,3,e_0,562,709,722,30,9,9,12,4,0,1,147,13,160
p_71,0,3,e_0,564,709,722,29,10,10,11,4,0,1,145,13,158
p_31,0,6,e_1,666,708,728,1,1,0,13,3,0,0,42,20,62
p_33,0,15,e_3,649,671,728,7,1,0,7,4,0,1,22,57,79
p_124,0,7,e_0,478,709,736,23,7,7,3,4,0,1,231,27,258
p_118,0,7,e_0,484,709,736,21,6,6,1,4,0,1,225,27,252
p_74,0,7,e_0,560,709,736,30,9,9,13,4,0,1,149,27,176
p_22,0,3,e_2,719,726,737,18,1,1,2,4,0,1,7,11,18
p_115,0,9,e_0,487,709,744,20,6,6,0,4,0,1,222,35,257
p_28,0,11,e_1,676,708,745,29,5,5,10,4,0,1,32,37,69
p_117,0,10,e_0,485,709,749,21,6,6,1,4,0,1,224,40,264
p_116,0,10,e_0,486,709,749,21,6,6,1,4,0,1,223,40,263
p_123,0,11,e_0,479,709,754,22,7,7,3,4,0,1,230,45,275
p_121,0,11,e_0,481,709,754,22,7,7,2,4,0,1,228,45,273
p_120,0,11,e_0,482,709,754,21,7,7,2,4,0,1,227,45,272
p_73,0,11,e_0,561,709,754,30,9,9,12,4,0,1,148,45,193
p_26,0,8,e_2,684,726,754,27,4,4,13,3,0,0,42,28,70
p_122,0,15,e_0,480,709,768,22,7,7,3,4,0,1,229,59,288
p_23,0,12,e_2,711,726,768,20,2,2,5,4,0,1,15,42,57
p_21,0,4,e_3,731,779,793,15,0,0,15,3,0,0,48,14,62
p_16,0,2,e_1,780,790,798,28,3,3,3,4,0,1,10,8,18
p_18,0,10,e_3,766,779,813,4,1,0,4,4,0,1,13,34,47
p_65,0,1,e_0,573,815,820,27,9,9,8,4,0,1,242,5,247
p_19,0,11,e_1,754,790,827,8,1,0,11,3,0,0,36,37,73
p_20,0,14,e_3,734,779,827,15,1,0,15,4,0,1,45,48,93
p_70,0,3,e_0,565,815,828,29,10,10,11,4,0,1,250,13,263
p_67,0,3,e_0,568,815,828,28,9,9,10,4,0,1,247,13,260
p_66,0,3,e_0,569,815,828,28,9,9,10,4,0,1,246,13,259
p_64,0,4,e_0,574,815,833,27,9,9,8,4,0,1,241,18,259
p_61,0,6,e_0,579,815,841,25,8,8,6,4,0,1,236,26,262
p_56,0,6,e_0,584,815,841,24,7,7,5,4,0,1,231,26,257
p_17,0,10,e_2,776,815,847,1,1,0,12,3,0,0,39,32,71
p_60,0,10,e_0,580,815,855,25,8,8,6,4,0,1,235,40,275
p_58,0,11,e_0,582,815,860,25,8,8,5,4,0,1,233,45,278
p_57,0,11,e_0,583,815,860,24,8,8,5,4,0,1,232,45,277
p_68,0,13,e_0,567,815,868,28,10,10,10,4,0,1,248,53,301
p_63,0,13,e_0,577,815,868,26,9,9,7,4,0,1,238,53,291
p_62,0,13,e_0,578,815,868,25,9,9,7,4,0,1,237,53,290
p_69,0,14,e_0,566,815,873,29,10,10,11,4,0,1,249,58,307
p_59,0,14,e_0,581,815,873,25,8,8,6,4,0,1,234,58,292
p_9,0,2,e_2,846,879,887,14,0,0,10,2,1,0,33,8,41
p_6,0,3,e_2,877,879,892,14,1,0,0,4,0,1,2,13,15
p_10,0,8,e_1,835,871,897,14,0,0,11,3,0,0,36,26,62
p_7,0,5,e_2,875,879,900,14,1,0,1,4,0,1,4,21,25
p_45,0,2,e_0,595,917,925,22,5,5,1,4,0,1,322,8,330
p_55,0,3,e_0,585,917,930,24,7,7,4,4,0,1,332,13,345
p_54,0,3,e_0,586,917,930,24,7,7,4,4,0,1,331,13,344
p_52,0,3,e_0,588,917,930,23,7,7,3,4,0,1,329,13,342
p_48,0,4,e_0,592,917,935,23,6,6,2,4,0,1,325,18,343
p_46,0,4,e_0,594,917,935,22,5,5,1,4,0,1,323,18,341
p_42,0,6,e_0,598,917,943,21,5,5,0,3,0,0,319,26,345
p_50,0,7,e_0,590,917,948,23,6,6,3,4,0,1,327,31,358
p_43,0,7,e_0,597,917,948,22,5,5,0,4,0,1,320,31,351
p_44,0,8,e_0,596,917,953,22,5,5,1,4,0,1,321,36,357
p_8,0,11,e_3,874,919,954,14,0,0,14,3,0,0,45,35,80
p_53,0,9,e_0,587,917,958,24,7,7,4,4,0,1,330,41,371
p_51,0,9,e_0,589,917,958,23,6,6,3,4,0,1,328,41,369
p_47,0,9,e_0,593,917,958,22,6,6,2,4,0,1,324,41,365
p_27,0,10,e_0,677,917,963,29,5,5,10,4,0,1,240,46,286
p_49,0,14,e_0,591,917,977,23,6,6,2,4,0,1,326,60,386
p_4,0,1,e_0,886,1021,1026,11,1,0,10,4,0,1,135,5,140
p_24,0,2,e_0,695,1021,1031,24,3,3,4,4,0,1,326,10,336
p_14,0,4,e_0,794,1021,1039,24,2,2,7,4,0,1,227,18,245
p_1,0,5,e_0,894,1021,1044,8,1,0,7,4,0,1,127,23,150
p_25,0,8,e_0,686,1021,1055,27,4,4,7,4,0,1,335,34,369
p_5,0,8,e_0,883,1021,1055,12,1,0,11,4,0,1,138,34,172
p_3,0,8,e_0,888,1021,1055,10,1,0,9,4,0,1,133,34,167
p_15,0,9,e_0,793,1021,1060,24,2,2,7,4,0,1,228,39,267
p_11,0,9,e_0,807,1021,1060,20,2,2,2,4,0,1,214,39,253
p_13,0,11,e_0,796,1021,1068,23,2,2,6,4,0,1,225,47,272
p_12,0,11,e_0,798,1021,1068,23,2,2,5,4,0,1,223,47,270
p_2,0,11,e_0,892,1021,1068,9,1,0,8,4,0,1,129,47,176
p_300,0,4,e_0,8,9,25,0,0,0,0,3,0,0,1,16,17
p_299,0,5,e_1,9,10,29,0,0,0,0,3,0,0,1,19,20
p_297,0,6,e_3,15,16,38,0,0,0,0,3,0,0,1,22,23
p_298,0,9,e_2,11,12,43,0,0,0,0,3,0,0,1,31,32
p_296,0,4,e_0,28,43,57,9,1,1,4,3,0,0,15,14,29
p_286,0,3,e_1,46,47,60,6,0,0,0,3,0,0,1,13,14
p_292,0,6,e_0,38,43,65,6,0,0,1,4,0,1,5,22,27
p_290,0,6,e_0,40,43,65,6,0,0,1,4,0,1,3,22,25
p_289,0,4,e_1,43,47,65,6,0,0,1,4,0,1,4,18,22
p_295,0,5,e_1,29,47,70,9,1,1,5,3,0,0,18,23,41
p_287,0,5,e_1,45,47,70,6,0,0,0,4,0,1,2,23,25
p_288,0,8,e_1,44,47,81,6,0,0,1,4,0,1,3,34,37
p_281,0,1,e_3,73,74,81,0,0,0,0,3,0,0,1,7,8
p_291,0,11,e_0,39,43,82,6,0,0,1,4,0,1,4,39,43
p_294,0,12,e_0,31,43,87,8,1,1,4,4,0,1,12,44,56
p_293,0,12,e_0,33,43,87,7,1,1,3,4,0,1,10,44,54
p_278,0,2,e_2,77,84,92,18,4,4,2,4,0,1,7,8,15
p_285,0,4,e_3,53,74,92,6,0,0,6,3,0,0,21,18,39
p_284,0,4,e_2,54,84,100,6,1,0,9,3,0,0,30,16,46
p_282,0,7,e_3,66,74,103,2,1,0,2,4,0,1,8,29,37
p_279,0,5,e_2,76,84,105,18,4,4,2,4,0,1,8,21,29
p_277,0,6,e_2,82,84,110,17,3,3,0,4,0,1,2,26,28
p_283,0,9,e_3,57,74,111,5,1,0,5,4,0,1,17,37,54
p_273,0,4,e_1,110,111,127,9,0,0,0,3,0,0,1,16,17
p_271,0,1,e_0,121,125,130,9,0,0,1,4,0,1,4,5,9
p_280,0,14,e_2,75,84,136,18,4,4,3,4,0,1,9,52,61
p_274,0,8,e_1,88,111,141,15,3,3,7,4,0,1,23,30,53
p_276,0,11,e_1,84,111,152,16,3,3,8,3,0,0,27,41,68
p_270,0,9,e_0,122,125,156,9,0,0,1,4,0,1,3,31,34
p_272,0,10,e_0,113,125,161,9,0,0,4,4,0,1,12,36,48
p_267,0,1,e_3,148,157,162,3,1,0,3,4,0,1,9,5,14
p_268,0,2,e_3,144,157,167,4,1,0,4,4,0,1,13,10,23
p_275,0,14,e_0,86,125,175,16,3,3,12,2,1,0,39,50,89
p_265,0,4,e_3,152,157,175,1,1,0,1,4,0,1,5,18,23
p_266,0,6,e_3,151,157,183,2,1,0,2,4,0,1,6,26,32
p_263,0,7,e_3,154,157,188,1,1,0,1,4,0,1,3,31,34
p_269,0,9,e_3,127,157,196,9,0,0,9,3,0,0,30,39,69
p_255,0,3,e_1,184,193,204,16,3,3,3,4,0,1,9,11,20
p_264,0,11,e_3,153,157,204,1,1,0,1,4,0,1,4,47,51
p_254,0,4,e_1,187,193,209,15,2,2,2,4,0,1,6,16,22
p_262,0,5,e_1,157,193,214,22,7,7,11,3,0,0,36,21,57
p_261,0,5,e_1,164,193,214,21,6,6,9,4,0,1,29,21,50
p_253,0,5,e_1,190,193,214,15,2,2,1,4,0,1,3,21,24
p_260,0,7,e_1,165,193,222,20,6,6,9,4,0,1,28,29,57
p_258,0,7,e_1,168,193,222,20,5,5,8,4,0,1,25,29,54
p_256,0,10,e_1,182,193,233,16,3,3,3,4,0,1,11,40,51
p_257,0,14,e_1,169,193,247,20,5,5,8,4,0,1,24,54,78
p_250,0,2,e_3,217,241,249,8,1,0,8,4,0,1,24,8,32
p_259,0,15,e_1,167,193,252,20,5,5,8,4,0,1,26,59,85
p_252,0,5,e_3,205,241,260,11,0,0,11,3,0,0,36,19,55
p_249,0,6,e_3,239,241,265,0,1,0,0,4,0,1,2,24,26
p_248,0,5,e_0,246,254,271,11,3,3,2,4,0,1,8,17,25
p_247,0,5,e_0,250,254,271,10,2,2,1,4,0,1,4,17,21
p_241,0,1,e_3,283,290,295,2,1,0,2,4,0,1,7,5,12
p_251,0,15,e_0,209,254,303,10,1,0,14,3,0,0,45,49,94
p_236,0,1,e_2,305,307,312,26,4,4,0,4,0,1,2,5,7
p_245,0,7,e_3,269,290,315,6,0,0,6,3,0,0,21,25,46
p_242,0,8,e_3,277,290,320,4,1,0,4,4,0,1,13,30,43
p_237,0,7,e_2,304,307,332,26,4,4,1,4,0,1,3,25,28
p_244,0,12,e_3,271,290,334,6,1,0,6,4,0,1,19,44,63
p_240,0,9,e_2,301,307,340,27,4,4,2,4,0,1,6,33,39
p_246,0,10,e_2,262,307,345,7,1,1,14,3,0,0,45,38,83
p_243,0,15,e_3,272,290,345,6,1,0,6,4,0,1,18,55,73
p_239,0,11,e_2,302,307,350,27,4,4,1,4,0,1,5,43,48
p_238,0,13,e_2,303,307,358,27,4,4,1,4,0,1,4,51,55
p_233,0,1,e_0,311,356,361,24,4,4,15,4,0,1,45,5,50
p_226,0,2,e_0,329,356,366,19,2,2,9,4,0,1,27,10,37
p_223,0,2,e_0,336,356,366,18,1,1,6,4,0,1,20,10,30
p_209,0,2,e_1,357,358,368,15,0,0,0,3,0,0,1,10,11
p_230,0,3,e_0,319,356,371,22,2,2,12,4,0,1,37,15,52
p_228,0,4,e_0,325,356,376,21,2,2,10,4,0,1,31,20,51
p_232,0,5,e_0,314,356,381,23,3,3,14,4,0,1,42,25,67
p_225,0,5,e_0,330,356,381,19,2,2,8,4,0,1,26,25,51
p_224,0,5,e_0,331,356,381,19,2,2,8,4,0,1,25,25,50
p_222,0,5,e_0,337,356,381,17,1,1,6,4,0,1,19,25,44
p_221,0,6,e_0,339,356,386,17,1,1,5,4,0,1,17,30,47
p_220,0,6,e_0,341,356,386,16,1,1,5,4,0,1,15,30,45
p_234,0,8,e_1,310,358,388,24,4,4,15,3,0,0,48,30,78
p_231,0,7,e_0,317,356,391,23,3,3,13,4,0,1,39,35,74
p_235,0,8,e_0,308,356,396,25,4,4,15,3,0,0,48,40,88
p_227,0,12,e_0,327,356,410,20,2,2,9,4,0,1,29,54,83
p_205,0,2,e_2,362,400,410,15,1,0,12,4,0,1,38,10,48
p_229,0,13,e_0,320,356,415,22,2,2,12,4,0,1,36,59,95
p_200,0,4,e_2,367,400,418,13,1,0,11,4,0,1,33,18,51
p_196,0,4,e_2,371,400,418,12,1,0,9,4,0,1,29,18,47
p_178,0,3,e_3,401,407,420,2,1,0,2,4,0,1,6,13,19
p_201,0,5,e_2,366,400,423,13,1,0,11,4,0,1,34,23,57
p_176,0,4,e_3,403,407,425,1,1,0,1,4,0,1,4,18,22
p_208,0,6,e_2,358,400,428,15,0,0,13,3,0,0,42,28,70
p_194,0,6,e_2,373,400,428,11,1,0,9,4,0,1,27,28,55
p_167,0,1,e_1,413,434,439,27,6,6,7,4,0,1,21,5,26
p_161,0,1,e_1,421,434,439,25,5,5,4,4,0,1,13,5,18
p_198,0,9,e_2,369,400,439,12,1,0,10,4,0,1,31,39,70
p_179,0,8,e_3,400,407,439,2,1,0,2,4,0,1,7,32,39
p_197,0,10,e_2,370,400,444,12,1,0,10,4,0,1,30,44,74
p_177,0,9,e_3,402,407,444,1,1,0,1,4,0,1,5,37,42
p_193,0,11,e_2,374,400,449,11,1,0,8,4,0,1,26,49,75
p_165,0,4,e_1,417,434,450,26,6,6,5,4,0,1,17,16,33
p_207,0,11,e_3,359,407,452,15,0,0,15,3,0,0,48,45,93
p_206,0,12,e_2,361,400,454,15,1,0,13,4,0,1,39,54,93
p_203,0,12,e_2,364,400,454,14,1,0,12,4,0,1,36,54,90
p_159,0,6,e_1,429,434,458,23,4,4,1,4,0,1,5,24,29
p_204,0,14,e_2,363,400,462,14,1,0,12,4,0,1,37,62,99
p_216,0,1,e_0,347,456,463,15,0,0,3,4,0,1,109,7,116
p_175,0,14,e_3,405,407,463,0,1,0,0,4,0,1,2,56,58
p_174,0,14,e_3,406,407,463,0,0,0,0,3,0,0,1,56,57
p_202,0,15,e_2,365,400,467,14,1,0,11,4,0,1,35,67,102
p_199,0,15,e_2,368,400,467,13,1,0,10,4,0,1,32,67,99
p_195,0,15,e_2,372,400,467,11,1,0,9,4,0,1,28,67,95
p_169,0,9,e_1,411,434,469,28,6,6,7,4,0,1,23,35,58
p_214,0,3,e_0,349,456,471,15,0,0,2,4,0,1,107,15,122
p_163,0,10,e_1,419,434,474,25,5,5,5,4,0,1,15,40,55
p_219,0,5,e_0,342,456,479,16,1,1,4,4,0,1,114,23,137
p_173,0,11,e_1,407,434,479,28,7,7,8,3,0,0,27,45,72
p_164,0,11,e_1,418,434,479,25,6,6,5,4,0,1,16,45,61
p_162,0,11,e_1,420,434,479,25,5,5,4,4,0,1,14,45,59
p_210,0,6,e_0,354,456,484,15,0,0,0,4,0,1,102,28,130
p_166,0,12,e_1,416,434,484,26,6,6,6,4,0,1,18,50,68
p_217,0,7,e_0,346,456,489,15,0,0,3,4,0,1,110,33,143
p_212,0,7,e_0,351,456,489,15,0,0,1,4,0,1,105,33,138
p_154,0,7,e_0,436,456,489,21,4,4,6,4,0,1,20,33,53
p_171,0,13,e_1,409,434,489,28,6,6,8,4,0,1,25,55,80
p_168,0,13,e_1,412,434,489,27,6,6,7,4,0,1,22,55,77
p_170,0,14,e_1,410,434,494,28,6,6,8,4,0,1,24,60,84
p_153,0,9,e_0,437,456,497,20,4,4,6,4,0,1,19,41,60
p_172,0,15,e_1,408,434,499,28,6,6,8,4,0,1,26,65,91
p_160,0,15,e_1,426,434,499,24,4,4,2,4,0,1,8,65,73
p_218,0,11,e_0,343,456,505,15,1,1,4,4,0,1,113,49,162
p_130,0,1,e_3,472,507,512,11,1,0,11,4,0,1,35,5,40
p_155,0,14,e_0,435,456,516,21,4,4,7,4,0,1,21,60,81
p_143,0,3,e_3,456,507,520,16,1,1,12,5,1,0,51,13,64
p_136,0,3,e_3,465,507,520,14,1,0,14,4,0,1,42,13,55
p_129,0,3,e_3,473,507,520,11,1,0,11,4,0,1,34,13,47
p_215,0,15,e_0,348,456,521,15,0,0,2,4,0,1,108,65,173
p_213,0,15,e_0,350,456,521,15,0,0,2,4,0,1,106,65,171
p_211,0,15,e_0,353,456,521,15,0,0,1,4,0,1,103,65,168
p_156,0,15,e_0,434,456,521,21,4,4,7,4,0,1,22,65,87
p_152,0,15,e_0,441,456,521,20,3,3,5,4,0,1,15,65,80
p_190,0,1,e_2,379,514,521,9,1,0,7,4,0,1,135,7,142
p_183,0,1,e_2,396,514,521,3,1,0,1,4,0,1,118,7,125
p_137,0,4,e_3,464,507,525,14,1,0,14,4,0,1,43,18,61
p_182,0,2,e_2,397,514,526,3,1,0,1,4,0,1,117,12,129
p_180,0,2,e_2,399,514,526,2,1,0,0,3,0,0,115,12,127
p_141,0,6,e_3,458,507,533,15,2,2,13,5,1,1,49,26,75
p_186,0,4,e_2,390,514,534,5,1,0,3,4,0,1,124,20,144
p_140,0,8,e_3,459,507,541,15,2,2,13,5,1,1,48,34,82
p_102,0,7,e_2,509,514,545,30,11,11,1,4,0,1,5,31,36
p_142,0,9,e_3,457,507,546,16,2,2,12,5,1,1,50,39,89
p_192,0,8,e_2,375,514,550,10,1,0,8,4,0,1,139,36,175
p_189,0,8,e_2,382,514,550,8,1,0,6,4,0,1,132,36,168
p_139,0,10,e_3,461,507,551,14,2,2,14,5,1,1,46,44,90
p_135,0,10,e_3,466,507,551,13,1,0,13,4,0,1,41,44,85
p_158,0,1,e_1,430,546,553,23,4,4,1,4,0,1,116,7,123
p_96,0,1,e_1,517,546,553,28,11,11,9,4,0,1,29,7,36
p_138,0,11,e_3,463,507,556,14,1,0,14,4,0,1,44,49,93
p_132,0,11,e_3,470,507,556,12,1,0,12,4,0,1,37,49,86
p_191,0,10,e_2,376,514,558,10,1,0,8,4,0,1,138,44,182
p_185,0,10,e_2,391,514,558,5,1,0,3,4,0,1,123,44,167
p_133,0,12,e_3,469,507,561,12,1,0,12,4,0,1,38,54,92
p_103,0,11,e_2,508,514,563,30,11,11,2,4,0,1,6,49,55
p_92,0,4,e_1,525,546,564,26,9,9,7,4,0,1,21,18,39
p_187,0,12,e_2,389,514,568,6,1,0,3,4,0,1,125,54,179
p_184,0,12,e_2,392,514,568,5,1,0,2,4,0,1,122,54,176
p_88,0,5,e_1,538,546,569,23,8,8,2,4,0,1,8,23,31
p_131,0,14,e_3,471,507,569,12,1,0,12,4,0,1,36,62,98
p_188,0,13,e_2,384,514,573,7,1,0,5,4,0,1,130,59,189
p_99,0,6,e_1,514,546,574,29,11,11,10,4,0,1,32,28,60
p_94,0,6,e_1,519,546,574,27,10,10,9,4,0,1,27,28,55
p_134,0,15,e_3,467,507,574,13,1,0,13,4,0,1,40,67,107
p_146,0,1,e_0,453,568,575,17,1,1,1,4,0,1,115,7,122
p_98,0,7,e_1,515,546,579,28,11,11,10,4,0,1,31,33,64
p_97,0,7,e_1,516,546,579,28,11,11,10,4,0,1,30,33,63
p_181,0,15,e_2,398,514,581,3,1,0,0,4,0,1,116,67,183
p_87,0,8,e_1,539,546,584,22,8,8,2,4,0,1,7,38,45
p_89,0,9,e_1,535,546,589,24,8,8,3,4,0,1,11,43,54
p_150,0,6,e_0,443,568,592,19,2,2,4,4,0,1,125,24,149
p_80,0,7,e_0,552,568,597,20,5,5,5,4,0,1,16,29,45
p_91,0,12,e_1,526,546,600,26,9,9,6,4,0,1,20,54,74
p_148,0,8,e_0,449,568,602,18,2,2,2,4,0,1,119,34,153
p_83,0,8,e_0,549,568,602,20,6,6,6,4,0,1,19,34,53
p_93,0,13,e_1,520,546,605,27,10,10,8,4,0,1,26,59,85
p_90,0,13,e_1,527,546,605,26,9,9,6,4,0,1,19,59,78
p_147,0,9,e_0,452,568,607,17,1,1,1,4,0,1,116,39,155
p_144,0,9,e_0,455,568,607,16,1,1,0,3,0,0,113,39,152
p_157,0,14,e_1,431,546,610,22,4,4,1,4,0,1,115,64,179
p_95,0,14,e_1,518,546,610,27,11,11,9,4,0,1,28,64,92
p_145,0,11,e_0,454,568,615,17,1,1,0,4,0,1,114,47,161
p_84,0,12,e_0,546,568,620,21,6,6,7,4,0,1,22,52,74
p_78,0,12,e_0,556,568,620,19,4,4,4,4,0,1,12,52,64
p_119,0,1,e_3,483,621,626,8,1,0,8,4,0,1,138,5,143
p_82,0,14,e_0,550,568,628,20,5,5,6,4,0,1,18,60,78
p_81,0,14,e_0,551,568,628,20,5,5,5,4,0,1,17,60,77
p_79,0,14,e_0,553,568,628,20,5,5,5,4,0,1,15,60,75
p_151,0,15,e_0,442,568,633,19,3,3,4,4,0,1,126,65,191
p_149,0,15,e_0,444,568,633,19,2,2,4,4,0,1,124,65,189
p_114,0,3,e_3,488,621,634,6,1,0,6,4,0,1,133,13,146
p_124,0,7,e_3,478,621,648,9,1,0,9,4,0,1,143,27,170
p_118,0,7,e_3,484,621,648,7,1,0,7,4,0,1,137,27,164
p_101,0,8,e_2,511,628,654,29,11,11,1,4,0,1,117,26,143
p_115,0,9,e_3,487,621,656,6,1,0,6,4,0,1,134,35,169
p_100,0,9,e_2,513,628,659,29,11,11,0,3,0,0,115,31,146
p_127,0,10,e_3,475,621,661,10,1,0,10,4,0,1,146,40,186
p_117,0,10,e_3,485,621,661,7,1,0,7,4,0,1,136,40,176
p_116,0,10,e_3,486,621,661,7,1,0,7,4,0,1,135,40,175
p_86,0,2,e_1,544,654,662,21,7,7,0,4,0,1,110,8,118
p_128,0,11,e_3,474,621,666,11,1,0,11,4,0,1,147,45,192
p_123,0,11,e_3,479,621,666,9,1,0,9,4,0,1,142,45,187
p_121,0,11,e_3,481,621,666,8,1,0,8,4,0,1,140,45,185
p_120,0,11,e_3,482,621,666,8,1,0,8,4,0,1,139,45,184
p_126,0,12,e_3,476,621,671,10,1,0,10,4,0,1,145,50,195
p_32,0,6,e_1,650,654,676,23,7,7,1,4,0,1,4,22,26
p_125,0,14,e_3,477,621,679,10,1,0,10,4,0,1,144,58,202
p_122,0,15,e_3,480,621,684,9,1,0,9,4,0,1,141,63,204
p_35,0,9,e_1,630,654,687,28,9,9,8,4,0,1,24,33,57
p_77,0,3,e_0,557,680,691,19,4,4,3,4,0,1,123,11,134
p_72,0,3,e_0,562,680,691,18,3,3,2,4,0,1,118,11,129
p_71,0,3,e_0,564,680,691,17,3,3,1,4,0,1,116,11,127
p_70,0,3,e_0,565,680,691,17,3,3,1,4,0,1,115,11,126
p_30,0,3,e_0,668,680,691,19,4,4,4,4,0,1,12,11,23
p_34,0,12,e_1,646,654,698,23,8,8,2,4,0,1,8,44,52
p_75,0,5,e_0,559,680,699,18,4,4,3,4,0,1,121,19,140
p_29,0,5,e_0,670,680,699,18,3,3,3,4,0,1,10,19,29
p_36,0,13,e_1,628,654,703,29,9,9,8,4,0,1,26,49,75
p_76,0,6,e_0,558,680,704,19,4,4,3,4,0,1,122,24,146
p_31,0,6,e_0,666,680,704,19,4,4,4,4,0,1,14,24,38
p_74,0,7,e_0,560,680,709,18,3,3,2,4,0,1,120,29,149
p_85,0,15,e_1,545,654,711,21,6,6,0,3,0,0,109,57,166
p_33,0,15,e_1,649,654,711,23,7,7,1,4,0,1,5,57,62
p_27,0,10,e_0,677,680,720,16,3,3,1,4,0,1,3,40,43
p_24,0,2,e_2,695,714,722,12,1,0,6,4,0,1,19,8,27
p_73,0,11,e_0,561,680,725,18,3,3,2,4,0,1,119,45,164
p_28,0,11,e_0,676,680,725,17,3,3,1,4,0,1,4,45,49
p_68,0,13,e_0,567,680,733,16,3,3,0,3,0,0,113,53,166
p_113,0,1,e_3,489,731,736,6,1,0,6,4,0,1,242,5,247
p_65,0,1,e_3,573,731,736,15,1,1,15,2,1,1,158,5,163
p_69,0,14,e_0,566,680,738,17,3,3,0,4,0,1,114,58,172
p_26,0,8,e_2,684,714,742,15,1,0,9,3,0,0,30,28,58
p_25,0,8,e_2,686,714,742,15,1,0,9,4,0,1,28,28,56
p_106,0,3,e_3,500,731,744,2,1,0,2,4,0,1,231,13,244
p_67,0,3,e_3,568,731,744,16,2,2,14,2,2,1,163,13,176
p_66,0,3,e_3,569,731,744,16,2,2,14,5,1,1,162,13,175
p_64,0,4,e_3,574,731,749,15,1,0,15,4,0,1,157,18,175
p_23,0,12,e_2,711,714,756,6,1,0,1,4,0,1,3,42,45
p_108,0,6,e_3,496,731,757,3,1,0,3,4,0,1,235,26,261
p_111,0,8,e_3,491,731,765,5,1,0,5,4,0,1,240,34,274
p_112,0,11,e_3,490,731,776,5,1,0,5,4,0,1,241,45,286
p_110,0,11,e_3,492,731,776,5,1,0,5,4,0,1,239,45,284
p_107,0,11,e_3,499,731,776,2,1,0,2,4,0,1,232,45,277
p_105,0,12,e_3,502,731,781,1,1,0,1,4,0,1,229,50,279
p_63,0,13,e_3,577,731,786,14,1,0,14,4,0,1,154,55,209
p_104,0,14,e_3,503,731,791,1,1,0,1,4,0,1,228,60,288
p_21,0,4,e_1,731,779,793,30,10,10,15,3,0,0,48,14,62
p_109,0,15,e_3,493,731,796,4,1,0,4,4,0,1,238,65,303
p_18,0,10,e_1,766,779,813,22,6,6,4,4,0,1,13,34,47
p_17,0,10,e_1,776,779,813,19,5,5,1,4,0,1,3,34,37
p_19,0,11,e_1,754,779,818,25,8,8,8,4,0,1,25,39,64
p_16,0,2,e_2,780,819,827,18,4,4,12,3,0,0,39,8,47
p_20,0,14,e_1,734,779,829,29,11,11,15,4,0,1,45,50,95
p_14,0,4,e_2,794,819,835,15,2,2,8,4,0,1,25,16,41
p_15,0,9,e_2,793,819,852,16,2,2,8,4,0,1,26,33,59
p_11,0,9,e_2,807,819,852,12,1,0,4,4,0,1,12,33,45
p_55,0,3,e_3,585,843,854,12,1,0,12,4,0,1,258,11,269
p_54,0,3,e_3,586,843,854,11,1,0,11,4,0,1,257,11,268
p_52,0,3,e_3,588,843,854,11,1,0,11,4,0,1,255,11,266
p_48,0,4,e_3,592,843,859,9,1,0,9,4,0,1,251,16,267
p_13,0,11,e_2,796,819,860,15,1,0,7,4,0,1,23,41,64
p_12,0,11,e_2,798,819,860,15,1,0,7,4,0,1,21,41,62
p_61,0,6,e_3,579,843,867,14,1,0,14,4,0,1,264,24,288
p_56,0,6,e_3,584,843,867,12,1,0,12,4,0,1,259,24,283
p_50,0,7,e_3,590,843,872,10,1,0,10,4,0,1,253,29,282
p_53,0,9,e_3,587,843,880,11,1,0,11,4,0,1,256,37,293
p_51,0,9,e_3,589,843,880,10,1,0,10,4,0,1,254,37,291
p_60,0,10,e_3,580,843,885,13,1,0,13,4,0,1,263,42,305
p_58,0,11,e_3,582,843,890,13,1,0,13,4,0,1,261,47,308
p_57,0,11,e_3,583,843,890,12,1,0,12,4,0,1,260,47,307
p_4,0,1,e_0,886,891,896,18,4,4,1,4,0,1,5,5,10
p_62,0,13,e_3,578,843,898,14,1,0,14,4,0,1,265,55,320
p_9,0,2,e_0,846,891,901,27,10,10,14,3,0,0,45,10,55
p_59,0,14,e_3,581,843,903,13,1,0,13,4,0,1,262,60,322
p_49,0,14,e_3,591,843,903,10,1,0,10,4,0,1,252,60,312
p_6,0,3,e_0,877,891,906,20,6,6,4,4,0,1,14,15,29
p_7,0,5,e_0,875,891,914,20,6,6,5,4,0,1,16,23,39
p_5,0,8,e_0,883,891,925,18,5,5,2,4,0,1,8,34,42
p_3,0,8,e_0,888,891,925,17,4,4,1,4,0,1,3,34,37
p_8,0,11,e_0,874,891,936,21,6,6,5,4,0,1,17,45,62
p_45,0,2,e_3,595,947,955,8,1,0,8,4,0,1,352,8,360
p_1,0,5,e_1,894,939,956,16,3,3,14,3,0,0,45,17,62
p_22,0,3,e_3,719,947,960,4,1,0,4,4,0,1,228,13,241
p_2,0,11,e_2,892,928,963,17,3,3,11,3,0,0,36,35,71
p_46,0,4,e_3,594,947,965,9,1,0,9,4,0,1,353,18,371
p_42,0,6,e_3,598,947,973,7,1,0,7,4,0,1,349,26,375
p_43,0,7,e_3,597,947,978,8,1,0,8,4,0,1,350,31,381
p_44,0,8,e_3,596,947,983,8,1,0,8,4,0,1,351,36,387
p_10,0,8,e_3,835,947,983,2,1,0,2,4,0,1,112,36,148
p_47,0,9,e_3,593,947,988,9,1,0,9,4,0,1,354,41,395
p_37,0,9,e_3,615,947,988,2,1,0,2,4,0,1,332,41,373
p_41,0,11,e_3,600,947,996,7,1,0,7,4,0,1,347,49,396
p_39,0,12,e_3,607,947,1001,4,1,0,4,4,0,1,340,54,394
p_40,0,13,e_3,602,947,1006,6,1,0,6,4,0,1,345,59,404
p_38,0,13,e_3,608,947,1006,4,1,0,4,4,0,1,339,59,398
p_300,0,4,e_0,8,9,25,0,0,0,0,3,0,0,1,16,17
p_299,0,5,e_1,9,10,29,0,0,0,0,3,0,0,1,19,20
p_297,0,6,e_3,15,16,38,0,0,0,0,3,0,0,1,22,23
p_298,0,9,e_2,11,12,43,0,0,0,0,3,0,0,1,31,32
p_296,0,4,e_0,28,43,57,9,1,1,4,3,0,0,15,14,29
p_286,0,3,e_1,46,47,60,6,0,0,0,3,0,0,1,13,14
p_292,0,6,e_0,38,43,65,6,0,0,1,4,0,1,5,22,27
p_290,0,6,e_0,40,43,65,6,0,0,1,4,0,1,3,22,25
p_289,0,4,e_1,43,47,65,6,0,0,1,4,0,1,4,18,22
p_295,0,5,e_1,29,47,70,9,1,1,5,3,0,0,18,23,41
p_287,0,5,e_1,45,47,70,6,0,0,0,4,0,1,2,23,25
p_288,0,8,e_1,44,47,81,6,0,0,1,4,0,1,3,34,37
p_281,0,1,e_3,73,74,81,0,0,0,0,3,0,0,1,7,8
p_291,0,11,e_0,39,43,82,6,0,0,1,4,0,1,4,39,43
p_294,0,12,e_0,31,43,87,8,1,1,4,4,0,1,12,44,56
p_293,0,12,e_0,33,43,87,7,1,1,3,4,0,1,10,44,54
p_285,0,4,e_3,53,74,92,6,0,0,6,3,0,0,21,18,39
p_284,0,4,e_3,54,74,92,6,1,0,6,4,0,1,20,18,38
p_282,0,7,e_3,66,74,103,2,1,0,2,4,0,1,8,29,37
p_283,0,9,e_3,57,74,111,5,1,0,5,4,0,1,17,37,54
p_278,0,2,e_2,77,105,113,18,4,4,9,4,0,1,28,8,36
p_279,0,5,e_2,76,105,124,18,4,4,9,4,0,1,29,19,48
p_277,0,6,e_1,82,109,129,17,3,3,8,3,0,0,27,20,47
p_274,0,8,e_2,88,105,135,15,3,3,5,4,0,1,17,30,47
p_271,0,1,e_3,121,140,145,6,1,0,6,4,0,1,19,5,24
p_276,0,11,e_2,84,105,146,16,3,3,7,4,0,1,21,41,62
p_273,0,4,e_3,110,140,156,9,0,0,9,2,1,0,30,16,46
p_280,0,14,e_2,75,105,157,18,4,4,9,3,0,0,30,52,82
p_275,0,14,e_2,86,105,157,16,3,3,6,4,0,1,19,52,71
p_267,0,1,e_1,148,165,172,18,3,3,5,4,0,1,17,7,24
p_270,0,9,e_3,122,140,173,6,1,0,6,4,0,1,18,33,51
p_269,0,9,e_3,127,140,173,4,1,0,4,4,0,1,13,33,46
p_268,0,2,e_1,144,165,177,19,3,3,6,3,0,0,21,12,33
p_272,0,10,e_3,113,140,178,9,1,0,9,4,0,1,27,38,65
p_265,0,4,e_1,152,165,185,17,3,3,4,4,0,1,13,20,33
p_262,0,5,e_1,157,165,190,16,2,2,2,4,0,1,8,25,33
p_261,0,5,e_1,164,165,190,14,2,2,0,3,0,0,1,25,26
p_266,0,6,e_1,151,165,195,17,3,3,4,4,0,1,14,30,44
p_263,0,7,e_1,154,165,200,16,3,3,3,4,0,1,11,35,46
p_264,0,11,e_1,153,165,214,17,3,3,4,4,0,1,12,49,61
p_255,0,3,e_0,184,204,215,10,0,0,6,4,0,1,20,11,31
p_254,0,4,e_0,187,204,220,10,0,0,5,4,0,1,17,16,33
p_253,0,5,e_0,190,204,225,10,0,0,4,4,0,1,14,21,35
p_260,0,7,e_0,165,204,233,13,2,2,12,3,0,0,39,29,68
p_258,0,7,e_0,168,204,233,12,2,2,12,4,0,1,36,29,65
p_256,0,10,e_0,182,204,244,10,0,0,7,4,0,1,22,40,62
p_250,0,2,e_3,217,238,246,7,1,0,7,4,0,1,21,8,29
p_252,0,5,e_3,205,238,257,10,0,0,10,3,0,0,33,19,52
p_257,0,14,e_0,169,204,258,12,2,2,11,4,0,1,35,54,89
p_259,0,15,e_0,167,204,263,13,2,2,12,4,0,1,37,59,96
p_251,0,15,e_3,209,238,289,9,1,0,9,4,0,1,29,51,80
p_248,0,5,e_1,246,275,292,28,2,2,9,4,0,1,29,17,46
p_247,0,5,e_1,250,275,292,27,2,2,8,4,0,1,25,17,42
p_249,0,6,e_1,239,275,297,30,3,3,11,3,0,0,36,22,58
p_245,0,7,e_1,269,275,302,21,1,1,2,4,0,1,6,27,33
p_246,0,10,e_1,262,275,313,24,1,1,4,4,0,1,13,38,51
p_244,0,12,e_1,271,275,321,21,1,1,1,4,0,1,4,46,50
p_241,0,1,e_2,283,322,327,17,1,1,13,4,0,1,39,5,44
p_236,0,1,e_2,305,322,327,15,0,0,5,4,0,1,17,5,22
p_233,0,1,e_2,311,322,327,15,0,0,3,4,0,1,11,5,16
p_243,0,15,e_1,272,275,332,20,1,1,1,4,0,1,3,57,60
p_230,0,3,e_2,319,322,335,15,0,0,1,4,0,1,3,13,16
p_232,0,5,e_2,314,322,343,15,0,0,2,4,0,1,8,21,29
p_237,0,7,e_2,304,322,351,15,0,0,6,4,0,1,18,29,47
p_231,0,7,e_2,317,322,351,15,0,0,1,4,0,1,5,29,34
p_242,0,8,e_2,277,322,356,19,1,1,14,3,0,0,45,34,79
p_235,0,8,e_2,308,322,356,15,0,0,4,4,0,1,14,34,48
p_234,0,8,e_2,310,322,356,15,0,0,4,4,0,1,12,34,46
p_240,0,9,e_2,301,322,361,15,0,0,7,4,0,1,21,39,60
p_239,0,11,e_2,302,322,369,15,0,0,6,4,0,1,20,47,67
p_238,0,13,e_2,303,322,377,15,0,0,6,4,0,1,19,55,74
p_229,0,13,e_2,320,322,377,15,0,0,0,4,0,1,2,55,57
p_216,0,1,e_0,347,373,380,9,1,0,8,4,0,1,26,7,33
p_226,0,2,e_0,329,373,385,15,1,0,14,4,0,1,44,12,56
p_223,0,2,e_0,336,373,385,13,1,0,12,4,0,1,37,12,49
p_214,0,3,e_0,349,373,390,8,1,0,8,4,0,1,24,17,41
p_228,0,4,e_0,325,373,395,15,0,0,15,3,0,0,48,22,70
p_224,0,5,e_1,331,379,396,14,1,0,15,2,1,0,48,17,65
p_194,0,6,e_3,373,375,397,0,1,0,0,4,0,1,2,22,24
p_225,0,5,e_0,330,373,400,15,1,0,14,4,0,1,43,27,70
p_222,0,5,e_0,337,373,400,12,1,0,12,4,0,1,36,27,63
p_219,0,5,e_0,342,373,400,11,1,0,10,4,0,1,31,27,58
p_221,0,6,e_0,339,373,405,12,1,0,11,4,0,1,34,32,66
p_220,0,6,e_0,341,373,405,11,1,0,10,4,0,1,32,32,64
p_192,0,8,e_1,375,379,407,24,4,4,1,4,0,1,4,28,32
p_217,0,7,e_0,346,373,410,9,1,0,9,4,0,1,27,37,64
p_212,0,7,e_0,351,373,410,8,1,0,7,4,0,1,22,37,59
p_193,0,11,e_3,374,375,414,0,0,0,0,3,0,0,1,39,40
p_191,0,10,e_1,376,379,415,24,3,3,1,4,0,1,3,36,39
p_227,0,12,e_3,327,375,419,15,0,0,15,3,0,0,48,44,92
p_218,0,11,e_0,343,373,424,10,1,0,10,4,0,1,30,51,81
p_190,0,1,e_2,379,421,428,24,3,3,13,3,0,0,42,7,49
p_183,0,1,e_2,396,421,428,18,2,2,8,4,0,1,25,7,32
p_182,0,2,e_2,397,421,433,18,2,2,8,4,0,1,24,12,36
p_180,0,2,e_2,399,421,433,18,2,2,7,4,0,1,22,12,34
p_215,0,15,e_0,348,373,438,9,1,0,8,4,0,1,25,65,90
p_213,0,15,e_0,350,373,438,8,1,0,7,4,0,1,23,65,88
p_178,0,3,e_2,401,421,438,17,2,2,6,4,0,1,20,17,37
p_186,0,4,e_2,390,421,443,20,3,3,10,4,0,1,31,22,53
p_176,0,4,e_2,403,421,443,16,2,2,6,4,0,1,18,22,40
p_189,0,8,e_2,382,421,457,23,3,3,13,4,0,1,39,36,75
p_179,0,8,e_2,400,421,457,17,2,2,7,4,0,1,21,36,57
p_161,0,1,e_1,421,454,461,12,0,0,10,3,0,0,33,7,40
p_158,0,1,e_1,430,454,461,12,0,0,8,4,0,1,24,7,31
p_177,0,9,e_2,402,421,462,17,2,2,6,4,0,1,19,41,60
p_185,0,10,e_2,391,421,467,20,3,3,10,4,0,1,30,46,76
p_187,0,12,e_2,389,421,475,20,3,3,10,4,0,1,32,54,86
p_184,0,12,e_2,392,421,475,19,3,3,9,4,0,1,29,54,83
p_159,0,6,e_1,429,454,478,12,0,0,8,4,0,1,25,24,49
p_150,0,6,e_1,443,454,478,12,0,0,3,4,0,1,11,24,35
p_188,0,13,e_2,384,421,480,22,3,3,12,4,0,1,37,59,96
p_154,0,7,e_1,436,454,483,12,0,0,6,4,0,1,18,29,47
p_148,0,8,e_1,449,454,488,12,0,0,1,4,0,1,5,34,39
p_181,0,15,e_2,398,421,488,18,2,2,7,4,0,1,23,67,90
p_153,0,9,e_1,437,454,493,12,0,0,5,4,0,1,17,39,56
p_147,0,9,e_1,452,454,493,12,0,0,0,4,0,1,2,39,41
p_209,0,2,e_0,357,485,495,6,1,0,5,4,0,1,128,10,138
p_205,0,2,e_0,362,485,495,4,1,0,3,4,0,1,123,10,133
p_200,0,4,e_0,367,485,503,2,1,0,2,4,0,1,118,18,136
p_201,0,5,e_0,366,485,508,3,1,0,2,4,0,1,119,23,142
p_157,0,14,e_1,431,454,510,12,0,0,7,4,0,1,23,56,79
p_155,0,14,e_1,435,454,510,12,0,0,6,4,0,1,19,56,75
p_210,0,6,e_0,354,485,513,7,1,0,6,4,0,1,131,28,159
p_208,0,6,e_0,358,485,513,5,1,0,5,4,0,1,127,28,155
p_160,0,15,e_1,426,454,515,12,0,0,9,4,0,1,28,61,89
p_156,0,15,e_1,434,454,515,12,0,0,6,4,0,1,20,61,81
p_152,0,15,e_1,441,454,515,12,0,0,4,4,0,1,13,61,74
p_151,0,15,e_1,442,454,515,12,0,0,4,4,0,1,12,61,73
p_149,0,15,e_1,444,454,515,12,0,0,3,4,0,1,10,61,71
p_198,0,9,e_0,369,485,524,2,1,0,1,4,0,1,116,39,155
p_197,0,10,e_0,370,485,529,1,1,0,1,4,0,1,115,44,159
p_113,0,1,e_3,489,524,529,11,1,0,11,4,0,1,35,5,40
p_207,0,11,e_0,359,485,534,5,1,0,4,4,0,1,126,49,175
p_114,0,3,e_3,488,524,537,12,1,0,12,4,0,1,36,13,49
p_106,0,3,e_3,500,524,537,8,1,0,8,4,0,1,24,13,37
p_206,0,12,e_0,361,485,539,4,1,0,4,4,0,1,124,54,178
p_203,0,12,e_0,364,485,539,3,1,0,3,4,0,1,121,54,175
p_167,0,1,e_2,413,535,540,13,1,1,2,4,0,1,122,5,127
p_204,0,14,e_0,363,485,547,4,1,0,3,4,0,1,122,62,184
p_108,0,6,e_3,496,524,548,9,1,0,9,4,0,1,28,24,52
p_165,0,4,e_2,417,535,551,12,1,1,1,4,0,1,118,16,134
p_92,0,4,e_2,525,535,551,30,10,10,3,4,0,1,10,16,26
p_211,0,15,e_0,353,485,552,7,1,0,6,4,0,1,132,67,199
p_202,0,15,e_0,365,485,552,3,1,0,2,4,0,1,120,67,187
p_199,0,15,e_0,368,485,552,2,1,0,1,4,0,1,117,67,184
p_111,0,8,e_3,491,524,556,11,1,0,11,4,0,1,33,32,65
p_115,0,9,e_3,487,524,561,12,1,0,12,4,0,1,37,37,74
p_117,0,10,e_3,485,524,566,12,0,0,12,3,0,0,39,42,81
p_116,0,10,e_3,486,524,566,12,1,0,12,4,0,1,38,42,80
p_169,0,9,e_2,411,535,568,14,2,2,3,4,0,1,124,33,157
p_146,0,1,e_1,453,562,569,12,0,0,0,3,0,0,109,7,116
p_112,0,11,e_3,490,524,571,11,1,0,11,4,0,1,34,47,81
p_110,0,11,e_3,492,524,571,10,1,0,10,4,0,1,32,47,79
p_107,0,11,e_3,499,524,571,8,1,0,8,4,0,1,25,47,72
p_103,0,11,e_3,508,524,571,5,1,0,5,4,0,1,16,47,63
p_163,0,10,e_2,419,535,573,12,0,0,0,4,0,1,116,38,154
p_86,0,2,e_1,544,562,574,25,9,9,6,4,0,1,18,12,30
p_105,0,12,e_3,502,524,576,7,1,0,7,4,0,1,22,52,74
p_173,0,11,e_2,407,535,578,15,2,2,4,4,0,1,128,43,171
p_164,0,11,e_2,418,535,578,12,0,0,1,4,0,1,117,43,160
p_162,0,11,e_2,420,535,578,12,0,0,0,3,0,0,115,43,158
p_77,0,3,e_1,557,562,579,22,7,7,1,4,0,1,5,17,22
p_166,0,12,e_2,416,535,583,13,1,1,1,4,0,1,119,48,167
p_104,0,14,e_3,503,524,584,7,1,0,7,4,0,1,21,60,81
p_88,0,5,e_1,538,562,587,27,9,9,8,4,0,1,24,25,49
p_171,0,13,e_2,409,535,588,14,2,2,4,4,0,1,126,53,179
p_168,0,13,e_2,412,535,588,13,2,2,3,4,0,1,123,53,176
p_109,0,15,e_3,493,524,589,10,1,0,10,4,0,1,31,65,96
p_76,0,6,e_1,558,562,592,22,7,7,1,4,0,1,4,30,34
p_175,0,14,e_2,405,535,593,16,2,2,5,4,0,1,130,58,188
p_174,0,14,e_2,406,535,593,15,2,2,5,4,0,1,129,58,187
p_170,0,14,e_2,410,535,593,14,2,2,3,4,0,1,125,58,183
p_80,0,7,e_1,552,562,597,23,8,8,3,4,0,1,10,35,45
p_172,0,15,e_2,408,535,598,15,2,2,4,4,0,1,127,63,190
p_87,0,8,e_1,539,562,602,27,9,9,7,4,0,1,23,40,63
p_83,0,8,e_1,549,562,602,24,8,8,4,4,0,1,13,40,53
p_89,0,9,e_1,535,562,607,27,10,10,9,4,0,1,27,45,72
p_143,0,3,e_0,456,599,612,12,0,0,9,4,0,1,143,13,156
p_136,0,3,e_0,465,599,612,12,0,0,6,4,0,1,134,13,147
p_196,0,4,e_0,371,599,617,1,1,0,0,4,0,1,228,18,246
p_137,0,4,e_0,464,599,617,12,0,0,7,4,0,1,135,18,153
p_84,0,12,e_1,546,562,618,24,9,9,5,4,0,1,16,56,72
p_78,0,12,e_1,556,562,618,22,7,7,2,4,0,1,6,56,62
p_141,0,6,e_0,458,599,625,12,0,0,9,4,0,1,141,26,167
p_82,0,14,e_1,550,562,626,24,8,8,4,4,0,1,12,64,76
p_81,0,14,e_1,551,562,626,23,8,8,3,4,0,1,11,64,75
p_79,0,14,e_1,553,562,626,23,8,8,3,4,0,1,9,64,73
p_85,0,15,e_1,545,562,631,25,9,9,5,4,0,1,17,69,86
p_140,0,8,e_0,459,599,633,12,0,0,8,4,0,1,140,34,174
p_144,0,9,e_0,455,599,638,12,0,0,10,4,0,1,144,39,183
p_142,0,9,e_0,457,599,638,12,0,0,9,4,0,1,142,39,181
p_96,0,1,e_3,517,636,641,2,1,0,2,4,0,1,119,5,124
p_139,0,10,e_0,461,599,643,12,0,0,8,4,0,1,138,44,182
p_135,0,10,e_0,466,599,643,12,0,0,6,4,0,1,133,44,177
p_145,0,11,e_0,454,599,648,12,0,0,10,4,0,1,145,49,194
p_138,0,11,e_0,463,599,648,12,0,0,7,4,0,1,136,49,185
p_133,0,12,e_0,469,599,653,12,0,0,5,4,0,1,130,54,184
p_99,0,6,e_3,514,636,658,3,1,0,3,4,0,1,122,22,144
p_94,0,6,e_3,519,636,658,1,1,0,1,4,0,1,117,22,139
p_102,0,7,e_3,509,636,663,5,1,0,5,4,0,1,127,27,154
p_98,0,7,e_3,515,636,663,3,1,0,3,4,0,1,121,27,148
p_97,0,7,e_3,516,636,663,2,1,0,2,4,0,1,120,27,147
p_195,0,15,e_0,372,599,664,1,1,0,0,3,0,0,227,65,292
p_134,0,15,e_0,467,599,664,12,0,0,6,4,0,1,132,65,197
p_101,0,8,e_3,511,636,668,4,1,0,4,4,0,1,125,32,157
p_100,0,9,e_3,513,636,673,3,1,0,3,4,0,1,123,37,160
p_37,0,9,e_3,615,636,673,7,1,0,7,4,0,1,21,37,58
p_41,0,11,e_3,600,636,681,12,1,0,12,4,0,1,36,45,81
p_91,0,12,e_2,526,645,683,30,10,10,3,4,0,1,119,38,157
p_39,0,12,e_3,607,636,686,9,1,0,9,4,0,1,29,50,79
p_90,0,13,e_2,527,645,688,29,11,11,2,4,0,1,118,43,161
p_30,0,3,e_1,668,678,691,20,6,6,3,4,0,1,10,13,23
p_93,0,13,e_3,520,636,691,1,1,0,1,4,0,1,116,55,171
p_40,0,13,e_3,602,636,691,11,1,0,11,4,0,1,34,55,89
p_38,0,13,e_3,608,636,691,9,1,0,9,4,0,1,28,55,83
p_95,0,14,e_3,518,636,696,2,1,0,2,4,0,1,118,60,178
p_75,0,5,e_1,559,678,699,21,7,7,1,4,0,1,119,21,140
p_29,0,5,e_1,670,678,699,20,6,6,2,4,0,1,8,21,29
p_32,0,6,e_1,650,678,704,24,9,9,9,4,0,1,28,26,54
p_31,0,6,e_1,666,678,704,20,7,7,4,4,0,1,12,26,38
p_74,0,7,e_1,560,678,709,21,6,6,0,4,0,1,118,31,149
p_130,0,1,e_0,472,711,716,12,0,0,4,4,0,1,239,5,244
p_119,0,1,e_0,483,711,716,12,0,0,0,4,0,1,228,5,233
p_27,0,10,e_1,677,678,720,18,5,5,0,3,0,0,1,42,43
p_129,0,3,e_0,473,711,724,12,0,0,4,4,0,1,238,13,251
p_73,0,11,e_1,561,678,725,21,6,6,0,3,0,0,117,47,164
p_28,0,11,e_1,676,678,725,18,5,5,0,4,0,1,2,47,49
p_34,0,12,e_1,646,678,730,26,9,9,10,4,0,1,32,52,84
p_124,0,7,e_0,478,711,738,12,0,0,2,4,0,1,233,27,260
p_118,0,7,e_0,484,711,738,12,0,0,0,3,0,0,227,27,254
p_33,0,15,e_1,649,678,741,25,9,9,9,4,0,1,29,63,92
p_127,0,10,e_0,475,711,749,12,0,0,3,4,0,1,236,38,274
p_22,0,3,e_3,719,740,751,7,1,0,7,4,0,1,21,11,32
p_132,0,11,e_0,470,711,754,12,0,0,5,4,0,1,241,43,284
p_128,0,11,e_0,474,711,754,12,0,0,3,4,0,1,237,43,280
p_123,0,11,e_0,479,711,754,12,0,0,2,4,0,1,232,43,275
p_121,0,11,e_0,481,711,754,12,0,0,1,4,0,1,230,43,273
p_120,0,11,e_0,482,711,754,12,0,0,1,4,0,1,229,43,272
p_21,0,4,e_3,731,740,756,3,1,0,3,4,0,1,9,16,25
p_126,0,12,e_0,476,711,759,12,0,0,3,4,0,1,235,48,283
p_131,0,14,e_0,471,711,767,12,0,0,4,4,0,1,240,56,296
p_125,0,14,e_0,477,711,767,12,0,0,2,4,0,1,234,56,290
p_122,0,15,e_0,480,711,772,12,0,0,1,4,0,1,231,61,292
p_35,0,9,e_3,630,740,773,2,1,0,2,4,0,1,110,33,143
p_23,0,12,e_3,711,740,784,9,1,0,9,4,0,1,29,44,73
p_36,0,13,e_3,628,740,789,2,1,0,2,4,0,1,112,49,161
p_20,0,14,e_3,734,740,794,2,1,0,2,4,0,1,6,54,60
p_16,0,2,e_2,780,796,804,17,3,3,5,4,0,1,16,8,24
p_14,0,4,e_2,794,796,812,14,0,0,0,4,0,1,2,16,18
p_65,0,1,e_0,573,819,824,19,4,4,8,4,0,1,246,5,251
p_15,0,9,e_2,793,796,829,14,0,0,1,4,0,1,3,33,36
p_72,0,3,e_0,562,819,832,21,6,6,12,4,0,1,257,13,270
p_71,0,3,e_0,564,819,832,20,6,6,11,4,0,1,255,13,268
p_70,0,3,e_0,565,819,832,20,5,5,11,4,0,1,254,13,267
p_67,0,3,e_0,568,819,832,20,5,5,10,4,0,1,251,13,264
p_66,0,3,e_0,569,819,832,19,5,5,10,4,0,1,250,13,263
p_18,0,10,e_2,766,796,834,21,4,4,10,4,0,1,30,38,68
p_17,0,10,e_2,776,796,834,18,3,3,6,4,0,1,20,38,58
p_64,0,4,e_0,574,819,837,18,4,4,8,4,0,1,245,18,263
p_19,0,11,e_2,754,796,839,24,5,5,13,3,0,0,42,43,85
p_61,0,6,e_0,579,819,845,17,3,3,6,4,0,1,240,26,266
p_60,0,10,e_0,580,819,859,17,3,3,6,4,0,1,239,40,279
p_58,0,11,e_0,582,819,864,16,3,3,5,4,0,1,237,45,282
p_68,0,13,e_0,567,819,872,20,5,5,10,4,0,1,252,53,305
p_63,0,13,e_0,577,819,872,18,3,3,7,4,0,1,242,53,295
p_62,0,13,e_0,578,819,872,18,3,3,7,4,0,1,241,53,294
p_69,0,14,e_0,566,819,877,20,5,5,11,4,0,1,253,58,311
p_59,0,14,e_0,581,819,877,17,3,3,6,4,0,1,238,58,296
p_9,0,2,e_2,846,874,882,14,0,0,9,4,0,1,28,8,36
p_10,0,8,e_2,835,874,902,14,0,0,10,5,1,0,39,28,67
p_45,0,2,e_0,595,921,929,13,1,0,1,4,0,1,326,8,334
p_55,0,3,e_0,585,921,934,16,2,2,4,4,0,1,336,13,349
p_54,0,3,e_0,586,921,934,16,2,2,4,4,0,1,335,13,348
p_52,0,3,e_0,588,921,934,15,1,1,3,4,0,1,333,13,346
p_1,0,5,e_3,894,919,936,8,1,0,8,4,0,1,25,17,42
p_48,0,4,e_0,592,921,939,14,1,0,2,4,0,1,329,18,347
p_46,0,4,e_0,594,921,939,14,1,0,1,4,0,1,327,18,345
p_7,0,5,e_1,875,923,940,14,1,0,15,3,0,0,48,17,65
p_56,0,6,e_0,584,921,947,16,2,2,5,4,0,1,337,26,363
p_3,0,8,e_3,888,919,947,10,1,0,10,4,0,1,31,28,59
p_50,0,7,e_0,590,921,952,15,1,0,3,4,0,1,331,31,362
p_43,0,7,e_0,597,921,952,13,1,0,0,4,0,1,324,31,355
p_44,0,8,e_0,596,921,957,13,1,0,1,4,0,1,325,36,361
p_8,0,11,e_3,874,919,958,14,0,0,14,3,0,0,45,39,84
p_53,0,9,e_0,587,921,962,15,2,2,4,4,0,1,334,41,375
p_51,0,9,e_0,589,921,962,15,1,0,3,4,0,1,332,41,373
p_47,0,9,e_0,593,921,962,14,1,0,2,4,0,1,328,41,369
p_57,0,11,e_0,583,921,970,16,2,2,5,4,0,1,338,49,387
p_49,0,14,e_0,591,921,981,15,1,0,2,4,0,1,330,60,390
p_4,0,1,e_0,886,1025,1030,11,1,0,11,4,0,1,139,5,144
p_24,0,2,e_0,695,1025,1035,14,1,1,5,4,0,1,330,10,340
p_6,0,3,e_0,877,1025,1040,14,1,0,14,4,0,1,148,15,163
p_42,0,6,e_0,598,1025,1051,12,1,0,0,3,0,0,427,26,453
p_26,0,8,e_0,684,1025,1059,16,4,4,9,4,0,1,341,34,375
p_25,0,8,e_0,686,1025,1059,16,3,3,8,4,0,1,339,34,373
p_5,0,8,e_0,883,1025,1059,12,1,0,12,4,0,1,142,34,176
p_11,0,9,e_0,807,1025,1064,14,0,0,4,4,0,1,218,39,257
p_13,0,11,e_0,796,1025,1072,14,0,0,7,4,0,1,229,47,276
p_12,0,11,e_0,798,1025,1072,14,0,0,7,4,0,1,227,47,274
p_2,0,11,e_0,892,1025,1072,9,1,0,9,4,0,1,133,47,180
p_300,0,4,e_0,8,9,25,0,0,0,0,3,0,0,1,16,17
p_299,0,5,e_1,9,10,29,0,0,0,0,3,0,0,1,19,20
p_297,0,6,e_3,15,16,38,0,0,0,0,3,0,0,1,22,23
p_298,0,9,e_2,11,12,43,0,0,0,0,3,0,0,1,31,32
p_296,0,4,e_0,28,43,57,9,1,1,4,3,0,0,15,14,29
p_286,0,3,e_1,46,47,60,6,0,0,0,3,0,0,1,13,14
p_292,0,6,e_0,38,43,65,6,0,0,1,4,0,1,5,22,27
p_290,0,6,e_0,40,43,65,6,0,0,1,4,0,1,3,22,25
p_289,0,4,e_1,43,47,65,6,0,0,1,4,0,1,4,18,22
p_295,0,5,e_1,29,47,70,9,1,1,5,3,0,0,18,23,41
p_287,0,5,e_1,45,47,70,6,0,0,0,4,0,1,2,23,25
p_288,0,8,e_1,44,47,81,6,0,0,1,4,0,1,3,34,37
p_281,0,1,e_3,73,74,81,0,0,0,0,3,0,0,1,7,8
p_291,0,11,e_0,39,43,82,6,0,0,1,4,0,1,4,39,43
p_294,0,12,e_0,31,43,87,8,1,1,4,4,0,1,12,44,56
p_293,0,12,e_0,33,43,87,7,1,1,3,4,0,1,10,44,54
p_278,0,2,e_2,77,84,92,18,4,4,2,4,0,1,7,8,15
p_285,0,4,e_3,53,74,92,6,0,0,6,3,0,0,21,18,39
p_284,0,4,e_2,54,84,100,6,1,0,9,3,0,0,30,16,46
p_282,0,7,e_3,66,74,103,2,1,0,2,4,0,1,8,29,37
p_279,0,5,e_2,76,84,105,18,4,4,2,4,0,1,8,21,29
p_277,0,6,e_2,82,84,110,17,3,3,0,4,0,1,2,26,28
p_283,0,9,e_3,57,74,111,5,1,0,5,4,0,1,17,37,54
p_273,0,4,e_1,110,111,127,9,0,0,0,3,0,0,1,16,17
p_280,0,14,e_2,75,84,136,18,4,4,3,4,0,1,9,52,61
p_274,0,8,e_1,88,111,141,15,3,3,7,4,0,1,23,30,53
p_271,0,1,e_3,121,143,148,7,1,0,7,4,0,1,22,5,27
p_276,0,11,e_1,84,111,152,16,3,3,8,3,0,0,27,41,68
p_275,0,14,e_1,86,111,163,16,3,3,8,4,0,1,25,52,77
p_270,0,9,e_3,122,143,174,7,1,0,7,4,0,1,21,31,52
p_269,0,9,e_3,127,143,174,5,1,0,5,4,0,1,16,31,47
p_272,0,10,e_3,113,143,179,9,0,0,9,3,0,0,30,36,66
p_268,0,2,e_0,144,183,193,20,3,3,12,3,0,0,39,10,49
p_267,0,1,e_2,148,193,198,19,2,2,14,3,0,0,45,5,50
p_265,0,4,e_0,152,183,201,18,2,2,10,4,0,1,31,18,49
p_262,0,5,e_0,157,183,206,16,2,2,8,4,0,1,26,23,49
p_261,0,5,e_0,164,183,206,14,2,2,6,4,0,1,19,23,42
p_255,0,3,e_2,184,193,206,10,0,0,3,4,0,1,9,13,22
p_266,0,6,e_0,151,183,211,18,2,2,10,4,0,1,32,28,60
p_254,0,4,e_2,187,193,211,10,0,0,2,4,0,1,6,18,24
p_263,0,7,e_0,154,183,216,17,2,2,9,4,0,1,29,33,62
p_260,0,7,e_0,165,183,216,14,2,2,6,4,0,1,18,33,51
p_258,0,7,e_0,168,183,216,13,2,2,5,4,0,1,15,33,48
p_253,0,5,e_2,190,193,216,10,0,0,1,4,0,1,3,23,26
p_256,0,10,e_0,182,183,227,10,0,0,0,3,0,0,1,44,45
p_264,0,11,e_0,153,183,232,18,2,2,10,4,0,1,30,49,79
p_257,0,14,e_0,169,183,243,12,2,2,4,4,0,1,14,60,74
p_250,0,2,e_2,217,235,243,7,1,0,5,3,0,0,18,8,26
p_259,0,15,e_0,167,183,248,13,2,2,5,4,0,1,16,65,81
p_252,0,5,e_3,205,238,255,10,0,0,10,3,0,0,33,17,50
p_248,0,5,e_2,246,255,272,28,2,2,2,3,0,0,9,17,26
p_247,0,5,e_2,250,255,272,26,2,2,1,4,0,1,5,17,22
p_251,0,15,e_3,209,238,287,9,1,0,9,4,0,1,29,49,78
p_241,0,1,e_1,283,284,291,16,1,1,0,3,0,0,1,7,8
p_249,0,6,e_1,239,284,308,30,2,2,14,3,0,0,45,24,69
p_245,0,7,e_1,269,284,313,21,1,1,5,4,0,1,15,29,44
p_242,0,8,e_1,277,284,318,18,1,1,2,4,0,1,7,34,41
p_246,0,10,e_1,262,284,326,23,1,1,7,4,0,1,22,42,64
p_244,0,12,e_2,271,289,327,20,1,1,5,2,1,0,18,38,56
p_243,0,15,e_1,272,284,343,20,1,1,4,4,0,1,12,59,71
p_236,0,1,e_0,305,349,356,15,1,0,14,4,0,1,44,7,51
p_233,0,1,e_0,311,349,356,13,1,0,12,4,0,1,38,7,45
p_226,0,2,e_0,329,349,361,7,1,0,6,4,0,1,20,12,32
p_214,0,3,e_3,349,350,363,0,0,0,0,3,0,0,1,13,14
p_230,0,3,e_0,319,349,366,10,1,0,10,4,0,1,30,17,47
p_228,0,4,e_0,325,349,371,8,1,0,8,4,0,1,24,22,46
p_232,0,5,e_0,314,349,376,12,1,0,11,4,0,1,35,27,62
p_225,0,5,e_0,330,349,376,6,1,0,6,4,0,1,19,27,46
p_237,0,7,e_0,304,349,384,15,1,0,15,4,0,1,45,35,80
p_231,0,7,e_0,317,349,384,11,1,0,10,4,0,1,32,35,67
p_235,0,8,e_0,308,349,389,14,1,0,13,4,0,1,41,40,81
p_234,0,8,e_0,310,349,389,13,1,0,13,4,0,1,39,40,79
p_239,0,11,e_3,302,350,389,15,0,0,15,3,0,0,48,39,87
p_240,0,9,e_0,301,349,394,15,0,0,15,3,0,0,48,45,93
p_209,0,2,e_2,357,389,397,21,2,2,10,4,0,1,32,8,40
p_205,0,2,e_2,362,389,397,19,1,1,9,4,0,1,27,8,35
p_227,0,12,e_0,327,349,405,7,1,0,7,4,0,1,22,56,78
p_200,0,4,e_2,367,389,405,18,1,1,7,4,0,1,22,16,38
p_183,0,1,e_1,396,399,406,11,0,0,1,4,0,1,3,7,10
p_238,0,13,e_0,303,349,410,15,1,0,15,4,0,1,46,61,107
p_229,0,13,e_0,320,349,410,10,1,0,9,4,0,1,29,61,90
p_201,0,5,e_2,366,389,410,18,1,1,7,4,0,1,23,21,44
p_182,0,2,e_1,397,399,411,11,0,0,0,4,0,1,2,12,14
p_210,0,6,e_2,354,389,415,22,2,2,11,4,0,1,35,26,61
p_208,0,6,e_2,358,389,415,20,2,2,10,4,0,1,31,26,57
p_186,0,4,e_1,390,399,419,11,0,0,3,4,0,1,9,20,29
p_198,0,9,e_2,369,389,426,17,1,1,6,4,0,1,20,37,57
p_212,0,7,e_1,351,399,430,22,2,2,15,3,0,0,48,31,79
p_207,0,11,e_2,359,389,434,20,2,2,10,4,0,1,30,45,75
p_206,0,12,e_2,361,389,439,19,2,2,9,4,0,1,28,50,78
p_203,0,12,e_2,364,389,439,19,1,1,8,4,0,1,25,50,75
p_185,0,10,e_1,391,399,441,11,0,0,2,4,0,1,8,42,50
p_167,0,1,e_3,413,435,442,7,1,0,7,4,0,1,22,7,29
p_204,0,14,e_2,363,389,447,19,1,1,8,4,0,1,26,58,84
p_180,0,2,e_3,399,435,447,11,0,0,11,3,0,0,36,12,48
p_187,0,12,e_1,389,399,449,11,0,0,3,4,0,1,10,50,60
p_184,0,12,e_1,392,399,449,11,0,0,2,4,0,1,7,50,57
p_213,0,15,e_2,350,389,452,22,3,3,12,3,0,0,39,63,102
p_211,0,15,e_2,353,389,452,22,2,2,12,4,0,1,36,63,99
p_202,0,15,e_2,365,389,452,19,1,1,8,4,0,1,24,63,87
p_199,0,15,e_2,368,389,452,18,1,1,7,4,0,1,21,63,84
p_178,0,3,e_3,401,435,452,11,1,0,11,4,0,1,34,17,51
p_216,0,1,e_0,347,451,456,1,1,0,0,4,0,1,104,5,109
p_176,0,4,e_3,403,435,457,10,1,0,10,4,0,1,32,22,54
p_181,0,15,e_1,398,399,460,11,0,0,0,3,0,0,1,61,62
p_223,0,2,e_0,336,451,461,4,1,0,4,4,0,1,115,10,125
p_179,0,8,e_3,400,435,471,11,1,0,11,4,0,1,35,36,71
p_224,0,5,e_0,331,451,472,6,1,0,6,4,0,1,120,21,141
p_222,0,5,e_0,337,451,472,4,1,0,4,4,0,1,114,21,135
p_219,0,5,e_0,342,451,472,2,1,0,2,4,0,1,109,21,130
p_177,0,9,e_3,402,435,476,11,1,0,11,4,0,1,33,41,74
p_169,0,9,e_3,411,435,476,8,1,0,8,4,0,1,24,41,65
p_221,0,6,e_0,339,451,477,3,1,0,3,4,0,1,112,26,138
p_220,0,6,e_0,341,451,477,3,1,0,2,4,0,1,110,26,136
p_217,0,7,e_0,346,451,482,1,1,0,1,4,0,1,105,31,136
p_154,0,7,e_0,436,451,482,30,11,11,5,4,0,1,15,31,46
p_173,0,11,e_3,407,435,484,9,1,0,9,4,0,1,28,49,77
p_166,0,12,e_3,416,435,489,6,1,0,6,4,0,1,19,54,73
p_153,0,9,e_0,437,451,490,30,11,11,4,4,0,1,14,39,53
p_171,0,13,e_3,409,435,494,8,1,0,8,4,0,1,26,59,85
p_168,0,13,e_3,412,435,494,7,1,0,7,4,0,1,23,59,82
p_218,0,11,e_0,343,451,498,2,1,0,2,4,0,1,108,47,155
p_175,0,14,e_3,405,435,499,10,1,0,10,4,0,1,30,64,94
p_174,0,14,e_3,406,435,499,9,1,0,9,4,0,1,29,64,93
p_170,0,14,e_3,410,435,499,8,1,0,8,4,0,1,25,64,89
p_190,0,1,e_2,379,499,504,14,1,1,3,4,0,1,120,5,125
p_146,0,1,e_2,453,499,504,27,9,9,15,4,0,1,46,5,51
p_172,0,15,e_3,408,435,504,9,1,0,9,4,0,1,27,69,96
p_155,0,14,e_0,435,451,509,30,12,12,5,4,0,1,16,58,74
p_143,0,3,e_2,456,499,512,4,8,8,14,4,0,1,43,13,56
p_215,0,15,e_0,348,451,514,0,1,0,0,3,0,0,103,63,166
p_152,0,15,e_0,441,451,514,29,11,11,3,4,0,1,10,63,73
p_151,0,15,e_0,442,451,514,29,11,11,3,4,0,1,9,63,72
p_196,0,4,e_2,371,499,517,17,1,1,6,4,0,1,128,18,146
p_106,0,3,e_1,500,507,518,16,2,2,2,4,0,1,7,11,18
p_194,0,6,e_2,373,499,525,16,1,1,5,4,0,1,126,26,152
p_192,0,8,e_2,375,499,533,15,1,1,4,4,0,1,124,34,158
p_189,0,8,e_2,382,499,533,13,1,1,2,4,0,1,117,34,151
p_140,0,8,e_1,459,507,535,26,8,8,15,2,1,0,48,28,76
p_147,0,9,e_2,452,499,538,27,9,9,15,4,0,1,47,39,86
p_144,0,9,e_2,455,499,538,26,9,9,14,4,0,1,44,39,83
p_197,0,10,e_2,370,499,543,17,1,1,6,4,0,1,129,44,173
p_191,0,10,e_2,376,499,543,15,1,1,4,4,0,1,123,44,167
p_107,0,11,e_1,499,507,546,16,2,2,2,4,0,1,8,39,47
p_193,0,11,e_2,374,499,548,16,1,1,5,4,0,1,125,49,174
p_145,0,11,e_2,454,499,548,27,9,9,15,4,0,1,45,49,94
p_105,0,12,e_1,502,507,551,15,2,2,1,4,0,1,5,44,49
p_188,0,13,e_2,384,499,556,12,1,1,1,4,0,1,115,57,172
p_161,0,1,e_3,421,551,558,4,1,0,4,4,0,1,130,7,137
p_158,0,1,e_3,430,551,558,1,1,0,1,4,0,1,121,7,128
p_104,0,14,e_1,503,507,559,15,1,1,1,4,0,1,4,52,56
p_195,0,15,e_2,372,499,564,16,1,1,5,4,0,1,127,65,192
p_165,0,4,e_3,417,551,569,6,1,0,6,4,0,1,134,18,152
p_77,0,3,e_0,557,561,574,29,10,10,1,4,0,1,4,13,17
p_159,0,6,e_3,429,551,577,2,1,0,2,4,0,1,122,26,148
p_99,0,6,e_3,514,551,577,12,1,0,12,4,0,1,37,26,63
p_75,0,5,e_0,559,561,582,29,10,10,0,4,0,1,2,21,23
p_102,0,7,e_3,509,551,582,14,1,0,14,4,0,1,42,31,73
p_150,0,6,e_0,443,561,587,29,11,11,2,4,0,1,118,26,144
p_76,0,6,e_0,558,561,587,29,10,10,1,4,0,1,3,26,29
p_101,0,8,e_3,511,551,587,13,1,0,13,4,0,1,40,36,76
p_80,0,7,e_0,552,561,592,30,10,10,3,4,0,1,9,31,40
p_74,0,7,e_0,560,561,592,29,10,10,0,3,0,0,1,31,32
p_100,0,9,e_3,513,551,592,12,1,0,12,4,0,1,38,41,79
p_148,0,8,e_0,449,561,597,28,10,10,0,4,0,1,112,36,148
p_163,0,10,e_3,419,551,597,5,1,0,5,4,0,1,132,46,178
p_164,0,11,e_3,418,551,602,5,1,0,5,4,0,1,133,51,184
p_162,0,11,e_3,420,551,602,5,1,0,5,4,0,1,131,51,182
p_103,0,11,e_3,508,551,602,14,1,0,14,4,0,1,43,51,94
p_78,0,12,e_0,556,561,611,29,11,11,1,4,0,1,5,50,55
p_65,0,1,e_1,573,606,611,25,9,9,11,4,0,1,33,5,38
p_157,0,14,e_3,431,551,613,1,1,0,1,4,0,1,120,62,182
p_130,0,1,e_2,472,611,616,22,7,7,9,4,0,1,139,5,144
p_160,0,15,e_3,426,551,618,3,1,0,3,4,0,1,125,67,192
p_156,0,15,e_3,434,551,618,0,0,0,0,3,0,0,117,67,184
p_81,0,14,e_0,551,561,619,30,11,11,3,4,0,1,10,58,68
p_79,0,14,e_0,553,561,619,30,10,10,2,4,0,1,8,58,66
p_72,0,3,e_1,562,606,619,28,10,10,14,4,0,1,44,13,57
p_71,0,3,e_1,564,606,619,27,10,10,14,4,0,1,42,13,55
p_70,0,3,e_1,565,606,619,27,10,10,13,4,0,1,41,13,54
p_67,0,3,e_1,568,606,619,4,9,9,12,4,0,1,38,13,51
p_66,0,3,e_1,569,606,619,26,9,9,12,4,0,1,37,13,50
p_149,0,15,e_0,444,561,624,29,11,11,2,4,0,1,117,63,180
p_64,0,4,e_1,574,606,624,25,9,9,10,4,0,1,32,18,50
p_136,0,3,e_2,465,611,624,24,8,8,11,4,0,1,146,13,159
p_129,0,3,e_2,473,611,624,22,7,7,8,4,0,1,138,13,151
p_137,0,4,e_2,464,611,629,24,8,8,11,4,0,1,147,18,165
p_61,0,6,e_1,579,606,632,24,8,8,9,4,0,1,27,26,53
p_141,0,6,e_2,458,611,637,26,8,8,13,4,0,1,153,26,179
p_60,0,10,e_1,580,606,646,23,8,8,8,4,0,1,26,40,66
p_142,0,9,e_2,457,611,648,26,8,8,14,4,0,1,154,37,191
p_73,0,11,e_1,561,606,651,28,10,10,14,3,0,0,45,45,90
p_139,0,10,e_2,461,611,653,25,8,8,12,4,0,1,150,42,192
p_135,0,10,e_2,466,611,653,23,8,8,11,4,0,1,145,42,187
p_127,0,10,e_2,475,611,653,21,6,6,8,4,0,1,136,42,178
p_138,0,11,e_2,463,611,658,24,8,8,12,4,0,1,148,47,195
p_132,0,11,e_2,470,611,658,22,7,7,9,4,0,1,141,47,188
p_128,0,11,e_2,474,611,658,21,7,7,8,4,0,1,137,47,184
p_68,0,13,e_1,567,606,659,26,10,10,13,4,0,1,39,53,92
p_63,0,13,e_1,577,606,659,24,8,8,9,4,0,1,29,53,82
p_62,0,13,e_1,578,606,659,24,8,8,9,4,0,1,28,53,81
p_133,0,12,e_2,469,611,663,22,8,8,10,4,0,1,142,52,194
p_69,0,14,e_1,566,606,664,27,10,10,13,4,0,1,40,58,98
p_59,0,14,e_1,581,606,664,23,7,7,8,4,0,1,25,58,83
p_96,0,1,e_3,517,665,670,11,1,0,11,4,0,1,148,5,153
p_131,0,14,e_2,471,611,671,22,7,7,9,4,0,1,140,60,200
p_86,0,2,e_3,544,665,675,2,1,0,2,4,0,1,121,10,131
p_134,0,15,e_2,467,611,676,23,8,8,10,4,0,1,144,65,209
p_92,0,4,e_3,525,665,683,8,1,0,8,4,0,1,140,18,158
p_30,0,3,e_0,668,676,687,29,13,13,2,4,0,1,8,11,19
p_88,0,5,e_3,538,665,688,4,1,0,4,4,0,1,127,23,150
p_94,0,6,e_3,519,665,693,10,1,0,10,4,0,1,146,28,174
p_29,0,5,e_0,670,676,695,29,12,12,2,4,0,1,6,19,25
p_98,0,7,e_3,515,665,698,12,1,0,12,4,0,1,150,33,183
p_97,0,7,e_3,516,665,698,11,1,0,11,4,0,1,149,33,182
p_31,0,6,e_0,666,676,700,30,12,12,3,4,0,1,10,24,34
p_87,0,8,e_3,539,665,703,4,1,0,4,4,0,1,126,38,164
p_89,0,9,e_3,535,665,708,5,1,0,5,4,0,1,130,43,173
p_45,0,2,e_1,595,708,716,20,5,5,3,4,0,1,113,8,121
p_91,0,12,e_3,526,665,719,8,1,0,8,4,0,1,139,54,193
p_84,0,12,e_3,546,665,719,1,1,0,1,4,0,1,119,54,173
p_55,0,3,e_1,585,708,721,22,7,7,7,4,0,1,123,13,136
p_54,0,3,e_1,586,708,721,22,6,6,6,4,0,1,122,13,135
p_52,0,3,e_1,588,708,721,22,6,6,6,4,0,1,120,13,133
p_36,0,13,e_0,628,676,723,12,1,0,15,3,0,0,48,47,95
p_93,0,13,e_3,520,665,724,10,1,0,10,4,0,1,145,59,204
p_90,0,13,e_3,527,665,724,8,1,0,8,4,0,1,138,59,197
p_48,0,4,e_1,592,708,726,21,5,5,4,4,0,1,116,18,134
p_46,0,4,e_1,594,708,726,21,5,5,4,4,0,1,114,18,132
p_119,0,1,e_2,483,723,728,19,5,5,5,4,0,1,240,5,245
p_113,0,1,e_2,489,723,728,18,4,4,3,4,0,1,234,5,239
p_95,0,14,e_3,518,665,729,11,1,0,11,4,0,1,147,64,211
p_56,0,6,e_1,584,708,734,23,7,7,7,4,0,1,124,26,150
p_85,0,15,e_3,545,665,734,2,1,0,2,4,0,1,120,69,189
p_114,0,3,e_2,488,723,736,18,4,4,3,4,0,1,235,13,248
p_50,0,7,e_1,590,708,739,21,6,6,5,4,0,1,118,31,149
p_44,0,8,e_1,596,708,744,20,4,4,3,4,0,1,112,36,148
p_53,0,9,e_1,587,708,749,22,6,6,6,4,0,1,121,41,162
p_51,0,9,e_1,589,708,749,22,6,6,5,4,0,1,119,41,160
p_47,0,9,e_1,593,708,749,21,5,5,4,4,0,1,115,41,156
p_124,0,7,e_2,478,723,750,21,6,6,7,4,0,1,245,27,272
p_118,0,7,e_2,484,723,750,19,5,5,5,4,0,1,239,27,266
p_58,0,11,e_1,582,708,757,23,7,7,8,4,0,1,126,49,175
p_57,0,11,e_1,583,708,757,23,7,7,7,4,0,1,125,49,174
p_115,0,9,e_2,487,723,758,18,5,5,4,4,0,1,236,35,271
p_117,0,10,e_2,485,723,763,19,5,5,4,4,0,1,238,40,278
p_116,0,10,e_2,486,723,763,19,5,5,4,4,0,1,237,40,277
p_49,0,14,e_1,591,708,768,21,5,5,5,4,0,1,117,60,177
p_123,0,11,e_2,479,723,768,20,6,6,6,4,0,1,244,45,289
p_121,0,11,e_2,481,723,768,20,6,6,6,4,0,1,242,45,287
p_120,0,11,e_2,482,723,768,19,6,6,5,4,0,1,241,45,286
p_112,0,11,e_2,490,723,768,18,4,4,3,4,0,1,233,45,278
p_126,0,12,e_2,476,723,773,21,6,6,7,4,0,1,247,50,297
p_125,0,14,e_2,477,723,781,21,6,6,7,4,0,1,246,58,304
p_122,0,15,e_2,480,723,786,20,6,6,6,4,0,1,243,63,306
p_21,0,4,e_0,731,773,787,16,2,2,13,3,0,0,42,14,56
p_16,0,2,e_3,780,781,791,0,0,0,0,3,0,0,1,10,11
p_32,0,6,e_3,650,781,805,5,1,0,5,4,0,1,131,24,155
p_18,0,10,e_0,766,773,807,5,1,0,2,4,0,1,7,34,41
p_19,0,11,e_0,754,773,812,9,1,0,6,4,0,1,19,39,58
p_83,0,8,e_3,549,781,813,0,1,0,0,4,0,1,232,32,264
p_37,0,9,e_3,615,781,818,16,2,2,14,5,1,1,166,37,203
p_35,0,9,e_3,630,781,818,11,1,0,11,4,0,1,151,37,188
p_24,0,2,e_1,695,812,820,24,8,8,4,4,0,1,117,8,125
p_20,0,14,e_0,734,773,823,15,1,0,13,4,0,1,39,50,89
p_17,0,10,e_3,776,781,823,1,1,0,1,4,0,1,5,42,47
p_14,0,4,e_1,794,812,828,27,7,7,6,4,0,1,18,16,34
p_34,0,12,e_3,646,781,831,6,1,0,6,4,0,1,135,50,185
p_42,0,6,e_1,598,812,836,20,4,4,2,4,0,1,214,24,238
p_82,0,14,e_3,550,781,839,0,0,0,0,3,0,0,231,58,289
p_43,0,7,e_1,597,812,841,20,4,4,3,4,0,1,215,29,244
p_22,0,3,e_2,719,833,844,18,4,4,1,4,0,1,114,11,125
p_33,0,15,e_3,649,781,844,5,1,0,5,4,0,1,132,63,195
p_26,0,8,e_1,684,812,846,26,10,10,8,4,0,1,128,34,162
p_25,0,8,e_1,686,812,846,25,10,10,7,4,0,1,126,34,160
p_15,0,9,e_1,793,812,851,28,7,7,6,4,0,1,19,39,58
p_11,0,9,e_1,807,812,851,24,6,6,1,4,0,1,5,39,44
p_108,0,6,e_2,496,833,855,17,3,3,1,4,0,1,337,22,359
p_27,0,10,e_1,677,812,856,28,11,11,10,4,0,1,135,44,179
p_41,0,11,e_1,600,812,861,19,4,4,2,4,0,1,212,49,261
p_28,0,11,e_1,676,812,861,28,11,11,10,4,0,1,136,49,185
p_13,0,11,e_1,796,812,861,27,7,7,5,4,0,1,16,49,65
p_12,0,11,e_1,798,812,861,26,7,7,4,4,0,1,14,49,63
p_111,0,8,e_2,491,833,863,18,4,4,2,4,0,1,342,30,372
p_40,0,13,e_1,602,812,869,19,3,3,1,4,0,1,210,57,267
p_110,0,11,e_2,492,833,874,17,4,4,2,4,0,1,341,41,382
p_39,0,12,e_2,607,833,879,18,3,3,1,4,0,1,226,46,272
p_23,0,12,e_2,711,833,879,20,5,5,4,4,0,1,122,46,168
p_38,0,13,e_2,608,833,884,17,3,3,1,4,0,1,225,51,276
p_9,0,2,e_0,846,880,888,15,0,0,11,4,0,1,34,8,42
p_109,0,15,e_2,493,833,892,17,3,3,2,4,0,1,340,59,399
p_6,0,3,e_0,877,880,893,15,0,0,1,4,0,1,3,13,16
p_7,0,5,e_0,875,880,901,15,0,0,1,4,0,1,5,21,26
p_10,0,8,e_0,835,880,912,17,2,2,14,3,0,0,45,32,77
p_8,0,11,e_0,874,880,923,15,0,0,2,4,0,1,6,43,49
p_4,0,1,e_3,886,934,939,15,0,0,15,3,0,0,48,5,53
p_1,0,5,e_1,894,925,942,13,1,0,10,4,0,1,31,17,48
p_5,0,8,e_1,883,925,953,15,0,0,13,3,0,0,42,28,70
p_3,0,8,e_1,888,925,953,15,1,0,12,4,0,1,37,28,65
p_2,0,11,e_1,892,925,964,14,1,0,11,4,0,1,33,39,72
p_300,0,4,e_0,8,9,25,0,0,0,0,3,0,0,1,16,17
p_299,0,5,e_1,9,10,29,0,0,0,0,3,0,0,1,19,20
p_297,0,6,e_3,15,16,38,0,0,0,0,3,0,0,1,22,23
p_298,0,9,e_2,11,12,43,0,0,0,0,3,0,0,1,31,32
p_296,0,4,e_0,28,43,57,9,1,1,4,3,0,0,15,14,29
p_295,0,5,e_0,29,43,62,9,1,1,4,4,0,1,14,19,33
p_292,0,6,e_0,38,43,67,6,0,0,1,4,0,1,5,24,29
p_290,0,6,e_0,40,43,67,6,0,0,1,4,0,1,3,24,27
p_286,0,3,e_1,46,61,72,6,0,0,5,4,0,1,15,11,26
p_289,0,4,e_1,43,61,77,6,0,0,5,3,0,0,18,16,34
p_285,0,4,e_1,53,61,77,6,0,0,2,4,0,1,8,16,24
p_284,0,4,e_1,54,61,77,6,0,0,2,4,0,1,7,16,23
p_287,0,5,e_1,45,61,82,6,0,0,5,4,0,1,16,21,37
p_291,0,11,e_0,39,43,84,6,0,0,1,4,0,1,4,41,45
p_294,0,12,e_0,31,43,89,8,1,1,4,4,0,1,12,46,58
p_293,0,12,e_0,33,43,89,7,1,1,3,4,0,1,10,46,56
p_288,0,8,e_1,44,61,93,6,0,0,5,4,0,1,17,32,49
p_281,0,1,e_3,73,87,94,4,1,0,4,4,0,1,14,7,21
p_283,0,9,e_1,57,61,98,6,0,0,1,4,0,1,4,37,41
p_278,0,2,e_3,77,87,99,3,1,0,3,4,0,1,10,12,22
p_279,0,5,e_3,76,87,110,3,1,0,3,4,0,1,11,23,34
p_277,0,6,e_3,82,87,115,1,1,0,1,4,0,1,5,28,33
p_282,0,7,e_3,66,87,120,6,0,0,6,3,0,0,21,33,54
p_273,0,4,e_2,110,118,132,23,4,4,2,4,0,1,8,14,22
p_276,0,11,e_3,84,87,134,1,1,0,1,4,0,1,3,47,50
p_280,0,14,e_3,75,87,145,4,1,0,4,4,0,1,12,58,70
p_275,0,14,e_3,86,87,145,0,0,0,0,3,0,0,1,58,59
p_274,0,8,e_2,88,118,146,28,7,7,9,3,0,0,30,28,58
p_272,0,10,e_2,113,118,154,22,4,4,1,4,0,1,5,36,41
p_271,0,1,e_1,121,151,156,21,2,2,9,3,0,0,30,5,35
p_267,0,1,e_1,148,151,156,14,0,0,1,4,0,1,3,5,8
p_268,0,2,e_1,144,151,161,14,0,0,2,4,0,1,7,10,17
p_270,0,9,e_1,122,151,184,21,2,2,9,4,0,1,29,33,62
p_269,0,9,e_1,127,151,184,19,2,2,8,4,0,1,24,33,57
p_255,0,3,e_2,184,186,197,14,0,0,0,4,0,1,2,11,13
p_265,0,4,e_2,152,186,202,14,0,0,10,5,1,0,34,16,50
p_254,0,4,e_0,187,190,204,14,0,0,1,4,0,1,3,14,17
p_262,0,5,e_2,157,186,207,14,0,0,9,4,0,1,29,21,50
p_261,0,5,e_2,164,186,207,14,0,0,7,4,0,1,22,21,43
p_266,0,6,e_0,151,190,212,14,0,0,12,3,0,0,39,22,61
p_263,0,7,e_2,154,186,215,14,0,0,10,4,0,1,32,29,61
p_260,0,7,e_2,165,186,215,14,0,0,7,4,0,1,21,29,50
p_258,0,7,e_2,168,186,215,14,0,0,6,4,0,1,18,29,47
p_256,0,10,e_2,182,186,226,14,0,0,1,4,0,1,4,40,44
p_250,0,2,e_1,217,220,228,14,0,0,1,4,0,1,3,8,11
p_264,0,11,e_2,153,186,231,14,0,0,10,2,1,1,33,45,78
p_253,0,5,e_1,190,220,239,14,0,0,9,3,0,0,30,19,49
p_252,0,5,e_1,205,220,239,14,0,0,5,4,0,1,15,19,34
p_257,0,14,e_2,169,186,242,14,0,0,5,4,0,1,17,56,73
p_259,0,15,e_2,167,186,247,14,0,0,6,4,0,1,19,61,80
p_251,0,15,e_1,209,220,271,14,0,0,3,4,0,1,11,51,62
p_248,0,5,e_0,246,260,277,14,0,0,4,4,0,1,14,17,31
p_247,0,5,e_0,250,260,277,14,0,0,3,4,0,1,10,17,27
p_249,0,6,e_0,239,260,282,14,0,0,6,3,0,0,21,22,43
p_241,0,1,e_0,283,302,309,8,1,0,6,4,0,1,19,7,26
p_236,0,1,e_3,305,307,312,0,1,0,0,4,0,1,2,5,7
p_242,0,8,e_0,277,302,332,10,1,0,5,5,1,0,25,30,55
p_245,0,7,e_3,269,307,332,12,1,0,12,4,0,1,38,25,63
p_237,0,7,e_3,304,307,332,1,1,0,1,4,0,1,3,25,28
p_240,0,9,e_0,301,302,337,2,1,0,0,3,0,0,1,35,36
p_246,0,10,e_3,262,307,343,14,0,0,14,3,0,0,45,36,81
p_239,0,11,e_3,302,307,348,1,1,0,1,4,0,1,5,41,46
p_244,0,12,e_3,271,307,353,12,1,0,12,4,0,1,36,46,82
p_238,0,13,e_3,303,307,358,1,1,0,1,4,0,1,4,51,55
p_233,0,1,e_1,311,356,361,29,6,6,15,4,0,1,45,5,50
p_226,0,2,e_1,329,356,366,24,6,6,9,4,0,1,27,10,37
p_223,0,2,e_1,336,356,366,22,5,5,6,4,0,1,20,10,30
p_243,0,15,e_3,272,307,366,11,1,0,11,4,0,1,35,59,94
p_209,0,2,e_2,357,358,368,17,1,1,0,3,0,0,1,10,11
p_230,0,3,e_1,319,356,371,27,6,6,12,4,0,1,37,15,52
p_228,0,4,e_1,325,356,376,25,6,6,10,4,0,1,31,20,51
p_232,0,5,e_1,314,356,381,29,6,6,14,4,0,1,42,25,67
p_225,0,5,e_1,330,356,381,23,6,6,8,4,0,1,26,25,51
p_224,0,5,e_1,331,356,381,23,5,5,8,4,0,1,25,25,50
p_222,0,5,e_1,337,356,381,22,5,5,6,4,0,1,19,25,44
p_221,0,6,e_1,339,356,386,21,5,5,5,4,0,1,17,30,47
p_220,0,6,e_1,341,356,386,20,5,5,5,4,0,1,15,30,45
p_234,0,8,e_2,310,358,388,29,7,7,15,3,0,0,48,30,78
p_231,0,7,e_1,317,356,391,28,6,6,13,4,0,1,39,35,74
p_205,0,2,e_0,362,388,396,16,1,1,8,4,0,1,26,8,34
p_235,0,8,e_1,308,356,396,30,7,7,15,3,0,0,48,40,88
p_200,0,4,e_0,367,388,404,15,0,0,7,4,0,1,21,16,37
p_196,0,4,e_0,371,388,404,15,0,0,5,4,0,1,17,16,33
p_201,0,5,e_0,366,388,409,15,0,0,7,4,0,1,22,21,43
p_227,0,12,e_1,327,356,410,24,6,6,9,4,0,1,29,54,83
p_208,0,6,e_0,358,388,414,17,1,1,9,3,0,0,30,26,56
p_194,0,6,e_0,373,388,414,15,0,0,5,4,0,1,15,26,41
p_229,0,13,e_1,320,356,415,27,6,6,12,4,0,1,36,59,95
p_183,0,1,e_2,396,416,421,15,0,0,6,4,0,1,20,5,25
p_198,0,9,e_0,369,388,425,15,0,0,6,4,0,1,19,37,56
p_182,0,2,e_2,397,416,426,15,0,0,6,4,0,1,19,10,29
p_180,0,2,e_2,399,416,426,15,0,0,5,4,0,1,17,10,27
p_197,0,10,e_0,370,388,430,15,0,0,6,4,0,1,18,42,60
p_178,0,3,e_2,401,416,431,15,0,0,5,4,0,1,15,15,30
p_207,0,11,e_0,359,388,435,17,1,1,9,4,0,1,29,47,76
p_186,0,4,e_2,390,416,436,15,0,0,8,4,0,1,26,20,46
p_176,0,4,e_2,403,416,436,15,0,0,4,4,0,1,13,20,33
p_206,0,12,e_0,361,388,440,16,1,1,9,4,0,1,27,52,79
p_203,0,12,e_0,364,388,440,15,1,1,8,4,0,1,24,52,76
p_204,0,14,e_0,363,388,448,16,1,1,8,4,0,1,25,60,85
p_179,0,8,e_2,400,416,450,15,0,0,5,4,0,1,16,34,50
p_202,0,15,e_0,365,388,453,15,0,0,7,4,0,1,23,65,88
p_199,0,15,e_0,368,388,453,15,0,0,6,4,0,1,20,65,85
p_195,0,15,e_0,372,388,453,15,0,0,5,4,0,1,16,65,81
p_177,0,9,e_2,402,416,455,15,0,0,4,4,0,1,14,39,53
p_185,0,10,e_2,391,416,460,15,0,0,8,4,0,1,25,44,69
p_216,0,1,e_1,347,456,463,19,3,3,3,4,0,1,109,7,116
p_173,0,11,e_2,407,416,465,15,0,0,3,4,0,1,9,49,58
p_187,0,12,e_2,389,416,470,15,0,0,8,3,0,0,27,54,81
p_184,0,12,e_2,392,416,470,15,0,0,8,4,0,1,24,54,78
p_214,0,3,e_1,349,456,471,19,3,3,2,4,0,1,107,15,122
p_165,0,4,e_1,417,456,476,15,0,0,13,4,0,1,39,20,59
p_175,0,14,e_2,405,416,478,15,0,0,3,4,0,1,11,62,73
p_174,0,14,e_2,406,416,478,15,0,0,3,4,0,1,10,62,72
p_219,0,5,e_1,342,456,481,20,4,4,4,4,0,1,114,25,139
p_181,0,15,e_2,398,416,483,15,0,0,6,4,0,1,18,67,85
p_210,0,6,e_1,354,456,486,18,2,2,0,4,0,1,102,30,132
p_217,0,7,e_1,346,456,491,19,4,4,3,4,0,1,110,35,145
p_212,0,7,e_1,351,456,491,18,3,3,1,4,0,1,105,35,140
p_163,0,10,e_1,419,456,502,15,0,0,12,4,0,1,37,46,83
p_190,0,1,e_0,379,500,507,15,0,0,3,4,0,1,121,7,128
p_218,0,11,e_1,343,456,507,20,4,4,4,4,0,1,113,51,164
p_164,0,11,e_1,418,456,507,15,0,0,12,4,0,1,38,51,89
p_162,0,11,e_1,420,456,507,15,0,0,12,4,0,1,36,51,87
p_166,0,12,e_1,416,456,512,15,0,0,13,4,0,1,40,56,96
p_143,0,3,e_0,456,500,515,15,0,0,14,4,0,1,44,15,59
p_136,0,3,e_0,465,500,515,15,0,0,11,4,0,1,35,15,50
p_137,0,4,e_0,464,500,520,15,0,0,12,4,0,1,36,20,56
p_215,0,15,e_1,348,456,523,19,3,3,2,4,0,1,108,67,175
p_213,0,15,e_1,350,456,523,19,3,3,2,4,0,1,106,67,173
p_211,0,15,e_1,353,456,523,18,2,2,1,4,0,1,103,67,170
p_141,0,6,e_0,458,500,528,15,0,0,14,4,0,1,42,28,70
p_167,0,1,e_2,413,530,535,15,0,0,1,4,0,1,117,5,122
p_192,0,8,e_0,375,500,536,15,0,0,4,4,0,1,125,36,161
p_189,0,8,e_0,382,500,536,15,0,0,2,4,0,1,118,36,154
p_140,0,8,e_0,459,500,536,15,0,0,13,4,0,1,41,36,77
p_142,0,9,e_0,457,500,541,15,0,0,14,4,0,1,43,41,84
p_106,0,3,e_2,500,530,543,15,0,0,10,4,0,1,30,13,43
p_191,0,10,e_0,376,500,546,15,0,0,4,4,0,1,124,46,170
p_139,0,10,e_0,461,500,546,15,0,0,13,4,0,1,39,46,85
p_135,0,10,e_0,466,500,546,15,0,0,11,4,0,1,34,46,80
p_193,0,11,e_0,374,500,551,15,0,0,4,4,0,1,126,51,177
p_138,0,11,e_0,463,500,551,15,0,0,12,4,0,1,37,51,88
p_99,0,6,e_2,514,530,554,15,0,0,5,4,0,1,16,24,40
p_188,0,13,e_0,384,500,559,15,0,0,1,4,0,1,116,59,175
p_102,0,7,e_2,509,530,559,15,0,0,7,4,0,1,21,29,50
p_98,0,7,e_2,515,530,559,15,0,0,5,4,0,1,15,29,44
p_101,0,8,e_2,511,530,564,15,0,0,6,4,0,1,19,34,53
p_169,0,9,e_2,411,530,569,15,0,0,1,4,0,1,119,39,158
p_100,0,9,e_2,513,530,569,15,0,0,5,4,0,1,17,39,56
p_161,0,1,e_1,421,570,577,15,0,0,11,4,0,1,149,7,156
p_158,0,1,e_1,430,570,577,15,0,0,8,4,0,1,140,7,147
p_103,0,11,e_2,508,530,577,15,0,0,7,4,0,1,22,47,69
p_105,0,12,e_2,502,530,582,15,0,0,9,4,0,1,28,52,80
p_171,0,13,e_2,409,530,587,15,0,0,2,4,0,1,121,57,178
p_168,0,13,e_2,412,530,587,15,0,0,1,4,0,1,118,57,175
p_170,0,14,e_2,410,530,592,15,0,0,2,4,0,1,120,62,182
p_104,0,14,e_2,503,530,592,15,0,0,9,4,0,1,27,62,89
p_159,0,6,e_1,429,570,594,15,0,0,9,4,0,1,141,24,165
p_150,0,6,e_1,443,570,594,15,0,0,4,4,0,1,127,24,151
p_172,0,15,e_2,408,530,597,15,0,0,2,4,0,1,122,67,189
p_154,0,7,e_1,436,570,599,15,0,0,6,4,0,1,134,29,163
p_148,0,8,e_1,449,570,604,15,0,0,2,4,0,1,121,34,155
p_130,0,1,e_0,472,600,605,15,0,0,9,4,0,1,128,5,133
p_153,0,9,e_1,437,570,609,15,0,0,6,4,0,1,133,39,172
p_147,0,9,e_1,452,570,609,15,0,0,1,4,0,1,118,39,157
p_129,0,3,e_0,473,600,613,15,0,0,9,4,0,1,127,13,140
p_157,0,14,e_1,431,570,626,15,0,0,8,4,0,1,139,56,195
p_155,0,14,e_1,435,570,626,15,0,0,7,4,0,1,135,56,191
p_124,0,7,e_0,478,600,627,15,0,0,7,4,0,1,122,27,149
p_160,0,15,e_1,426,570,631,15,0,0,10,4,0,1,144,61,205
p_156,0,15,e_1,434,570,631,15,0,0,7,4,0,1,136,61,197
p_152,0,15,e_1,441,570,631,15,0,0,5,4,0,1,129,61,190
p_151,0,15,e_1,442,570,631,15,0,0,4,4,0,1,128,61,189
p_149,0,15,e_1,444,570,631,15,0,0,4,4,0,1,126,61,187
p_127,0,10,e_0,475,600,638,15,0,0,8,4,0,1,125,38,163
p_132,0,11,e_0,470,600,643,15,0,0,10,4,0,1,130,43,173
p_128,0,11,e_0,474,600,643,15,0,0,8,4,0,1,126,43,169
p_123,0,11,e_0,479,600,643,15,0,0,7,4,0,1,121,43,164
p_121,0,11,e_0,481,600,643,15,0,0,6,4,0,1,119,43,162
p_120,0,11,e_0,482,600,643,15,0,0,6,4,0,1,118,43,161
p_133,0,12,e_0,469,600,648,15,0,0,10,4,0,1,131,48,179
p_126,0,12,e_0,476,600,648,15,0,0,8,4,0,1,124,48,172
p_96,0,1,e_2,517,644,649,15,0,0,4,4,0,1,127,5,132
p_131,0,14,e_0,471,600,656,15,0,0,9,4,0,1,129,56,185
p_125,0,14,e_0,477,600,656,15,0,0,7,4,0,1,123,56,179
p_92,0,4,e_2,525,644,660,15,0,0,1,4,0,1,119,16,135
p_134,0,15,e_0,467,600,661,15,0,0,11,4,0,1,133,61,194
p_122,0,15,e_0,480,600,661,15,0,0,6,4,0,1,120,61,181
p_94,0,6,e_2,519,644,668,15,0,0,3,4,0,1,125,24,149
p_97,0,7,e_2,516,644,673,15,0,0,4,4,0,1,128,29,157
p_37,0,9,e_2,615,644,681,15,0,0,9,4,0,1,29,37,66
p_35,0,9,e_2,630,644,681,15,0,0,4,4,0,1,14,37,51
p_146,0,1,e_1,453,678,685,15,0,0,1,4,0,1,225,7,232
p_41,0,11,e_2,600,644,689,15,0,0,14,4,0,1,44,45,89
p_86,0,2,e_1,544,678,690,15,0,0,8,4,0,1,134,12,146
p_91,0,12,e_2,526,644,694,15,0,0,1,4,0,1,118,50,168
p_39,0,12,e_2,607,644,694,15,0,0,12,4,0,1,37,50,87
p_93,0,13,e_2,520,644,699,15,0,0,3,4,0,1,124,55,179
p_90,0,13,e_2,527,644,699,15,0,0,1,4,0,1,117,55,172
p_40,0,13,e_2,602,644,699,15,0,0,14,4,0,1,42,55,97
p_38,0,13,e_2,608,644,699,15,0,0,12,4,0,1,36,55,91
p_36,0,13,e_2,628,644,699,15,0,0,5,4,0,1,16,55,71
p_88,0,5,e_1,538,678,701,15,0,0,10,4,0,1,140,23,163
p_95,0,14,e_2,518,644,704,15,0,0,4,4,0,1,126,60,186
p_80,0,7,e_1,552,678,709,15,0,0,6,4,0,1,126,31,157
p_119,0,1,e_0,483,708,713,15,0,0,5,4,0,1,225,5,230
p_113,0,1,e_0,489,708,713,15,0,0,3,4,0,1,219,5,224
p_65,0,1,e_0,573,708,713,15,0,0,9,4,0,1,135,5,140
p_87,0,8,e_1,539,678,714,15,0,0,10,4,0,1,139,36,175
p_83,0,8,e_1,549,678,714,15,0,0,7,4,0,1,129,36,165
p_144,0,9,e_1,455,678,719,15,0,0,0,3,0,0,223,41,264
p_89,0,9,e_1,535,678,719,15,0,0,11,4,0,1,143,41,184
p_114,0,3,e_0,488,708,721,15,0,0,4,4,0,1,220,13,233
p_64,0,4,e_0,574,708,726,15,0,0,8,4,0,1,134,18,152
p_145,0,11,e_1,454,678,727,15,0,0,0,4,0,1,224,49,273
p_84,0,12,e_1,546,678,732,15,0,0,8,4,0,1,132,54,186
p_78,0,12,e_1,556,678,732,15,0,0,4,4,0,1,122,54,176
p_108,0,6,e_0,496,708,734,15,0,0,1,4,0,1,212,26,238
p_118,0,7,e_0,484,708,739,15,0,0,5,4,0,1,224,31,255
p_82,0,14,e_1,550,678,740,15,0,0,6,4,0,1,128,62,190
p_81,0,14,e_1,551,678,740,15,0,0,6,4,0,1,127,62,189
p_79,0,14,e_1,553,678,740,15,0,0,5,4,0,1,125,62,187
p_111,0,8,e_0,491,708,744,15,0,0,3,4,0,1,217,36,253
p_85,0,15,e_1,545,678,745,15,0,0,8,4,0,1,133,67,200
p_115,0,9,e_0,487,708,749,15,0,0,4,4,0,1,221,41,262
p_117,0,10,e_0,485,708,754,15,0,0,5,4,0,1,223,46,269
p_116,0,10,e_0,486,708,754,15,0,0,4,4,0,1,222,46,268
p_112,0,11,e_0,490,708,759,15,0,0,3,4,0,1,218,51,269
p_110,0,11,e_0,492,708,759,15,0,0,2,4,0,1,216,51,267
p_107,0,11,e_0,499,708,759,15,0,0,0,3,0,0,209,51,260
p_22,0,3,e_2,719,756,767,15,0,0,12,4,0,1,37,11,48
p_21,0,4,e_2,731,756,772,15,0,0,8,4,0,1,25,16,41
p_109,0,15,e_0,493,708,773,15,0,0,2,4,0,1,215,65,280
p_19,0,11,e_2,754,756,795,15,0,0,0,4,0,1,2,39,41
p_23,0,12,e_2,711,756,800,15,0,0,14,3,0,0,45,44,89
p_77,0,3,e_1,557,792,803,15,0,0,4,4,0,1,235,11,246
p_72,0,3,e_1,562,792,803,15,0,0,2,4,0,1,230,11,241
p_71,0,3,e_1,564,792,803,15,0,0,2,4,0,1,228,11,239
p_70,0,3,e_1,565,792,803,15,0,0,1,4,0,1,227,11,238
p_67,0,3,e_1,568,792,803,15,0,0,0,4,0,1,224,11,235
p_66,0,3,e_1,569,792,803,15,0,0,0,3,0,0,223,11,234
p_20,0,14,e_2,734,756,808,15,0,0,7,4,0,1,22,52,74
p_75,0,5,e_1,559,792,811,15,0,0,3,4,0,1,233,19,252
p_76,0,6,e_1,558,792,816,15,0,0,4,4,0,1,234,24,258
p_32,0,6,e_1,650,792,816,15,0,0,9,4,0,1,142,24,166
p_74,0,7,e_1,560,792,821,15,0,0,3,4,0,1,232,29,261
p_55,0,3,e_0,585,820,831,15,0,0,5,4,0,1,235,11,246
p_54,0,3,e_0,586,820,831,15,0,0,4,4,0,1,234,11,245
p_52,0,3,e_0,588,820,831,15,0,0,4,4,0,1,232,11,243
p_73,0,11,e_1,561,792,835,15,0,0,3,4,0,1,231,43,274
p_34,0,12,e_1,646,792,840,15,0,0,10,4,0,1,146,48,194
p_61,0,6,e_0,579,820,842,15,0,0,7,4,0,1,241,22,263
p_56,0,6,e_0,584,820,842,15,0,0,5,4,0,1,236,22,258
p_68,0,13,e_1,567,792,845,15,0,0,1,4,0,1,225,53,278
p_50,0,7,e_0,590,820,847,15,0,0,3,4,0,1,230,27,257
p_69,0,14,e_1,566,792,850,15,0,0,1,4,0,1,226,58,284
p_53,0,9,e_0,587,820,855,15,0,0,4,4,0,1,233,35,268
p_51,0,9,e_0,589,820,855,15,0,0,3,4,0,1,231,35,266
p_33,0,15,e_1,649,792,855,15,0,0,9,4,0,1,143,63,206
p_60,0,10,e_0,580,820,860,15,0,0,6,4,0,1,240,40,280
p_58,0,11,e_0,582,820,865,15,0,0,6,4,0,1,238,45,283
p_57,0,11,e_0,583,820,865,15,0,0,5,4,0,1,237,45,282
p_63,0,13,e_0,577,820,873,15,0,0,7,4,0,1,243,53,296
p_62,0,13,e_0,578,820,873,15,0,0,7,4,0,1,242,53,295
p_59,0,14,e_0,581,820,878,15,0,0,6,4,0,1,239,58,297
p_49,0,14,e_0,591,820,878,15,0,0,3,4,0,1,229,58,287
p_9,0,2,e_2,846,880,888,15,0,0,11,4,0,1,34,8,42
p_6,0,3,e_2,877,880,893,15,0,0,1,4,0,1,3,13,16
p_7,0,5,e_2,875,880,901,15,0,0,1,4,0,1,5,21,26
p_4,0,1,e_1,886,902,907,15,0,0,5,4,0,1,16,5,21
p_16,0,2,e_1,780,902,912,15,0,0,4,4,0,1,122,10,132
p_10,0,8,e_2,835,880,912,15,0,0,14,3,0,0,45,32,77
p_30,0,3,e_1,668,902,917,15,0,0,3,4,0,1,234,15,249
p_8,0,11,e_2,874,880,923,15,0,0,2,4,0,1,6,43,49
p_29,0,5,e_1,670,902,925,15,0,0,2,4,0,1,232,23,255
p_1,0,5,e_1,894,902,925,15,0,0,2,4,0,1,8,23,31
p_45,0,2,e_0,595,922,930,15,0,0,1,4,0,1,327,8,335
p_24,0,2,e_0,695,922,930,15,0,0,4,4,0,1,227,8,235
p_31,0,6,e_1,666,902,930,15,0,0,4,4,0,1,236,28,264
p_48,0,4,e_0,592,922,938,15,0,0,2,4,0,1,330,16,346
p_46,0,4,e_0,594,922,938,15,0,0,2,4,0,1,328,16,344
p_14,0,4,e_0,794,922,938,15,0,0,8,4,0,1,128,16,144
p_5,0,8,e_1,883,902,938,15,0,0,6,4,0,1,19,36,55
p_3,0,8,e_1,888,902,938,15,0,0,4,4,0,1,14,36,50
p_42,0,6,e_0,598,922,946,15,0,0,0,4,0,1,324,24,348
p_27,0,10,e_1,677,902,946,15,0,0,0,3,0,0,225,44,269
p_18,0,10,e_1,766,902,946,15,0,0,8,4,0,1,136,44,180
p_17,0,10,e_1,776,902,946,15,0,0,5,4,0,1,126,44,170
p_43,0,7,e_0,597,922,951,15,0,0,1,4,0,1,325,29,354
p_28,0,11,e_1,676,902,951,15,0,0,0,4,0,1,226,49,275
p_2,0,11,e_1,892,902,951,15,0,0,3,4,0,1,10,49,59
p_44,0,8,e_0,596,922,956,15,0,0,1,4,0,1,326,34,360
p_26,0,8,e_0,684,922,956,15,0,0,8,4,0,1,238,34,272
p_25,0,8,e_0,686,922,956,15,0,0,7,4,0,1,236,34,270
p_47,0,9,e_0,593,922,961,15,0,0,2,4,0,1,329,39,368
p_15,0,9,e_0,793,922,961,15,0,0,9,4,0,1,129,39,168
p_11,0,9,e_0,807,922,961,15,0,0,4,4,0,1,115,39,154
p_13,0,11,e_0,796,922,969,15,0,0,8,4,0,1,126,47,173
p_12,0,11,e_0,798,922,969,15,0,0,7,4,0,1,124,47,171
p_300,0,4,e_0,8,9,25,0,0,0,0,3,0,0,1,16,17
p_299,0,5,e_1,9,10,29,0,0,0,0,3,0,0,1,19,20
p_297,0,6,e_3,15,16,38,0,0,0,0,3,0,0,1,22,23
p_298,0,9,e_2,11,12,43,0,0,0,0,3,0,0,1,31,32
p_296,0,4,e_0,28,43,57,9,1,1,4,3,0,0,15,14,29
p_286,0,3,e_1,46,47,60,6,0,0,0,3,0,0,1,13,14
p_292,0,6,e_0,38,43,65,6,0,0,1,4,0,1,5,22,27
p_290,0,6,e_0,40,43,65,6,0,0,1,4,0,1,3,22,25
p_289,0,4,e_1,43,47,65,6,0,0,1,4,0,1,4,18,22
p_295,0,5,e_1,29,47,70,9,1,1,5,3,0,0,18,23,41
p_287,0,5,e_1,45,47,70,6,0,0,0,4,0,1,2,23,25
p_288,0,8,e_1,44,47,81,6,0,0,1,4,0,1,3,34,37
p_281,0,1,e_3,73,74,81,0,0,0,0,3,0,0,1,7,8
p_291,0,11,e_0,39,43,82,6,0,0,1,4,0,1,4,39,43
p_294,0,12,e_0,31,43,87,8,1,1,4,4,0,1,12,44,56
p_293,0,12,e_0,33,43,87,7,1,1,3,4,0,1,10,44,54
p_285,0,4,e_3,53,74,92,6,0,0,6,3,0,0,21,18,39
p_284,0,4,e_3,54,74,92,6,1,0,6,4,0,1,20,18,38
p_282,0,7,e_3,66,74,103,2,1,0,2,4,0,1,8,29,37
p_283,0,9,e_3,57,74,111,5,1,0,5,4,0,1,17,37,54
p_278,0,2,e_2,77,105,113,18,4,4,9,4,0,1,28,8,36
p_279,0,5,e_2,76,105,124,18,4,4,9,4,0,1,29,19,48
p_277,0,6,e_1,82,109,129,17,3,3,8,3,0,0,27,20,47
p_274,0,8,e_2,88,105,135,15,3,3,5,4,0,1,17,30,47
p_271,0,1,e_3,121,140,145,6,1,0,6,4,0,1,19,5,24
p_276,0,11,e_2,84,105,146,16,3,3,7,4,0,1,21,41,62
p_273,0,4,e_3,110,140,156,9,0,0,9,2,1,0,30,16,46
p_280,0,14,e_2,75,105,157,18,4,4,9,3,0,0,30,52,82
p_275,0,14,e_2,86,105,157,16,3,3,6,4,0,1,19,52,71
p_267,0,1,e_1,148,165,172,18,3,3,5,4,0,1,17,7,24
p_270,0,9,e_3,122,140,173,6,1,0,6,4,0,1,18,33,51
p_269,0,9,e_3,127,140,173,4,1,0,4,4,0,1,13,33,46
p_268,0,2,e_1,144,165,177,19,3,3,6,3,0,0,21,12,33
p_272,0,10,e_3,113,140,178,9,1,0,9,4,0,1,27,38,65
p_265,0,4,e_1,152,165,185,17,3,3,4,4,0,1,13,20,33
p_262,0,5,e_1,157,165,190,16,2,2,2,4,0,1,8,25,33
p_261,0,5,e_1,164,165,190,14,2,2,0,3,0,0,1,25,26
p_266,0,6,e_1,151,165,195,17,3,3,4,4,0,1,14,30,44
p_263,0,7,e_1,154,165,200,16,3,3,3,4,0,1,11,35,46
p_264,0,11,e_1,153,165,214,17,3,3,4,4,0,1,12,49,61
p_255,0,3,e_0,184,204,215,10,0,0,6,4,0,1,20,11,31
p_254,0,4,e_0,187,204,220,10,0,0,5,4,0,1,17,16,33
p_253,0,5,e_0,190,204,225,10,0,0,4,4,0,1,14,21,35
p_260,0,7,e_0,165,204,233,13,2,2,12,3,0,0,39,29,68
p_258,0,7,e_0,168,204,233,12,2,2,12,4,0,1,36,29,65
p_256,0,10,e_0,182,204,244,10,0,0,7,4,0,1,22,40,62
p_250,0,2,e_3,217,238,246,7,1,0,7,4,0,1,21,8,29
p_252,0,5,e_3,205,238,257,10,0,0,10,3,0,0,33,19,52
p_257,0,14,e_0,169,204,258,12,2,2,11,4,0,1,35,54,89
p_259,0,15,e_0,167,204,263,13,2,2,12,4,0,1,37,59,96
p_251,0,15,e_3,209,238,289,9,1,0,9,4,0,1,29,51,80
p_248,0,5,e_1,246,275,292,28,2,2,9,4,0,1,29,17,46
p_247,0,5,e_1,250,275,292,27,2,2,8,4,0,1,25,17,42
p_249,0,6,e_1,239,275,297,30,3,3,11,3,0,0,36,22,58
p_245,0,7,e_1,269,275,302,21,1,1,2,4,0,1,6,27,33
p_246,0,10,e_1,262,275,313,24,1,1,4,4,0,1,13,38,51
p_244,0,12,e_1,271,275,321,21,1,1,1,4,0,1,4,46,50
p_241,0,1,e_2,283,322,327,17,1,1,13,4,0,1,39,5,44
p_236,0,1,e_2,305,322,327,15,0,0,5,4,0,1,17,5,22
p_233,0,1,e_2,311,322,327,15,0,0,3,4,0,1,11,5,16
p_243,0,15,e_1,272,275,332,20,1,1,1,4,0,1,3,57,60
p_230,0,3,e_2,319,322,335,15,0,0,1,4,0,1,3,13,16
p_232,0,5,e_2,314,322,343,15,0,0,2,4,0,1,8,21,29
p_237,0,7,e_2,304,322,351,15,0,0,6,4,0,1,18,29,47
p_231,0,7,e_2,317,322,351,15,0,0,1,4,0,1,5,29,34
p_242,0,8,e_2,277,322,356,19,1,1,14,3,0,0,45,34,79
p_235,0,8,e_2,308,322,356,15,0,0,4,4,0,1,14,34,48
p_234,0,8,e_2,310,322,356,15,0,0,4,4,0,1,12,34,46
p_240,0,9,e_2,301,322,361,15,0,0,7,4,0,1,21,39,60
p_239,0,11,e_2,302,322,369,15,0,0,6,4,0,1,20,47,67
p_238,0,13,e_2,303,322,377,15,0,0,6,4,0,1,19,55,74
p_229,0,13,e_2,320,322,377,15,0,0,0,4,0,1,2,55,57
p_216,0,1,e_0,347,373,380,9,1,0,8,4,0,1,26,7,33
p_226,0,2,e_0,329,373,385,15,1,0,14,4,0,1,44,12,56
p_223,0,2,e_0,336,373,385,13,1,0,12,4,0,1,37,12,49
p_214,0,3,e_0,349,373,390,8,1,0,8,4,0,1,24,17,41
p_228,0,4,e_0,325,373,395,15,0,0,15,3,0,0,48,22,70
p_224,0,5,e_1,331,379,396,14,1,0,15,2,1,0,48,17,65
p_194,0,6,e_3,373,375,397,0,1,0,0,4,0,1,2,22,24
p_225,0,5,e_0,330,373,400,15,1,0,14,4,0,1,43,27,70
p_222,0,5,e_0,337,373,400,12,1,0,12,4,0,1,36,27,63
p_219,0,5,e_0,342,373,400,11,1,0,10,4,0,1,31,27,58
p_221,0,6,e_0,339,373,405,12,1,0,11,4,0,1,34,32,66
p_220,0,6,e_0,341,373,405,11,1,0,10,4,0,1,32,32,64
p_192,0,8,e_1,375,379,407,24,4,4,1,4,0,1,4,28,32
p_217,0,7,e_0,346,373,410,9,1,0,9,4,0,1,27,37,64
p_212,0,7,e_0,351,373,410,8,1,0,7,4,0,1,22,37,59
p_193,0,11,e_3,374,375,414,0,0,0,0,3,0,0,1,39,40
p_191,0,10,e_1,376,379,415,24,3,3,1,4,0,1,3,36,39
p_227,0,12,e_3,327,375,419,15,0,0,15,3,0,0,48,44,92
p_218,0,11,e_0,343,373,424,10,1,0,10,4,0,1,30,51,81
p_190,0,1,e_2,379,421,428,24,3,3,13,3,0,0,42,7,49
p_183,0,1,e_2,396,421,428,18,2,2,8,4,0,1,25,7,32
p_182,0,2,e_2,397,421,433,18,2,2,8,4,0,1,24,12,36
p_180,0,2,e_2,399,421,433,18,2,2,7,4,0,1,22,12,34
p_215,0,15,e_0,348,373,438,9,1,0,8,4,0,1,25,65,90
p_213,0,15,e_0,350,373,438,8,1,0,7,4,0,1,23,65,88
p_178,0,3,e_2,401,421,438,17,2,2,6,4,0,1,20,17,37
p_186,0,4,e_2,390,421,443,20,3,3,10,4,0,1,31,22,53
p_176,0,4,e_2,403,421,443,16,2,2,6,4,0,1,18,22,40
p_189,0,8,e_2,382,421,457,23,3,3,13,4,0,1,39,36,75
p_179,0,8,e_2,400,421,457,17,2,2,7,4,0,1,21,36,57
p_161,0,1,e_1,421,454,461,12,0,0,10,3,0,0,33,7,40
p_158,0,1,e_1,430,454,461,12,0,0,8,4,0,1,24,7,31
p_177,0,9,e_2,402,421,462,17,2,2,6,4,0,1,19,41,60
p_185,0,10,e_2,391,421,467,20,3,3,10,4,0,1,30,46,76
p_187,0,12,e_2,389,421,475,20,3,3,10,4,0,1,32,54,86
p_184,0,12,e_2,392,421,475,19,3,3,9,4,0,1,29,54,83
p_159,0,6,e_1,429,454,478,12,0,0,8,4,0,1,25,24,49
p_150,0,6,e_1,443,454,478,12,0,0,3,4,0,1,11,24,35
p_188,0,13,e_2,384,421,480,22,3,3,12,4,0,1,37,59,96
p_154,0,7,e_1,436,454,483,12,0,0,6,4,0,1,18,29,47
p_148,0,8,e_1,449,454,488,12,0,0,1,4,0,1,5,34,39
p_181,0,15,e_2,398,421,488,18,2,2,7,4,0,1,23,67,90
p_153,0,9,e_1,437,454,493,12,0,0,5,4,0,1,17,39,56
p_147,0,9,e_1,452,454,493,12,0,0,0,4,0,1,2,39,41
p_209,0,2,e_0,357,485,495,6,1,0,5,4,0,1,128,10,138
p_205,0,2,e_0,362,485,495,4,1,0,3,4,0,1,123,10,133
p_200,0,4,e_0,367,485,503,2,1,0,2,4,0,1,118,18,136
p_201,0,5,e_0,366,485,508,3,1,0,2,4,0,1,119,23,142
p_157,0,14,e_1,431,454,510,12,0,0,7,4,0,1,23,56,79
p_155,0,14,e_1,435,454,510,12,0,0,6,4,0,1,19,56,75
p_210,0,6,e_0,354,485,513,7,1,0,6,4,0,1,131,28,159
p_208,0,6,e_0,358,485,513,5,1,0,5,4,0,1,127,28,155
p_160,0,15,e_1,426,454,515,12,0,0,9,4,0,1,28,61,89
p_156,0,15,e_1,434,454,515,12,0,0,6,4,0,1,20,61,81
p_152,0,15,e_1,441,454,515,12,0,0,4,4,0,1,13,61,74
p_151,0,15,e_1,442,454,515,12,0,0,4,4,0,1,12,61,73
p_149,0,15,e_1,444,454,515,12,0,0,3,4,0,1,10,61,71
p_198,0,9,e_0,369,485,524,2,1,0,1,4,0,1,116,39,155
p_197,0,10,e_0,370,485,529,1,1,0,1,4,0,1,115,44,159
p_113,0,1,e_3,489,524,529,11,1,0,11,4,0,1,35,5,40
p_207,0,11,e_0,359,485,534,5,1,0,4,4,0,1,126,49,175
p_114,0,3,e_3,488,524,537,12,1,0,12,4,0,1,36,13,49
p_106,0,3,e_3,500,524,537,8,1,0,8,4,0,1,24,13,37
p_206,0,12,e_0,361,485,539,4,1,0,4,4,0,1,124,54,178
p_203,0,12,e_0,364,485,539,3,1,0,3,4,0,1,121,54,175
p_167,0,1,e_2,413,535,540,13,1,1,2,4,0,1,122,5,127
p_204,0,14,e_0,363,485,547,4,1,0,3,4,0,1,122,62,184
p_108,0,6,e_3,496,524,548,9,1,0,9,4,0,1,28,24,52
p_165,0,4,e_2,417,535,551,12,1,1,1,4,0,1,118,16,134
p_92,0,4,e_2,525,535,551,30,10,10,3,4,0,1,10,16,26
p_211,0,15,e_0,353,485,552,7,1,0,6,4,0,1,132,67,199
p_202,0,15,e_0,365,485,552,3,1,0,2,4,0,1,120,67,187
p_199,0,15,e_0,368,485,552,2,1,0,1,4,0,1,117,67,184
p_111,0,8,e_3,491,524,556,11,1,0,11,4,0,1,33,32,65
p_115,0,9,e_3,487,524,561,12,1,0,12,4,0,1,37,37,74
p_117,0,10,e_3,485,524,566,12,0,0,12,3,0,0,39,42,81
p_116,0,10,e_3,486,524,566,12,1,0,12,4,0,1,38,42,80
p_169,0,9,e_2,411,535,568,14,2,2,3,4,0,1,124,33,157
p_146,0,1,e_1,453,562,569,12,0,0,0,3,0,0,109,7,116
p_112,0,11,e_3,490,524,571,11,1,0,11,4,0,1,34,47,81
p_110,0,11,e_3,492,524,571,10,1,0,10,4,0,1,32,47,79
p_107,0,11,e_3,499,524,571,8,1,0,8,4,0,1,25,47,72
p_103,0,11,e_3,508,524,571,5,1,0,5,4,0,1,16,47,63
p_163,0,10,e_2,419,535,573,12,0,0,0,4,0,1,116,38,154
p_86,0,2,e_1,544,562,574,25,9,9,6,4,0,1,18,12,30
p_105,0,12,e_3,502,524,576,7,1,0,7,4,0,1,22,52,74
p_173,0,11,e_2,407,535,578,15,2,2,4,4,0,1,128,43,171
p_164,0,11,e_2,418,535,578,12,0,0,1,4,0,1,117,43,160
p_162,0,11,e_2,420,535,578,12,0,0,0,3,0,0,115,43,158
p_77,0,3,e_1,557,562,579,22,7,7,1,4,0,1,5,17,22
p_166,0,12,e_2,416,535,583,13,1,1,1,4,0,1,119,48,167
p_104,0,14,e_3,503,524,584,7,1,0,7,4,0,1,21,60,81
p_88,0,5,e_1,538,562,587,27,9,9,8,4,0,1,24,25,49
p_171,0,13,e_2,409,535,588,14,2,2,4,4,0,1,126,53,179
p_168,0,13,e_2,412,535,588,13,2,2,3,4,0,1,123,53,176
p_109,0,15,e_3,493,524,589,10,1,0,10,4,0,1,31,65,96
p_76,0,6,e_1,558,562,592,22,7,7,1,4,0,1,4,30,34
p_175,0,14,e_2,405,535,593,16,2,2,5,4,0,1,130,58,188
p_174,0,14,e_2,406,535,593,15,2,2,5,4,0,1,129,58,187
p_170,0,14,e_2,410,535,593,14,2,2,3,4,0,1,125,58,183
p_80,0,7,e_1,552,562,597,23,8,8,3,4,0,1,10,35,45
p_172,0,15,e_2,408,535,598,15,2,2,4,4,0,1,127,63,190
p_87,0,8,e_1,539,562,602,27,9,9,7,4,0,1,23,40,63
p_83,0,8,e_1,549,562,602,24,8,8,4,4,0,1,13,40,53
p_89,0,9,e_1,535,562,607,27,10,10,9,4,0,1,27,45,72
p_143,0,3,e_0,456,599,612,12,0,0,9,4,0,1,143,13,156
p_136,0,3,e_0,465,599,612,12,0,0,6,4,0,1,134,13,147
p_196,0,4,e_0,371,599,617,1,1,0,0,4,0,1,228,18,246
p_137,0,4,e_0,464,599,617,12,0,0,7,4,0,1,135,18,153
p_84,0,12,e_1,546,562,618,24,9,9,5,4,0,1,16,56,72
p_78,0,12,e_1,556,562,618,22,7,7,2,4,0,1,6,56,62
p_141,0,6,e_0,458,599,625,12,0,0,9,4,0,1,141,26,167
p_82,0,14,e_1,550,562,626,24,8,8,4,4,0,1,12,64,76
p_81,0,14,e_1,551,562,626,23,8,8,3,4,0,1,11,64,75
p_79,0,14,e_1,553,562,626,23,8,8,3,4,0,1,9,64,73
p_85,0,15,e_1,545,562,631,25,9,9,5,4,0,1,17,69,86
p_140,0,8,e_0,459,599,633,12,0,0,8,4,0,1,140,34,174
p_144,0,9,e_0,455,599,638,12,0,0,10,4,0,1,144,39,183
p_142,0,9,e_0,457,599,638,12,0,0,9,4,0,1,142,39,181
p_96,0,1,e_3,517,636,641,2,1,0,2,4,0,1,119,5,124
p_139,0,10,e_0,461,599,643,12,0,0,8,4,0,1,138,44,182
p_135,0,10,e_0,466,599,643,12,0,0,6,4,0,1,133,44,177
p_145,0,11,e_0,454,599,648,12,0,0,10,4,0,1,145,49,194
p_138,0,11,e_0,463,599,648,12,0,0,7,4,0,1,136,49,185
p_133,0,12,e_0,469,599,653,12,0,0,5,4,0,1,130,54,184
p_99,0,6,e_3,514,636,658,3,1,0,3,4,0,1,122,22,144
p_94,0,6,e_3,519,636,658,1,1,0,1,4,0,1,117,22,139
p_102,0,7,e_3,509,636,663,5,1,0,5,4,0,1,127,27,154
p_98,0,7,e_3,515,636,663,3,1,0,3,4,0,1,121,27,148
p_97,0,7,e_3,516,636,663,2,1,0,2,4,0,1,120,27,147
p_195,0,15,e_0,372,599,664,1,1,0,0,3,0,0,227,65,292
p_134,0,15,e_0,467,599,664,12,0,0,6,4,0,1,132,65,197
p_101,0,8,e_3,511,636,668,4,1,0,4,4,0,1,125,32,157
p_100,0,9,e_3,513,636,673,3,1,0,3,4,0,1,123,37,160
p_37,0,9,e_3,615,636,673,7,1,0,7,4,0,1,21,37,58
p_41,0,11,e_3,600,636,681,12,1,0,12,4,0,1,36,45,81
p_91,0,12,e_2,526,645,683,30,10,10,3,4,0,1,119,38,157
p_39,0,12,e_3,607,636,686,9,1,0,9,4,0,1,29,50,79
p_90,0,13,e_2,527,645,688,29,11,11,2,4,0,1,118,43,161
p_30,0,3,e_1,668,678,691,20,6,6,3,4,0,1,10,13,23
p_93,0,13,e_3,520,636,691,1,1,0,1,4,0,1,116,55,171
p_40,0,13,e_3,602,636,691,11,1,0,11,4,0,1,34,55,89
p_38,0,13,e_3,608,636,691,9,1,0,9,4,0,1,28,55,83
p_95,0,14,e_3,518,636,696,2,1,0,2,4,0,1,118,60,178
p_75,0,5,e_1,559,678,699,21,7,7,1,4,0,1,119,21,140
p_29,0,5,e_1,670,678,699,20,6,6,2,4,0,1,8,21,29
p_32,0,6,e_1,650,678,704,24,9,9,9,4,0,1,28,26,54
p_31,0,6,e_1,666,678,704,20,7,7,4,4,0,1,12,26,38
p_74,0,7,e_1,560,678,709,21,6,6,0,4,0,1,118,31,149
p_130,0,1,e_0,472,711,716,12,0,0,4,4,0,1,239,5,244
p_119,0,1,e_0,483,711,716,12,0,0,0,4,0,1,228,5,233
p_27,0,10,e_1,677,678,720,18,5,5,0,3,0,0,1,42,43
p_129,0,3,e_0,473,711,724,12,0,0,4,4,0,1,238,13,251
p_73,0,11,e_1,561,678,725,21,6,6,0,3,0,0,117,47,164
p_28,0,11,e_1,676,678,725,18,5,5,0,4,0,1,2,47,49
p_34,0,12,e_1,646,678,730,26,9,9,10,4,0,1,32,52,84
p_124,0,7,e_0,478,711,738,12,0,0,2,4,0,1,233,27,260
p_118,0,7,e_0,484,711,738,12,0,0,0,3,0,0,227,27,254
p_33,0,15,e_1,649,678,741,25,9,9,9,4,0,1,29,63,92
p_127,0,10,e_0,475,711,749,12,0,0,3,4,0,1,236,38,274
p_22,0,3,e_3,719,740,751,7,1,0,7,4,0,1,21,11,32
p_132,0,11,e_0,470,711,754,12,0,0,5,4,0,1,241,43,284
p_128,0,11,e_0,474,711,754,12,0,0,3,4,0,1,237,43,280
p_123,0,11,e_0,479,711,754,12,0,0,2,4,0,1,232,43,275
p_121,0,11,e_0,481,711,754,12,0,0,1,4,0,1,230,43,273
p_120,0,11,e_0,482,711,754,12,0,0,1,4,0,1,229,43,272
p_21,0,4,e_3,731,740,756,3,1,0,3,4,0,1,9,16,25
p_126,0,12,e_0,476,711,759,12,0,0,3,4,0,1,235,48,283
p_131,0,14,e_0,471,711,767,12,0,0,4,4,0,1,240,56,296
p_125,0,14,e_0,477,711,767,12,0,0,2,4,0,1,234,56,290
p_122,0,15,e_0,480,711,772,12,0,0,1,4,0,1,231,61,292
p_35,0,9,e_3,630,740,773,2,1,0,2,4,0,1,110,33,143
p_23,0,12,e_3,711,740,784,9,1,0,9,4,0,1,29,44,73
p_36,0,13,e_3,628,740,789,2,1,0,2,4,0,1,112,49,161
p_20,0,14,e_3,734,740,794,2,1,0,2,4,0,1,6,54,60
p_16,0,2,e_2,780,796,804,17,3,3,5,4,0,1,16,8,24
p_14,0,4,e_2,794,796,812,14,0,0,0,4,0,1,2,16,18
p_65,0,1,e_0,573,819,824,19,4,4,8,4,0,1,246,5,251
p_15,0,9,e_2,793,796,829,14,0,0,1,4,0,1,3,33,36
p_72,0,3,e_0,562,819,832,21,6,6,12,4,0,1,257,13,270
p_71,0,3,e_0,564,819,832,20,6,6,11,4,0,1,255,13,268
p_70,0,3,e_0,565,819,832,20,5,5,11,4,0,1,254,13,267
p_67,0,3,e_0,568,819,832,20,5,5,10,4,0,1,251,13,264
p_66,0,3,e_0,569,819,832,19,5,5,10,4,0,1,250,13,263
p_18,0,10,e_2,766,796,834,21,4,4,10,4,0,1,30,38,68
p_17,0,10,e_2,776,796,834,18,3,3,6,4,0,1,20,38,58
p_64,0,4,e_0,574,819,837,18,4,4,8,4,0,1,245,18,263
p_19,0,11,e_2,754,796,839,24,5,5,13,3,0,0,42,43,85
p_61,0,6,e_0,579,819,845,17,3,3,6,4,0,1,240,26,266
p_60,0,10,e_0,580,819,859,17,3,3,6,4,0,1,239,40,279
p_58,0,11,e_0,582,819,864,16,3,3,5,4,0,1,237,45,282
p_68,0,13,e_0,567,819,872,20,5,5,10,4,0,1,252,53,305
p_63,0,13,e_0,577,819,872,18,3,3,7,4,0,1,242,53,295
p_62,0,13,e_0,578,819,872,18,3,3,7,4,0,1,241,53,294
p_69,0,14,e_0,566,819,877,20,5,5,11,4,0,1,253,58,311
p_59,0,14,e_0,581,819,877,17,3,3,6,4,0,1,238,58,296
p_9,0,2,e_2,846,882,890,11,1,0,11,3,0,0,36,8,44
p_6,0,3,e_2,877,882,895,1,1,0,1,4,0,1,5,13,18
p_7,0,5,e_3,875,880,897,1,1,0,1,4,0,1,5,17,22
p_10,0,8,e_3,835,880,908,14,0,0,14,3,0,0,45,28,73
p_8,0,11,e_2,874,882,921,2,1,0,2,4,0,1,8,39,47
p_45,0,2,e_0,595,921,929,13,1,0,1,4,0,1,326,8,334
p_55,0,3,e_0,585,921,934,16,2,2,4,4,0,1,336,13,349
p_54,0,3,e_0,586,921,934,16,2,2,4,4,0,1,335,13,348
p_52,0,3,e_0,588,921,934,15,1,1,3,4,0,1,333,13,346
p_48,0,4,e_0,592,921,939,14,1,0,2,4,0,1,329,18,347
p_46,0,4,e_0,594,921,939,14,1,0,1,4,0,1,327,18,345
p_56,0,6,e_0,584,921,947,16,2,2,5,4,0,1,337,26,363
p_50,0,7,e_0,590,921,952,15,1,0,3,4,0,1,331,31,362
p_43,0,7,e_0,597,921,952,13,1,0,0,4,0,1,324,31,355
p_44,0,8,e_0,596,921,957,13,1,0,1,4,0,1,325,36,361
p_53,0,9,e_0,587,921,962,15,2,2,4,4,0,1,334,41,375
p_51,0,9,e_0,589,921,962,15,1,0,3,4,0,1,332,41,373
p_47,0,9,e_0,593,921,962,14,1,0,2,4,0,1,328,41,369
p_57,0,11,e_0,583,921,970,16,2,2,5,4,0,1,338,49,387
p_49,0,14,e_0,591,921,981,15,1,0,2,4,0,1,330,60,390
p_4,0,1,e_0,886,1025,1030,14,2,2,11,4,0,1,139,5,144
p_24,0,2,e_0,695,1025,1035,14,1,1,5,4,0,1,330,10,340
p_1,0,5,e_0,894,1025,1046,12,2,2,9,4,0,1,131,21,152
p_42,0,6,e_0,598,1025,1051,12,1,0,0,3,0,0,427,26,453
p_26,0,8,e_0,684,1025,1059,16,4,4,9,4,0,1,341,34,375
p_25,0,8,e_0,686,1025,1059,16,3,3,8,4,0,1,339,34,373
p_5,0,8,e_0,883,1025,1059,15,2,2,12,4,0,1,142,34,176
p_3,0,8,e_0,888,1025,1059,14,2,2,11,4,0,1,137,34,171
p_11,0,9,e_0,807,1025,1064,14,0,0,4,4,0,1,218,39,257
p_13,0,11,e_0,796,1025,1072,14,0,0,7,4,0,1,229,47,276
p_12,0,11,e_0,798,1025,1072,14,0,0,7,4,0,1,227,47,274
p_2,0,11,e_0,892,1025,1072,12,2,2,9,4,0,1,133,47,180
p_300,0,4,e_0,8,9,25,0,0,0,0,3,0,0,1,16,17
p_299,0,5,e_1,9,10,29,0,0,0,0,3,0,0,1,19,20
p_297,0,6,e_3,15,16,38,0,0,0,0,3,0,0,1,22,23
p_298,0,9,e_2,11,12,43,0,0,0,0,3,0,0,1,31,32
p_296,0,4,e_0,28,43,57,9,1,1,4,3,0,0,15,14,29
p_286,0,3,e_1,46,47,60,6,0,0,0,3,0,0,1,13,14
p_292,0,6,e_0,38,43,65,6,0,0,1,4,0,1,5,22,27
p_290,0,6,e_0,40,43,65,6,0,0,1,4,0,1,3,22,25
p_289,0,4,e_1,43,47,65,6,0,0,1,4,0,1,4,18,22
p_295,0,5,e_1,29,47,70,9,1,1,5,3,0,0,18,23,41
p_287,0,5,e_1,45,47,70,6,0,0,0,4,0,1,2,23,25
p_288,0,8,e_1,44,47,81,6,0,0,1,4,0,1,3,34,37
p_281,0,1,e_3,73,74,81,0,0,0,0,3,0,0,1,7,8
p_291,0,11,e_0,39,43,82,6,0,0,1,4,0,1,4,39,43
p_294,0,12,e_0,31,43,87,8,1,1,4,4,0,1,12,44,56
p_293,0,12,e_0,33,43,87,7,1,1,3,4,0,1,10,44,54
p_285,0,4,e_3,53,74,92,6,0,0,6,3,0,0,21,18,39
p_284,0,4,e_3,54,74,92,6,1,0,6,4,0,1,20,18,38
p_282,0,7,e_3,66,74,103,2,1,0,2,4,0,1,8,29,37
p_283,0,9,e_3,57,74,111,5,1,0,5,4,0,1,17,37,54
p_278,0,2,e_2,77,105,113,18,4,4,9,4,0,1,28,8,36
p_279,0,5,e_2,76,105,124,18,4,4,9,4,0,1,29,19,48
p_277,0,6,e_1,82,109,129,17,3,3,8,3,0,0,27,20,47
p_274,0,8,e_2,88,105,135,15,3,3,5,4,0,1,17,30,47
p_271,0,1,e_3,121,140,145,6,1,0,6,4,0,1,19,5,24
p_276,0,11,e_2,84,105,146,16,3,3,7,4,0,1,21,41,62
p_273,0,4,e_3,110,140,156,9,0,0,9,2,1,0,30,16,46
p_280,0,14,e_2,75,105,157,18,4,4,9,3,0,0,30,52,82
p_275,0,14,e_2,86,105,157,16,3,3,6,4,0,1,19,52,71
p_267,0,1,e_1,148,165,172,18,3,3,5,4,0,1,17,7,24
p_270,0,9,e_3,122,140,173,6,1,0,6,4,0,1,18,33,51
p_269,0,9,e_3,127,140,173,4,1,0,4,4,0,1,13,33,46
p_268,0,2,e_1,144,165,177,19,3,3,6,3,0,0,21,12,33
p_272,0,10,e_3,113,140,178,9,1,0,9,4,0,1,27,38,65
p_265,0,4,e_1,152,165,185,17,3,3,4,4,0,1,13,20,33
p_262,0,5,e_1,157,165,190,16,2,2,2,4,0,1,8,25,33
p_261,0,5,e_1,164,165,190,14,2,2,0,3,0,0,1,25,26
p_266,0,6,e_1,151,165,195,17,3,3,4,4,0,1,14,30,44
p_263,0,7,e_1,154,165,200,16,3,3,3,4,0,1,11,35,46
p_264,0,11,e_1,153,165,214,17,3,3,4,4,0,1,12,49,61
p_255,0,3,e_0,184,204,215,10,0,0,6,4,0,1,20,11,31
p_254,0,4,e_0,187,204,220,10,0,0,5,4,0,1,17,16,33
p_253,0,5,e_0,190,204,225,10,0,0,4,4,0,1,14,21,35
p_260,0,7,e_0,165,204,233,13,2,2,12,3,0,0,39,29,68
p_258,0,7,e_0,168,204,233,12,2,2,12,4,0,1,36,29,65
p_256,0,10,e_0,182,204,244,10,0,0,7,4,0,1,22,40,62
p_250,0,2,e_3,217,238,246,7,1,0,7,4,0,1,21,8,29
p_252,0,5,e_3,205,238,257,10,0,0,10,3,0,0,33,19,52
p_257,0,14,e_0,169,204,258,12,2,2,11,4,0,1,35,54,89
p_259,0,15,e_0,167,204,263,13,2,2,12,4,0,1,37,59,96
p_251,0,15,e_3,209,238,289,9,1,0,9,4,0,1,29,51,80
p_248,0,5,e_1,246,275,292,28,2,2,9,4,0,1,29,17,46
p_247,0,5,e_1,250,275,292,27,2,2,8,4,0,1,25,17,42
p_249,0,6,e_1,239,275,297,30,3,3,11,3,0,0,36,22,58
p_245,0,7,e_1,269,275,302,21,1,1,2,4,0,1,6,27,33
p_246,0,10,e_1,262,275,313,24,1,1,4,4,0,1,13,38,51
p_244,0,12,e_1,271,275,321,21,1,1,1,4,0,1,4,46,50
p_241,0,1,e_2,283,322,327,17,1,1,13,4,0,1,39,5,44
p_236,0,1,e_2,305,322,327,15,0,0,5,4,0,1,17,5,22
p_233,0,1,e_2,311,322,327,15,0,0,3,4,0,1,11,5,16
p_243,0,15,e_1,272,275,332,20,1,1,1,4,0,1,3,57,60
p_230,0,3,e_2,319,322,335,15,0,0,1,4,0,1,3,13,16
p_232,0,5,e_2,314,322,343,15,0,0,2,4,0,1,8,21,29
p_237,0,7,e_2,304,322,351,15,0,0,6,4,0,1,18,29,47
p_231,0,7,e_2,317,322,351,15,0,0,1,4,0,1,5,29,34
p_242,0,8,e_2,277,322,356,19,1,1,14,3,0,0,45,34,79
p_235,0,8,e_2,308,322,356,15,0,0,4,4,0,1,14,34,48
p_234,0,8,e_2,310,322,356,15,0,0,4,4,0,1,12,34,46
p_240,0,9,e_2,301,322,361,15,0,0,7,4,0,1,21,39,60
p_239,0,11,e_2,302,322,369,15,0,0,6,4,0,1,20,47,67
p_238,0,13,e_2,303,322,377,15,0,0,6,4,0,1,19,55,74
p_229,0,13,e_2,320,322,377,15,0,0,0,4,0,1,2,55,57
p_216,0,1,e_0,347,373,380,9,1,0,8,4,0,1,26,7,33
p_226,0,2,e_0,329,373,385,15,1,0,14,4,0,1,44,12,56
p_223,0,2,e_0,336,373,385,13,1,0,12,4,0,1,37,12,49
p_214,0,3,e_0,349,373,390,8,1,0,8,4,0,1,24,17,41
p_228,0,4,e_0,325,373,395,15,0,0,15,3,0,0,48,22,70
p_224,0,5,e_1,331,379,396,14,1,0,15,2,1,0,48,17,65
p_194,0,6,e_3,373,375,397,0,1,0,0,4,0,1,2,22,24
p_225,0,5,e_0,330,373,400,15,1,0,14,4,0,1,43,27,70
p_222,0,5,e_0,337,373,400,12,1,0,12,4,0,1,36,27,63
p_219,0,5,e_0,342,373,400,11,1,0,10,4,0,1,31,27,58
p_221,0,6,e_0,339,373,405,12,1,0,11,4,0,1,34,32,66
p_220,0,6,e_0,341,373,405,11,1,0,10,4,0,1,32,32,64
p_192,0,8,e_1,375,379,407,24,4,4,1,4,0,1,4,28,32
p_217,0,7,e_0,346,373,410,9,1,0,9,4,0,1,27,37,64
p_212,0,7,e_0,351,373,410,8,1,0,7,4,0,1,22,37,59
p_193,0,11,e_3,374,375,414,0,0,0,0,3,0,0,1,39,40
p_191,0,10,e_1,376,379,415,24,3,3,1,4,0,1,3,36,39
p_227,0,12,e_3,327,375,419,15,0,0,15,3,0,0,48,44,92
p_218,0,11,e_0,343,373,424,10,1,0,10,4,0,1,30,51,81
p_190,0,1,e_2,379,421,428,24,3,3,13,3,0,0,42,7,49
p_183,0,1,e_2,396,421,428,18,2,2,8,4,0,1,25,7,32
p_182,0,2,e_2,397,421,433,18,2,2,8,4,0,1,24,12,36
p_180,0,2,e_2,399,421,433,18,2,2,7,4,0,1,22,12,34
p_215,0,15,e_0,348,373,438,9,1,0,8,4,0,1,25,65,90
p_213,0,15,e_0,350,373,438,8,1,0,7,4,0,1,23,65,88
p_178,0,3,e_2,401,421,438,17,2,2,6,4,0,1,20,17,37
p_186,0,4,e_2,390,421,443,20,3,3,10,4,0,1,31,22,53
p_176,0,4,e_2,403,421,443,16,2,2,6,4,0,1,18,22,40
p_189,0,8,e_2,382,421,457,23,3,3,13,4,0,1,39,36,75
p_179,0,8,e_2,400,421,457,17,2,2,7,4,0,1,21,36,57
p_161,0,1,e_1,421,454,461,12,0,0,10,3,0,0,33,7,40
p_158,0,1,e_1,430,454,461,12,0,0,8,4,0,1,24,7,31
p_177,0,9,e_2,402,421,462,17,2,2,6,4,0,1,19,41,60
p_185,0,10,e_2,391,421,467,20,3,3,10,4,0,1,30,46,76
p_187,0,12,e_2,389,421,475,20,3,3,10,4,0,1,32,54,86
p_184,0,12,e_2,392,421,475,19,3,3,9,4,0,1,29,54,83
p_159,0,6,e_1,429,454,478,12,0,0,8,4,0,1,25,24,49
p_150,0,6,e_1,443,454,478,12,0,0,3,4,0,1,11,24,35
p_188,0,13,e_2,384,421,480,22,3,3,12,4,0,1,37,59,96
p_154,0,7,e_1,436,454,483,12,0,0,6,4,0,1,18,29,47
p_148,0,8,e_1,449,454,488,12,0,0,1,4,0,1,5,34,39
p_181,0,15,e_2,398,421,488,18,2,2,7,4,0,1,23,67,90
p_153,0,9,e_1,437,454,493,12,0,0,5,4,0,1,17,39,56
p_147,0,9,e_1,452,454,493,12,0,0,0,4,0,1,2,39,41
p_209,0,2,e_0,357,485,495,6,1,0,5,4,0,1,128,10,138
p_205,0,2,e_0,362,485,495,4,1,0,3,4,0,1,123,10,133
p_200,0,4,e_0,367,485,503,2,1,0,2,4,0,1,118,18,136
p_201,0,5,e_0,366,485,508,3,1,0,2,4,0,1,119,23,142
p_157,0,14,e_1,431,454,510,12,0,0,7,4,0,1,23,56,79
p_155,0,14,e_1,435,454,510,12,0,0,6,4,0,1,19,56,75
p_210,0,6,e_0,354,485,513,7,1,0,6,4,0,1,131,28,159
p_208,0,6,e_0,358,485,513,5,1,0,5,4,0,1,127,28,155
p_160,0,15,e_1,426,454,515,12,0,0,9,4,0,1,28,61,89
p_156,0,15,e_1,434,454,515,12,0,0,6,4,0,1,20,61,81
p_152,0,15,e_1,441,454,515,12,0,0,4,4,0,1,13,61,74
p_151,0,15,e_1,442,454,515,12,0,0,4,4,0,1,12,61,73
p_149,0,15,e_1,444,454,515,12,0,0,3,4,0,1,10,61,71
p_198,0,9,e_0,369,485,524,2,1,0,1,4,0,1,116,39,155
p_197,0,10,e_0,370,485,529,1,1,0,1,4,0,1,115,44,159
p_113,0,1,e_3,489,524,529,11,1,0,11,4,0,1,35,5,40
p_207,0,11,e_0,359,485,534,5,1,0,4,4,0,1,126,49,175
p_114,0,3,e_3,488,524,537,12,1,0,12,4,0,1,36,13,49
p_106,0,3,e_3,500,524,537,8,1,0,8,4,0,1,24,13,37
p_206,0,12,e_0,361,485,539,4,1,0,4,4,0,1,124,54,178
p_203,0,12,e_0,364,485,539,3,1,0,3,4,0,1,121,54,175
p_167,0,1,e_2,413,535,540,13,1,1,2,4,0,1,122,5,127
p_204,0,14,e_0,363,485,547,4,1,0,3,4,0,1,122,62,184
p_108,0,6,e_3,496,524,548,9,1,0,9,4,0,1,28,24,52
p_165,0,4,e_2,417,535,551,12,1,1,1,4,0,1,118,16,134
p_92,0,4,e_2,525,535,551,30,10,10,3,4,0,1,10,16,26
p_211,0,15,e_0,353,485,552,7,1,0,6,4,0,1,132,67,199
p_202,0,15,e_0,365,485,552,3,1,0,2,4,0,1,120,67,187
p_199,0,15,e_0,368,485,552,2,1,0,1,4,0,1,117,67,184
p_111,0,8,e_3,491,524,556,11,1,0,11,4,0,1,33,32,65
p_115,0,9,e_3,487,524,561,12,1,0,12,4,0,1,37,37,74
p_117,0,10,e_3,485,524,566,12,0,0,12,3,0,0,39,42,81
p_116,0,10,e_3,486,524,566,12,1,0,12,4,0,1,38,42,80
p_169,0,9,e_2,411,535,568,14,2,2,3,4,0,1,124,33,157
p_146,0,1,e_1,453,562,569,12,0,0,0,3,0,0,109,7,116
p_112,0,11,e_3,490,524,571,11,1,0,11,4,0,1,34,47,81
p_110,0,11,e_3,492,524,571,10,1,0,10,4,0,1,32,47,79
p_107,0,11,e_3,499,524,571,8,1,0,8,4,0,1,25,47,72
p_103,0,11,e_3,508,524,571,5,1,0,5,4,0,1,16,47,63
p_163,0,10,e_2,419,535,573,12,0,0,0,4,0,1,116,38,154
p_86,0,2,e_1,544,562,574,25,9,9,6,4,0,1,18,12,30
p_105,0,12,e_3,502,524,576,7,1,0,7,4,0,1,22,52,74
p_173,0,11,e_2,407,535,578,15,2,2,4,4,0,1,128,43,171
p_164,0,11,e_2,418,535,578,12,0,0,1,4,0,1,117,43,160
p_162,0,11,e_2,420,535,578,12,0,0,0,3,0,0,115,43,158
p_77,0,3,e_1,557,562,579,22,7,7,1,4,0,1,5,17,22
p_166,0,12,e_2,416,535,583,13,1,1,1,4,0,1,119,48,167
p_104,0,14,e_3,503,524,584,7,1,0,7,4,0,1,21,60,81
p_88,0,5,e_1,538,562,587,27,9,9,8,4,0,1,24,25,49
p_171,0,13,e_2,409,535,588,14,2,2,4,4,0,1,126,53,179
p_168,0,13,e_2,412,535,588,13,2,2,3,4,0,1,123,53,176
p_109,0,15,e_3,493,524,589,10,1,0,10,4,0,1,31,65,96
p_76,0,6,e_1,558,562,592,22,7,7,1,4,0,1,4,30,34
p_175,0,14,e_2,405,535,593,16,2,2,5,4,0,1,130,58,188
p_174,0,14,e_2,406,535,593,15,2,2,5,4,0,1,129,58,187
p_170,0,14,e_2,410,535,593,14,2,2,3,4,0,1,125,58,183
p_80,0,7,e_1,552,562,597,23,8,8,3,4,0,1,10,35,45
p_172,0,15,e_2,408,535,598,15,2,2,4,4,0,1,127,63,190
p_87,0,8,e_1,539,562,602,27,9,9,7,4,0,1,23,40,63
p_83,0,8,e_1,549,562,602,24,8,8,4,4,0,1,13,40,53
p_89,0,9,e_1,535,562,607,27,10,10,9,4,0,1,27,45,72
p_143,0,3,e_0,456,599,612,12,0,0,9,4,0,1,143,13,156
p_136,0,3,e_0,465,599,612,12,0,0,6,4,0,1,134,13,147
p_196,0,4,e_0,371,599,617,1,1,0,0,4,0,1,228,18,246
p_137,0,4,e_0,464,599,617,12,0,0,7,4,0,1,135,18,153
p_84,0,12,e_1,546,562,618,24,9,9,5,4,0,1,16,56,72
p_78,0,12,e_1,556,562,618,22,7,7,2,4,0,1,6,56,62
p_141,0,6,e_0,458,599,625,12,0,0,9,4,0,1,141,26,167
p_82,0,14,e_1,550,562,626,24,8,8,4,4,0,1,12,64,76
p_81,0,14,e_1,551,562,626,23,8,8,3,4,0,1,11,64,75
p_79,0,14,e_1,553,562,626,23,8,8,3,4,0,1,9,64,73
p_85,0,15,e_1,545,562,631,25,9,9,5,4,0,1,17,69,86
p_140,0,8,e_0,459,599,633,12,0,0,8,4,0,1,140,34,174
p_144,0,9,e_0,455,599,638,12,0,0,10,4,0,1,144,39,183
p_142,0,9,e_0,457,599,638,12,0,0,9,4,0,1,142,39,181
p_96,0,1,e_3,517,636,641,2,1,0,2,4,0,1,119,5,124
p_139,0,10,e_0,461,599,643,12,0,0,8,4,0,1,138,44,182
p_135,0,10,e_0,466,599,643,12,0,0,6,4,0,1,133,44,177
p_145,0,11,e_0,454,599,648,12,0,0,10,4,0,1,145,49,194
p_138,0,11,e_0,463,599,648,12,0,0,7,4,0,1,136,49,185
p_133,0,12,e_0,469,599,653,12,0,0,5,4,0,1,130,54,184
p_99,0,6,e_3,514,636,658,3,1,0,3,4,0,1,122,22,144
p_94,0,6,e_3,519,636,658,1,1,0,1,4,0,1,117,22,139
p_102,0,7,e_3,509,636,663,5,1,0,5,4,0,1,127,27,154
p_98,0,7,e_3,515,636,663,3,1,0,3,4,0,1,121,27,148
p_97,0,7,e_3,516,636,663,2,1,0,2,4,0,1,120,27,147
p_195,0,15,e_0,372,599,664,1,1,0,0,3,0,0,227,65,292
p_134,0,15,e_0,467,599,664,12,0,0,6,4,0,1,132,65,197
p_101,0,8,e_3,511,636,668,4,1,0,4,4,0,1,125,32,157
p_100,0,9,e_3,513,636,673,3,1,0,3,4,0,1,123,37,160
p_37,0,9,e_3,615,636,673,7,1,0,7,4,0,1,21,37,58
p_41,0,11,e_3,600,636,681,12,1,0,12,4,0,1,36,45,81
p_91,0,12,e_2,526,645,683,30,10,10,3,4,0,1,119,38,157
p_39,0,12,e_3,607,636,686,9,1,0,9,4,0,1,29,50,79
p_90,0,13,e_2,527,645,688,29,11,11,2,4,0,1,118,43,161
p_30,0,3,e_1,668,678,691,20,6,6,3,4,0,1,10,13,23
p_93,0,13,e_3,520,636,691,1,1,0,1,4,0,1,116,55,171
p_40,0,13,e_3,602,636,691,11,1,0,11,4,0,1,34,55,89
p_38,0,13,e_3,608,636,691,9,1,0,9,4,0,1,28,55,83
p_95,0,14,e_3,518,636,696,2,1,0,2,4,0,1,118,60,178
p_75,0,5,e_1,559,678,699,21,7,7,1,4,0,1,119,21,140
p_29,0,5,e_1,670,678,699,20,6,6,2,4,0,1,8,21,29
p_32,0,6,e_1,650,678,704,24,9,9,9,4,0,1,28,26,54
p_31,0,6,e_1,666,678,704,20,7,7,4,4,0,1,12,26,38
p_74,0,7,e_1,560,678,709,21,6,6,0,4,0,1,118,31,149
p_130,0,1,e_0,472,711,716,12,0,0,4,4,0,1,239,5,244
p_119,0,1,e_0,483,711,716,12,0,0,0,4,0,1,228,5,233
p_27,0,10,e_1,677,678,720,18,5,5,0,3,0,0,1,42,43
p_129,0,3,e_0,473,711,724,12,0,0,4,4,0,1,238,13,251
p_73,0,11,e_1,561,678,725,21,6,6,0,3,0,0,117,47,164
p_28,0,11,e_1,676,678,725,18,5,5,0,4,0,1,2,47,49
p_34,0,12,e_1,646,678,730,26,9,9,10,4,0,1,32,52,84
p_124,0,7,e_0,478,711,738,12,0,0,2,4,0,1,233,27,260
p_118,0,7,e_0,484,711,738,12,0,0,0,3,0,0,227,27,254
p_33,0,15,e_1,649,678,741,25,9,9,9,4,0,1,29,63,92
p_127,0,10,e_0,475,711,749,12,0,0,3,4,0,1,236,38,274
p_22,0,3,e_3,719,740,751,7,1,0,7,4,0,1,21,11,32
p_132,0,11,e_0,470,711,754,12,0,0,5,4,0,1,241,43,284
p_128,0,11,e_0,474,711,754,12,0,0,3,4,0,1,237,43,280
p_123,0,11,e_0,479,711,754,12,0,0,2,4,0,1,232,43,275
p_121,0,11,e_0,481,711,754,12,0,0,1,4,0,1,230,43,273
p_120,0,11,e_0,482,711,754,12,0,0,1,4,0,1,229,43,272
p_21,0,4,e_3,731,740,756,3,1,0,3,4,0,1,9,16,25
p_126,0,12,e_0,476,711,759,12,0,0,3,4,0,1,235,48,283
p_131,0,14,e_0,471,711,767,12,0,0,4,4,0,1,240,56,296
p_125,0,14,e_0,477,711,767,12,0,0,2,4,0,1,234,56,290
p_122,0,15,e_0,480,711,772,12,0,0,1,4,0,1,231,61,292
p_35,0,9,e_3,630,740,773,2,1,0,2,4,0,1,110,33,143
p_23,0,12,e_3,711,740,784,9,1,0,9,4,0,1,29,44,73
p_36,0,13,e_3,628,740,789,2,1,0,2,4,0,1,112,49,161
p_20,0,14,e_3,734,740,794,2,1,0,2,4,0,1,6,54,60
p_16,0,2,e_2,780,796,804,17,3,3,5,4,0,1,16,8,24
p_14,0,4,e_2,794,796,812,14,0,0,0,4,0,1,2,16,18
p_65,0,1,e_0,573,819,824,19,4,4,8,4,0,1,246,5,251
p_15,0,9,e_2,793,796,829,14,0,0,1,4,0,1,3,33,36
p_72,0,3,e_0,562,819,832,21,6,6,12,4,0,1,257,13,270
p_71,0,3,e_0,564,819,832,20,6,6,11,4,0,1,255,13,268
p_70,0,3,e_0,565,819,832,20,5,5,11,4,0,1,254,13,267
p_67,0,3,e_0,568,819,832,20,5,5,10,4,0,1,251,13,264
p_66,0,3,e_0,569,819,832,19,5,5,10,4,0,1,250,13,263
p_18,0,10,e_2,766,796,834,21,4,4,10,4,0,1,30,38,68
p_17,0,10,e_2,776,796,834,18,3,3,6,4,0,1,20,38,58
p_64,0,4,e_0,574,819,837,18,4,4,8,4,0,1,245,18,263
p_19,0,11,e_2,754,796,839,24,5,5,13,3,0,0,42,43,85
p_61,0,6,e_0,579,819,845,17,3,3,6,4,0,1,240,26,266
p_60,0,10,e_0,580,819,859,17,3,3,6,4,0,1,239,40,279
p_58,0,11,e_0,582,819,864,16,3,3,5,4,0,1,237,45,282
p_68,0,13,e_0,567,819,872,20,5,5,10,4,0,1,252,53,305
p_63,0,13,e_0,577,819,872,18,3,3,7,4,0,1,242,53,295
p_62,0,13,e_0,578,819,872,18,3,3,7,4,0,1,241,53,294
p_69,0,14,e_0,566,819,877,20,5,5,11,4,0,1,253,58,311
p_59,0,14,e_0,581,819,877,17,3,3,6,4,0,1,238,58,296
p_9,0,2,e_2,846,882,890,11,1,0,11,3,0,0,36,8,44
p_6,0,3,e_2,877,882,895,1,1,0,1,4,0,1,5,13,18
p_7,0,5,e_3,875,880,897,1,1,0,1,4,0,1,5,17,22
p_10,0,8,e_3,835,880,908,14,0,0,14,3,0,0,45,28,73
p_8,0,11,e_2,874,882,921,2,1,0,2,4,0,1,8,39,47
p_45,0,2,e_0,595,921,929,13,1,0,1,4,0,1,326,8,334
p_55,0,3,e_0,585,921,934,16,2,2,4,4,0,1,336,13,349
p_54,0,3,e_0,586,921,934,16,2,2,4,4,0,1,335,13,348
p_52,0,3,e_0,588,921,934,15,1,1,3,4,0,1,333,13,346
p_48,0,4,e_0,592,921,939,14,1,0,2,4,0,1,329,18,347
p_46,0,4,e_0,594,921,939,14,1,0,1,4,0,1,327,18,345
p_56,0,6,e_0,584,921,947,16,2,2,5,4,0,1,337,26,363
p_50,0,7,e_0,590,921,952,15,1,0,3,4,0,1,331,31,362
p_43,0,7,e_0,597,921,952,13,1,0,0,4,0,1,324,31,355
p_44,0,8,e_0,596,921,957,13,1,0,1,4,0,1,325,36,361
p_53,0,9,e_0,587,921,962,15,2,2,4,4,0,1,334,41,375
p_51,0,9,e_0,589,921,962,15,1,0,3,4,0,1,332,41,373
p_47,0,9,e_0,593,921,962,14,1,0,2,4,0,1,328,41,369
p_57,0,11,e_0,583,921,970,16,2,2,5,4,0,1,338,49,387
p_49,0,14,e_0,591,921,981,15,1,0,2,4,0,1,330,60,390
p_4,0,1,e_0,886,1025,1030,14,2,2,11,4,0,1,139,5,144
p_24,0,2,e_0,695,1025,1035,14,1,1,5,4,0,1,330,10,340
p_1,0,5,e_0,894,1025,1046,12,2,2,9,4,0,1,131,21,152
p_42,0,6,e_0,598,1025,1051,12,1,0,0,3,0,0,427,26,453
p_26,0,8,e_0,684,1025,1059,16,4,4,9,4,0,1,341,34,375
p_25,0,8,e_0,686,1025,1059,16,3,3,8,4,0,1,339,34,373
p_5,0,8,e_0,883,1025,1059,15,2,2,12,4,0,1,142,34,176
p_3,0,8,e_0,888,1025,1059,14,2,2,11,4,0,1,137,34,171
p_11,0,9,e_0,807,1025,1064,14,0,0,4,4,0,1,218,39,257
p_13,0,11,e_0,796,1025,1072,14,0,0,7,4,0,1,229,47,276
p_12,0,11,e_0,798,1025,1072,14,0,0,7,4,0,1,227,47,274
p_2,0,11,e_0,892,1025,1072,12,2,2,9,4,0,1,133,47,180
p_300,0,4,e_0,8,9,25,0,0,0,0,3,0,0,1,16,17
p_299,0,5,e_1,9,10,29,0,0,0,0,3,0,0,1,19,20
p_297,0,6,e_3,15,16,38,0,0,0,0,3,0,0,1,22,23
p_298,0,9,e_2,11,12,43,0,0,0,0,3,0,0,1,31,32
p_296,0,4,e_0,28,43,57,9,1,1,4,3,0,0,15,14,29
p_295,0,5,e_0,29,43,62,9,1,1,4,4,0,1,14,19,33
p_292,0,6,e_0,38,43,67,6,0,0,1,4,0,1,5,24,29
p_290,0,6,e_0,40,43,67,6,0,0,1,4,0,1,3,24,27
p_286,0,3,e_1,46,61,72,6,0,0,5,4,0,1,15,11,26
p_289,0,4,e_1,43,61,77,6,0,0,5,3,0,0,18,16,34
p_285,0,4,e_1,53,61,77,6,0,0,2,4,0,1,8,16,24
p_284,0,4,e_1,54,61,77,6,0,0,2,4,0,1,7,16,23
p_287,0,5,e_1,45,61,82,6,0,0,5,4,0,1,16,21,37
p_291,0,11,e_0,39,43,84,6,0,0,1,4,0,1,4,41,45
p_294,0,12,e_0,31,43,89,8,1,1,4,4,0,1,12,46,58
p_293,0,12,e_0,33,43,89,7,1,1,3,4,0,1,10,46,56
p_288,0,8,e_1,44,61,93,6,0,0,5,4,0,1,17,32,49
p_281,0,1,e_3,73,87,94,4,1,0,4,4,0,1,14,7,21
p_283,0,9,e_1,57,61,98,6,0,0,1,4,0,1,4,37,41
p_278,0,2,e_3,77,87,99,3,1,0,3,4,0,1,10,12,22
p_279,0,5,e_3,76,87,110,3,1,0,3,4,0,1,11,23,34
p_277,0,6,e_3,82,87,115,1,1,0,1,4,0,1,5,28,33
p_282,0,7,e_3,66,87,120,6,0,0,6,3,0,0,21,33,54
p_273,0,4,e_2,110,118,132,23,4,4,2,4,0,1,8,14,22
p_276,0,11,e_3,84,87,134,1,1,0,1,4,0,1,3,47,50
p_280,0,14,e_3,75,87,145,4,1,0,4,4,0,1,12,58,70
p_275,0,14,e_3,86,87,145,0,0,0,0,3,0,0,1,58,59
p_274,0,8,e_2,88,118,146,28,7,7,9,3,0,0,30,28,58
p_272,0,10,e_2,113,118,154,22,4,4,1,4,0,1,5,36,41
p_271,0,1,e_1,121,151,156,21,2,2,9,3,0,0,30,5,35
p_267,0,1,e_1,148,151,156,14,0,0,1,4,0,1,3,5,8
p_268,0,2,e_1,144,151,161,14,0,0,2,4,0,1,7,10,17
p_270,0,9,e_1,122,151,184,21,2,2,9,4,0,1,29,33,62
p_269,0,9,e_1,127,151,184,19,2,2,8,4,0,1,24,33,57
p_255,0,3,e_2,184,186,197,14,0,0,0,4,0,1,2,11,13
p_265,0,4,e_2,152,186,202,14,0,0,10,5,1,0,34,16,50
p_254,0,4,e_0,187,190,204,14,0,0,1,4,0,1,3,14,17
p_262,0,5,e_2,157,186,207,14,0,0,9,4,0,1,29,21,50
p_261,0,5,e_2,164,186,207,14,0,0,7,4,0,1,22,21,43
p_266,0,6,e_0,151,190,212,14,0,0,12,3,0,0,39,22,61
p_263,0,7,e_2,154,186,215,14,0,0,10,4,0,1,32,29,61
p_260,0,7,e_2,165,186,215,14,0,0,7,4,0,1,21,29,50
p_258,0,7,e_2,168,186,215,14,0,0,6,4,0,1,18,29,47
p_256,0,10,e_2,182,186,226,14,0,0,1,4,0,1,4,40,44
p_250,0,2,e_1,217,220,228,14,0,0,1,4,0,1,3,8,11
p_264,0,11,e_2,153,186,231,14,0,0,10,2,1,1,33,45,78
p_253,0,5,e_1,190,220,239,14,0,0,9,3,0,0,30,19,49
p_252,0,5,e_1,205,220,239,14,0,0,5,4,0,1,15,19,34
p_257,0,14,e_2,169,186,242,14,0,0,5,4,0,1,17,56,73
p_259,0,15,e_2,167,186,247,14,0,0,6,4,0,1,19,61,80
p_251,0,15,e_1,209,220,271,14,0,0,3,4,0,1,11,51,62
p_248,0,5,e_0,246,260,277,14,0,0,4,4,0,1,14,17,31
p_247,0,5,e_0,250,260,277,14,0,0,3,4,0,1,10,17,27
p_249,0,6,e_0,239,260,282,14,0,0,6,3,0,0,21,22,43
p_241,0,1,e_0,283,302,309,8,1,0,6,4,0,1,19,7,26
p_236,0,1,e_3,305,307,312,0,1,0,0,4,0,1,2,5,7
p_242,0,8,e_0,277,302,332,10,1,0,5,5,1,0,25,30,55
p_245,0,7,e_3,269,307,332,12,1,0,12,4,0,1,38,25,63
p_237,0,7,e_3,304,307,332,1,1,0,1,4,0,1,3,25,28
p_240,0,9,e_0,301,302,337,2,1,0,0,3,0,0,1,35,36
p_246,0,10,e_3,262,307,343,14,0,0,14,3,0,0,45,36,81
p_239,0,11,e_3,302,307,348,1,1,0,1,4,0,1,5,41,46
p_244,0,12,e_3,271,307,353,12,1,0,12,4,0,1,36,46,82
p_238,0,13,e_3,303,307,358,1,1,0,1,4,0,1,4,51,55
p_233,0,1,e_1,311,356,361,29,6,6,15,4,0,1,45,5,50
p_226,0,2,e_1,329,356,366,24,6,6,9,4,0,1,27,10,37
p_223,0,2,e_1,336,356,366,22,5,5,6,4,0,1,20,10,30
p_243,0,15,e_3,272,307,366,11,1,0,11,4,0,1,35,59,94
p_209,0,2,e_2,357,358,368,17,1,1,0,3,0,0,1,10,11
p_230,0,3,e_1,319,356,371,27,6,6,12,4,0,1,37,15,52
p_228,0,4,e_1,325,356,376,25,6,6,10,4,0,1,31,20,51
p_232,0,5,e_1,314,356,381,29,6,6,14,4,0,1,42,25,67
p_225,0,5,e_1,330,356,381,23,6,6,8,4,0,1,26,25,51
p_224,0,5,e_1,331,356,381,23,5,5,8,4,0,1,25,25,50
p_222,0,5,e_1,337,356,381,22,5,5,6,4,0,1,19,25,44
p_221,0,6,e_1,339,356,386,21,5,5,5,4,0,1,17,30,47
p_220,0,6,e_1,341,356,386,20,5,5,5,4,0,1,15,30,45
p_234,0,8,e_2,310,358,388,29,7,7,15,3,0,0,48,30,78
p_231,0,7,e_1,317,356,391,28,6,6,13,4,0,1,39,35,74
p_205,0,2,e_0,362,388,396,16,1,1,8,4,0,1,26,8,34
p_235,0,8,e_1,308,356,396,30,7,7,15,3,0,0,48,40,88
p_200,0,4,e_0,367,388,404,15,0,0,7,4,0,1,21,16,37
p_196,0,4,e_0,371,388,404,15,0,0,5,4,0,1,17,16,33
p_201,0,5,e_0,366,388,409,15,0,0,7,4,0,1,22,21,43
p_227,0,12,e_1,327,356,410,24,6,6,9,4,0,1,29,54,83
p_208,0,6,e_0,358,388,414,17,1,1,9,3,0,0,30,26,56
p_194,0,6,e_0,373,388,414,15,0,0,5,4,0,1,15,26,41
p_229,0,13,e_1,320,356,415,27,6,6,12,4,0,1,36,59,95
p_183,0,1,e_2,396,416,421,15,0,0,6,4,0,1,20,5,25
p_198,0,9,e_0,369,388,425,15,0,0,6,4,0,1,19,37,56
p_182,0,2,e_2,397,416,426,15,0,0,6,4,0,1,19,10,29
p_180,0,2,e_2,399,416,426,15,0,0,5,4,0,1,17,10,27
p_197,0,10,e_0,370,388,430,15,0,0,6,4,0,1,18,42,60
p_178,0,3,e_2,401,416,431,15,0,0,5,4,0,1,15,15,30
p_207,0,11,e_0,359,388,435,17,1,1,9,4,0,1,29,47,76
p_186,0,4,e_2,390,416,436,15,0,0,8,4,0,1,26,20,46
p_176,0,4,e_2,403,416,436,15,0,0,4,4,0,1,13,20,33
p_206,0,12,e_0,361,388,440,16,1,1,9,4,0,1,27,52,79
p_203,0,12,e_0,364,388,440,15,1,1,8,4,0,1,24,52,76
p_204,0,14,e_0,363,388,448,16,1,1,8,4,0,1,25,60,85
p_179,0,8,e_2,400,416,450,15,0,0,5,4,0,1,16,34,50
p_202,0,15,e_0,365,388,453,15,0,0,7,4,0,1,23,65,88
p_199,0,15,e_0,368,388,453,15,0,0,6,4,0,1,20,65,85
p_195,0,15,e_0,372,388,453,15,0,0,5,4,0,1,16,65,81
p_177,0,9,e_2,402,416,455,15,0,0,4,4,0,1,14,39,53
p_185,0,10,e_2,391,416,460,15,0,0,8,4,0,1,25,44,69
p_216,0,1,e_1,347,456,463,19,3,3,3,4,0,1,109,7,116
p_173,0,11,e_2,407,416,465,15,0,0,3,4,0,1,9,49,58
p_187,0,12,e_2,389,416,470,15,0,0,8,3,0,0,27,54,81
p_184,0,12,e_2,392,416,470,15,0,0,8,4,0,1,24,54,78
p_214,0,3,e_1,349,456,471,19,3,3,2,4,0,1,107,15,122
p_165,0,4,e_1,417,456,476,15,0,0,13,4,0,1,39,20,59
p_175,0,14,e_2,405,416,478,15,0,0,3,4,0,1,11,62,73
p_174,0,14,e_2,406,416,478,15,0,0,3,4,0,1,10,62,72
p_219,0,5,e_1,342,456,481,20,4,4,4,4,0,1,114,25,139
p_181,0,15,e_2,398,416,483,15,0,0,6,4,0,1,18,67,85
p_210,0,6,e_1,354,456,486,18,2,2,0,4,0,1,102,30,132
p_217,0,7,e_1,346,456,491,19,4,4,3,4,0,1,110,35,145
p_212,0,7,e_1,351,456,491,18,3,3,1,4,0,1,105,35,140
p_163,0,10,e_1,419,456,502,15,0,0,12,4,0,1,37,46,83
p_190,0,1,e_0,379,500,507,15,0,0,3,4,0,1,121,7,128
p_218,0,11,e_1,343,456,507,20,4,4,4,4,0,1,113,51,164
p_164,0,11,e_1,418,456,507,15,0,0,12,4,0,1,38,51,89
p_162,0,11,e_1,420,456,507,15,0,0,12,4,0,1,36,51,87
p_166,0,12,e_1,416,456,512,15,0,0,13,4,0,1,40,56,96
p_143,0,3,e_0,456,500,515,15,0,0,14,4,0,1,44,15,59
p_136,0,3,e_0,465,500,515,15,0,0,11,4,0,1,35,15,50
p_137,0,4,e_0,464,500,520,15,0,0,12,4,0,1,36,20,56
p_215,0,15,e_1,348,456,523,19,3,3,2,4,0,1,108,67,175
p_213,0,15,e_1,350,456,523,19,3,3,2,4,0,1,106,67,173
p_211,0,15,e_1,353,456,523,18,2,2,1,4,0,1,103,67,170
p_141,0,6,e_0,458,500,528,15,0,0,14,4,0,1,42,28,70
p_167,0,1,e_2,413,530,535,15,0,0,1,4,0,1,117,5,122
p_192,0,8,e_0,375,500,536,15,0,0,4,4,0,1,125,36,161
p_189,0,8,e_0,382,500,536,15,0,0,2,4,0,1,118,36,154
p_140,0,8,e_0,459,500,536,15,0,0,13,4,0,1,41,36,77
p_142,0,9,e_0,457,500,541,15,0,0,14,4,0,1,43,41,84
p_106,0,3,e_2,500,530,543,15,0,0,10,4,0,1,30,13,43
p_191,0,10,e_0,376,500,546,15,0,0,4,4,0,1,124,46,170
p_139,0,10,e_0,461,500,546,15,0,0,13,4,0,1,39,46,85
p_135,0,10,e_0,466,500,546,15,0,0,11,4,0,1,34,46,80
p_193,0,11,e_0,374,500,551,15,0,0,4,4,0,1,126,51,177
p_138,0,11,e_0,463,500,551,15,0,0,12,4,0,1,37,51,88
p_99,0,6,e_2,514,530,554,15,0,0,5,4,0,1,16,24,40
p_188,0,13,e_0,384,500,559,15,0,0,1,4,0,1,116,59,175
p_102,0,7,e_2,509,530,559,15,0,0,7,4,0,1,21,29,50
p_98,0,7,e_2,515,530,559,15,0,0,5,4,0,1,15,29,44
p_101,0,8,e_2,511,530,564,15,0,0,6,4,0,1,19,34,53
p_169,0,9,e_2,411,530,569,15,0,0,1,4,0,1,119,39,158
p_100,0,9,e_2,513,530,569,15,0,0,5,4,0,1,17,39,56
p_161,0,1,e_1,421,570,577,15,0,0,11,4,0,1,149,7,156
p_158,0,1,e_1,430,570,577,15,0,0,8,4,0,1,140,7,147
p_103,0,11,e_2,508,530,577,15,0,0,7,4,0,1,22,47,69
p_105,0,12,e_2,502,530,582,15,0,0,9,4,0,1,28,52,80
p_171,0,13,e_2,409,530,587,15,0,0,2,4,0,1,121,57,178
p_168,0,13,e_2,412,530,587,15,0,0,1,4,0,1,118,57,175
p_170,0,14,e_2,410,530,592,15,0,0,2,4,0,1,120,62,182
p_104,0,14,e_2,503,530,592,15,0,0,9,4,0,1,27,62,89
p_159,0,6,e_1,429,570,594,15,0,0,9,4,0,1,141,24,165
p_150,0,6,e_1,443,570,594,15,0,0,4,4,0,1,127,24,151
p_172,0,15,e_2,408,530,597,15,0,0,2,4,0,1,122,67,189
p_154,0,7,e_1,436,570,599,15,0,0,6,4,0,1,134,29,163
p_148,0,8,e_1,449,570,604,15,0,0,2,4,0,1,121,34,155
p_130,0,1,e_0,472,600,605,15,0,0,9,4,0,1,128,5,133
p_153,0,9,e_1,437,570,609,15,0,0,6,4,0,1,133,39,172
p_147,0,9,e_1,452,570,609,15,0,0,1,4,0,1,118,39,157
p_129,0,3,e_0,473,600,613,15,0,0,9,4,0,1,127,13,140
p_157,0,14,e_1,431,570,626,15,0,0,8,4,0,1,139,56,195
p_155,0,14,e_1,435,570,626,15,0,0,7,4,0,1,135,56,191
p_124,0,7,e_0,478,600,627,15,0,0,7,4,0,1,122,27,149
p_160,0,15,e_1,426,570,631,15,0,0,10,4,0,1,144,61,205
p_156,0,15,e_1,434,570,631,15,0,0,7,4,0,1,136,61,197
p_152,0,15,e_1,441,570,631,15,0,0,5,4,0,1,129,61,190
p_151,0,15,e_1,442,570,631,15,0,0,4,4,0,1,128,61,189
p_149,0,15,e_1,444,570,631,15,0,0,4,4,0,1,126,61,187
p_127,0,10,e_0,475,600,638,15,0,0,8,4,0,1,125,38,163
p_132,0,11,e_0,470,600,643,15,0,0,10,4,0,1,130,43,173
p_128,0,11,e_0,474,600,643,15,0,0,8,4,0,1,126,43,169
p_123,0,11,e_0,479,600,643,15,0,0,7,4,0,1,121,43,164
p_121,0,11,e_0,481,600,643,15,0,0,6,4,0,1,119,43,162
p_120,0,11,e_0,482,600,643,15,0,0,6,4,0,1,118,43,161
p_133,0,12,e_0,469,600,648,15,0,0,10,4,0,1,131,48,179
p_126,0,12,e_0,476,600,648,15,0,0,8,4,0,1,124,48,172
p_96,0,1,e_2,517,644,649,15,0,0,4,4,0,1,127,5,132
p_131,0,14,e_0,471,600,656,15,0,0,9,4,0,1,129,56,185
p_125,0,14,e_0,477,600,656,15,0,0,7,4,0,1,123,56,179
p_92,0,4,e_2,525,644,660,15,0,0,1,4,0,1,119,16,135
p_134,0,15,e_0,467,600,661,15,0,0,11,4,0,1,133,61,194
p_122,0,15,e_0,480,600,661,15,0,0,6,4,0,1,120,61,181
p_94,0,6,e_2,519,644,668,15,0,0,3,4,0,1,125,24,149
p_97,0,7,e_2,516,644,673,15,0,0,4,4,0,1,128,29,157
p_37,0,9,e_2,615,644,681,15,0,0,9,4,0,1,29,37,66
p_35,0,9,e_2,630,644,681,15,0,0,4,4,0,1,14,37,51
p_146,0,1,e_1,453,678,685,15,0,0,1,4,0,1,225,7,232
p_41,0,11,e_2,600,644,689,15,0,0,14,4,0,1,44,45,89
p_86,0,2,e_1,544,678,690,15,0,0,8,4,0,1,134,12,146
p_91,0,12,e_2,526,644,694,15,0,0,1,4,0,1,118,50,168
p_39,0,12,e_2,607,644,694,15,0,0,12,4,0,1,37,50,87
p_93,0,13,e_2,520,644,699,15,0,0,3,4,0,1,124,55,179
p_90,0,13,e_2,527,644,699,15,0,0,1,4,0,1,117,55,172
p_40,0,13,e_2,602,644,699,15,0,0,14,4,0,1,42,55,97
p_38,0,13,e_2,608,644,699,15,0,0,12,4,0,1,36,55,91
p_36,0,13,e_2,628,644,699,15,0,0,5,4,0,1,16,55,71
p_88,0,5,e_1,538,678,701,15,0,0,10,4,0,1,140,23,163
p_95,0,14,e_2,518,644,704,15,0,0,4,4,0,1,126,60,186
p_80,0,7,e_1,552,678,709,15,0,0,6,4,0,1,126,31,157
p_119,0,1,e_0,483,708,713,15,0,0,5,4,0,1,225,5,230
p_113,0,1,e_0,489,708,713,15,0,0,3,4,0,1,219,5,224
p_65,0,1,e_0,573,708,713,15,0,0,9,4,0,1,135,5,140
p_87,0,8,e_1,539,678,714,15,0,0,10,4,0,1,139,36,175
p_83,0,8,e_1,549,678,714,15,0,0,7,4,0,1,129,36,165
p_144,0,9,e_1,455,678,719,15,0,0,0,3,0,0,223,41,264
p_89,0,9,e_1,535,678,719,15,0,0,11,4,0,1,143,41,184
p_114,0,3,e_0,488,708,721,15,0,0,4,4,0,1,220,13,233
p_64,0,4,e_0,574,708,726,15,0,0,8,4,0,1,134,18,152
p_145,0,11,e_1,454,678,727,15,0,0,0,4,0,1,224,49,273
p_84,0,12,e_1,546,678,732,15,0,0,8,4,0,1,132,54,186
p_78,0,12,e_1,556,678,732,15,0,0,4,4,0,1,122,54,176
p_108,0,6,e_0,496,708,734,15,0,0,1,4,0,1,212,26,238
p_118,0,7,e_0,484,708,739,15,0,0,5,4,0,1,224,31,255
p_82,0,14,e_1,550,678,740,15,0,0,6,4,0,1,128,62,190
p_81,0,14,e_1,551,678,740,15,0,0,6,4,0,1,127,62,189
p_79,0,14,e_1,553,678,740,15,0,0,5,4,0,1,125,62,187
p_111,0,8,e_0,491,708,744,15,0,0,3,4,0,1,217,36,253
p_85,0,15,e_1,545,678,745,15,0,0,8,4,0,1,133,67,200
p_115,0,9,e_0,487,708,749,15,0,0,4,4,0,1,221,41,262
p_117,0,10,e_0,485,708,754,15,0,0,5,4,0,1,223,46,269
p_116,0,10,e_0,486,708,754,15,0,0,4,4,0,1,222,46,268
p_112,0,11,e_0,490,708,759,15,0,0,3,4,0,1,218,51,269
p_110,0,11,e_0,492,708,759,15,0,0,2,4,0,1,216,51,267
p_107,0,11,e_0,499,708,759,15,0,0,0,3,0,0,209,51,260
p_22,0,3,e_2,719,756,767,15,0,0,12,4,0,1,37,11,48
p_21,0,4,e_2,731,756,772,15,0,0,8,4,0,1,25,16,41
p_109,0,15,e_0,493,708,773,15,0,0,2,4,0,1,215,65,280
p_19,0,11,e_2,754,756,795,15,0,0,0,4,0,1,2,39,41
p_23,0,12,e_2,711,756,800,15,0,0,14,3,0,0,45,44,89
p_77,0,3,e_1,557,792,803,15,0,0,4,4,0,1,235,11,246
p_72,0,3,e_1,562,792,803,15,0,0,2,4,0,1,230,11,241
p_71,0,3,e_1,564,792,803,15,0,0,2,4,0,1,228,11,239
p_70,0,3,e_1,565,792,803,15,0,0,1,4,0,1,227,11,238
p_67,0,3,e_1,568,792,803,15,0,0,0,4,0,1,224,11,235
p_66,0,3,e_1,569,792,803,15,0,0,0,3,0,0,223,11,234
p_20,0,14,e_2,734,756,808,15,0,0,7,4,0,1,22,52,74
p_75,0,5,e_1,559,792,811,15,0,0,3,4,0,1,233,19,252
p_76,0,6,e_1,558,792,816,15,0,0,4,4,0,1,234,24,258
p_32,0,6,e_1,650,792,816,15,0,0,9,4,0,1,142,24,166
p_74,0,7,e_1,560,792,821,15,0,0,3,4,0,1,232,29,261
p_55,0,3,e_0,585,820,831,15,0,0,5,4,0,1,235,11,246
p_54,0,3,e_0,586,820,831,15,0,0,4,4,0,1,234,11,245
p_52,0,3,e_0,588,820,831,15,0,0,4,4,0,1,232,11,243
p_73,0,11,e_1,561,792,835,15,0,0,3,4,0,1,231,43,274
p_34,0,12,e_1,646,792,840,15,0,0,10,4,0,1,146,48,194
p_61,0,6,e_0,579,820,842,15,0,0,7,4,0,1,241,22,263
p_56,0,6,e_0,584,820,842,15,0,0,5,4,0,1,236,22,258
p_68,0,13,e_1,567,792,845,15,0,0,1,4,0,1,225,53,278
p_50,0,7,e_0,590,820,847,15,0,0,3,4,0,1,230,27,257
p_69,0,14,e_1,566,792,850,15,0,0,1,4,0,1,226,58,284
p_53,0,9,e_0,587,820,855,15,0,0,4,4,0,1,233,35,268
p_51,0,9,e_0,589,820,855,15,0,0,3,4,0,1,231,35,266
p_33,0,15,e_1,649,792,855,15,0,0,9,4,0,1,143,63,206
p_60,0,10,e_0,580,820,860,15,0,0,6,4,0,1,240,40,280
p_58,0,11,e_0,582,820,865,15,0,0,6,4,0,1,238,45,283
p_57,0,11,e_0,583,820,865,15,0,0,5,4,0,1,237,45,282
p_63,0,13,e_0,577,820,873,15,0,0,7,4,0,1,243,53,296
p_62,0,13,e_0,578,820,873,15,0,0,7,4,0,1,242,53,295
p_59,0,14,e_0,581,820,878,15,0,0,6,4,0,1,239,58,297
p_49,0,14,e_0,591,820,878,15,0,0,3,4,0,1,229,58,287
p_9,0,2,e_2,846,880,888,15,0,0,11,4,0,1,34,8,42
p_6,0,3,e_2,877,880,893,15,0,0,1,4,0,1,3,13,16
p_7,0,5,e_2,875,880,901,15,0,0,1,4,0,1,5,21,26
p_4,0,1,e_1,886,902,907,15,0,0,5,4,0,1,16,5,21
p_16,0,2,e_1,780,902,912,15,0,0,4,4,0,1,122,10,132
p_10,0,8,e_2,835,880,912,15,0,0,14,3,0,0,45,32,77
p_30,0,3,e_1,668,902,917,15,0,0,3,4,0,1,234,15,249
p_8,0,11,e_2,874,880,923,15,0,0,2,4,0,1,6,43,49
p_29,0,5,e_1,670,902,925,15,0,0,2,4,0,1,232,23,255
p_1,0,5,e_1,894,902,925,15,0,0,2,4,0,1,8,23,31
p_45,0,2,e_0,595,922,930,15,0,0,1,4,0,1,327,8,335
p_24,0,2,e_0,695,922,930,15,0,0,4,4,0,1,227,8,235
p_31,0,6,e_1,666,902,930,15,0,0,4,4,0,1,236,28,264
p_48,0,4,e_0,592,922,938,15,0,0,2,4,0,1,330,16,346
p_46,0,4,e_0,594,922,938,15,0,0,2,4,0,1,328,16,344
p_14,0,4,e_0,794,922,938,15,0,0,8,4,0,1,128,16,144
p_5,0,8,e_1,883,902,938,15,0,0,6,4,0,1,19,36,55
p_3,0,8,e_1,888,902,938,15,0,0,4,4,0,1,14,36,50
p_42,0,6,e_0,598,922,946,15,0,0,0,4,0,1,324,24,348
p_27,0,10,e_1,677,902,946,15,0,0,0,3,0,0,225,44,269
p_18,0,10,e_1,766,902,946,15,0,0,8,4,0,1,136,44,180
p_17,0,10,e_1,776,902,946,15,0,0,5,4,0,1,126,44,170
p_43,0,7,e_0,597,922,951,15,0,0,1,4,0,1,325,29,354
p_28,0,11,e_1,676,902,951,15,0,0,0,4,0,1,226,49,275
p_2,0,11,e_1,892,902,951,15,0,0,3,4,0,1,10,49,59
p_44,0,8,e_0,596,922,956,15,0,0,1,4,0,1,326,34,360
p_26,0,8,e_0,684,922,956,15,0,0,8,4,0,1,238,34,272
p_25,0,8,e_0,686,922,956,15,0,0,7,4,0,1,236,34,270
p_47,0,9,e_0,593,922,961,15,0,0,2,4,0,1,329,39,368
p_15,0,9,e_0,793,922,961,15,0,0,9,4,0,1,129,39,168
p_11,0,9,e_0,807,922,961,15,0,0,4,4,0,1,115,39,154
p_13,0,11,e_0,796,922,969,15,0,0,8,4,0,1,126,47,173
p_12,0,11,e_0,798,922,969,15,0,0,7,4,0,1,124,47,171
p_300,0,4,e_0,8,9,25,0,0,0,0,3,0,0,1,16,17
p_299,0,5,e_1,9,10,29,0,0,0,0,3,0,0,1,19,20
p_297,0,6,e_3,15,16,38,0,0,0,0,3,0,0,1,22,23
p_298,0,9,e_2,11,12,43,0,0,0,0,3,0,0,1,31,32
p_296,0,4,e_0,28,43,57,9,1,1,4,3,0,0,15,14,29
p_295,0,5,e_0,29,43,62,9,1,1,4,4,0,1,14,19,33
p_292,0,6,e_0,38,43,67,6,0,0,1,4,0,1,5,24,29
p_290,0,6,e_0,40,43,67,6,0,0,1,4,0,1,3,24,27
p_286,0,3,e_1,46,61,72,6,0,0,5,4,0,1,15,11,26
p_289,0,4,e_1,43,61,77,6,0,0,5,3,0,0,18,16,34
p_285,0,4,e_1,53,61,77,6,0,0,2,4,0,1,8,16,24
p_284,0,4,e_1,54,61,77,6,0,0,2,4,0,1,7,16,23
p_287,0,5,e_1,45,61,82,6,0,0,5,4,0,1,16,21,37
p_291,0,11,e_0,39,43,84,6,0,0,1,4,0,1,4,41,45
p_294,0,12,e_0,31,43,89,8,1,1,4,4,0,1,12,46,58
p_293,0,12,e_0,33,43,89,7,1,1,3,4,0,1,10,46,56
p_288,0,8,e_1,44,61,93,6,0,0,5,4,0,1,17,32,49
p_281,0,1,e_3,73,87,94,4,1,0,4,4,0,1,14,7,21
p_283,0,9,e_1,57,61,98,6,0,0,1,4,0,1,4,37,41
p_278,0,2,e_3,77,87,99,3,1,0,3,4,0,1,10,12,22
p_279,0,5,e_3,76,87,110,3,1,0,3,4,0,1,11,23,34
p_277,0,6,e_3,82,87,115,1,1,0,1,4,0,1,5,28,33
p_282,0,7,e_3,66,87,120,6,0,0,6,3,0,0,21,33,54
p_273,0,4,e_2,110,118,132,23,4,4,2,4,0,1,8,14,22
p_276,0,11,e_3,84,87,134,1,1,0,1,4,0,1,3,47,50
p_280,0,14,e_3,75,87,145,4,1,0,4,4,0,1,12,58,70
p_275,0,14,e_3,86,87,145,0,0,0,0,3,0,0,1,58,59
p_274,0,8,e_2,88,118,146,28,7,7,9,3,0,0,30,28,58
p_272,0,10,e_2,113,118,154,22,4,4,1,4,0,1,5,36,41
p_271,0,1,e_1,121,151,156,21,2,2,9,3,0,0,30,5,35
p_267,0,1,e_1,148,151,156,14,0,0,1,4,0,1,3,5,8
p_268,0,2,e_1,144,151,161,14,0,0,2,4,0,1,7,10,17
p_270,0,9,e_1,122,151,184,21,2,2,9,4,0,1,29,33,62
p_269,0,9,e_1,127,151,184,19,2,2,8,4,0,1,24,33,57
p_255,0,3,e_2,184,186,197,14,0,0,0,4,0,1,2,11,13
p_265,0,4,e_2,152,186,202,14,0,0,10,5,1,1,34,16,50
p_262,0,5,e_2,157,186,207,14,0,0,9,4,0,1,29,21,50
p_261,0,5,e_2,164,186,207,14,0,0,7,4,0,1,22,21,43
p_266,0,6,e_2,151,186,212,14,0,0,9,5,1,0,35,26,61
p_263,0,7,e_2,154,186,217,14,0,0,10,4,0,1,32,31,63
p_260,0,7,e_2,165,186,217,14,0,0,7,4,0,1,21,31,52
p_258,0,7,e_2,168,186,217,14,0,0,6,4,0,1,18,31,49
p_256,0,10,e_2,182,186,228,14,0,0,1,4,0,1,4,42,46
p_254,0,4,e_1,187,217,231,14,0,0,9,3,0,0,30,14,44
p_264,0,11,e_2,153,186,233,14,0,0,10,2,1,1,33,47,80
p_253,0,5,e_1,190,217,236,14,0,0,9,4,0,1,27,19,46
p_252,0,5,e_1,205,217,236,14,0,0,4,4,0,1,12,19,31
p_257,0,14,e_2,169,186,244,14,0,0,5,4,0,1,17,58,75
p_259,0,15,e_2,167,186,249,14,0,0,6,4,0,1,19,63,82
p_250,0,2,e_0,217,256,264,14,0,0,12,3,0,0,39,8,47
p_251,0,15,e_1,209,217,268,14,0,0,2,4,0,1,8,51,59
p_248,0,5,e_0,246,256,275,14,0,0,3,4,0,1,10,19,29
p_247,0,5,e_0,250,256,275,14,0,0,2,4,0,1,6,19,25
p_249,0,6,e_0,239,256,280,14,0,0,5,4,0,1,17,24,41
p_241,0,1,e_0,283,300,305,14,0,0,5,4,0,1,17,5,22
p_245,0,7,e_0,269,300,325,14,0,0,3,5,2,1,31,25,56
p_242,0,8,e_0,277,300,330,14,0,0,5,5,1,1,23,30,53
p_246,0,10,e_0,262,300,338,14,0,0,2,5,3,0,38,38,76
p_244,0,12,e_0,271,300,346,14,0,0,4,5,2,1,29,46,75
p_236,0,1,e_3,305,346,351,13,1,0,13,4,0,1,41,5,46
p_233,0,1,e_3,311,346,351,11,1,0,11,4,0,1,35,5,40
p_226,0,2,e_3,329,346,356,5,1,0,5,4,0,1,17,10,27
p_243,0,15,e_0,272,300,357,14,0,0,4,5,2,1,28,57,85
p_230,0,3,e_3,319,346,361,9,1,0,9,4,0,1,27,15,42
p_228,0,4,e_3,325,346,366,7,1,0,7,4,0,1,21,20,41
p_232,0,5,e_3,314,346,371,10,1,0,10,4,0,1,32,25,57
p_237,0,7,e_3,304,346,379,14,1,0,14,4,0,1,42,33,75
p_231,0,7,e_3,317,346,379,9,1,0,9,4,0,1,29,33,62
p_235,0,8,e_3,308,346,384,12,1,0,12,4,0,1,38,38,76
p_234,0,8,e_3,310,346,384,12,1,0,12,4,0,1,36,38,74
p_240,0,9,e_3,301,346,389,14,0,0,14,3,0,0,45,43,88
p_239,0,11,e_3,302,346,397,14,1,0,14,4,0,1,44,51,95
p_216,0,1,e_2,347,395,400,26,11,11,15,3,0,0,48,5,53
p_209,0,2,e_1,357,394,402,24,10,10,12,4,0,1,37,8,45
p_205,0,2,e_1,362,394,402,23,9,9,10,4,0,1,32,8,40
p_227,0,12,e_3,327,346,402,6,1,0,6,4,0,1,19,56,75
p_214,0,3,e_1,349,394,407,25,12,12,15,4,0,1,45,13,58
p_238,0,13,e_3,303,346,407,14,1,0,14,4,0,1,43,61,104
p_229,0,13,e_3,320,346,407,8,1,0,8,4,0,1,26,61,87
p_183,0,1,e_2,396,405,410,15,3,3,0,5,1,0,9,5,14
p_201,0,5,e_1,366,394,415,22,8,8,9,4,0,1,28,21,49
p_182,0,2,e_2,397,405,415,15,3,3,0,5,1,1,8,10,18
p_180,0,2,e_2,399,405,415,15,3,3,1,2,1,1,6,10,16
p_210,0,6,e_1,354,394,420,24,11,11,13,4,0,1,40,26,66
p_208,0,6,e_1,358,394,420,24,10,10,12,4,0,1,36,26,62
p_178,0,3,e_2,401,405,420,14,2,2,1,4,0,1,4,15,19
p_217,0,7,e_1,346,394,425,26,11,11,15,3,0,0,48,31,79
p_212,0,7,e_1,351,394,425,25,11,11,14,4,0,1,43,31,74
p_176,0,4,e_2,403,405,425,14,2,2,0,4,0,1,2,20,22
p_207,0,11,e_1,359,394,439,23,10,10,11,4,0,1,35,45,80
p_179,0,8,e_2,400,405,439,14,3,3,1,4,0,1,5,34,39
p_206,0,12,e_1,361,394,444,23,9,9,11,4,0,1,33,50,83
p_203,0,12,e_1,364,394,444,22,9,9,10,4,0,1,30,50,80
p_177,0,9,e_2,402,405,444,14,2,2,1,4,0,1,3,39,42
p_204,0,14,e_1,363,394,452,23,9,9,10,4,0,1,31,58,89
p_223,0,2,e_3,336,448,456,3,1,0,3,4,0,1,112,8,120
p_215,0,15,e_1,348,394,457,26,11,11,15,4,0,1,46,63,109
p_213,0,15,e_1,350,394,457,25,11,11,14,4,0,1,44,63,107
p_211,0,15,e_1,353,394,457,25,11,11,13,4,0,1,41,63,104
p_181,0,15,e_2,398,405,464,15,3,3,1,5,1,1,7,59,66
p_225,0,5,e_3,330,448,467,5,1,0,5,4,0,1,118,19,137
p_224,0,5,e_3,331,448,467,5,1,0,5,4,0,1,117,19,136
p_222,0,5,e_3,337,448,467,3,1,0,3,4,0,1,111,19,130
p_219,0,5,e_3,342,448,467,1,1,0,1,4,0,1,106,19,125
p_221,0,6,e_3,339,448,472,2,1,0,2,4,0,1,109,24,133
p_220,0,6,e_3,341,448,472,1,1,0,1,4,0,1,107,24,131
p_218,0,11,e_3,343,448,489,1,1,0,1,4,0,1,105,41,146
p_173,0,11,e_3,407,448,489,13,1,0,13,4,0,1,41,41,82
p_171,0,13,e_3,409,448,497,13,1,0,13,4,0,1,39,49,88
p_175,0,14,e_3,405,448,502,13,2,2,13,5,1,1,43,54,97
p_174,0,14,e_3,406,448,502,13,1,1,13,2,1,1,42,54,96
p_170,0,14,e_3,410,448,502,12,1,0,12,4,0,1,38,54,92
p_146,0,1,e_0,453,497,504,29,8,8,14,4,0,1,44,7,51
p_202,0,15,e_3,365,448,507,4,8,8,4,3,8,1,83,59,142
p_172,0,15,e_3,408,448,507,13,1,0,13,4,0,1,40,59,99
p_190,0,1,e_1,379,504,511,19,6,6,5,4,0,1,125,7,132
p_143,0,3,e_0,456,497,512,28,7,7,13,4,0,1,41,15,56
p_136,0,3,e_0,465,497,512,25,7,7,10,4,0,1,32,15,47
p_137,0,4,e_0,464,497,517,26,7,7,11,4,0,1,33,20,53
p_200,0,4,e_1,367,504,522,22,8,8,9,4,0,1,137,18,155
p_196,0,4,e_1,371,504,522,21,7,7,7,4,0,1,133,18,151
p_186,0,4,e_1,390,504,522,17,4,4,1,4,0,1,114,18,132
p_141,0,6,e_0,458,497,525,28,7,7,13,4,0,1,39,28,67
p_194,0,6,e_1,373,504,530,21,7,7,7,4,0,1,131,26,157
p_148,0,8,e_0,449,497,533,30,7,7,15,3,0,0,48,36,84
p_140,0,8,e_0,459,497,533,27,7,7,12,4,0,1,38,36,74
p_147,0,9,e_0,452,497,538,29,8,8,15,4,0,1,45,41,86
p_144,0,9,e_0,455,497,538,28,7,7,14,4,0,1,42,41,83
p_142,0,9,e_0,457,497,538,28,7,7,13,4,0,1,40,41,81
p_192,0,8,e_1,375,504,538,20,7,7,6,4,0,1,129,34,163
p_189,0,8,e_1,382,504,538,18,6,6,4,4,0,1,122,34,156
p_139,0,10,e_0,461,497,543,27,7,7,12,4,0,1,36,46,82
p_135,0,10,e_0,466,497,543,25,6,6,10,4,0,1,31,46,77
p_198,0,9,e_1,369,504,543,21,8,8,8,4,0,1,135,39,174
p_145,0,11,e_0,454,497,548,28,8,8,14,4,0,1,43,51,94
p_138,0,11,e_0,463,497,548,26,7,7,11,4,0,1,34,51,85
p_197,0,10,e_1,370,504,548,21,7,7,8,4,0,1,134,44,178
p_191,0,10,e_1,376,504,548,20,7,7,6,4,0,1,128,44,172
p_193,0,11,e_1,374,504,553,20,7,7,6,4,0,1,130,49,179
p_187,0,12,e_1,389,504,558,17,4,4,1,4,0,1,115,54,169
p_167,0,1,e_3,413,554,561,11,1,0,11,4,0,1,141,7,148
p_161,0,1,e_3,421,554,561,9,1,0,9,4,0,1,133,7,140
p_158,0,1,e_3,430,554,561,6,1,0,6,4,0,1,124,7,131
p_134,0,15,e_0,467,497,562,25,6,6,10,4,0,1,30,65,95
p_188,0,13,e_1,384,504,563,18,5,5,3,4,0,1,120,59,179
p_199,0,15,e_1,368,504,571,22,8,8,8,4,0,1,136,67,203
p_195,0,15,e_1,372,504,571,21,7,7,7,4,0,1,132,67,199
p_165,0,4,e_3,417,554,572,10,1,0,10,4,0,1,137,18,155
p_102,0,7,e_2,509,556,579,15,1,0,15,4,0,1,47,23,70
p_98,0,7,e_2,515,556,579,13,1,0,13,4,0,1,41,23,64
p_159,0,6,e_3,429,554,580,6,1,0,6,4,0,1,125,26,151
p_87,0,8,e_2,539,556,584,5,1,0,5,4,0,1,17,28,45
p_169,0,9,e_3,411,554,591,12,1,0,12,4,0,1,143,37,180
p_103,0,11,e_2,508,556,595,15,1,0,15,3,0,0,48,39,87
p_163,0,10,e_3,419,554,596,9,1,0,9,4,0,1,135,42,177
p_164,0,11,e_3,418,554,601,10,1,0,10,4,0,1,136,47,183
p_162,0,11,e_3,420,554,601,9,1,0,9,4,0,1,134,47,181
p_90,0,13,e_2,527,556,603,9,1,0,9,4,0,1,29,47,76
p_166,0,12,e_3,416,554,606,10,1,0,10,4,0,1,138,52,190
p_95,0,14,e_2,518,556,608,12,1,0,12,4,0,1,38,52,90
p_81,0,14,e_2,551,556,608,1,1,0,1,4,0,1,5,52,57
p_168,0,13,e_3,412,554,611,12,1,0,12,4,0,1,142,57,199
p_85,0,15,e_2,545,556,613,3,1,0,3,4,0,1,11,57,68
p_130,0,1,e_0,472,609,616,24,5,5,8,4,0,1,137,7,144
p_119,0,1,e_0,483,609,616,21,5,5,4,4,0,1,126,7,133
p_157,0,14,e_3,431,554,616,5,1,0,5,4,0,1,123,62,185
p_155,0,14,e_3,435,554,616,4,1,0,4,4,0,1,119,62,181
p_160,0,15,e_3,426,554,621,7,1,0,7,4,0,1,128,67,195
p_156,0,15,e_3,434,554,621,4,1,0,4,4,0,1,120,67,187
p_129,0,3,e_0,473,609,624,24,5,5,8,4,0,1,136,15,151
p_106,0,3,e_1,500,618,629,16,3,3,1,4,0,1,118,11,129
p_124,0,7,e_0,478,609,638,22,5,5,6,4,0,1,131,29,160
p_127,0,10,e_0,475,609,649,23,5,5,7,4,0,1,134,40,174
p_37,0,9,e_1,615,618,649,16,2,2,1,4,0,1,3,31,34
p_132,0,11,e_0,470,609,654,24,6,6,9,4,0,1,139,45,184
p_128,0,11,e_0,474,609,654,24,5,5,7,4,0,1,135,45,180
p_123,0,11,e_0,479,609,654,22,5,5,6,4,0,1,130,45,175
p_121,0,11,e_0,481,609,654,21,5,5,5,4,0,1,128,45,173
p_120,0,11,e_0,482,609,654,21,5,5,5,4,0,1,127,45,172
p_185,0,10,e_1,391,618,654,17,4,4,1,4,0,1,227,36,263
p_133,0,12,e_0,469,609,659,25,6,6,9,4,0,1,140,50,190
p_126,0,12,e_0,476,609,659,23,5,5,7,4,0,1,133,50,183
p_107,0,11,e_1,499,618,659,17,3,3,1,4,0,1,119,41,160
p_184,0,12,e_1,392,618,664,16,4,4,0,4,0,1,226,46,272
p_105,0,12,e_1,502,618,664,16,2,2,0,4,0,1,116,46,162
p_131,0,14,e_0,471,609,667,24,5,5,8,4,0,1,138,58,196
p_125,0,14,e_0,477,609,667,23,5,5,6,4,0,1,132,58,190
p_122,0,15,e_0,480,609,672,22,5,5,5,4,0,1,129,63,192
p_104,0,14,e_1,503,618,672,16,2,2,0,3,0,0,115,54,169
p_96,0,1,e_3,517,668,673,12,1,0,12,4,0,1,151,5,156
p_92,0,4,e_3,525,668,684,9,1,0,9,4,0,1,143,16,159
p_150,0,6,e_3,443,668,692,1,1,0,1,4,0,1,225,24,249
p_99,0,6,e_3,514,668,692,13,1,0,13,4,0,1,154,24,178
p_94,0,6,e_3,519,668,692,11,1,0,11,4,0,1,149,24,173
p_154,0,7,e_3,436,668,697,4,1,0,4,4,0,1,232,29,261
p_101,0,8,e_3,511,668,702,14,1,0,14,4,0,1,157,34,191
p_153,0,9,e_3,437,668,707,3,1,0,3,4,0,1,231,39,270
p_100,0,9,e_3,513,668,707,13,1,0,13,4,0,1,155,39,194
p_89,0,9,e_3,535,668,707,6,1,0,6,4,0,1,133,39,172
p_91,0,12,e_3,526,668,718,9,1,0,9,4,0,1,142,50,192
p_93,0,13,e_3,520,668,723,11,1,0,11,4,0,1,148,55,203
p_113,0,1,e_0,489,719,724,19,4,4,2,4,0,1,230,5,235
p_24,0,2,e_1,695,716,724,23,7,7,7,4,0,1,21,8,29
p_30,0,3,e_2,668,716,727,30,9,9,15,3,0,0,48,11,59
p_152,0,15,e_3,441,668,731,2,1,0,2,4,0,1,227,63,290
p_151,0,15,e_3,442,668,731,2,1,0,2,4,0,1,226,63,289
p_149,0,15,e_3,444,668,731,1,1,0,1,4,0,1,224,63,287
p_114,0,3,e_0,488,719,732,19,4,4,3,4,0,1,231,13,244
p_77,0,3,e_0,557,719,732,30,10,10,14,5,1,1,162,13,175
p_29,0,5,e_1,670,716,735,30,9,9,14,5,1,0,46,19,65
p_108,0,6,e_0,496,719,743,17,3,3,0,3,0,0,223,24,247
p_76,0,6,e_0,558,719,743,30,10,10,14,5,1,1,161,24,185
p_26,0,8,e_1,684,716,746,26,8,8,10,4,0,1,32,30,62
p_25,0,8,e_1,686,716,746,26,8,8,10,4,0,1,30,30,60
p_118,0,7,e_0,484,719,748,20,5,5,4,4,0,1,235,29,264
p_97,0,7,e_0,516,719,748,12,1,0,4,3,7,1,203,29,232
p_22,0,3,e_2,719,738,749,18,3,3,1,5,1,0,19,11,30
p_111,0,8,e_0,491,719,753,19,4,4,2,4,0,1,228,34,262
p_27,0,10,e_1,677,716,754,28,9,9,13,4,0,1,39,38,77
p_21,0,4,e_2,731,738,754,15,1,0,2,4,0,1,7,16,23
p_115,0,9,e_0,487,719,758,19,5,5,3,4,0,1,232,39,271
p_28,0,11,e_1,676,716,759,28,9,9,13,4,0,1,40,43,83
p_117,0,10,e_0,485,719,763,20,5,5,4,4,0,1,234,44,278
p_116,0,10,e_0,486,719,763,20,5,5,3,4,0,1,233,44,277
p_23,0,12,e_1,711,716,764,20,4,4,1,4,0,1,5,48,53
p_112,0,11,e_0,490,719,768,19,4,4,2,4,0,1,229,49,278
p_110,0,11,e_0,492,719,768,18,4,4,1,4,0,1,227,49,276
p_78,0,12,e_0,556,719,773,30,10,10,13,5,1,1,163,54,217
p_109,0,15,e_0,493,719,784,18,4,4,1,4,0,1,226,65,291
p_20,0,14,e_2,734,738,786,14,1,0,1,4,0,1,4,48,52
p_86,0,2,e_3,544,778,786,3,1,0,3,4,0,1,234,8,242
p_88,0,5,e_3,538,778,797,5,1,0,5,4,0,1,240,19,259
p_32,0,6,e_3,650,778,802,6,1,0,6,4,0,1,128,24,152
p_31,0,6,e_3,666,778,802,0,1,0,0,4,0,1,112,24,136
p_80,0,7,e_3,552,778,807,0,1,0,0,4,0,1,226,29,255
p_83,0,8,e_3,549,778,812,1,1,0,1,4,0,1,229,34,263
p_35,0,9,e_3,630,778,817,12,1,0,12,4,0,1,148,39,187
p_18,0,10,e_3,766,778,822,4,1,0,4,4,0,1,12,44,56
p_16,0,2,e_1,780,819,827,30,12,12,12,3,0,0,39,8,47
p_19,0,11,e_3,754,778,827,8,1,0,8,4,0,1,24,49,73
p_84,0,12,e_3,546,778,832,2,1,0,2,4,0,1,232,54,286
p_34,0,12,e_3,646,778,832,7,1,0,7,4,0,1,132,54,186
p_14,0,4,e_1,794,819,835,26,12,12,8,4,0,1,25,16,41
p_65,0,1,e_0,573,831,836,26,9,9,12,4,0,1,258,5,263
p_36,0,13,e_3,628,778,837,13,1,0,13,4,0,1,150,59,209
p_82,0,14,e_3,550,778,842,1,1,0,1,4,0,1,228,64,292
p_79,0,14,e_3,553,778,842,0,0,0,0,3,0,0,225,64,289
p_72,0,3,e_0,562,831,844,29,10,10,15,4,0,1,269,13,282
p_71,0,3,e_0,564,831,844,28,10,10,15,4,0,1,267,13,280
p_70,0,3,e_0,565,831,844,28,10,10,14,4,0,1,266,13,279
p_67,0,3,e_0,568,831,844,27,10,10,13,4,0,1,263,13,276
p_66,0,3,e_0,569,831,844,27,10,10,13,4,0,1,262,13,275
p_33,0,15,e_3,649,778,847,6,1,0,6,4,0,1,129,69,198
p_64,0,4,e_0,574,831,849,26,9,9,11,4,0,1,257,18,275
p_15,0,9,e_1,793,819,852,26,12,12,8,4,0,1,26,33,59
p_11,0,9,e_1,807,819,852,23,9,9,4,4,0,1,12,33,45
p_75,0,5,e_0,559,831,854,29,11,11,14,5,1,1,272,23,295
p_61,0,6,e_0,579,831,859,24,8,8,10,4,0,1,252,28,280
p_13,0,11,e_1,796,819,860,25,11,11,7,4,0,1,23,41,64
p_12,0,11,e_1,798,819,860,25,11,11,7,4,0,1,21,41,62
p_74,0,7,e_0,560,831,864,29,10,10,15,5,1,1,271,33,304
p_73,0,11,e_0,561,831,878,29,10,10,15,2,1,1,270,47,317
p_68,0,13,e_0,567,831,886,27,10,10,14,4,0,1,264,55,319
p_63,0,13,e_0,577,831,886,25,9,9,10,4,0,1,254,55,309
p_62,0,13,e_0,578,831,886,24,9,9,10,4,0,1,253,55,308
p_9,0,2,e_2,846,880,888,15,1,1,11,4,0,1,34,8,42
p_69,0,14,e_0,566,831,891,28,10,10,14,4,0,1,265,60,325
p_6,0,3,e_2,877,880,893,5,1,0,1,4,0,1,3,13,16
p_4,0,1,e_3,886,894,899,2,1,0,2,4,0,1,8,5,13
p_7,0,5,e_2,875,880,901,6,1,0,1,4,0,1,5,21,26
p_10,0,8,e_2,835,880,912,17,4,4,14,3,0,0,45,32,77
p_5,0,8,e_3,883,894,922,3,1,0,3,4,0,1,11,28,39
p_3,0,8,e_3,888,894,922,2,1,0,2,4,0,1,6,28,34
p_8,0,11,e_2,874,880,923,6,1,0,2,4,0,1,6,43,49
p_17,0,10,e_3,776,894,930,0,1,0,0,4,0,1,118,36,154
p_2,0,11,e_3,892,894,935,0,1,0,0,4,0,1,2,41,43
p_55,0,3,e_0,585,935,946,23,8,8,8,4,0,1,350,11,361
p_54,0,3,e_0,586,935,946,22,8,8,7,4,0,1,349,11,360
p_52,0,3,e_0,588,935,946,22,8,8,7,4,0,1,347,11,358
p_1,0,5,e_1,894,930,947,22,4,4,11,3,0,0,36,17,53
p_48,0,4,e_0,592,935,951,21,7,7,5,4,0,1,343,16,359
p_46,0,4,e_0,594,935,951,20,7,7,5,4,0,1,341,16,357
p_56,0,6,e_0,584,935,959,23,8,8,8,4,0,1,351,24,375
p_50,0,7,e_0,590,935,964,21,7,7,6,4,0,1,345,29,374
p_53,0,9,e_0,587,935,972,22,8,8,7,4,0,1,348,37,385
p_51,0,9,e_0,589,935,972,21,8,8,6,4,0,1,346,37,383
p_47,0,9,e_0,593,935,972,21,7,7,5,4,0,1,342,37,379
p_60,0,10,e_0,580,935,977,24,8,8,9,4,0,1,355,42,397
p_58,0,11,e_0,582,935,982,24,8,8,9,4,0,1,353,47,400
p_57,0,11,e_0,583,935,982,23,8,8,8,4,0,1,352,47,399
p_59,0,14,e_0,581,935,993,24,8,8,9,4,0,1,354,58,412
p_49,0,14,e_0,591,935,993,21,7,7,6,4,0,1,344,58,402
p_45,0,2,e_0,595,1037,1045,20,6,6,4,4,0,1,442,8,450
p_42,0,6,e_0,598,1037,1059,20,6,6,3,4,0,1,439,22,461
p_43,0,7,e_0,597,1037,1064,20,6,6,4,4,0,1,440,27,467
p_44,0,8,e_0,596,1037,1069,20,6,6,4,4,0,1,441,32,473
p_41,0,11,e_0,600,1037,1080,19,5,5,3,4,0,1,437,43,480
p_39,0,12,e_0,607,1037,1085,18,4,4,0,4,0,1,430,48,478
p_40,0,13,e_0,602,1037,1090,19,5,5,2,4,0,1,435,53,488
p_38,0,13,e_0,608,1037,1090,18,4,4,0,3,0,0,429,53,482
p_300,0,4,e_0,8,9,25,0,0,0,0,3,0,0,1,16,17
p_299,0,5,e_1,9,10,29,0,0,0,0,3,0,0,1,19,20
p_297,0,6,e_3,15,16,38,0,0,0,0,3,0,0,1,22,23
p_298,0,9,e_2,11,12,43,0,0,0,0,3,0,0,1,31,32
p_296,0,4,e_0,28,43,57,9,1,1,4,3,0,0,15,14,29
p_286,0,3,e_1,46,47,60,6,0,0,0,3,0,0,1,13,14
p_292,0,6,e_0,38,43,65,6,0,0,1,4,0,1,5,22,27
p_290,0,6,e_0,40,43,65,6,0,0,1,4,0,1,3,22,25
p_289,0,4,e_1,43,47,65,6,0,0,1,4,0,1,4,18,22
p_295,0,5,e_1,29,47,70,9,1,1,5,3,0,0,18,23,41
p_287,0,5,e_1,45,47,70,6,0,0,0,4,0,1,2,23,25
p_288,0,8,e_1,44,47,81,6,0,0,1,4,0,1,3,34,37
p_281,0,1,e_3,73,74,81,0,0,0,0,3,0,0,1,7,8
p_291,0,11,e_0,39,43,82,6,0,0,1,4,0,1,4,39,43
p_294,0,12,e_0,31,43,87,8,1,1,4,4,0,1,12,44,56
p_293,0,12,e_0,33,43,87,7,1,1,3,4,0,1,10,44,54
p_285,0,4,e_3,53,74,92,6,0,0,6,3,0,0,21,18,39
p_284,0,4,e_3,54,74,92,6,1,0,6,4,0,1,20,18,38
p_282,0,7,e_3,66,74,103,2,1,0,2,4,0,1,8,29,37
p_283,0,9,e_3,57,74,111,5,1,0,5,4,0,1,17,37,54
p_278,0,2,e_2,77,105,113,18,4,4,9,4,0,1,28,8,36
p_279,0,5,e_2,76,105,124,18,4,4,9,4,0,1,29,19,48
p_277,0,6,e_1,82,109,129,17,3,3,8,3,0,0,27,20,47
p_274,0,8,e_2,88,105,135,15,3,3,5,4,0,1,17,30,47
p_271,0,1,e_3,121,140,145,6,1,0,6,4,0,1,19,5,24
p_276,0,11,e_2,84,105,146,16,3,3,7,4,0,1,21,41,62
p_273,0,4,e_3,110,140,156,9,0,0,9,2,1,0,30,16,46
p_280,0,14,e_2,75,105,157,18,4,4,9,3,0,0,30,52,82
p_275,0,14,e_2,86,105,157,16,3,3,6,4,0,1,19,52,71
p_267,0,1,e_1,148,165,172,18,3,3,5,4,0,1,17,7,24
p_270,0,9,e_3,122,140,173,6,1,0,6,4,0,1,18,33,51
p_269,0,9,e_3,127,140,173,4,1,0,4,4,0,1,13,33,46
p_268,0,2,e_1,144,165,177,19,3,3,6,3,0,0,21,12,33
p_272,0,10,e_3,113,140,178,9,1,0,9,4,0,1,27,38,65
p_265,0,4,e_1,152,165,185,17,3,3,4,4,0,1,13,20,33
p_262,0,5,e_1,157,165,190,16,2,2,2,4,0,1,8,25,33
p_261,0,5,e_1,164,165,190,14,2,2,0,3,0,0,1,25,26
p_266,0,6,e_1,151,165,195,17,3,3,4,4,0,1,14,30,44
p_263,0,7,e_1,154,165,200,16,3,3,3,4,0,1,11,35,46
p_264,0,11,e_1,153,165,214,17,3,3,4,4,0,1,12,49,61
p_255,0,3,e_0,184,204,215,10,0,0,6,4,0,1,20,11,31
p_254,0,4,e_0,187,204,220,10,0,0,5,4,0,1,17,16,33
p_253,0,5,e_0,190,204,225,10,0,0,4,4,0,1,14,21,35
p_260,0,7,e_0,165,204,233,13,2,2,12,3,0,0,39,29,68
p_258,0,7,e_0,168,204,233,12,2,2,12,4,0,1,36,29,65
p_256,0,10,e_0,182,204,244,10,0,0,7,4,0,1,22,40,62
p_250,0,2,e_3,217,238,246,7,1,0,7,4,0,1,21,8,29
p_252,0,5,e_3,205,238,257,10,0,0,10,3,0,0,33,19,52
p_257,0,14,e_0,169,204,258,12,2,2,11,4,0,1,35,54,89
p_259,0,15,e_0,167,204,263,13,2,2,12,4,0,1,37,59,96
p_251,0,15,e_3,209,238,289,9,1,0,9,4,0,1,29,51,80
p_248,0,5,e_1,246,275,292,28,2,2,9,4,0,1,29,17,46
p_247,0,5,e_1,250,275,292,27,2,2,8,4,0,1,25,17,42
p_249,0,6,e_1,239,275,297,30,3,3,11,3,0,0,36,22,58
p_245,0,7,e_1,269,275,302,21,1,1,2,4,0,1,6,27,33
p_246,0,10,e_1,262,275,313,24,1,1,4,4,0,1,13,38,51
p_244,0,12,e_1,271,275,321,21,1,1,1,4,0,1,4,46,50
p_241,0,1,e_2,283,322,327,17,1,1,13,4,0,1,39,5,44
p_236,0,1,e_2,305,322,327,15,0,0,5,4,0,1,17,5,22
p_233,0,1,e_2,311,322,327,15,0,0,3,4,0,1,11,5,16
p_243,0,15,e_1,272,275,332,20,1,1,1,4,0,1,3,57,60
p_230,0,3,e_2,319,322,335,15,0,0,1,4,0,1,3,13,16
p_232,0,5,e_2,314,322,343,15,0,0,2,4,0,1,8,21,29
p_237,0,7,e_2,304,322,351,15,0,0,6,4,0,1,18,29,47
p_231,0,7,e_2,317,322,351,15,0,0,1,4,0,1,5,29,34
p_242,0,8,e_2,277,322,356,19,1,1,14,3,0,0,45,34,79
p_235,0,8,e_2,308,322,356,15,0,0,4,4,0,1,14,34,48
p_234,0,8,e_2,310,322,356,15,0,0,4,4,0,1,12,34,46
p_240,0,9,e_2,301,322,361,15,0,0,7,4,0,1,21,39,60
p_239,0,11,e_2,302,322,369,15,0,0,6,4,0,1,20,47,67
p_238,0,13,e_2,303,322,377,15,0,0,6,4,0,1,19,55,74
p_229,0,13,e_2,320,322,377,15,0,0,0,4,0,1,2,55,57
p_216,0,1,e_0,347,373,380,9,1,0,8,4,0,1,26,7,33
p_226,0,2,e_0,329,373,385,15,1,0,14,4,0,1,44,12,56
p_223,0,2,e_0,336,373,385,13,1,0,12,4,0,1,37,12,49
p_214,0,3,e_0,349,373,390,8,1,0,8,4,0,1,24,17,41
p_228,0,4,e_0,325,373,395,15,0,0,15,3,0,0,48,22,70
p_224,0,5,e_1,331,379,396,14,1,0,15,2,1,0,48,17,65
p_194,0,6,e_3,373,375,397,0,1,0,0,4,0,1,2,22,24
p_225,0,5,e_0,330,373,400,15,1,0,14,4,0,1,43,27,70
p_222,0,5,e_0,337,373,400,12,1,0,12,4,0,1,36,27,63
p_219,0,5,e_0,342,373,400,11,1,0,10,4,0,1,31,27,58
p_221,0,6,e_0,339,373,405,12,1,0,11,4,0,1,34,32,66
p_220,0,6,e_0,341,373,405,11,1,0,10,4,0,1,32,32,64
p_192,0,8,e_1,375,379,407,24,4,4,1,4,0,1,4,28,32
p_217,0,7,e_0,346,373,410,9,1,0,9,4,0,1,27,37,64
p_212,0,7,e_0,351,373,410,8,1,0,7,4,0,1,22,37,59
p_193,0,11,e_3,374,375,414,0,0,0,0,3,0,0,1,39,40
p_191,0,10,e_1,376,379,415,24,3,3,1,4,0,1,3,36,39
p_227,0,12,e_3,327,375,419,15,0,0,15,3,0,0,48,44,92
p_218,0,11,e_0,343,373,424,10,1,0,10,4,0,1,30,51,81
p_190,0,1,e_2,379,421,428,24,3,3,13,3,0,0,42,7,49
p_183,0,1,e_2,396,421,428,18,2,2,8,4,0,1,25,7,32
p_182,0,2,e_2,397,421,433,18,2,2,8,4,0,1,24,12,36
p_180,0,2,e_2,399,421,433,18,2,2,7,4,0,1,22,12,34
p_215,0,15,e_0,348,373,438,9,1,0,8,4,0,1,25,65,90
p_213,0,15,e_0,350,373,438,8,1,0,7,4,0,1,23,65,88
p_178,0,3,e_2,401,421,438,17,2,2,6,4,0,1,20,17,37
p_186,0,4,e_2,390,421,443,20,3,3,10,4,0,1,31,22,53
p_176,0,4,e_2,403,421,443,16,2,2,6,4,0,1,18,22,40
p_189,0,8,e_2,382,421,457,23,3,3,13,4,0,1,39,36,75
p_179,0,8,e_2,400,421,457,17,2,2,7,4,0,1,21,36,57
p_161,0,1,e_1,421,454,461,12,0,0,10,3,0,0,33,7,40
p_158,0,1,e_1,430,454,461,12,0,0,8,4,0,1,24,7,31
p_177,0,9,e_2,402,421,462,17,2,2,6,4,0,1,19,41,60
p_185,0,10,e_2,391,421,467,20,3,3,10,4,0,1,30,46,76
p_187,0,12,e_2,389,421,475,20,3,3,10,4,0,1,32,54,86
p_184,0,12,e_2,392,421,475,19,3,3,9,4,0,1,29,54,83
p_159,0,6,e_1,429,454,478,12,0,0,8,4,0,1,25,24,49
p_150,0,6,e_1,443,454,478,12,0,0,3,4,0,1,11,24,35
p_188,0,13,e_2,384,421,480,22,3,3,12,4,0,1,37,59,96
p_154,0,7,e_1,436,454,483,12,0,0,6,4,0,1,18,29,47
p_148,0,8,e_1,449,454,488,12,0,0,1,4,0,1,5,34,39
p_181,0,15,e_2,398,421,488,18,2,2,7,4,0,1,23,67,90
p_153,0,9,e_1,437,454,493,12,0,0,5,4,0,1,17,39,56
p_147,0,9,e_1,452,454,493,12,0,0,0,4,0,1,2,39,41
p_209,0,2,e_0,357,485,495,6,1,0,5,4,0,1,128,10,138
p_205,0,2,e_0,362,485,495,4,1,0,3,4,0,1,123,10,133
p_200,0,4,e_0,367,485,503,2,1,0,2,4,0,1,118,18,136
p_201,0,5,e_0,366,485,508,3,1,0,2,4,0,1,119,23,142
p_157,0,14,e_1,431,454,510,12,0,0,7,4,0,1,23,56,79
p_155,0,14,e_1,435,454,510,12,0,0,6,4,0,1,19,56,75
p_210,0,6,e_0,354,485,513,7,1,0,6,4,0,1,131,28,159
p_208,0,6,e_0,358,485,513,5,1,0,5,4,0,1,127,28,155
p_160,0,15,e_1,426,454,515,12,0,0,9,4,0,1,28,61,89
p_156,0,15,e_1,434,454,515,12,0,0,6,4,0,1,20,61,81
p_152,0,15,e_1,441,454,515,12,0,0,4,4,0,1,13,61,74
p_151,0,15,e_1,442,454,515,12,0,0,4,4,0,1,12,61,73
p_149,0,15,e_1,444,454,515,12,0,0,3,4,0,1,10,61,71
p_198,0,9,e_0,369,485,524,2,1,0,1,4,0,1,116,39,155
p_197,0,10,e_0,370,485,529,1,1,0,1,4,0,1,115,44,159
p_113,0,1,e_3,489,524,529,11,1,0,11,4,0,1,35,5,40
p_207,0,11,e_0,359,485,534,5,1,0,4,4,0,1,126,49,175
p_114,0,3,e_3,488,524,537,12,1,0,12,4,0,1,36,13,49
p_106,0,3,e_3,500,524,537,8,1,0,8,4,0,1,24,13,37
p_206,0,12,e_0,361,485,539,4,1,0,4,4,0,1,124,54,178
p_203,0,12,e_0,364,485,539,3,1,0,3,4,0,1,121,54,175
p_167,0,1,e_2,413,535,540,13,1,1,2,4,0,1,122,5,127
p_204,0,14,e_0,363,485,547,4,1,0,3,4,0,1,122,62,184
p_108,0,6,e_3,496,524,548,9,1,0,9,4,0,1,28,24,52
p_165,0,4,e_2,417,535,551,12,1,1,1,4,0,1,118,16,134
p_92,0,4,e_2,525,535,551,30,10,10,3,4,0,1,10,16,26
p_211,0,15,e_0,353,485,552,7,1,0,6,4,0,1,132,67,199
p_202,0,15,e_0,365,485,552,3,1,0,2,4,0,1,120,67,187
p_199,0,15,e_0,368,485,552,2,1,0,1,4,0,1,117,67,184
p_111,0,8,e_3,491,524,556,11,1,0,11,4,0,1,33,32,65
p_115,0,9,e_3,487,524,561,12,1,0,12,4,0,1,37,37,74
p_117,0,10,e_3,485,524,566,12,0,0,12,3,0,0,39,42,81
p_116,0,10,e_3,486,524,566,12,1,0,12,4,0,1,38,42,80
p_169,0,9,e_2,411,535,568,14,2,2,3,4,0,1,124,33,157
p_146,0,1,e_1,453,562,569,12,0,0,0,3,0,0,109,7,116
p_112,0,11,e_3,490,524,571,11,1,0,11,4,0,1,34,47,81
p_110,0,11,e_3,492,524,571,10,1,0,10,4,0,1,32,47,79
p_107,0,11,e_3,499,524,571,8,1,0,8,4,0,1,25,47,72
p_103,0,11,e_3,508,524,571,5,1,0,5,4,0,1,16,47,63
p_163,0,10,e_2,419,535,573,12,0,0,0,4,0,1,116,38,154
p_86,0,2,e_1,544,562,574,25,9,9,6,4,0,1,18,12,30
p_105,0,12,e_3,502,524,576,7,1,0,7,4,0,1,22,52,74
p_173,0,11,e_2,407,535,578,15,2,2,4,4,0,1,128,43,171
p_164,0,11,e_2,418,535,578,12,0,0,1,4,0,1,117,43,160
p_162,0,11,e_2,420,535,578,12,0,0,0,3,0,0,115,43,158
p_77,0,3,e_1,557,562,579,22,7,7,1,4,0,1,5,17,22
p_166,0,12,e_2,416,535,583,13,1,1,1,4,0,1,119,48,167
p_104,0,14,e_3,503,524,584,7,1,0,7,4,0,1,21,60,81
p_88,0,5,e_1,538,562,587,27,9,9,8,4,0,1,24,25,49
p_171,0,13,e_2,409,535,588,14,2,2,4,4,0,1,126,53,179
p_168,0,13,e_2,412,535,588,13,2,2,3,4,0,1,123,53,176
p_109,0,15,e_3,493,524,589,10,1,0,10,4,0,1,31,65,96
p_76,0,6,e_1,558,562,592,22,7,7,1,4,0,1,4,30,34
p_175,0,14,e_2,405,535,593,16,2,2,5,4,0,1,130,58,188
p_174,0,14,e_2,406,535,593,15,2,2,5,4,0,1,129,58,187
p_170,0,14,e_2,410,535,593,14,2,2,3,4,0,1,125,58,183
p_80,0,7,e_1,552,562,597,23,8,8,3,4,0,1,10,35,45
p_172,0,15,e_2,408,535,598,15,2,2,4,4,0,1,127,63,190
p_87,0,8,e_1,539,562,602,27,9,9,7,4,0,1,23,40,63
p_83,0,8,e_1,549,562,602,24,8,8,4,4,0,1,13,40,53
p_89,0,9,e_1,535,562,607,27,10,10,9,4,0,1,27,45,72
p_143,0,3,e_0,456,599,612,12,0,0,9,4,0,1,143,13,156
p_136,0,3,e_0,465,599,612,12,0,0,6,4,0,1,134,13,147
p_196,0,4,e_0,371,599,617,1,1,0,0,4,0,1,228,18,246
p_137,0,4,e_0,464,599,617,12,0,0,7,4,0,1,135,18,153
p_84,0,12,e_1,546,562,618,24,9,9,5,4,0,1,16,56,72
p_78,0,12,e_1,556,562,618,22,7,7,2,4,0,1,6,56,62
p_141,0,6,e_0,458,599,625,12,0,0,9,4,0,1,141,26,167
p_82,0,14,e_1,550,562,626,24,8,8,4,4,0,1,12,64,76
p_81,0,14,e_1,551,562,626,23,8,8,3,4,0,1,11,64,75
p_79,0,14,e_1,553,562,626,23,8,8,3,4,0,1,9,64,73
p_85,0,15,e_1,545,562,631,25,9,9,5,4,0,1,17,69,86
p_140,0,8,e_0,459,599,633,12,0,0,8,4,0,1,140,34,174
p_144,0,9,e_0,455,599,638,12,0,0,10,4,0,1,144,39,183
p_142,0,9,e_0,457,599,638,12,0,0,9,4,0,1,142,39,181
p_96,0,1,e_3,517,636,641,2,1,0,2,4,0,1,119,5,124
p_139,0,10,e_0,461,599,643,12,0,0,8,4,0,1,138,44,182
p_135,0,10,e_0,466,599,643,12,0,0,6,4,0,1,133,44,177
p_145,0,11,e_0,454,599,648,12,0,0,10,4,0,1,145,49,194
p_138,0,11,e_0,463,599,648,12,0,0,7,4,0,1,136,49,185
p_133,0,12,e_0,469,599,653,12,0,0,5,4,0,1,130,54,184
p_99,0,6,e_3,514,636,658,3,1,0,3,4,0,1,122,22,144
p_94,0,6,e_3,519,636,658,1,1,0,1,4,0,1,117,22,139
p_102,0,7,e_3,509,636,663,5,1,0,5,4,0,1,127,27,154
p_98,0,7,e_3,515,636,663,3,1,0,3,4,0,1,121,27,148
p_97,0,7,e_3,516,636,663,2,1,0,2,4,0,1,120,27,147
p_195,0,15,e_0,372,599,664,1,1,0,0,3,0,0,227,65,292
p_134,0,15,e_0,467,599,664,12,0,0,6,4,0,1,132,65,197
p_101,0,8,e_3,511,636,668,4,1,0,4,4,0,1,125,32,157
p_100,0,9,e_3,513,636,673,3,1,0,3,4,0,1,123,37,160
p_37,0,9,e_3,615,636,673,7,1,0,7,4,0,1,21,37,58
p_41,0,11,e_3,600,636,681,12,1,0,12,4,0,1,36,45,81
p_91,0,12,e_2,526,645,683,30,10,10,3,4,0,1,119,38,157
p_39,0,12,e_3,607,636,686,9,1,0,9,4,0,1,29,50,79
p_90,0,13,e_2,527,645,688,29,11,11,2,4,0,1,118,43,161
p_30,0,3,e_1,668,678,691,20,6,6,3,4,0,1,10,13,23
p_93,0,13,e_3,520,636,691,1,1,0,1,4,0,1,116,55,171
p_40,0,13,e_3,602,636,691,11,1,0,11,4,0,1,34,55,89
p_38,0,13,e_3,608,636,691,9,1,0,9,4,0,1,28,55,83
p_95,0,14,e_3,518,636,696,2,1,0,2,4,0,1,118,60,178
p_75,0,5,e_1,559,678,699,21,7,7,1,4,0,1,119,21,140
p_29,0,5,e_1,670,678,699,20,6,6,2,4,0,1,8,21,29
p_32,0,6,e_1,650,678,704,24,9,9,9,4,0,1,28,26,54
p_31,0,6,e_1,666,678,704,20,7,7,4,4,0,1,12,26,38
p_74,0,7,e_1,560,678,709,21,6,6,0,4,0,1,118,31,149
p_130,0,1,e_0,472,711,716,12,0,0,4,4,0,1,239,5,244
p_119,0,1,e_0,483,711,716,12,0,0,0,4,0,1,228,5,233
p_27,0,10,e_1,677,678,720,18,5,5,0,3,0,0,1,42,43
p_129,0,3,e_0,473,711,724,12,0,0,4,4,0,1,238,13,251
p_73,0,11,e_1,561,678,725,21,6,6,0,3,0,0,117,47,164
p_28,0,11,e_1,676,678,725,18,5,5,0,4,0,1,2,47,49
p_34,0,12,e_1,646,678,730,26,9,9,10,4,0,1,32,52,84
p_124,0,7,e_0,478,711,738,12,0,0,2,4,0,1,233,27,260
p_118,0,7,e_0,484,711,738,12,0,0,0,3,0,0,227,27,254
p_33,0,15,e_1,649,678,741,25,9,9,9,4,0,1,29,63,92
p_127,0,10,e_0,475,711,749,12,0,0,3,4,0,1,236,38,274
p_22,0,3,e_3,719,740,751,7,1,0,7,4,0,1,21,11,32
p_132,0,11,e_0,470,711,754,12,0,0,5,4,0,1,241,43,284
p_128,0,11,e_0,474,711,754,12,0,0,3,4,0,1,237,43,280
p_123,0,11,e_0,479,711,754,12,0,0,2,4,0,1,232,43,275
p_121,0,11,e_0,481,711,754,12,0,0,1,4,0,1,230,43,273
p_120,0,11,e_0,482,711,754,12,0,0,1,4,0,1,229,43,272
p_21,0,4,e_3,731,740,756,3,1,0,3,4,0,1,9,16,25
p_126,0,12,e_0,476,711,759,12,0,0,3,4,0,1,235,48,283
p_131,0,14,e_0,471,711,767,12,0,0,4,4,0,1,240,56,296
p_125,0,14,e_0,477,711,767,12,0,0,2,4,0,1,234,56,290
p_122,0,15,e_0,480,711,772,12,0,0,1,4,0,1,231,61,292
p_35,0,9,e_3,630,740,773,2,1,0,2,4,0,1,110,33,143
p_23,0,12,e_3,711,740,784,9,1,0,9,4,0,1,29,44,73
p_36,0,13,e_3,628,740,789,2,1,0,2,4,0,1,112,49,161
p_20,0,14,e_3,734,740,794,2,1,0,2,4,0,1,6,54,60
p_16,0,2,e_2,780,796,804,17,3,3,5,4,0,1,16,8,24
p_14,0,4,e_2,794,796,812,14,0,0,0,4,0,1,2,16,18
p_65,0,1,e_0,573,819,824,19,4,4,8,4,0,1,246,5,251
p_15,0,9,e_2,793,796,829,14,0,0,1,4,0,1,3,33,36
p_72,0,3,e_0,562,819,832,21,6,6,12,4,0,1,257,13,270
p_71,0,3,e_0,564,819,832,20,6,6,11,4,0,1,255,13,268
p_70,0,3,e_0,565,819,832,20,5,5,11,4,0,1,254,13,267
p_67,0,3,e_0,568,819,832,20,5,5,10,4,0,1,251,13,264
p_66,0,3,e_0,569,819,832,19,5,5,10,4,0,1,250,13,263
p_18,0,10,e_2,766,796,834,21,4,4,10,4,0,1,30,38,68
p_17,0,10,e_2,776,796,834,18,3,3,6,4,0,1,20,38,58
p_64,0,4,e_0,574,819,837,18,4,4,8,4,0,1,245,18,263
p_19,0,11,e_2,754,796,839,24,5,5,13,3,0,0,42,43,85
p_61,0,6,e_0,579,819,845,17,3,3,6,4,0,1,240,26,266
p_60,0,10,e_0,580,819,859,17,3,3,6,4,0,1,239,40,279
p_58,0,11,e_0,582,819,864,16,3,3,5,4,0,1,237,45,282
p_68,0,13,e_0,567,819,872,20,5,5,10,4,0,1,252,53,305
p_63,0,13,e_0,577,819,872,18,3,3,7,4,0,1,242,53,295
p_62,0,13,e_0,578,819,872,18,3,3,7,4,0,1,241,53,294
p_69,0,14,e_0,566,819,877,20,5,5,11,4,0,1,253,58,311
p_59,0,14,e_0,581,819,877,17,3,3,6,4,0,1,238,58,296
p_9,0,2,e_2,846,882,890,11,1,0,11,3,0,0,36,8,44
p_6,0,3,e_2,877,882,895,1,1,0,1,4,0,1,5,13,18
p_7,0,5,e_3,875,880,897,1,1,0,1,4,0,1,5,17,22
p_10,0,8,e_3,835,880,908,14,0,0,14,3,0,0,45,28,73
p_8,0,11,e_2,874,882,921,2,1,0,2,4,0,1,8,39,47
p_45,0,2,e_0,595,921,929,13,1,0,1,4,0,1,326,8,334
p_55,0,3,e_0,585,921,934,16,2,2,4,4,0,1,336,13,349
p_54,0,3,e_0,586,921,934,16,2,2,4,4,0,1,335,13,348
p_52,0,3,e_0,588,921,934,15,1,1,3,4,0,1,333,13,346
p_48,0,4,e_0,592,921,939,14,1,0,2,4,0,1,329,18,347
p_46,0,4,e_0,594,921,939,14,1,0,1,4,0,1,327,18,345
p_56,0,6,e_0,584,921,947,16,2,2,5,4,0,1,337,26,363
p_50,0,7,e_0,590,921,952,15,1,0,3,4,0,1,331,31,362
p_43,0,7,e_0,597,921,952,13,1,0,0,4,0,1,324,31,355
p_44,0,8,e_0,596,921,957,13,1,0,1,4,0,1,325,36,361
p_53,0,9,e_0,587,921,962,15,2,2,4,4,0,1,334,41,375
p_51,0,9,e_0,589,921,962,15,1,0,3,4,0,1,332,41,373
p_47,0,9,e_0,593,921,962,14,1,0,2,4,0,1,328,41,369
p_57,0,11,e_0,583,921,970,16,2,2,5,4,0,1,338,49,387
p_49,0,14,e_0,591,921,981,15,1,0,2,4,0,1,330,60,390
p_4,0,1,e_0,886,1025,1030,14,2,2,11,4,0,1,139,5,144
p_24,0,2,e_0,695,1025,1035,14,1,1,5,4,0,1,330,10,340
p_1,0,5,e_0,894,1025,1046,12,2,2,9,4,0,1,131,21,152
p_42,0,6,e_0,598,1025,1051,12,1,0,0,3,0,0,427,26,453
p_26,0,8,e_0,684,1025,1059,16,4,4,9,4,0,1,341,34,375
p_25,0,8,e_0,686,1025,1059,16,3,3,8,4,0,1,339,34,373
p_5,0,8,e_0,883,1025,1059,15,2,2,12,4,0,1,142,34,176
p_3,0,8,e_0,888,1025,1059,14,2,2,11,4,0,1,137,34,171
p_11,0,9,e_0,807,1025,1064,14,0,0,4,4,0,1,218,39,257
p_13,0,11,e_0,796,1025,1072,14,0,0,7,4,0,1,229,47,276
p_12,0,11,e_0,798,1025,1072,14,0,0,7,4,0,1,227,47,274
p_2,0,11,e_0,892,1025,1072,12,2,2,9,4,0,1,133,47,180
p_300,0,4,e_0,8,9,25,0,0,0,0,3,0,0,1,16,17
p_299,0,5,e_1,9,10,29,0,0,0,0,3,0,0,1,19,20
p_297,0,6,e_3,15,16,38,0,0,0,0,3,0,0,1,22,23
p_298,0,9,e_2,11,12,43,0,0,0,0,3,0,0,1,31,32
p_296,0,4,e_0,28,43,57,9,1,1,4,3,0,0,15,14,29
p_286,0,3,e_1,46,47,60,4,1,0,0,3,0,0,1,13,14
p_290,0,6,e_0,40,43,65,6,1,0,1,4,0,1,3,22,25
p_289,0,4,e_1,43,47,65,5,1,0,1,4,0,1,4,18,22
p_295,0,5,e_1,29,47,70,9,1,1,5,3,0,0,18,23,41
p_287,0,5,e_1,45,47,70,4,1,0,0,4,0,1,2,23,25
p_284,0,4,e_3,54,59,73,1,1,0,1,4,0,1,5,14,19
p_288,0,8,e_1,44,47,81,5,1,0,1,4,0,1,3,34,37
p_292,0,6,e_3,38,59,81,6,0,0,6,3,0,0,21,22,43
p_291,0,11,e_0,39,43,82,6,1,0,1,4,0,1,4,39,43
p_294,0,12,e_0,31,43,87,8,1,1,4,4,0,1,12,44,56
p_293,0,12,e_0,33,43,87,7,1,1,3,4,0,1,10,44,54
p_281,0,1,e_2,73,83,90,14,2,2,3,4,0,1,10,7,17
p_283,0,9,e_3,57,59,92,0,1,0,0,4,0,1,2,33,35
p_278,0,2,e_2,77,83,95,13,2,2,2,4,0,1,6,12,18
p_285,0,4,e_2,53,83,103,2,1,0,9,3,0,0,30,20,50
p_279,0,5,e_2,76,83,108,13,2,2,2,4,0,1,7,25,32
p_277,0,6,e_2,82,83,113,12,1,1,0,3,0,0,1,30,31
p_282,0,7,e_2,66,83,118,16,3,3,5,4,0,1,17,35,52
p_273,0,4,e_1,110,111,127,9,0,0,0,3,0,0,1,16,17
p_271,0,1,e_0,121,125,130,7,1,0,1,4,0,1,4,5,9
p_274,0,8,e_1,88,111,141,10,1,1,7,4,0,1,23,30,53
p_280,0,14,e_2,75,83,141,14,2,2,2,4,0,1,8,58,66
p_276,0,11,e_1,84,111,152,11,1,1,8,3,0,0,27,41,68
p_270,0,9,e_0,122,125,156,7,1,0,1,4,0,1,3,31,34
p_269,0,9,e_3,127,143,172,5,1,0,5,4,0,1,16,29,45
p_275,0,14,e_0,86,125,173,11,1,1,12,2,1,0,39,48,87
p_272,0,10,e_3,113,143,177,9,0,0,9,3,0,0,30,34,64
p_267,0,1,e_2,148,189,194,19,2,2,13,4,0,1,41,5,46
p_255,0,3,e_1,184,187,198,10,0,0,1,4,0,1,3,11,14
p_268,0,2,e_2,144,189,199,20,2,2,14,3,0,0,45,10,55
p_265,0,4,e_1,152,187,203,17,2,2,11,4,0,1,35,16,51
p_254,0,4,e_2,187,189,207,10,0,0,0,4,0,1,2,18,20
p_262,0,5,e_1,157,187,208,16,2,2,10,4,0,1,30,21,51
p_261,0,5,e_1,164,187,208,13,2,2,7,4,0,1,23,21,44
p_266,0,6,e_1,151,187,213,18,2,2,11,2,1,0,36,26,62
p_263,0,7,e_1,154,187,218,17,2,2,11,4,0,1,33,31,64
p_260,0,7,e_1,165,187,218,13,2,2,7,4,0,1,22,31,53
p_258,0,7,e_1,168,187,218,12,2,2,6,4,0,1,19,31,50
p_256,0,10,e_1,182,187,229,10,0,0,1,4,0,1,5,42,47
p_250,0,2,e_2,217,224,232,2,1,0,2,4,0,1,7,8,15
p_264,0,11,e_1,153,187,234,17,2,2,11,4,0,1,34,47,81
p_253,0,5,e_3,190,223,240,10,0,0,10,3,0,0,33,17,50
p_252,0,5,e_3,205,223,240,6,1,0,6,4,0,1,18,17,35
p_257,0,14,e_1,169,187,245,12,2,2,6,4,0,1,18,58,76
p_259,0,15,e_1,167,187,250,12,2,2,6,4,0,1,20,63,83
p_251,0,15,e_2,209,224,273,4,1,0,4,3,0,0,15,49,64
p_248,0,5,e_3,246,257,274,3,1,0,3,4,0,1,11,17,28
p_247,0,5,e_3,250,257,274,2,1,0,2,4,0,1,7,17,24
p_249,0,6,e_3,239,257,279,5,0,0,5,2,1,0,18,22,40
p_241,0,1,e_3,283,304,311,6,0,0,6,3,0,0,21,7,28
p_236,0,1,e_0,305,307,312,26,4,4,0,4,0,1,2,5,7
p_233,0,1,e_1,311,317,322,25,3,3,2,4,0,1,6,5,11
p_237,0,7,e_0,304,307,332,26,5,5,1,4,0,1,3,25,28
p_230,0,3,e_2,319,320,333,23,3,3,0,3,0,0,1,13,14
p_232,0,5,e_1,314,317,336,24,3,3,1,4,0,1,3,19,22
p_242,0,8,e_0,277,307,337,6,1,1,10,4,0,1,30,30,60
p_240,0,9,e_3,301,304,337,1,1,0,1,4,0,1,3,33,36
p_245,0,7,e_1,269,317,344,8,2,2,15,3,0,0,48,27,75
p_246,0,10,e_0,262,307,345,11,2,2,14,3,0,0,45,38,83
p_239,0,11,e_3,302,304,345,0,1,0,0,4,0,1,2,41,43
p_231,0,7,e_2,317,320,347,23,3,3,1,4,0,1,3,27,30
p_235,0,8,e_1,308,317,349,26,4,4,3,4,0,1,9,32,41
p_234,0,8,e_1,310,317,349,25,3,3,2,4,0,1,7,32,39
p_244,0,12,e_0,271,307,353,8,2,2,12,4,0,1,36,46,82
p_238,0,13,e_3,303,304,353,0,0,0,0,3,0,0,1,49,50
p_243,0,15,e_2,272,320,373,7,2,2,15,2,1,0,48,53,101
p_216,0,1,e_1,347,375,382,15,2,2,8,5,1,1,28,7,35
p_226,0,2,e_1,329,375,387,19,4,4,3,5,3,1,46,12,58
p_223,0,2,e_1,336,375,387,17,3,3,5,5,2,1,39,12,51
p_214,0,3,e_1,349,375,392,14,2,2,8,4,0,1,26,17,43
p_228,0,4,e_1,325,375,397,21,4,4,2,5,3,0,50,22,72
p_190,0,1,e_0,379,391,398,5,1,0,4,4,0,1,12,7,19
p_225,0,5,e_1,330,375,402,19,4,4,3,5,3,1,45,27,72
p_222,0,5,e_1,337,375,402,17,3,3,5,5,2,1,38,27,65
p_219,0,5,e_1,342,375,402,16,3,3,7,5,2,1,33,27,60
p_221,0,6,e_1,339,375,407,17,3,3,6,5,2,1,36,32,68
p_220,0,6,e_1,341,375,407,16,3,3,6,5,2,1,34,32,66
p_186,0,4,e_0,390,391,409,1,1,0,0,3,0,0,1,18,19
p_217,0,7,e_1,346,375,412,15,2,2,7,5,1,1,29,37,66
p_212,0,7,e_1,351,375,412,13,2,2,8,4,0,1,24,37,61
p_224,0,5,e_0,331,391,414,19,4,4,7,2,4,0,60,23,83
p_192,0,8,e_0,375,391,425,6,1,0,5,4,0,1,16,34,50
p_189,0,8,e_0,382,391,425,4,1,0,3,4,0,1,9,34,43
p_218,0,11,e_1,343,375,426,15,3,3,7,2,2,1,32,51,83
p_185,0,10,e_3,391,394,426,1,1,0,1,4,0,1,3,32,35
p_183,0,1,e_2,396,420,427,26,3,3,8,4,0,1,24,7,31
p_182,0,2,e_2,397,420,432,25,3,3,7,4,0,1,23,12,35
p_180,0,2,e_2,399,420,432,25,3,3,7,4,0,1,21,12,33
p_191,0,10,e_0,376,391,433,6,1,0,5,4,0,1,15,42,57
p_184,0,12,e_3,392,394,434,0,1,0,0,4,0,1,2,40,42
p_178,0,3,e_2,401,420,437,24,3,3,6,4,0,1,19,17,36
p_229,0,13,e_3,320,394,439,22,3,3,4,5,3,0,74,45,119
p_215,0,15,e_1,348,375,440,14,2,2,8,2,1,1,27,65,92
p_213,0,15,e_1,350,375,440,14,2,2,8,4,0,1,25,65,90
p_187,0,12,e_0,389,391,441,1,1,0,0,4,0,1,2,50,52
p_176,0,4,e_2,403,420,442,23,3,3,5,4,0,1,17,22,39
p_188,0,13,e_0,384,391,446,3,1,0,2,4,0,1,7,55,62
p_179,0,8,e_2,400,420,456,24,3,3,6,4,0,1,20,36,56
p_177,0,9,e_2,402,420,461,24,3,3,6,4,0,1,18,41,59
p_173,0,11,e_2,407,420,469,22,3,3,4,4,0,1,13,49,62
p_227,0,12,e_2,327,420,474,20,4,4,1,5,3,0,93,54,147
p_171,0,13,e_2,409,420,479,21,3,3,3,4,0,1,11,59,70
p_175,0,14,e_2,405,420,484,23,3,3,5,4,0,1,15,64,79
p_174,0,14,e_2,406,420,484,22,3,3,4,4,0,1,14,64,78
p_170,0,14,e_2,410,420,484,21,3,3,3,4,0,1,10,64,74
p_146,0,1,e_3,453,480,487,9,1,0,9,4,0,1,27,7,34
p_181,0,15,e_2,398,420,489,25,3,3,7,4,0,1,22,69,91
p_172,0,15,e_2,408,420,489,22,3,3,4,4,0,1,12,69,81
p_143,0,3,e_3,456,480,495,8,1,0,8,4,0,1,24,15,39
p_209,0,2,e_1,357,487,497,12,1,0,6,4,0,1,130,10,140
p_205,0,2,e_1,362,487,497,10,1,0,4,4,0,1,125,10,135
p_113,0,1,e_0,489,491,498,29,8,8,0,4,0,1,2,7,9
p_200,0,4,e_1,367,487,505,9,1,0,2,4,0,1,120,18,138
p_114,0,3,e_0,488,491,506,29,8,8,1,4,0,1,3,15,18
p_150,0,6,e_3,443,480,506,12,1,0,12,4,0,1,37,26,63
p_201,0,5,e_1,366,487,510,9,1,0,3,4,0,1,121,23,144
p_154,0,7,e_3,436,480,511,14,2,2,12,5,1,1,44,31,75
p_210,0,6,e_1,354,487,515,13,1,0,7,4,0,1,133,28,161
p_208,0,6,e_1,358,487,515,12,1,0,5,4,0,1,129,28,157
p_153,0,9,e_3,437,480,519,13,2,2,13,5,1,1,43,39,82
p_147,0,9,e_3,452,480,519,9,1,0,9,4,0,1,28,39,67
p_144,0,9,e_3,455,480,519,8,1,0,8,4,0,1,25,39,64
p_142,0,9,e_3,457,480,519,7,1,0,7,4,0,1,23,39,62
p_148,0,8,e_0,449,491,523,10,1,0,13,3,0,0,42,32,74
p_198,0,9,e_1,369,487,526,8,1,0,2,4,0,1,118,39,157
p_162,0,11,e_3,420,480,527,18,3,3,8,5,3,0,60,47,107
p_145,0,11,e_3,454,480,527,8,1,0,8,4,0,1,26,47,73
p_115,0,9,e_0,487,491,528,29,8,8,1,4,0,1,4,37,41
p_197,0,10,e_1,370,487,531,8,1,0,1,4,0,1,117,44,161
p_112,0,11,e_0,490,491,536,28,8,8,0,3,0,0,1,45,46
p_207,0,11,e_1,359,487,536,11,1,0,5,4,0,1,128,49,177
p_155,0,14,e_3,435,480,538,14,2,2,12,5,1,1,45,58,103
p_206,0,12,e_1,361,487,541,11,1,0,4,4,0,1,126,54,180
p_203,0,12,e_1,364,487,541,10,1,0,3,4,0,1,123,54,177
p_167,0,1,e_2,413,536,543,20,3,3,2,4,0,1,123,7,130
p_156,0,15,e_3,434,480,543,14,2,2,12,5,1,1,46,63,109
p_152,0,15,e_3,441,480,543,13,1,0,13,4,0,1,39,63,102
p_151,0,15,e_3,442,480,543,12,1,0,12,4,0,1,38,63,101
p_149,0,15,e_3,444,480,543,12,1,0,12,4,0,1,36,63,99
p_204,0,14,e_1,363,487,549,10,1,0,4,4,0,1,124,62,186
p_106,0,3,e_2,500,536,551,26,7,7,12,4,0,1,36,15,51
p_211,0,15,e_1,353,487,554,13,1,0,7,4,0,1,134,67,201
p_202,0,15,e_1,365,487,554,9,1,0,3,4,0,1,122,67,189
p_199,0,15,e_1,368,487,554,8,1,0,2,4,0,1,119,67,186
p_165,0,4,e_2,417,536,556,19,3,3,1,4,0,1,119,20,139
p_108,0,6,e_2,496,536,564,27,7,7,13,4,0,1,40,28,68
p_111,0,8,e_2,491,536,572,28,8,8,15,4,0,1,45,36,81
p_169,0,9,e_2,411,536,577,21,3,3,3,4,0,1,125,41,166
p_163,0,10,e_2,419,536,582,18,3,3,0,3,0,0,117,46,163
p_86,0,2,e_0,544,574,584,15,1,0,10,4,0,1,30,10,40
p_164,0,11,e_2,418,536,587,18,3,3,0,4,0,1,118,51,169
p_110,0,11,e_2,492,536,587,28,8,8,14,4,0,1,44,51,95
p_107,0,11,e_2,499,536,587,26,7,7,12,4,0,1,37,51,88
p_77,0,3,e_0,557,574,589,11,1,0,5,4,0,1,17,15,32
p_166,0,12,e_2,416,536,592,19,3,3,1,4,0,1,120,56,176
p_105,0,12,e_2,502,536,592,25,7,7,11,4,0,1,34,56,90
p_88,0,5,e_0,538,574,597,16,2,2,11,3,0,0,36,23,59
p_75,0,5,e_0,559,574,597,10,1,0,5,4,0,1,15,23,38
p_168,0,13,e_2,412,536,597,20,3,3,2,4,0,1,124,61,185
p_130,0,1,e_3,472,590,597,2,1,0,2,4,0,1,118,7,125
p_76,0,6,e_0,558,574,602,10,1,0,5,4,0,1,16,28,44
p_104,0,14,e_2,503,536,602,25,7,7,11,4,0,1,33,66,99
p_136,0,3,e_3,465,590,605,5,1,0,5,4,0,1,125,15,140
p_129,0,3,e_3,473,590,605,2,1,0,2,4,0,1,117,15,132
p_80,0,7,e_0,552,574,607,12,1,0,7,4,0,1,22,33,55
p_74,0,7,e_0,560,574,607,10,1,0,4,4,0,1,14,33,47
p_109,0,15,e_2,493,536,607,27,8,8,14,4,0,1,43,71,114
p_161,0,1,e_1,421,601,608,17,4,4,10,5,2,1,180,7,187
p_158,0,1,e_1,430,601,608,15,3,3,12,5,1,1,171,7,178
p_119,0,1,e_1,483,601,608,30,8,8,1,4,0,1,118,7,125
p_137,0,4,e_3,464,590,610,5,1,0,5,4,0,1,126,20,146
p_87,0,8,e_0,539,574,612,16,2,2,11,4,0,1,35,38,73
p_83,0,8,e_0,549,574,612,13,1,0,8,4,0,1,25,38,63
p_141,0,6,e_3,458,590,618,7,1,0,7,4,0,1,132,28,160
p_196,0,4,e_1,371,601,619,7,1,0,1,4,0,1,230,18,248
p_84,0,12,e_0,546,574,626,14,1,0,9,4,0,1,28,52,80
p_78,0,12,e_0,556,574,626,11,1,0,6,4,0,1,18,52,70
p_140,0,8,e_3,459,590,626,7,1,0,7,4,0,1,131,36,167
p_194,0,6,e_1,373,601,627,7,1,0,0,4,0,1,228,26,254
p_159,0,6,e_1,429,601,627,15,3,3,12,5,1,1,172,26,198
p_118,0,7,e_1,484,601,632,30,8,8,1,4,0,1,117,31,148
p_82,0,14,e_0,550,574,634,13,1,0,8,4,0,1,24,60,84
p_81,0,14,e_0,551,574,634,13,1,0,7,4,0,1,23,60,83
p_79,0,14,e_0,553,574,634,12,1,0,7,4,0,1,21,60,81
p_139,0,10,e_3,461,590,634,6,1,0,6,4,0,1,129,44,173
p_135,0,10,e_3,466,590,634,4,1,0,4,4,0,1,124,44,168
p_127,0,10,e_3,475,590,634,1,1,0,1,4,0,1,115,44,159
p_85,0,15,e_0,545,574,639,15,1,0,9,4,0,1,29,65,94
p_138,0,11,e_3,463,590,639,5,1,0,5,4,0,1,127,49,176
p_132,0,11,e_3,470,590,639,3,1,0,3,4,0,1,120,49,169
p_128,0,11,e_3,474,590,639,2,1,0,2,4,0,1,116,49,165
p_117,0,10,e_1,485,601,643,29,9,9,0,4,0,1,116,42,158
p_133,0,12,e_3,469,590,644,3,1,0,3,4,0,1,121,54,175
p_193,0,11,e_1,374,601,648,6,1,0,0,3,0,0,227,47,274
p_121,0,11,e_1,481,601,648,30,8,8,2,4,0,1,120,47,167
p_120,0,11,e_1,482,601,648,30,8,8,1,4,0,1,119,47,166
p_131,0,14,e_3,471,590,652,3,1,0,3,4,0,1,119,62,181
p_134,0,15,e_3,467,590,657,4,1,0,4,4,0,1,123,67,190
p_157,0,14,e_1,431,601,659,15,3,3,12,5,1,1,170,58,228
p_96,0,1,e_2,517,654,659,21,5,5,6,4,0,1,137,5,142
p_195,0,15,e_1,372,601,664,7,1,0,1,4,0,1,229,63,292
p_160,0,15,e_1,426,601,664,16,3,3,11,5,1,1,175,63,238
p_122,0,15,e_1,480,601,664,30,9,9,2,4,0,1,121,63,184
p_92,0,4,e_2,525,654,670,19,4,4,3,4,0,1,129,16,145
p_99,0,6,e_2,514,654,678,22,5,5,7,4,0,1,140,24,164
p_94,0,6,e_2,519,654,678,21,4,4,5,4,0,1,135,24,159
p_102,0,7,e_2,509,654,683,23,6,6,9,4,0,1,145,29,174
p_98,0,7,e_2,515,654,683,22,5,5,7,4,0,1,139,29,168
p_97,0,7,e_2,516,654,683,22,5,5,6,4,0,1,138,29,167
p_101,0,8,e_2,511,654,688,23,5,5,8,4,0,1,143,34,177
p_65,0,1,e_0,573,686,691,5,1,0,0,3,0,0,113,5,118
p_100,0,9,e_2,513,654,693,23,5,5,7,4,0,1,141,39,180
p_89,0,9,e_2,535,654,693,17,3,3,0,3,0,0,119,39,158
p_72,0,3,e_0,562,686,699,9,1,0,4,4,0,1,124,13,137
p_71,0,3,e_0,564,686,699,8,1,0,3,4,0,1,122,13,135
p_70,0,3,e_0,565,686,699,8,1,0,3,4,0,1,121,13,134
p_67,0,3,e_0,568,686,699,7,1,0,2,4,0,1,118,13,131
p_66,0,3,e_0,569,686,699,7,1,0,1,4,0,1,117,13,130
p_30,0,3,e_0,668,686,699,12,1,0,6,4,0,1,18,13,31
p_103,0,11,e_2,508,654,701,24,6,6,9,4,0,1,146,47,193
p_91,0,12,e_2,526,654,706,19,3,3,3,4,0,1,128,52,180
p_29,0,5,e_0,670,686,707,11,1,0,5,4,0,1,16,21,37
p_93,0,13,e_2,520,654,711,21,4,4,5,4,0,1,134,57,191
p_90,0,13,e_2,527,654,711,19,3,3,3,4,0,1,127,57,184
p_31,0,6,e_0,666,686,712,12,1,0,6,4,0,1,20,26,46
p_55,0,3,e_3,585,704,715,1,1,0,1,4,0,1,119,11,130
p_54,0,3,e_3,586,704,715,1,1,0,1,4,0,1,118,11,129
p_95,0,14,e_2,518,654,716,21,4,4,6,4,0,1,136,62,198
p_45,0,2,e_1,595,711,719,29,11,11,2,4,0,1,116,8,124
p_26,0,8,e_0,684,686,720,6,1,0,0,4,0,1,2,34,36
p_64,0,4,e_3,574,704,720,5,1,0,5,4,0,1,130,16,146
p_48,0,4,e_1,592,711,727,30,10,10,3,4,0,1,119,16,135
p_46,0,4,e_1,594,711,727,30,10,10,2,4,0,1,117,16,133
p_27,0,10,e_0,677,686,728,9,1,0,3,4,0,1,9,42,51
p_61,0,6,e_3,579,704,728,3,1,0,3,4,0,1,125,24,149
p_56,0,6,e_3,584,704,728,2,1,0,2,4,0,1,120,24,144
p_73,0,11,e_0,561,686,733,9,1,0,4,4,0,1,125,47,172
p_28,0,11,e_0,676,686,733,9,1,0,3,4,0,1,10,47,57
p_124,0,7,e_3,478,704,733,0,1,0,0,4,0,1,226,29,255
p_42,0,6,e_1,598,711,735,29,10,10,1,4,0,1,113,24,137
p_50,0,7,e_1,590,711,740,30,11,11,3,4,0,1,121,29,150
p_43,0,7,e_1,597,711,740,29,10,10,1,4,0,1,114,29,143
p_68,0,13,e_0,567,686,741,7,1,0,2,4,0,1,119,55,174
p_60,0,10,e_3,580,704,744,3,1,0,3,4,0,1,124,40,164
p_44,0,8,e_1,596,711,745,29,10,10,1,4,0,1,115,34,149
p_69,0,14,e_0,566,686,746,8,1,0,2,4,0,1,120,60,180
p_123,0,11,e_3,479,704,749,0,0,0,0,3,0,0,225,45,270
p_58,0,11,e_3,582,704,749,2,1,0,2,4,0,1,122,45,167
p_57,0,11,e_3,583,704,749,2,1,0,2,4,0,1,121,45,166
p_47,0,9,e_1,593,711,750,30,10,10,2,4,0,1,118,39,157
p_126,0,12,e_3,476,704,754,1,1,0,1,4,0,1,228,50,278
p_116,0,10,e_1,486,711,755,29,8,8,0,3,0,0,225,44,269
p_63,0,13,e_3,577,704,759,4,1,0,4,4,0,1,127,55,182
p_62,0,13,e_3,578,704,759,4,1,0,4,4,0,1,126,55,181
p_41,0,11,e_1,600,711,760,28,10,10,0,3,0,0,111,49,160
p_125,0,14,e_3,477,704,764,1,1,0,1,4,0,1,227,60,287
p_59,0,14,e_3,581,704,764,3,1,0,3,4,0,1,123,60,183
p_49,0,14,e_1,591,711,771,30,10,10,3,4,0,1,120,60,180
p_22,0,3,e_2,719,760,771,4,8,8,13,4,0,1,41,11,52
p_21,0,4,e_2,731,760,776,21,7,7,9,4,0,1,29,16,45
p_32,0,6,e_2,650,760,784,16,3,3,1,4,0,1,110,24,134
p_37,0,9,e_2,615,760,795,25,8,8,13,4,0,1,145,35,180
p_35,0,9,e_2,630,760,795,21,6,6,8,4,0,1,130,35,165
p_19,0,11,e_2,754,760,803,16,3,3,2,4,0,1,6,43,49
p_39,0,12,e_2,607,760,808,27,9,9,15,4,0,1,153,48,201
p_34,0,12,e_2,646,760,808,18,3,3,2,4,0,1,114,48,162
p_23,0,12,e_2,711,760,808,26,10,10,13,5,1,1,49,48,97
p_40,0,13,e_2,602,760,813,28,10,10,14,5,1,1,158,53,211
p_38,0,13,e_2,608,760,813,26,9,9,15,4,0,1,152,53,205
p_36,0,13,e_2,628,760,813,22,6,6,8,4,0,1,132,53,185
p_20,0,14,e_2,734,760,818,21,6,6,8,4,0,1,26,58,84
p_24,0,2,e_3,695,808,818,3,1,0,3,4,0,1,113,10,123
p_16,0,2,e_3,780,808,818,9,1,0,9,4,0,1,28,10,38
p_33,0,15,e_2,649,760,823,17,3,3,1,4,0,1,111,63,174
p_52,0,3,e_3,588,808,823,0,1,0,0,4,0,1,220,15,235
p_14,0,4,e_3,794,808,828,4,1,0,4,4,0,1,14,20,34
p_25,0,8,e_3,686,808,842,6,1,0,6,4,0,1,122,34,156
p_18,0,10,e_0,766,811,843,14,1,0,14,3,0,0,45,32,77
p_53,0,9,e_3,587,808,847,1,1,0,1,4,0,1,221,39,260
p_51,0,9,e_3,589,808,847,0,0,0,0,3,0,0,219,39,258
p_15,0,9,e_3,793,808,847,5,1,0,5,4,0,1,15,39,54
p_11,0,9,e_3,807,808,847,0,0,0,0,3,0,0,1,39,40
p_17,0,10,e_1,776,821,853,10,1,0,14,3,0,0,45,32,77
p_13,0,11,e_3,796,808,855,4,1,0,4,4,0,1,12,47,59
p_12,0,11,e_3,798,808,855,3,1,0,3,4,0,1,10,47,57
p_9,0,2,e_0,846,879,887,13,1,1,10,3,0,0,33,8,41
p_6,0,3,e_0,877,879,892,11,0,0,0,4,0,1,2,13,15
p_7,0,5,e_0,875,879,900,11,0,0,1,4,0,1,4,21,25
p_10,0,8,e_2,835,883,909,16,3,3,15,3,0,0,48,26,74
p_8,0,11,e_0,874,879,920,11,0,0,1,4,0,1,5,41,46
p_4,0,1,e_3,886,922,927,11,0,0,11,3,0,0,36,5,41
p_1,0,5,e_1,894,916,933,9,1,0,7,4,0,1,22,17,39
p_5,0,8,e_1,883,916,944,11,0,0,10,3,0,0,33,28,61
p_3,0,8,e_1,888,916,944,11,1,0,9,4,0,1,28,28,56
p_2,0,11,e_1,892,916,955,10,1,0,8,4,0,1,24,39,63
p_300,0,4,e_0,8,9,25,0,0,0,0,3,0,0,1,16,17
p_299,0,5,e_1,9,10,29,0,0,0,0,3,0,0,1,19,20
p_297,0,6,e_3,15,16,38,0,0,0,0,3,0,0,1,22,23
p_298,0,9,e_2,11,12,43,0,0,0,0,3,0,0,1,31,32
p_296,0,4,e_0,28,43,57,9,1,1,4,3,0,0,15,14,29
p_286,0,3,e_1,46,47,60,6,0,0,0,3,0,0,1,13,14
p_292,0,6,e_0,38,43,65,6,0,0,1,4,0,1,5,22,27
p_290,0,6,e_0,40,43,65,6,0,0,1,4,0,1,3,22,25
p_289,0,4,e_1,43,47,65,6,0,0,1,4,0,1,4,18,22
p_295,0,5,e_1,29,47,70,9,1,1,5,3,0,0,18,23,41
p_287,0,5,e_1,45,47,70,6,0,0,0,4,0,1,2,23,25
p_288,0,8,e_1,44,47,81,6,0,0,1,4,0,1,3,34,37
p_281,0,1,e_3,73,74,81,0,0,0,0,3,0,0,1,7,8
p_291,0,11,e_0,39,43,82,6,0,0,1,4,0,1,4,39,43
p_294,0,12,e_0,31,43,87,8,1,1,4,4,0,1,12,44,56
p_293,0,12,e_0,33,43,87,7,1,1,3,4,0,1,10,44,54
p_278,0,2,e_2,77,84,92,18,4,4,2,4,0,1,7,8,15
p_285,0,4,e_3,53,74,92,6,0,0,6,3,0,0,21,18,39
p_284,0,4,e_2,54,84,100,6,1,0,9,3,0,0,30,16,46
p_282,0,7,e_3,66,74,103,2,1,0,2,4,0,1,8,29,37
p_279,0,5,e_2,76,84,105,18,4,4,2,4,0,1,8,21,29
p_277,0,6,e_2,82,84,110,17,3,3,0,4,0,1,2,26,28
p_283,0,9,e_3,57,74,111,5,1,0,5,4,0,1,17,37,54
p_273,0,4,e_1,110,111,127,9,0,0,0,3,0,0,1,16,17
p_280,0,14,e_2,75,84,136,18,4,4,3,4,0,1,9,52,61
p_274,0,8,e_1,88,111,141,15,3,3,7,4,0,1,23,30,53
p_271,0,1,e_3,121,143,148,7,1,0,7,4,0,1,22,5,27
p_276,0,11,e_1,84,111,152,16,3,3,8,3,0,0,27,41,68
p_275,0,14,e_1,86,111,163,16,3,3,8,4,0,1,25,52,77
p_270,0,9,e_3,122,143,174,7,1,0,7,4,0,1,21,31,52
p_269,0,9,e_3,127,143,174,5,1,0,5,4,0,1,16,31,47
p_272,0,10,e_3,113,143,179,9,0,0,9,3,0,0,30,36,66
p_268,0,2,e_0,144,183,193,20,3,3,12,3,0,0,39,10,49
p_267,0,1,e_2,148,193,198,19,2,2,14,3,0,0,45,5,50
p_265,0,4,e_0,152,183,201,18,2,2,10,4,0,1,31,18,49
p_262,0,5,e_0,157,183,206,16,2,2,8,4,0,1,26,23,49
p_261,0,5,e_0,164,183,206,14,2,2,6,4,0,1,19,23,42
p_255,0,3,e_2,184,193,206,10,0,0,3,4,0,1,9,13,22
p_266,0,6,e_0,151,183,211,18,2,2,10,4,0,1,32,28,60
p_254,0,4,e_2,187,193,211,10,0,0,2,4,0,1,6,18,24
p_263,0,7,e_0,154,183,216,17,2,2,9,4,0,1,29,33,62
p_260,0,7,e_0,165,183,216,14,2,2,6,4,0,1,18,33,51
p_258,0,7,e_0,168,183,216,13,2,2,5,4,0,1,15,33,48
p_253,0,5,e_2,190,193,216,10,0,0,1,4,0,1,3,23,26
p_256,0,10,e_0,182,183,227,10,0,0,0,3,0,0,1,44,45
p_264,0,11,e_0,153,183,232,18,2,2,10,4,0,1,30,49,79
p_257,0,14,e_0,169,183,243,12,2,2,4,4,0,1,14,60,74
p_250,0,2,e_2,217,235,243,7,1,0,5,3,0,0,18,8,26
p_259,0,15,e_0,167,183,248,13,2,2,5,4,0,1,16,65,81
p_252,0,5,e_3,205,238,255,10,0,0,10,3,0,0,33,17,50
p_248,0,5,e_2,246,251,270,28,2,2,1,4,0,1,5,19,24
p_247,0,5,e_2,250,251,270,26,2,2,0,3,0,0,1,19,20
p_249,0,6,e_2,239,251,275,30,2,2,1,5,1,0,12,24,36
p_251,0,15,e_3,209,238,287,9,1,0,9,4,0,1,29,49,78
p_241,0,1,e_2,283,295,300,16,1,1,4,4,0,1,12,5,17
p_236,0,1,e_1,305,307,312,15,0,0,0,4,0,1,2,5,7
p_245,0,7,e_2,269,295,320,21,1,1,5,2,2,0,26,25,51
p_233,0,1,e_0,311,319,324,15,0,0,2,4,0,1,8,5,13
p_242,0,8,e_2,277,295,325,18,1,1,6,4,0,1,18,30,48
p_237,0,7,e_1,304,307,332,15,0,0,1,4,0,1,3,25,28
p_232,0,5,e_0,314,319,338,15,0,0,1,4,0,1,5,19,24
p_240,0,9,e_1,301,307,340,15,0,0,2,4,0,1,6,33,39
p_246,0,10,e_1,262,307,345,23,1,1,14,3,0,0,45,38,83
p_231,0,7,e_0,317,319,346,15,0,0,0,4,0,1,2,27,29
p_239,0,11,e_1,302,307,350,15,0,0,1,4,0,1,5,43,48
p_235,0,8,e_0,308,319,351,15,0,0,3,4,0,1,11,32,43
p_234,0,8,e_0,310,319,351,15,0,0,3,4,0,1,9,32,41
p_238,0,13,e_1,303,307,358,15,0,0,1,4,0,1,4,51,55
p_216,0,1,e_2,347,351,358,6,1,0,1,4,0,1,4,7,11
p_226,0,2,e_2,329,351,363,12,1,0,7,4,0,1,22,12,34
p_223,0,2,e_2,336,351,363,10,1,0,5,4,0,1,15,12,27
p_244,0,12,e_0,271,319,365,20,1,1,15,3,0,0,48,46,94
p_243,0,15,e_1,272,307,366,20,1,1,11,4,0,1,35,59,94
p_228,0,4,e_2,325,351,371,14,1,0,8,4,0,1,26,20,46
p_225,0,5,e_2,330,351,376,12,1,0,7,4,0,1,21,25,46
p_224,0,5,e_2,331,351,376,12,1,0,6,4,0,1,20,25,45
p_222,0,5,e_2,337,351,376,10,1,0,4,4,0,1,14,25,39
p_219,0,5,e_2,342,351,376,8,1,0,3,4,0,1,9,25,34
p_209,0,2,e_3,357,367,377,3,1,0,3,4,0,1,10,10,20
p_205,0,2,e_3,362,367,377,1,1,0,1,4,0,1,5,10,15
p_221,0,6,e_2,339,351,381,9,1,0,4,4,0,1,12,30,42
p_220,0,6,e_2,341,351,381,8,1,0,3,4,0,1,10,30,40
p_230,0,3,e_3,319,367,382,15,0,0,15,3,0,0,48,15,63
p_217,0,7,e_2,346,351,386,7,1,0,1,4,0,1,5,35,40
p_201,0,5,e_3,366,367,390,0,0,0,0,3,0,0,1,23,24
p_210,0,6,e_3,354,367,395,4,1,0,4,4,0,1,13,28,41
p_208,0,6,e_3,358,367,395,3,1,0,3,4,0,1,9,28,37
p_218,0,11,e_2,343,351,400,8,1,0,2,4,0,1,8,49,57
p_212,0,7,e_3,351,367,400,5,1,0,5,4,0,1,16,33,49
p_227,0,12,e_2,327,351,405,13,1,0,8,4,0,1,24,54,78
p_229,0,13,e_2,320,351,410,15,1,0,7,5,1,0,31,59,90
p_190,0,1,e_0,379,406,413,28,8,8,9,4,0,1,27,7,34
p_207,0,11,e_3,359,367,414,2,1,0,2,4,0,1,8,47,55
p_215,0,15,e_2,348,351,418,6,1,0,1,4,0,1,3,67,70
p_206,0,12,e_3,361,367,419,2,1,0,2,4,0,1,6,52,58
p_203,0,12,e_3,364,367,419,1,1,0,1,4,0,1,3,52,55
p_167,0,1,e_1,413,416,421,19,3,3,1,4,0,1,3,5,8
p_200,0,4,e_0,367,406,424,30,10,10,12,3,0,0,39,18,57
p_196,0,4,e_0,371,406,424,30,9,9,11,4,0,1,35,18,53
p_186,0,4,e_0,390,406,424,25,6,6,5,4,0,1,16,18,34
p_204,0,14,e_3,363,367,427,1,1,0,1,4,0,1,4,60,64
p_194,0,6,e_0,373,406,432,29,9,9,11,4,0,1,33,26,59
p_211,0,15,e_3,353,367,432,4,1,0,4,4,0,1,14,65,79
p_202,0,15,e_3,365,367,432,0,1,0,0,4,0,1,2,65,67
p_192,0,8,e_0,375,406,440,28,9,9,10,4,0,1,31,34,65
p_189,0,8,e_0,382,406,440,27,7,7,8,4,0,1,24,34,58
p_198,0,9,e_0,369,406,445,30,9,9,12,4,0,1,37,39,76
p_169,0,9,e_1,411,416,447,20,4,4,1,4,0,1,5,31,36
p_197,0,10,e_0,370,406,450,30,9,9,12,4,0,1,36,44,80
p_191,0,10,e_0,376,406,450,28,8,8,10,4,0,1,30,44,74
p_185,0,10,e_0,391,406,450,25,6,6,5,4,0,1,15,44,59
p_193,0,11,e_0,374,406,455,29,9,9,10,4,0,1,32,49,81
p_173,0,11,e_1,407,416,455,21,4,4,3,4,0,1,9,39,48
p_187,0,12,e_0,389,406,460,25,6,6,5,4,0,1,17,54,71
p_171,0,13,e_1,409,416,463,20,4,4,2,4,0,1,7,47,54
p_168,0,13,e_1,412,416,463,19,4,4,1,4,0,1,4,47,51
p_188,0,13,e_0,384,406,465,27,7,7,7,4,0,1,22,59,81
p_174,0,14,e_1,406,416,468,21,4,4,3,4,0,1,10,52,62
p_170,0,14,e_1,410,416,468,20,4,4,2,4,0,1,6,52,58
p_161,0,1,e_2,421,465,472,18,2,2,14,4,0,1,44,7,51
p_158,0,1,e_2,430,465,472,15,1,1,11,4,0,1,35,7,42
p_195,0,15,e_0,372,406,473,29,9,9,11,4,0,1,34,67,101
p_199,0,15,e_1,368,416,473,30,9,9,15,3,0,0,48,57,105
p_172,0,15,e_1,408,416,473,21,4,4,2,4,0,1,8,57,65
p_214,0,3,e_2,349,465,480,6,1,0,0,4,0,1,116,15,131
p_165,0,4,e_2,417,465,485,18,3,3,15,2,1,1,48,20,68
p_159,0,6,e_2,429,465,493,16,1,1,12,4,0,1,36,28,64
p_154,0,7,e_2,436,465,498,15,0,0,9,4,0,1,29,33,62
p_163,0,10,e_2,419,465,509,18,2,2,15,4,0,1,46,44,90
p_164,0,11,e_2,418,465,514,18,2,2,15,4,0,1,47,49,96
p_162,0,11,e_2,420,465,514,18,2,2,15,4,0,1,45,49,94
p_166,0,12,e_2,416,465,519,19,3,3,15,5,1,1,49,54,103
p_136,0,3,e_3,465,513,524,15,0,0,15,3,0,0,48,11,59
p_129,0,3,e_3,473,513,524,13,1,0,13,4,0,1,40,11,51
p_183,0,1,e_0,396,520,527,24,5,5,3,4,0,1,124,7,131
p_96,0,1,e_0,517,520,527,29,8,8,1,4,0,1,3,7,10
p_130,0,1,e_1,472,520,527,13,1,0,15,2,1,0,48,7,55
p_157,0,14,e_2,431,465,527,15,0,0,11,4,0,1,34,62,96
p_155,0,14,e_2,435,465,527,15,0,0,10,4,0,1,30,62,92
p_182,0,2,e_0,397,520,532,24,5,5,3,4,0,1,123,12,135
p_180,0,2,e_0,399,520,532,23,4,4,2,4,0,1,121,12,133
p_213,0,15,e_2,350,465,532,5,1,0,0,3,0,0,115,67,182
p_160,0,15,e_2,426,465,532,16,1,1,13,4,0,1,39,67,106
p_156,0,15,e_2,434,465,532,15,0,0,10,4,0,1,31,67,98
p_178,0,3,e_0,401,520,537,23,4,4,1,4,0,1,119,17,136
p_124,0,7,e_3,478,513,538,11,1,0,11,4,0,1,35,25,60
p_176,0,4,e_0,403,520,542,22,4,4,1,4,0,1,117,22,139
p_135,0,10,e_3,466,513,549,15,1,0,15,4,0,1,47,36,83
p_127,0,10,e_3,475,513,549,12,1,0,12,4,0,1,38,36,74
p_99,0,6,e_0,514,520,550,30,7,7,2,4,0,1,6,30,36
p_132,0,11,e_3,470,513,554,14,1,0,14,4,0,1,43,41,84
p_128,0,11,e_3,474,513,554,13,1,0,13,4,0,1,39,41,80
p_123,0,11,e_3,479,513,554,11,1,0,11,4,0,1,34,41,75
p_121,0,11,e_3,481,513,554,10,1,0,10,4,0,1,32,41,73
p_98,0,7,e_0,515,520,555,30,7,7,1,4,0,1,5,35,40
p_97,0,7,e_0,516,520,555,29,8,8,1,4,0,1,4,35,39
p_133,0,12,e_3,469,513,559,14,1,0,14,4,0,1,44,46,90
p_126,0,12,e_3,476,513,559,12,1,0,12,4,0,1,37,46,83
p_179,0,8,e_0,400,520,560,23,4,4,2,4,0,1,120,40,160
p_177,0,9,e_0,402,520,565,23,4,4,1,4,0,1,118,45,163
p_100,0,9,e_0,513,520,565,30,7,7,2,4,0,1,7,45,52
p_93,0,13,e_1,520,522,565,28,8,8,0,5,1,0,2,43,45
p_131,0,14,e_3,471,513,567,14,1,0,14,4,0,1,42,54,96
p_125,0,14,e_3,477,513,567,12,1,0,12,4,0,1,36,54,90
p_134,0,15,e_3,467,513,572,15,1,0,15,4,0,1,46,59,105
p_122,0,15,e_3,480,513,572,11,1,0,11,4,0,1,33,59,92
p_184,0,12,e_0,392,520,576,25,6,6,4,4,0,1,128,56,184
p_175,0,14,e_0,405,520,584,22,4,4,0,3,0,0,115,64,179
p_146,0,1,e_2,453,579,586,15,0,0,4,4,0,1,126,7,133
p_181,0,15,e_0,398,520,589,23,5,5,2,4,0,1,122,69,191
p_143,0,3,e_2,456,579,594,15,0,0,3,4,0,1,123,15,138
p_150,0,6,e_2,443,579,605,15,0,0,7,4,0,1,136,26,162
p_141,0,6,e_2,458,579,605,15,0,0,2,4,0,1,121,26,147
p_148,0,8,e_2,449,579,613,15,0,0,5,4,0,1,130,34,164
p_140,0,8,e_2,459,579,613,15,0,0,2,4,0,1,120,34,154
p_153,0,9,e_2,437,579,618,15,0,0,9,4,0,1,142,39,181
p_147,0,9,e_2,452,579,618,15,0,0,4,4,0,1,127,39,166
p_144,0,9,e_2,455,579,618,15,0,0,3,4,0,1,124,39,163
p_142,0,9,e_2,457,579,618,15,0,0,2,4,0,1,122,39,161
p_139,0,10,e_2,461,579,623,15,0,0,1,4,0,1,118,44,162
p_119,0,1,e_3,483,619,624,10,1,0,10,4,0,1,136,5,141
p_113,0,1,e_3,489,619,624,8,1,0,8,4,0,1,130,5,135
p_145,0,11,e_2,454,579,628,15,0,0,3,4,0,1,125,49,174
p_45,0,2,e_1,595,621,629,8,1,0,8,4,0,1,26,8,34
p_114,0,3,e_3,488,619,632,8,1,0,8,4,0,1,131,13,144
p_106,0,3,e_3,500,619,632,4,1,0,4,4,0,1,119,13,132
p_54,0,3,e_1,586,621,634,11,1,0,11,4,0,1,35,13,48
p_48,0,4,e_1,592,621,639,9,1,0,9,4,0,1,29,18,47
p_152,0,15,e_2,441,579,642,15,0,0,8,4,0,1,138,63,201
p_151,0,15,e_2,442,579,642,15,0,0,7,4,0,1,137,63,200
p_149,0,15,e_2,444,579,642,15,0,0,7,4,0,1,135,63,198
p_108,0,6,e_3,496,619,643,5,1,0,5,4,0,1,123,24,147
p_61,0,6,e_1,579,621,647,13,1,0,13,3,0,0,42,26,68
p_42,0,6,e_1,598,621,647,7,1,0,7,4,0,1,23,26,49
p_118,0,7,e_3,484,619,648,9,1,0,9,4,0,1,135,29,164
p_111,0,8,e_3,491,619,653,7,1,0,7,4,0,1,128,34,162
p_94,0,6,e_0,519,636,656,28,8,8,0,3,0,0,117,20,137
p_51,0,9,e_1,589,621,658,10,1,0,10,4,0,1,32,37,69
p_115,0,9,e_3,487,619,658,8,1,0,8,4,0,1,132,39,171
p_60,0,10,e_1,580,621,663,13,1,0,13,4,0,1,41,42,83
p_117,0,10,e_3,485,619,663,9,1,0,9,4,0,1,134,44,178
p_116,0,10,e_3,486,619,663,9,1,0,9,4,0,1,133,44,177
p_35,0,9,e_0,630,636,667,27,9,9,2,4,0,1,6,31,37
p_57,0,11,e_1,583,621,668,12,1,0,12,4,0,1,38,47,85
p_120,0,11,e_3,482,619,668,10,1,0,10,4,0,1,137,49,186
p_112,0,11,e_3,490,619,668,7,1,0,7,4,0,1,129,49,178
p_110,0,11,e_3,492,619,668,7,1,0,7,4,0,1,127,49,176
p_107,0,11,e_3,499,619,668,4,1,0,4,4,0,1,120,49,169
p_39,0,12,e_1,607,621,673,4,1,0,4,4,0,1,14,52,66
p_36,0,13,e_0,628,636,681,28,9,9,2,4,0,1,8,45,53
p_109,0,15,e_3,493,619,682,6,1,0,6,4,0,1,126,63,189
p_95,0,14,e_0,518,636,686,29,8,8,0,4,0,1,118,50,168
p_86,0,2,e_2,544,689,697,21,6,6,11,4,0,1,145,8,153
p_137,0,4,e_2,464,689,705,15,0,0,0,3,0,0,225,16,241
p_92,0,4,e_2,525,689,705,27,7,7,14,5,2,1,164,16,180
p_88,0,5,e_2,538,689,710,23,6,6,13,4,0,1,151,21,172
p_80,0,7,e_2,552,689,718,19,5,5,9,4,0,1,137,29,166
p_87,0,8,e_2,539,689,723,23,6,6,13,4,0,1,150,34,184
p_83,0,8,e_2,549,689,723,20,5,5,10,4,0,1,140,34,174
p_89,0,9,e_2,535,689,728,24,7,7,14,4,0,1,154,39,193
p_138,0,11,e_2,463,689,736,15,0,0,0,4,0,1,226,47,273
p_55,0,3,e_3,585,729,740,11,1,0,11,4,0,1,144,11,155
p_52,0,3,e_3,588,729,740,10,1,0,10,4,0,1,141,11,152
p_91,0,12,e_2,526,689,741,27,7,7,14,2,2,1,163,52,215
p_84,0,12,e_2,546,689,741,21,6,6,11,4,0,1,143,52,195
p_24,0,2,e_1,695,734,742,11,1,0,12,3,0,0,39,8,47
p_46,0,4,e_3,594,729,745,8,1,0,8,4,0,1,135,16,151
p_90,0,13,e_2,527,689,746,26,7,7,14,5,1,1,162,57,219
p_21,0,4,e_1,731,734,750,28,9,9,1,4,0,1,3,16,19
p_82,0,14,e_2,550,689,751,20,5,5,9,4,0,1,139,62,201
p_81,0,14,e_2,551,689,751,20,5,5,9,4,0,1,138,62,200
p_56,0,6,e_3,584,729,753,11,1,0,11,4,0,1,145,24,169
p_85,0,15,e_2,545,689,756,21,6,6,11,4,0,1,144,67,211
p_102,0,7,e_3,509,729,758,1,1,0,1,4,0,1,220,29,249
p_50,0,7,e_3,590,729,758,9,1,0,9,4,0,1,139,29,168
p_101,0,8,e_3,511,729,763,0,1,0,0,4,0,1,218,34,252
p_53,0,9,e_3,587,729,768,10,1,0,10,4,0,1,142,39,181
p_47,0,9,e_3,593,729,768,8,1,0,8,4,0,1,136,39,175
p_103,0,11,e_3,508,729,776,1,1,0,1,4,0,1,221,47,268
p_58,0,11,e_3,582,729,776,12,1,0,12,4,0,1,147,47,194
p_105,0,12,e_3,502,729,781,3,1,0,3,4,0,1,227,52,279
p_104,0,14,e_3,503,729,789,3,1,0,3,4,0,1,226,60,286
p_59,0,14,e_3,581,729,789,12,1,0,12,4,0,1,148,60,208
p_49,0,14,e_3,591,729,789,9,1,0,9,4,0,1,138,60,198
p_18,0,10,e_1,766,769,801,19,5,5,1,4,0,1,3,32,35
p_19,0,11,e_1,754,769,806,22,7,7,4,3,0,0,15,37,52
p_65,0,1,e_2,573,803,808,15,1,0,2,4,0,1,230,5,235
p_17,0,10,e_0,776,779,811,17,3,3,1,4,0,1,3,32,35
p_77,0,3,e_2,557,803,816,18,4,4,7,4,0,1,246,13,259
p_72,0,3,e_2,562,803,816,17,3,3,5,4,0,1,241,13,254
p_71,0,3,e_2,564,803,816,17,3,3,5,4,0,1,239,13,252
p_70,0,3,e_2,565,803,816,16,3,3,4,4,0,1,238,13,251
p_67,0,3,e_2,568,803,816,16,2,2,3,4,0,1,235,13,248
p_66,0,3,e_2,569,803,816,16,2,2,3,4,0,1,234,13,247
p_75,0,5,e_2,559,803,824,18,3,3,6,4,0,1,244,21,265
p_20,0,14,e_0,734,779,825,27,10,10,14,3,0,0,45,46,91
p_76,0,6,e_2,558,803,829,18,3,3,7,4,0,1,245,26,271
p_74,0,7,e_2,560,803,834,18,3,3,6,4,0,1,243,31,274
p_22,0,3,e_3,719,833,844,3,1,0,3,4,0,1,114,11,125
p_73,0,11,e_2,561,803,848,18,3,3,6,4,0,1,242,45,287
p_78,0,12,e_2,556,803,853,19,4,4,7,4,0,1,247,50,297
p_68,0,13,e_2,567,803,858,16,2,2,4,4,0,1,236,55,291
p_43,0,7,e_3,597,833,858,7,1,0,7,4,0,1,236,25,261
p_79,0,14,e_2,553,803,863,19,4,4,8,4,0,1,250,60,310
p_69,0,14,e_2,566,803,863,16,2,2,4,4,0,1,237,60,297
p_44,0,8,e_3,596,833,863,7,1,0,7,4,0,1,237,30,267
p_37,0,9,e_3,615,833,868,1,1,0,1,4,0,1,218,35,253
p_10,0,8,e_1,835,843,869,26,7,7,2,4,0,1,8,26,34
p_11,0,9,e_1,807,843,874,8,1,0,11,3,0,0,36,31,67
p_41,0,11,e_3,600,833,876,6,1,0,6,4,0,1,233,43,276
p_23,0,12,e_3,711,833,881,6,1,0,6,4,0,1,122,48,170
p_40,0,13,e_3,602,833,886,5,1,0,5,4,0,1,231,53,284
p_38,0,13,e_3,608,833,886,3,1,0,3,4,0,1,225,53,278
p_4,0,1,e_0,886,891,896,13,0,0,1,4,0,1,5,5,10
p_9,0,2,e_0,846,891,901,23,6,6,14,3,0,0,45,10,55
p_6,0,3,e_0,877,891,906,15,2,2,4,4,0,1,14,15,29
p_7,0,5,e_0,875,891,914,15,2,2,5,4,0,1,16,23,39
p_16,0,2,e_2,780,907,915,16,2,2,7,4,0,1,127,8,135
p_30,0,3,e_2,668,907,920,19,2,2,7,4,0,1,239,13,252
p_5,0,8,e_0,883,891,925,14,1,1,2,4,0,1,8,34,42
p_3,0,8,e_0,888,891,925,13,0,0,1,4,0,1,3,34,37
p_64,0,4,e_2,574,907,925,15,1,0,1,4,0,1,333,18,351
p_29,0,5,e_2,670,907,930,19,2,2,6,4,0,1,237,23,260
p_32,0,6,e_2,650,907,935,23,6,6,13,4,0,1,257,28,285
p_31,0,6,e_2,666,907,935,19,3,3,7,4,0,1,241,28,269
p_8,0,11,e_0,874,891,936,15,3,3,5,4,0,1,17,45,62
p_26,0,8,e_2,684,907,943,15,1,0,1,4,0,1,223,36,259
p_25,0,8,e_2,686,907,943,14,1,0,1,4,0,1,221,36,257
p_15,0,9,e_2,793,907,948,13,1,0,3,4,0,1,114,41,155
p_27,0,10,e_2,677,907,953,16,2,2,4,4,0,1,230,46,276
p_28,0,11,e_2,676,907,958,17,2,2,4,4,0,1,231,51,282
p_34,0,12,e_2,646,907,963,23,7,7,14,4,0,1,261,56,317
p_63,0,13,e_2,577,907,968,14,1,0,0,4,0,1,330,61,391
p_62,0,13,e_2,578,907,968,13,1,0,0,3,0,0,329,61,390
p_33,0,15,e_2,649,907,976,23,6,6,13,4,0,1,258,69,327
p_14,0,4,e_2,794,1023,1037,13,1,0,3,4,0,1,229,14,243
p_1,0,5,e_2,894,1023,1042,13,0,0,4,4,0,1,129,19,148
p_13,0,11,e_2,796,1023,1062,12,1,0,2,4,0,1,227,39,266
p_12,0,11,e_2,798,1023,1062,11,1,0,1,4,0,1,225,39,264
p_2,0,11,e_2,892,1023,1062,13,0,0,5,4,0,1,131,39,170
p_300,0,4,e_0,8,9,25,0,0,0,0,3,0,0,1,16,17
p_299,0,5,e_1,9,10,29,0,0,0,0,3,0,0,1,19,20
p_297,0,6,e_3,15,16,38,0,0,0,0,3,0,0,1,22,23
p_298,0,9,e_2,11,12,43,0,0,0,0,3,0,0,1,31,32
p_296,0,4,e_0,28,43,57,9,1,1,4,3,0,0,15,14,29
p_295,0,5,e_0,29,43,62,9,1,1,4,4,0,1,14,19,33
p_292,0,6,e_0,38,43,67,6,0,0,1,4,0,1,5,24,29
p_290,0,6,e_0,40,43,67,6,0,0,1,4,0,1,3,24,27
p_286,0,3,e_1,46,61,72,6,0,0,5,4,0,1,15,11,26
p_289,0,4,e_1,43,61,77,6,0,0,5,3,0,0,18,16,34
p_285,0,4,e_1,53,61,77,6,0,0,2,4,0,1,8,16,24
p_284,0,4,e_1,54,61,77,6,0,0,2,4,0,1,7,16,23
p_287,0,5,e_1,45,61,82,6,0,0,5,4,0,1,16,21,37
p_291,0,11,e_0,39,43,84,6,0,0,1,4,0,1,4,41,45
p_294,0,12,e_0,31,43,89,8,1,1,4,4,0,1,12,46,58
p_293,0,12,e_0,33,43,89,7,1,1,3,4,0,1,10,46,56
p_288,0,8,e_1,44,61,93,6,0,0,5,4,0,1,17,32,49
p_281,0,1,e_3,73,87,94,4,1,0,4,4,0,1,14,7,21
p_283,0,9,e_1,57,61,98,6,0,0,1,4,0,1,4,37,41
p_278,0,2,e_3,77,87,99,3,1,0,3,4,0,1,10,12,22
p_279,0,5,e_3,76,87,110,3,1,0,3,4,0,1,11,23,34
p_277,0,6,e_3,82,87,115,1,1,0,1,4,0,1,5,28,33
p_282,0,7,e_3,66,87,120,6,0,0,6,3,0,0,21,33,54
p_273,0,4,e_2,110,118,132,23,4,4,2,4,0,1,8,14,22
p_276,0,11,e_3,84,87,134,1,1,0,1,4,0,1,3,47,50
p_280,0,14,e_3,75,87,145,4,1,0,4,4,0,1,12,58,70
p_275,0,14,e_3,86,87,145,0,0,0,0,3,0,0,1,58,59
p_274,0,8,e_2,88,118,146,28,7,7,9,3,0,0,30,28,58
p_272,0,10,e_2,113,118,154,22,4,4,1,4,0,1,5,36,41
p_271,0,1,e_1,121,151,156,21,2,2,9,3,0,0,30,5,35
p_267,0,1,e_1,148,151,156,14,0,0,1,4,0,1,3,5,8
p_268,0,2,e_1,144,151,161,14,0,0,2,4,0,1,7,10,17
p_270,0,9,e_1,122,151,184,21,2,2,9,4,0,1,29,33,62
p_269,0,9,e_1,127,151,184,19,2,2,8,4,0,1,24,33,57
p_255,0,3,e_2,184,186,197,14,0,0,0,4,0,1,2,11,13
p_265,0,4,e_2,152,186,202,14,0,0,10,5,1,0,34,16,50
p_254,0,4,e_0,187,190,204,14,0,0,1,4,0,1,3,14,17
p_262,0,5,e_2,157,186,207,14,0,0,9,4,0,1,29,21,50
p_261,0,5,e_2,164,186,207,14,0,0,7,4,0,1,22,21,43
p_266,0,6,e_0,151,190,212,14,0,0,12,3,0,0,39,22,61
p_263,0,7,e_2,154,186,215,14,0,0,10,4,0,1,32,29,61
p_260,0,7,e_2,165,186,215,14,0,0,7,4,0,1,21,29,50
p_258,0,7,e_2,168,186,215,14,0,0,6,4,0,1,18,29,47
p_256,0,10,e_2,182,186,226,14,0,0,1,4,0,1,4,40,44
p_250,0,2,e_1,217,220,228,14,0,0,1,4,0,1,3,8,11
p_264,0,11,e_2,153,186,231,14,0,0,10,2,1,1,33,45,78
p_253,0,5,e_1,190,220,239,14,0,0,9,3,0,0,30,19,49
p_252,0,5,e_1,205,220,239,14,0,0,5,4,0,1,15,19,34
p_257,0,14,e_2,169,186,242,14,0,0,5,4,0,1,17,56,73
p_259,0,15,e_2,167,186,247,14,0,0,6,4,0,1,19,61,80
p_251,0,15,e_1,209,220,271,14,0,0,3,4,0,1,11,51,62
p_248,0,5,e_0,246,260,277,14,0,0,4,4,0,1,14,17,31
p_247,0,5,e_0,250,260,277,14,0,0,3,4,0,1,10,17,27
p_249,0,6,e_0,239,260,282,14,0,0,6,3,0,0,21,22,43
p_241,0,1,e_0,283,302,309,8,1,0,6,4,0,1,19,7,26
p_236,0,1,e_3,305,307,312,0,1,0,0,4,0,1,2,5,7
p_245,0,7,e_0,269,302,329,12,1,0,3,5,2,0,33,27,60
p_237,0,7,e_3,304,307,332,1,1,0,1,4,0,1,3,25,28
p_242,0,8,e_0,277,302,334,10,1,0,5,5,1,1,25,32,57
p_240,0,9,e_0,301,302,339,2,1,0,0,3,0,0,1,37,38
p_246,0,10,e_3,262,307,343,14,0,0,14,3,0,0,45,36,81
p_239,0,11,e_3,302,307,348,1,1,0,1,4,0,1,5,41,46
p_244,0,12,e_0,271,302,350,12,1,0,3,5,2,1,31,48,79
p_238,0,13,e_3,303,307,356,1,1,0,1,4,0,1,4,49,53
p_243,0,15,e_0,272,302,361,11,1,0,4,5,2,1,30,59,89
p_233,0,1,e_1,311,356,361,25,4,4,15,4,0,1,45,5,50
p_226,0,2,e_1,329,356,366,20,4,4,9,4,0,1,27,10,37
p_223,0,2,e_1,336,356,366,18,3,3,6,4,0,1,20,10,30
p_209,0,2,e_2,357,358,368,13,0,0,0,3,0,0,1,10,11
p_230,0,3,e_1,319,356,371,23,4,4,12,4,0,1,37,15,52
p_228,0,4,e_1,325,356,376,21,4,4,10,4,0,1,31,20,51
p_232,0,5,e_1,314,356,381,25,4,4,14,4,0,1,42,25,67
p_225,0,5,e_1,330,356,381,19,4,4,8,4,0,1,26,25,51
p_224,0,5,e_1,331,356,381,19,3,3,8,4,0,1,25,25,50
p_222,0,5,e_1,337,356,381,18,3,3,6,4,0,1,19,25,44
p_221,0,6,e_1,339,356,386,17,3,3,5,4,0,1,17,30,47
p_220,0,6,e_1,341,356,386,16,3,3,5,4,0,1,15,30,45
p_234,0,8,e_2,310,358,388,25,5,5,15,3,0,0,48,30,78
p_231,0,7,e_1,317,356,391,24,4,4,13,4,0,1,39,35,74
p_235,0,8,e_1,308,356,396,26,5,5,15,3,0,0,48,40,88
p_227,0,12,e_1,327,356,410,20,4,4,9,4,0,1,29,54,83
p_205,0,2,e_3,362,400,410,12,1,0,12,4,0,1,38,10,48
p_229,0,13,e_1,320,356,415,23,4,4,12,4,0,1,36,59,95
p_200,0,4,e_3,367,400,418,11,1,0,11,4,0,1,33,18,51
p_196,0,4,e_3,371,400,418,9,1,0,9,4,0,1,29,18,47
p_201,0,5,e_3,366,400,423,11,1,0,11,4,0,1,34,23,57
p_208,0,6,e_3,358,400,428,13,0,0,13,3,0,0,42,28,70
p_194,0,6,e_3,373,400,428,9,1,0,9,4,0,1,27,28,55
p_167,0,1,e_2,413,427,434,27,10,10,4,4,0,1,14,7,21
p_198,0,9,e_3,369,400,439,10,1,0,10,4,0,1,31,39,70
p_178,0,3,e_2,401,427,442,30,10,10,8,4,0,1,26,15,41
p_197,0,10,e_3,370,400,444,10,1,0,10,4,0,1,30,44,74
p_176,0,4,e_2,403,427,447,30,10,10,8,4,0,1,24,20,44
p_165,0,4,e_2,417,427,447,4,9,9,3,4,0,1,10,20,30
p_207,0,11,e_3,359,400,449,13,1,0,13,4,0,1,41,49,90
p_206,0,12,e_3,361,400,454,13,1,0,13,4,0,1,39,54,93
p_203,0,12,e_3,364,400,454,12,1,0,12,4,0,1,36,54,90
p_179,0,8,e_2,400,427,461,30,11,11,8,3,0,0,27,34,61
p_204,0,14,e_3,363,400,462,12,1,0,12,4,0,1,37,62,99
p_216,0,1,e_1,347,456,463,15,1,1,3,4,0,1,109,7,116
p_158,0,1,e_1,430,456,463,24,7,7,8,4,0,1,26,7,33
p_177,0,9,e_2,402,427,466,30,10,10,8,4,0,1,25,39,64
p_169,0,9,e_2,411,427,466,28,10,10,5,4,0,1,16,39,55
p_202,0,15,e_3,365,400,467,11,1,0,11,4,0,1,35,67,102
p_199,0,15,e_3,368,400,467,10,1,0,10,4,0,1,32,67,99
p_195,0,15,e_3,372,400,467,9,1,0,9,4,0,1,28,67,95
p_214,0,3,e_1,349,456,471,15,1,1,2,4,0,1,107,15,122
p_173,0,11,e_2,407,427,474,29,11,11,6,4,0,1,20,47,67
p_219,0,5,e_1,342,456,479,16,2,2,4,4,0,1,114,23,137
p_166,0,12,e_2,416,427,479,26,10,10,3,4,0,1,11,52,63
p_210,0,6,e_1,354,456,484,13,1,1,0,4,0,1,102,28,130
p_159,0,6,e_1,429,456,484,24,7,7,9,4,0,1,27,28,55
p_171,0,13,e_2,409,427,484,28,10,10,6,4,0,1,18,57,75
p_168,0,13,e_2,412,427,484,28,10,10,5,4,0,1,15,57,72
p_217,0,7,e_1,346,456,489,15,2,2,3,4,0,1,110,33,143
p_212,0,7,e_1,351,456,489,14,1,1,1,4,0,1,105,33,138
p_175,0,14,e_2,405,427,489,29,11,11,7,4,0,1,22,62,84
p_174,0,14,e_2,406,427,489,29,11,11,7,4,0,1,21,62,83
p_170,0,14,e_2,410,427,489,28,10,10,5,4,0,1,17,62,79
p_172,0,15,e_2,408,427,494,28,11,11,6,4,0,1,19,67,86
p_218,0,11,e_1,343,456,503,16,2,2,4,4,0,1,113,47,160
p_130,0,1,e_0,472,504,511,14,1,0,10,4,0,1,32,7,39
p_157,0,14,e_1,431,456,514,23,7,7,8,4,0,1,25,58,83
p_155,0,14,e_1,435,456,514,22,7,7,7,4,0,1,21,58,79
p_143,0,3,e_0,456,504,519,18,3,3,15,3,0,0,48,15,63
p_136,0,3,e_0,465,504,519,15,2,2,13,4,0,1,39,15,54
p_129,0,3,e_0,473,504,519,13,1,0,10,4,0,1,31,15,46
p_215,0,15,e_1,348,456,519,15,1,1,2,4,0,1,108,63,171
p_213,0,15,e_1,350,456,519,15,1,1,2,4,0,1,106,63,169
p_211,0,15,e_1,353,456,519,14,1,1,1,4,0,1,103,63,166
p_156,0,15,e_1,434,456,519,22,7,7,7,4,0,1,22,63,85
p_190,0,1,e_3,379,514,521,7,1,0,7,4,0,1,135,7,142
p_183,0,1,e_3,396,514,521,1,1,0,1,4,0,1,118,7,125
p_137,0,4,e_0,464,504,524,16,2,2,13,4,0,1,40,20,60
p_182,0,2,e_3,397,514,526,1,1,0,1,4,0,1,117,12,129
p_180,0,2,e_3,399,514,526,0,0,0,0,3,0,0,115,12,127
p_141,0,6,e_0,458,504,532,17,3,3,15,4,0,1,46,28,74
p_186,0,4,e_3,390,514,534,3,1,0,3,4,0,1,124,20,144
p_140,0,8,e_0,459,504,540,17,3,3,15,4,0,1,45,36,81
p_142,0,9,e_0,457,504,545,17,3,3,15,4,0,1,47,41,88
p_161,0,1,e_2,421,541,546,25,9,9,2,4,0,1,120,5,125
p_96,0,1,e_2,517,541,546,30,9,9,8,4,0,1,24,5,29
p_192,0,8,e_3,375,514,548,8,1,0,8,4,0,1,139,34,173
p_189,0,8,e_3,382,514,548,6,1,0,6,4,0,1,132,34,166
p_139,0,10,e_0,461,504,550,16,2,2,14,4,0,1,43,46,89
p_135,0,10,e_0,466,504,550,15,1,1,12,4,0,1,38,46,84
p_138,0,11,e_0,463,504,555,16,2,2,13,4,0,1,41,51,92
p_132,0,11,e_0,470,504,555,14,1,0,11,4,0,1,34,51,85
p_191,0,10,e_3,376,514,556,8,1,0,8,4,0,1,138,42,180
p_185,0,10,e_3,391,514,556,3,1,0,3,4,0,1,123,42,165
p_92,0,4,e_2,525,541,557,28,8,8,5,4,0,1,16,16,32
p_133,0,12,e_0,469,504,560,15,1,0,11,4,0,1,35,56,91
p_193,0,11,e_3,374,514,561,8,1,0,8,4,0,1,140,47,187
p_103,0,11,e_3,508,514,561,2,1,0,2,4,0,1,6,47,53
p_99,0,6,e_2,514,541,565,30,10,10,9,4,0,1,27,24,51
p_94,0,6,e_2,519,541,565,29,10,10,7,4,0,1,22,24,46
p_187,0,12,e_3,389,514,566,3,1,0,3,4,0,1,125,52,177
p_184,0,12,e_3,392,514,566,2,1,0,2,4,0,1,122,52,174
p_131,0,14,e_0,471,504,568,14,1,0,11,4,0,1,33,64,97
p_98,0,7,e_2,515,541,570,30,9,9,8,4,0,1,26,29,55
p_97,0,7,e_2,516,541,570,30,9,9,8,4,0,1,25,29,54
p_188,0,13,e_3,384,514,571,5,1,0,5,4,0,1,130,57,187
p_134,0,15,e_0,467,504,573,15,1,0,12,4,0,1,37,69,106
p_146,0,1,e_1,453,566,573,18,3,3,1,4,0,1,113,7,120
p_86,0,2,e_1,544,566,578,23,7,7,7,4,0,1,22,12,34
p_181,0,15,e_3,398,514,579,0,1,0,0,4,0,1,116,65,181
p_163,0,10,e_2,419,541,581,26,9,9,2,4,0,1,122,40,162
p_164,0,11,e_2,418,541,586,26,9,9,3,4,0,1,123,45,168
p_162,0,11,e_2,420,541,586,26,9,9,2,4,0,1,121,45,166
p_91,0,12,e_2,526,541,591,28,8,8,5,4,0,1,15,50,65
p_150,0,6,e_1,443,566,592,20,5,5,4,4,0,1,123,26,149
p_93,0,13,e_2,520,541,596,29,9,9,7,4,0,1,21,55,76
p_90,0,13,e_2,527,541,596,28,8,8,4,4,0,1,14,55,69
p_154,0,7,e_1,436,566,597,22,7,7,6,4,0,1,130,31,161
p_95,0,14,e_2,518,541,601,30,9,9,7,4,0,1,23,60,83
p_148,0,8,e_1,449,566,602,19,4,4,2,4,0,1,117,36,153
p_83,0,8,e_1,549,566,602,22,6,6,5,4,0,1,17,36,53
p_160,0,15,e_2,426,541,606,24,8,8,0,3,0,0,115,65,180
p_153,0,9,e_1,437,566,607,21,7,7,6,4,0,1,129,41,170
p_147,0,9,e_1,452,566,607,18,4,4,1,4,0,1,114,41,155
p_144,0,9,e_1,455,566,607,18,3,3,0,3,0,0,111,41,152
p_145,0,11,e_1,454,566,615,18,3,3,0,4,0,1,112,49,161
p_84,0,12,e_1,546,566,620,22,7,7,6,4,0,1,20,54,74
p_119,0,1,e_0,483,620,625,10,1,0,7,4,0,1,137,5,142
p_152,0,15,e_1,441,566,631,21,6,6,5,4,0,1,125,65,190
p_151,0,15,e_1,442,566,631,20,6,6,4,4,0,1,124,65,189
p_149,0,15,e_1,444,566,631,20,5,5,4,4,0,1,122,65,187
p_85,0,15,e_1,545,566,631,23,7,7,7,4,0,1,21,65,86
p_114,0,3,e_0,488,620,633,8,1,0,5,4,0,1,132,13,145
p_124,0,7,e_0,478,620,647,12,1,0,8,4,0,1,142,27,169
p_118,0,7,e_0,484,620,647,10,1,0,6,4,0,1,136,27,163
p_102,0,7,e_3,509,626,649,1,1,0,1,4,0,1,117,23,140
p_101,0,8,e_3,511,626,654,1,1,0,1,4,0,1,115,28,143
p_115,0,9,e_0,487,620,655,9,1,0,5,4,0,1,133,35,168
p_100,0,9,e_3,513,626,659,0,0,0,0,3,0,0,113,33,146
p_127,0,10,e_0,475,620,660,13,1,0,9,4,0,1,145,40,185
p_117,0,10,e_0,485,620,660,9,1,0,6,4,0,1,135,40,175
p_116,0,10,e_0,486,620,660,9,1,0,6,4,0,1,134,40,174
p_128,0,11,e_0,474,620,665,13,1,0,10,4,0,1,146,45,191
p_123,0,11,e_0,479,620,665,11,1,0,8,4,0,1,141,45,186
p_121,0,11,e_0,481,620,665,11,1,0,7,4,0,1,139,45,184
p_120,0,11,e_0,482,620,665,10,1,0,7,4,0,1,138,45,183
p_126,0,12,e_0,476,620,670,12,1,0,9,4,0,1,144,50,194
p_88,0,5,e_2,538,653,670,25,7,7,1,4,0,1,115,17,132
p_32,0,6,e_2,650,653,675,11,2,2,1,4,0,1,3,22,25
p_125,0,14,e_0,477,620,678,12,1,0,9,4,0,1,143,58,201
p_122,0,15,e_0,480,620,683,11,1,0,8,4,0,1,140,63,203
p_87,0,8,e_2,539,653,683,25,7,7,0,4,0,1,114,30,144
p_89,0,9,e_2,535,653,688,26,7,7,2,4,0,1,118,35,153
p_35,0,9,e_2,630,653,688,17,3,3,7,4,0,1,23,35,58
p_77,0,3,e_1,557,678,691,20,5,5,3,4,0,1,121,13,134
p_72,0,3,e_1,562,678,691,19,4,4,1,4,0,1,116,13,129
p_71,0,3,e_1,564,678,691,18,4,4,0,4,0,1,114,13,127
p_70,0,3,e_1,565,678,691,18,3,3,0,3,0,0,113,13,126
p_30,0,3,e_1,668,678,691,9,0,0,3,4,0,1,10,13,23
p_75,0,5,e_1,559,678,699,19,5,5,2,4,0,1,119,21,140
p_34,0,12,e_2,646,653,699,12,3,3,2,4,0,1,7,46,53
p_76,0,6,e_1,558,678,704,20,5,5,2,4,0,1,120,26,146
p_31,0,6,e_1,666,678,704,9,0,0,4,4,0,1,12,26,38
p_36,0,13,e_2,628,653,704,18,3,3,8,4,0,1,25,51,76
p_80,0,7,e_1,552,678,709,21,6,6,4,4,0,1,126,31,157
p_74,0,7,e_1,560,678,709,19,4,4,2,4,0,1,118,31,149
p_33,0,15,e_2,649,653,712,11,2,2,1,4,0,1,4,59,63
p_24,0,2,e_3,695,714,722,6,1,0,6,4,0,1,19,8,27
p_73,0,11,e_1,561,678,723,19,4,4,1,4,0,1,117,45,162
p_78,0,12,e_1,556,678,728,20,5,5,3,4,0,1,122,50,172
p_113,0,1,e_0,489,730,735,8,1,0,5,4,0,1,241,5,246
p_65,0,1,e_0,573,730,735,17,2,2,15,4,0,1,157,5,162
p_82,0,14,e_1,550,678,736,22,6,6,5,4,0,1,128,58,186
p_81,0,14,e_1,551,678,736,21,6,6,5,4,0,1,127,58,185
p_79,0,14,e_1,553,678,736,21,6,6,4,4,0,1,125,58,183
p_26,0,8,e_3,684,714,742,9,0,0,9,3,0,0,30,28,58
p_25,0,8,e_3,686,714,742,9,1,0,9,4,0,1,28,28,56
p_106,0,3,e_0,500,730,743,4,1,0,1,4,0,1,230,13,243
p_67,0,3,e_0,568,730,743,18,3,3,14,5,1,1,162,13,175
p_66,0,3,e_0,569,730,743,17,3,3,14,5,1,1,161,13,174
p_108,0,6,e_0,496,730,754,6,1,0,2,4,0,1,234,24,258
p_23,0,12,e_3,711,714,756,1,1,0,1,4,0,1,3,42,45
p_111,0,8,e_0,491,730,762,7,1,0,4,4,0,1,239,32,271
p_112,0,11,e_0,490,730,773,8,1,0,4,4,0,1,240,43,283
p_110,0,11,e_0,492,730,773,7,1,0,4,4,0,1,238,43,281
p_107,0,11,e_0,499,730,773,5,1,0,1,4,0,1,231,43,274
p_105,0,12,e_0,502,730,778,4,1,0,0,4,0,1,228,48,276
p_68,0,13,e_0,567,730,783,18,3,3,14,2,2,1,163,53,216
p_104,0,14,e_0,503,730,788,3,1,0,0,3,0,0,227,58,285
p_69,0,14,e_0,566,730,788,18,3,3,14,5,2,1,164,58,222
p_109,0,15,e_0,493,730,793,7,1,0,3,4,0,1,237,63,300
p_21,0,4,e_2,731,779,793,19,2,2,15,3,0,0,48,14,62
p_29,0,5,e_1,670,780,797,9,0,0,2,4,0,1,110,17,127
p_27,0,10,e_1,677,780,814,9,0,0,0,3,0,0,103,34,137
p_18,0,10,e_1,766,780,814,12,0,0,4,4,0,1,14,34,48
p_17,0,10,e_1,776,780,814,12,0,0,1,4,0,1,4,34,38
p_28,0,11,e_1,676,780,819,9,0,0,0,4,0,1,104,39,143
p_19,0,11,e_1,754,780,819,12,1,1,8,4,0,1,26,39,65
p_20,0,14,e_2,734,779,825,18,2,2,15,4,0,1,45,46,91
p_16,0,2,e_3,780,819,827,12,0,0,12,3,0,0,39,8,47
p_14,0,4,e_3,794,819,835,8,1,0,8,4,0,1,25,16,41
p_55,0,3,e_0,585,840,851,13,1,0,11,4,0,1,255,11,266
p_54,0,3,e_0,586,840,851,13,1,0,11,4,0,1,254,11,265
p_52,0,3,e_0,588,840,851,12,1,0,10,4,0,1,252,11,263
p_15,0,9,e_3,793,819,852,8,1,0,8,4,0,1,26,33,59
p_11,0,9,e_3,807,819,852,4,1,0,4,4,0,1,12,33,45
p_64,0,4,e_0,574,840,856,16,2,2,15,4,0,1,266,16,282
p_13,0,11,e_3,796,819,860,7,1,0,7,4,0,1,23,41,64
p_12,0,11,e_3,798,819,860,7,1,0,7,4,0,1,21,41,62
p_61,0,6,e_0,579,840,864,15,1,0,13,4,0,1,261,24,285
p_56,0,6,e_0,584,840,864,14,1,0,12,4,0,1,256,24,280
p_50,0,7,e_0,590,840,869,12,1,0,10,4,0,1,250,29,279
p_53,0,9,e_0,587,840,877,13,1,0,11,4,0,1,253,37,290
p_51,0,9,e_0,589,840,877,12,1,0,10,4,0,1,251,37,288
p_60,0,10,e_0,580,840,882,15,1,0,13,4,0,1,260,42,302
p_58,0,11,e_0,582,840,887,14,1,0,12,4,0,1,258,47,305
p_57,0,11,e_0,583,840,887,14,1,0,12,4,0,1,257,47,304
p_9,0,2,e_1,846,882,890,15,2,2,11,3,0,0,36,8,44
p_63,0,13,e_0,577,840,895,15,2,2,14,4,0,1,263,55,318
p_62,0,13,e_0,578,840,895,15,1,1,14,4,0,1,262,55,317
p_6,0,3,e_1,877,882,895,11,0,0,1,4,0,1,5,13,18
p_59,0,14,e_0,581,840,900,15,1,0,13,4,0,1,259,60,319
p_7,0,5,e_1,875,882,903,11,0,0,2,4,0,1,7,21,28
p_8,0,11,e_1,874,882,923,11,0,0,2,4,0,1,8,41,49
p_4,0,1,e_3,886,919,924,11,1,0,11,4,0,1,33,5,38
p_1,0,5,e_3,894,919,938,8,1,0,8,4,0,1,25,19,44
p_5,0,8,e_3,883,919,949,11,0,0,11,3,0,0,36,30,66
p_3,0,8,e_3,888,919,949,10,1,0,10,4,0,1,31,30,61
p_45,0,2,e_0,595,944,952,10,1,0,8,4,0,1,349,8,357
p_22,0,3,e_0,719,944,957,23,3,3,3,4,0,1,225,13,238
p_2,0,11,e_3,892,919,960,9,1,0,9,4,0,1,27,41,68
p_48,0,4,e_0,592,944,962,11,1,0,9,4,0,1,352,18,370
p_46,0,4,e_0,594,944,962,10,1,0,8,4,0,1,350,18,368
p_42,0,6,e_0,598,944,970,9,1,0,7,4,0,1,346,26,372
p_43,0,7,e_0,597,944,975,9,1,0,7,4,0,1,347,31,378
p_44,0,8,e_0,596,944,980,10,1,0,8,4,0,1,348,36,384
p_10,0,8,e_0,835,944,980,18,2,2,1,4,0,1,109,36,145
p_47,0,9,e_0,593,944,985,11,1,0,9,4,0,1,351,41,392
p_37,0,9,e_0,615,944,985,3,1,0,1,4,0,1,329,41,370
p_41,0,11,e_0,600,944,993,8,1,0,6,4,0,1,344,49,393
p_39,0,12,e_0,607,944,998,6,1,0,4,4,0,1,337,54,391
p_40,0,13,e_0,602,944,1003,8,1,0,6,4,0,1,342,59,401
p_38,0,13,e_0,608,944,1003,6,1,0,4,4,0,1,336,59,395
p_49,0,14,e_0,591,944,1008,11,1,0,9,4,0,1,353,64,417
p_300,0,4,e_0,8,9,25,0,0,0,0,3,0,0,1,16,17
p_299,0,5,e_1,9,10,29,0,0,0,0,3,0,0,1,19,20
p_297,0,6,e_3,15,16,38,0,0,0,0,3,0,0,1,22,23
p_298,0,9,e_2,11,12,43,0,0,0,0,3,0,0,1,31,32
p_296,0,4,e_0,28,43,57,9,1,1,4,3,0,0,15,14,29
p_286,0,3,e_1,46,47,60,6,0,0,0,3,0,0,1,13,14
p_292,0,6,e_0,38,43,65,6,0,0,1,4,0,1,5,22,27
p_290,0,6,e_0,40,43,65,6,0,0,1,4,0,1,3,22,25
p_289,0,4,e_1,43,47,65,6,0,0,1,4,0,1,4,18,22
p_295,0,5,e_1,29,47,70,9,1,1,5,3,0,0,18,23,41
p_287,0,5,e_1,45,47,70,6,0,0,0,4,0,1,2,23,25
p_288,0,8,e_1,44,47,81,6,0,0,1,4,0,1,3,34,37
p_281,0,1,e_3,73,74,81,0,0,0,0,3,0,0,1,7,8
p_291,0,11,e_0,39,43,82,6,0,0,1,4,0,1,4,39,43
p_294,0,12,e_0,31,43,87,8,1,1,4,4,0,1,12,44,56
p_293,0,12,e_0,33,43,87,7,1,1,3,4,0,1,10,44,54
p_285,0,4,e_3,53,74,92,6,0,0,6,3,0,0,21,18,39
p_284,0,4,e_3,54,74,92,6,1,0,6,4,0,1,20,18,38
p_282,0,7,e_3,66,74,103,2,1,0,2,4,0,1,8,29,37
p_283,0,9,e_3,57,74,111,5,1,0,5,4,0,1,17,37,54
p_278,0,2,e_2,77,105,113,18,4,4,9,4,0,1,28,8,36
p_279,0,5,e_2,76,105,124,18,4,4,9,4,0,1,29,19,48
p_277,0,6,e_1,82,109,129,17,3,3,8,3,0,0,27,20,47
p_274,0,8,e_2,88,105,135,15,3,3,5,4,0,1,17,30,47
p_271,0,1,e_3,121,140,145,6,1,0,6,4,0,1,19,5,24
p_276,0,11,e_2,84,105,146,16,3,3,7,4,0,1,21,41,62
p_273,0,4,e_3,110,140,156,9,0,0,9,2,1,0,30,16,46
p_280,0,14,e_2,75,105,157,18,4,4,9,3,0,0,30,52,82
p_275,0,14,e_2,86,105,157,16,3,3,6,4,0,1,19,52,71
p_267,0,1,e_1,148,165,172,18,3,3,5,4,0,1,17,7,24
p_270,0,9,e_3,122,140,173,6,1,0,6,4,0,1,18,33,51
p_269,0,9,e_3,127,140,173,4,1,0,4,4,0,1,13,33,46
p_268,0,2,e_1,144,165,177,19,3,3,6,3,0,0,21,12,33
p_272,0,10,e_3,113,140,178,9,1,0,9,4,0,1,27,38,65
p_265,0,4,e_1,152,165,185,17,3,3,4,4,0,1,13,20,33
p_262,0,5,e_1,157,165,190,16,2,2,2,4,0,1,8,25,33
p_261,0,5,e_1,164,165,190,14,2,2,0,3,0,0,1,25,26
p_266,0,6,e_1,151,165,195,17,3,3,4,4,0,1,14,30,44
p_263,0,7,e_1,154,165,200,16,3,3,3,4,0,1,11,35,46
p_264,0,11,e_1,153,165,214,17,3,3,4,4,0,1,12,49,61
p_255,0,3,e_0,184,204,215,10,0,0,6,4,0,1,20,11,31
p_254,0,4,e_0,187,204,220,10,0,0,5,4,0,1,17,16,33
p_253,0,5,e_0,190,204,225,10,0,0,4,4,0,1,14,21,35
p_260,0,7,e_0,165,204,233,13,2,2,12,3,0,0,39,29,68
p_258,0,7,e_0,168,204,233,12,2,2,12,4,0,1,36,29,65
p_256,0,10,e_0,182,204,244,10,0,0,7,4,0,1,22,40,62
p_250,0,2,e_3,217,238,246,7,1,0,7,4,0,1,21,8,29
p_252,0,5,e_3,205,238,257,10,0,0,10,3,0,0,33,19,52
p_257,0,14,e_0,169,204,258,12,2,2,11,4,0,1,35,54,89
p_259,0,15,e_0,167,204,263,13,2,2,12,4,0,1,37,59,96
p_251,0,15,e_3,209,238,289,9,1,0,9,4,0,1,29,51,80
p_248,0,5,e_1,246,275,292,28,2,2,9,4,0,1,29,17,46
p_247,0,5,e_1,250,275,292,27,2,2,8,4,0,1,25,17,42
p_249,0,6,e_1,239,275,297,30,3,3,11,3,0,0,36,22,58
p_245,0,7,e_1,269,275,302,21,1,1,2,4,0,1,6,27,33
p_246,0,10,e_1,262,275,313,24,1,1,4,4,0,1,13,38,51
p_244,0,12,e_1,271,275,321,21,1,1,1,4,0,1,4,46,50
p_241,0,1,e_2,283,322,327,17,1,1,13,4,0,1,39,5,44
p_236,0,1,e_2,305,322,327,15,0,0,5,4,0,1,17,5,22
p_233,0,1,e_2,311,322,327,15,0,0,3,4,0,1,11,5,16
p_243,0,15,e_1,272,275,332,20,1,1,1,4,0,1,3,57,60
p_230,0,3,e_2,319,322,335,15,0,0,1,4,0,1,3,13,16
p_232,0,5,e_2,314,322,343,15,0,0,2,4,0,1,8,21,29
p_237,0,7,e_2,304,322,351,15,0,0,6,4,0,1,18,29,47
p_231,0,7,e_2,317,322,351,15,0,0,1,4,0,1,5,29,34
p_242,0,8,e_2,277,322,356,19,1,1,14,3,0,0,45,34,79
p_235,0,8,e_2,308,322,356,15,0,0,4,4,0,1,14,34,48
p_234,0,8,e_2,310,322,356,15,0,0,4,4,0,1,12,34,46
p_240,0,9,e_2,301,322,361,15,0,0,7,4,0,1,21,39,60
p_239,0,11,e_2,302,322,369,15,0,0,6,4,0,1,20,47,67
p_238,0,13,e_2,303,322,377,15,0,0,6,4,0,1,19,55,74
p_229,0,13,e_2,320,322,377,15,0,0,0,4,0,1,2,55,57
p_216,0,1,e_0,347,373,380,9,1,0,8,4,0,1,26,7,33
p_226,0,2,e_0,329,373,385,15,1,0,14,4,0,1,44,12,56
p_223,0,2,e_0,336,373,385,13,1,0,12,4,0,1,37,12,49
p_214,0,3,e_0,349,373,390,8,1,0,8,4,0,1,24,17,41
p_228,0,4,e_0,325,373,395,15,0,0,15,3,0,0,48,22,70
p_224,0,5,e_1,331,379,396,14,1,0,15,2,1,0,48,17,65
p_194,0,6,e_3,373,375,397,0,1,0,0,4,0,1,2,22,24
p_225,0,5,e_0,330,373,400,15,1,0,14,4,0,1,43,27,70
p_222,0,5,e_0,337,373,400,12,1,0,12,4,0,1,36,27,63
p_219,0,5,e_0,342,373,400,11,1,0,10,4,0,1,31,27,58
p_221,0,6,e_0,339,373,405,12,1,0,11,4,0,1,34,32,66
p_220,0,6,e_0,341,373,405,11,1,0,10,4,0,1,32,32,64
p_192,0,8,e_1,375,379,407,24,4,4,1,4,0,1,4,28,32
p_217,0,7,e_0,346,373,410,9,1,0,9,4,0,1,27,37,64
p_212,0,7,e_0,351,373,410,8,1,0,7,4,0,1,22,37,59
p_193,0,11,e_3,374,375,414,0,0,0,0,3,0,0,1,39,40
p_191,0,10,e_1,376,379,415,24,3,3,1,4,0,1,3,36,39
p_227,0,12,e_3,327,375,419,15,0,0,15,3,0,0,48,44,92
p_218,0,11,e_0,343,373,424,10,1,0,10,4,0,1,30,51,81
p_190,0,1,e_2,379,421,428,24,3,3,13,3,0,0,42,7,49
p_183,0,1,e_2,396,421,428,18,2,2,8,4,0,1,25,7,32
p_182,0,2,e_2,397,421,433,18,2,2,8,4,0,1,24,12,36
p_180,0,2,e_2,399,421,433,18,2,2,7,4,0,1,22,12,34
p_215,0,15,e_0,348,373,438,9,1,0,8,4,0,1,25,65,90
p_213,0,15,e_0,350,373,438,8,1,0,7,4,0,1,23,65,88
p_178,0,3,e_2,401,421,438,17,2,2,6,4,0,1,20,17,37
p_186,0,4,e_2,390,421,443,20,3,3,10,4,0,1,31,22,53
p_176,0,4,e_2,403,421,443,16,2,2,6,4,0,1,18,22,40
p_189,0,8,e_2,382,421,457,23,3,3,13,4,0,1,39,36,75
p_179,0,8,e_2,400,421,457,17,2,2,7,4,0,1,21,36,57
p_161,0,1,e_1,421,454,461,12,0,0,10,3,0,0,33,7,40
p_158,0,1,e_1,430,454,461,12,0,0,8,4,0,1,24,7,31
p_177,0,9,e_2,402,421,462,17,2,2,6,4,0,1,19,41,60
p_185,0,10,e_2,391,421,467,20,3,3,10,4,0,1,30,46,76
p_187,0,12,e_2,389,421,475,20,3,3,10,4,0,1,32,54,86
p_184,0,12,e_2,392,421,475,19,3,3,9,4,0,1,29,54,83
p_159,0,6,e_1,429,454,478,12,0,0,8,4,0,1,25,24,49
p_150,0,6,e_1,443,454,478,12,0,0,3,4,0,1,11,24,35
p_188,0,13,e_2,384,421,480,22,3,3,12,4,0,1,37,59,96
p_154,0,7,e_1,436,454,483,12,0,0,6,4,0,1,18,29,47
p_148,0,8,e_1,449,454,488,12,0,0,1,4,0,1,5,34,39
p_181,0,15,e_2,398,421,488,18,2,2,7,4,0,1,23,67,90
p_153,0,9,e_1,437,454,493,12,0,0,5,4,0,1,17,39,56
p_147,0,9,e_1,452,454,493,12,0,0,0,4,0,1,2,39,41
p_209,0,2,e_0,357,485,495,6,1,0,5,4,0,1,128,10,138
p_205,0,2,e_0,362,485,495,4,1,0,3,4,0,1,123,10,133
p_200,0,4,e_0,367,485,503,2,1,0,2,4,0,1,118,18,136
p_201,0,5,e_0,366,485,508,3,1,0,2,4,0,1,119,23,142
p_157,0,14,e_1,431,454,510,12,0,0,7,4,0,1,23,56,79
p_155,0,14,e_1,435,454,510,12,0,0,6,4,0,1,19,56,75
p_210,0,6,e_0,354,485,513,7,1,0,6,4,0,1,131,28,159
p_208,0,6,e_0,358,485,513,5,1,0,5,4,0,1,127,28,155
p_160,0,15,e_1,426,454,515,12,0,0,9,4,0,1,28,61,89
p_156,0,15,e_1,434,454,515,12,0,0,6,4,0,1,20,61,81
p_152,0,15,e_1,441,454,515,12,0,0,4,4,0,1,13,61,74
p_151,0,15,e_1,442,454,515,12,0,0,4,4,0,1,12,61,73
p_149,0,15,e_1,444,454,515,12,0,0,3,4,0,1,10,61,71
p_198,0,9,e_0,369,485,524,2,1,0,1,4,0,1,116,39,155
p_197,0,10,e_0,370,485,529,1,1,0,1,4,0,1,115,44,159
p_113,0,1,e_3,489,524,529,11,1,0,11,4,0,1,35,5,40
p_207,0,11,e_0,359,485,534,5,1,0,4,4,0,1,126,49,175
p_114,0,3,e_3,488,524,537,12,1,0,12,4,0,1,36,13,49
p_106,0,3,e_3,500,524,537,8,1,0,8,4,0,1,24,13,37
p_206,0,12,e_0,361,485,539,4,1,0,4,4,0,1,124,54,178
p_203,0,12,e_0,364,485,539,3,1,0,3,4,0,1,121,54,175
p_167,0,1,e_2,413,535,540,13,1,1,2,4,0,1,122,5,127
p_204,0,14,e_0,363,485,547,4,1,0,3,4,0,1,122,62,184
p_108,0,6,e_3,496,524,548,9,1,0,9,4,0,1,28,24,52
p_165,0,4,e_2,417,535,551,12,1,1,1,4,0,1,118,16,134
p_92,0,4,e_2,525,535,551,30,10,10,3,4,0,1,10,16,26
p_211,0,15,e_0,353,485,552,7,1,0,6,4,0,1,132,67,199
p_202,0,15,e_0,365,485,552,3,1,0,2,4,0,1,120,67,187
p_199,0,15,e_0,368,485,552,2,1,0,1,4,0,1,117,67,184
p_111,0,8,e_3,491,524,556,11,1,0,11,4,0,1,33,32,65
p_115,0,9,e_3,487,524,561,12,1,0,12,4,0,1,37,37,74
p_117,0,10,e_3,485,524,566,12,0,0,12,3,0,0,39,42,81
p_116,0,10,e_3,486,524,566,12,1,0,12,4,0,1,38,42,80
p_169,0,9,e_2,411,535,568,14,2,2,3,4,0,1,124,33,157
p_146,0,1,e_1,453,562,569,12,0,0,0,3,0,0,109,7,116
p_112,0,11,e_3,490,524,571,11,1,0,11,4,0,1,34,47,81
p_110,0,11,e_3,492,524,571,10,1,0,10,4,0,1,32,47,79
p_107,0,11,e_3,499,524,571,8,1,0,8,4,0,1,25,47,72
p_103,0,11,e_3,508,524,571,5,1,0,5,4,0,1,16,47,63
p_163,0,10,e_2,419,535,573,12,0,0,0,4,0,1,116,38,154
p_86,0,2,e_1,544,562,574,25,9,9,6,4,0,1,18,12,30
p_105,0,12,e_3,502,524,576,7,1,0,7,4,0,1,22,52,74
p_173,0,11,e_2,407,535,578,15,2,2,4,4,0,1,128,43,171
p_164,0,11,e_2,418,535,578,12,0,0,1,4,0,1,117,43,160
p_162,0,11,e_2,420,535,578,12,0,0,0,3,0,0,115,43,158
p_77,0,3,e_1,557,562,579,22,7,7,1,4,0,1,5,17,22
p_166,0,12,e_2,416,535,583,13,1,1,1,4,0,1,119,48,167
p_104,0,14,e_3,503,524,584,7,1,0,7,4,0,1,21,60,81
p_88,0,5,e_1,538,562,587,27,9,9,8,4,0,1,24,25,49
p_171,0,13,e_2,409,535,588,14,2,2,4,4,0,1,126,53,179
p_168,0,13,e_2,412,535,588,13,2,2,3,4,0,1,123,53,176
p_109,0,15,e_3,493,524,589,10,1,0,10,4,0,1,31,65,96
p_76,0,6,e_1,558,562,592,22,7,7,1,4,0,1,4,30,34
p_175,0,14,e_2,405,535,593,16,2,2,5,4,0,1,130,58,188
p_174,0,14,e_2,406,535,593,15,2,2,5,4,0,1,129,58,187
p_170,0,14,e_2,410,535,593,14,2,2,3,4,0,1,125,58,183
p_80,0,7,e_1,552,562,597,23,8,8,3,4,0,1,10,35,45
p_172,0,15,e_2,408,535,598,15,2,2,4,4,0,1,127,63,190
p_87,0,8,e_1,539,562,602,27,9,9,7,4,0,1,23,40,63
p_83,0,8,e_1,549,562,602,24,8,8,4,4,0,1,13,40,53
p_89,0,9,e_1,535,562,607,27,10,10,9,4,0,1,27,45,72
p_143,0,3,e_0,456,599,612,12,0,0,9,4,0,1,143,13,156
p_136,0,3,e_0,465,599,612,12,0,0,6,4,0,1,134,13,147
p_196,0,4,e_0,371,599,617,1,1,0,0,4,0,1,228,18,246
p_137,0,4,e_0,464,599,617,12,0,0,7,4,0,1,135,18,153
p_84,0,12,e_1,546,562,618,24,9,9,5,4,0,1,16,56,72
p_78,0,12,e_1,556,562,618,22,7,7,2,4,0,1,6,56,62
p_141,0,6,e_0,458,599,625,12,0,0,9,4,0,1,141,26,167
p_82,0,14,e_1,550,562,626,24,8,8,4,4,0,1,12,64,76
p_81,0,14,e_1,551,562,626,23,8,8,3,4,0,1,11,64,75
p_79,0,14,e_1,553,562,626,23,8,8,3,4,0,1,9,64,73
p_85,0,15,e_1,545,562,631,25,9,9,5,4,0,1,17,69,86
p_140,0,8,e_0,459,599,633,12,0,0,8,4,0,1,140,34,174
p_144,0,9,e_0,455,599,638,12,0,0,10,4,0,1,144,39,183
p_142,0,9,e_0,457,599,638,12,0,0,9,4,0,1,142,39,181
p_96,0,1,e_3,517,636,641,2,1,0,2,4,0,1,119,5,124
p_139,0,10,e_0,461,599,643,12,0,0,8,4,0,1,138,44,182
p_135,0,10,e_0,466,599,643,12,0,0,6,4,0,1,133,44,177
p_145,0,11,e_0,454,599,648,12,0,0,10,4,0,1,145,49,194
p_138,0,11,e_0,463,599,648,12,0,0,7,4,0,1,136,49,185
p_133,0,12,e_0,469,599,653,12,0,0,5,4,0,1,130,54,184
p_99,0,6,e_3,514,636,658,3,1,0,3,4,0,1,122,22,144
p_94,0,6,e_3,519,636,658,1,1,0,1,4,0,1,117,22,139
p_102,0,7,e_3,509,636,663,5,1,0,5,4,0,1,127,27,154
p_98,0,7,e_3,515,636,663,3,1,0,3,4,0,1,121,27,148
p_97,0,7,e_3,516,636,663,2,1,0,2,4,0,1,120,27,147
p_195,0,15,e_0,372,599,664,1,1,0,0,3,0,0,227,65,292
p_134,0,15,e_0,467,599,664,12,0,0,6,4,0,1,132,65,197
p_101,0,8,e_3,511,636,668,4,1,0,4,4,0,1,125,32,157
p_100,0,9,e_3,513,636,673,3,1,0,3,4,0,1,123,37,160
p_37,0,9,e_3,615,636,673,7,1,0,7,4,0,1,21,37,58
p_41,0,11,e_3,600,636,681,12,1,0,12,4,0,1,36,45,81
p_91,0,12,e_2,526,645,683,30,10,10,3,4,0,1,119,38,157
p_39,0,12,e_3,607,636,686,9,1,0,9,4,0,1,29,50,79
p_90,0,13,e_2,527,645,688,29,11,11,2,4,0,1,118,43,161
p_30,0,3,e_1,668,678,691,20,6,6,3,4,0,1,10,13,23
p_93,0,13,e_3,520,636,691,1,1,0,1,4,0,1,116,55,171
p_40,0,13,e_3,602,636,691,11,1,0,11,4,0,1,34,55,89
p_38,0,13,e_3,608,636,691,9,1,0,9,4,0,1,28,55,83
p_95,0,14,e_3,518,636,696,2,1,0,2,4,0,1,118,60,178
p_75,0,5,e_1,559,678,699,21,7,7,1,4,0,1,119,21,140
p_29,0,5,e_1,670,678,699,20,6,6,2,4,0,1,8,21,29
p_32,0,6,e_1,650,678,704,24,9,9,9,4,0,1,28,26,54
p_31,0,6,e_1,666,678,704,20,7,7,4,4,0,1,12,26,38
p_74,0,7,e_1,560,678,709,21,6,6,0,4,0,1,118,31,149
p_130,0,1,e_0,472,711,716,12,0,0,4,4,0,1,239,5,244
p_119,0,1,e_0,483,711,716,12,0,0,0,4,0,1,228,5,233
p_27,0,10,e_1,677,678,720,18,5,5,0,3,0,0,1,42,43
p_129,0,3,e_0,473,711,724,12,0,0,4,4,0,1,238,13,251
p_73,0,11,e_1,561,678,725,21,6,6,0,3,0,0,117,47,164
p_28,0,11,e_1,676,678,725,18,5,5,0,4,0,1,2,47,49
p_34,0,12,e_1,646,678,730,26,9,9,10,4,0,1,32,52,84
p_124,0,7,e_0,478,711,738,12,0,0,2,4,0,1,233,27,260
p_118,0,7,e_0,484,711,738,12,0,0,0,3,0,0,227,27,254
p_33,0,15,e_1,649,678,741,25,9,9,9,4,0,1,29,63,92
p_127,0,10,e_0,475,711,749,12,0,0,3,4,0,1,236,38,274
p_22,0,3,e_3,719,740,751,7,1,0,7,4,0,1,21,11,32
p_132,0,11,e_0,470,711,754,12,0,0,5,4,0,1,241,43,284
p_128,0,11,e_0,474,711,754,12,0,0,3,4,0,1,237,43,280
p_123,0,11,e_0,479,711,754,12,0,0,2,4,0,1,232,43,275
p_121,0,11,e_0,481,711,754,12,0,0,1,4,0,1,230,43,273
p_120,0,11,e_0,482,711,754,12,0,0,1,4,0,1,229,43,272
p_21,0,4,e_3,731,740,756,3,1,0,3,4,0,1,9,16,25
p_126,0,12,e_0,476,711,759,12,0,0,3,4,0,1,235,48,283
p_131,0,14,e_0,471,711,767,12,0,0,4,4,0,1,240,56,296
p_125,0,14,e_0,477,711,767,12,0,0,2,4,0,1,234,56,290
p_122,0,15,e_0,480,711,772,12,0,0,1,4,0,1,231,61,292
p_35,0,9,e_3,630,740,773,2,1,0,2,4,0,1,110,33,143
p_23,0,12,e_3,711,740,784,9,1,0,9,4,0,1,29,44,73
p_36,0,13,e_3,628,740,789,2,1,0,2,4,0,1,112,49,161
p_20,0,14,e_3,734,740,794,2,1,0,2,4,0,1,6,54,60
p_16,0,2,e_2,780,796,804,17,3,3,5,4,0,1,16,8,24
p_14,0,4,e_2,794,796,812,14,0,0,0,4,0,1,2,16,18
p_65,0,1,e_0,573,819,824,19,4,4,8,4,0,1,246,5,251
p_15,0,9,e_2,793,796,829,14,0,0,1,4,0,1,3,33,36
p_72,0,3,e_0,562,819,832,21,6,6,12,4,0,1,257,13,270
p_71,0,3,e_0,564,819,832,20,6,6,11,4,0,1,255,13,268
p_70,0,3,e_0,565,819,832,20,5,5,11,4,0,1,254,13,267
p_67,0,3,e_0,568,819,832,20,5,5,10,4,0,1,251,13,264
p_66,0,3,e_0,569,819,832,19,5,5,10,4,0,1,250,13,263
p_18,0,10,e_2,766,796,834,21,4,4,10,4,0,1,30,38,68
p_17,0,10,e_2,776,796,834,18,3,3,6,4,0,1,20,38,58
p_64,0,4,e_0,574,819,837,18,4,4,8,4,0,1,245,18,263
p_19,0,11,e_2,754,796,839,24,5,5,13,3,0,0,42,43,85
p_61,0,6,e_0,579,819,845,17,3,3,6,4,0,1,240,26,266
p_60,0,10,e_0,580,819,859,17,3,3,6,4,0,1,239,40,279
p_58,0,11,e_0,582,819,864,16,3,3,5,4,0,1,237,45,282
p_68,0,13,e_0,567,819,872,20,5,5,10,4,0,1,252,53,305
p_63,0,13,e_0,577,819,872,18,3,3,7,4,0,1,242,53,295
p_62,0,13,e_0,578,819,872,18,3,3,7,4,0,1,241,53,294
p_69,0,14,e_0,566,819,877,20,5,5,11,4,0,1,253,58,311
p_59,0,14,e_0,581,819,877,17,3,3,6,4,0,1,238,58,296
p_9,0,2,e_2,846,882,890,11,1,0,11,3,0,0,36,8,44
p_6,0,3,e_2,877,882,895,1,1,0,1,4,0,1,5,13,18
p_7,0,5,e_3,875,880,897,1,1,0,1,4,0,1,5,17,22
p_10,0,8,e_3,835,880,908,14,0,0,14,3,0,0,45,28,73
p_8,0,11,e_2,874,882,921,2,1,0,2,4,0,1,8,39,47
p_45,0,2,e_0,595,921,929,13,1,0,1,4,0,1,326,8,334
p_55,0,3,e_0,585,921,934,16,2,2,4,4,0,1,336,13,349
p_54,0,3,e_0,586,921,934,16,2,2,4,4,0,1,335,13,348
p_52,0,3,e_0,588,921,934,15,1,1,3,4,0,1,333,13,346
p_48,0,4,e_0,592,921,939,14,1,0,2,4,0,1,329,18,347
p_46,0,4,e_0,594,921,939,14,1,0,1,4,0,1,327,18,345
p_56,0,6,e_0,584,921,947,16,2,2,5,4,0,1,337,26,363
p_50,0,7,e_0,590,921,952,15,1,0,3,4,0,1,331,31,362
p_43,0,7,e_0,597,921,952,13,1,0,0,4,0,1,324,31,355
p_44,0,8,e_0,596,921,957,13,1,0,1,4,0,1,325,36,361
p_53,0,9,e_0,587,921,962,15,2,2,4,4,0,1,334,41,375
p_51,0,9,e_0,589,921,962,15,1,0,3,4,0,1,332,41,373
p_47,0,9,e_0,593,921,962,14,1,0,2,4,0,1,328,41,369
p_57,0,11,e_0,583,921,970,16,2,2,5,4,0,1,338,49,387
p_49,0,14,e_0,591,921,981,15,1,0,2,4,0,1,330,60,390
p_4,0,1,e_0,886,1025,1030,14,2,2,11,4,0,1,139,5,144
p_24,0,2,e_0,695,1025,1035,14,1,1,5,4,0,1,330,10,340
p_1,0,5,e_0,894,1025,1046,12,2,2,9,4,0,1,131,21,152
p_42,0,6,e_0,598,1025,1051,12,1,0,0,3,0,0,427,26,453
p_26,0,8,e_0,684,1025,1059,16,4,4,9,4,0,1,341,34,375
p_25,0,8,e_0,686,1025,1059,16,3,3,8,4,0,1,339,34,373
p_5,0,8,e_0,883,1025,1059,15,2,2,12,4,0,1,142,34,176
p_3,0,8,e_0,888,1025,1059,14,2,2,11,4,0,1,137,34,171
p_11,0,9,e_0,807,1025,1064,14,0,0,4,4,0,1,218,39,257
p_13,0,11,e_0,796,1025,1072,14,0,0,7,4,0,1,229,47,276
p_12,0,11,e_0,798,1025,1072,14,0,0,7,4,0,1,227,47,274
p_2,0,11,e_0,892,1025,1072,12,2,2,9,4,0,1,133,47,180
p_300,0,4,e_0,8,9,25,0,0,0,0,3,0,0,1,16,17
p_299,0,5,e_1,9,10,29,0,0,0,0,3,0,0,1,19,20
p_297,0,6,e_3,15,16,38,0,0,0,0,3,0,0,1,22,23
p_298,0,9,e_2,11,12,43,0,0,0,0,3,0,0,1,31,32
p_296,0,4,e_0,28,43,57,9,1,1,4,3,0,0,15,14,29
p_286,0,3,e_1,46,47,60,6,0,0,0,3,0,0,1,13,14
p_292,0,6,e_0,38,43,65,6,0,0,1,4,0,1,5,22,27
p_290,0,6,e_0,40,43,65,6,0,0,1,4,0,1,3,22,25
p_289,0,4,e_1,43,47,65,6,0,0,1,4,0,1,4,18,22
p_295,0,5,e_1,29,47,70,9,1,1,5,3,0,0,18,23,41
p_287,0,5,e_1,45,47,70,6,0,0,0,4,0,1,2,23,25
p_288,0,8,e_1,44,47,81,6,0,0,1,4,0,1,3,34,37
p_281,0,1,e_3,73,74,81,0,0,0,0,3,0,0,1,7,8
p_291,0,11,e_0,39,43,82,6,0,0,1,4,0,1,4,39,43
p_294,0,12,e_0,31,43,87,8,1,1,4,4,0,1,12,44,56
p_293,0,12,e_0,33,43,87,7,1,1,3,4,0,1,10,44,54
p_285,0,4,e_3,53,74,92,6,0,0,6,3,0,0,21,18,39
p_284,0,4,e_3,54,74,92,6,1,0,6,4,0,1,20,18,38
p_282,0,7,e_3,66,74,103,2,1,0,2,4,0,1,8,29,37
p_283,0,9,e_3,57,74,111,5,1,0,5,4,0,1,17,37,54
p_278,0,2,e_2,77,105,113,18,4,4,9,4,0,1,28,8,36
p_279,0,5,e_2,76,105,124,18,4,4,9,4,0,1,29,19,48
p_277,0,6,e_1,82,109,129,17,3,3,8,3,0,0,27,20,47
p_274,0,8,e_2,88,105,135,15,3,3,5,4,0,1,17,30,47
p_271,0,1,e_3,121,140,145,6,1,0,6,4,0,1,19,5,24
p_276,0,11,e_2,84,105,146,16,3,3,7,4,0,1,21,41,62
p_273,0,4,e_3,110,140,156,9,0,0,9,2,1,0,30,16,46
p_280,0,14,e_2,75,105,157,18,4,4,9,3,0,0,30,52,82
p_275,0,14,e_2,86,105,157,16,3,3,6,4,0,1,19,52,71
p_267,0,1,e_1,148,165,172,18,3,3,5,4,0,1,17,7,24
p_270,0,9,e_3,122,140,173,6,1,0,6,4,0,1,18,33,51
p_269,0,9,e_3,127,140,173,4,1,0,4,4,0,1,13,33,46
p_268,0,2,e_1,144,165,177,19,3,3,6,3,0,0,21,12,33
p_272,0,10,e_3,113,140,178,9,1,0,9,4,0,1,27,38,65
p_265,0,4,e_1,152,165,185,17,3,3,4,4,0,1,13,20,33
p_262,0,5,e_1,157,165,190,16,2,2,2,4,0,1,8,25,33
p_261,0,5,e_1,164,165,190,14,2,2,0,3,0,0,1,25,26
p_266,0,6,e_1,151,165,195,17,3,3,4,4,0,1,14,30,44
p_263,0,7,e_1,154,165,200,16,3,3,3,4,0,1,11,35,46
p_264,0,11,e_1,153,165,214,17,3,3,4,4,0,1,12,49,61
p_255,0,3,e_0,184,204,215,10,0,0,6,4,0,1,20,11,31
p_254,0,4,e_0,187,204,220,10,0,0,5,4,0,1,17,16,33
p_253,0,5,e_0,190,204,225,10,0,0,4,4,0,1,14,21,35
p_260,0,7,e_0,165,204,233,13,2,2,12,3,0,0,39,29,68
p_258,0,7,e_0,168,204,233,12,2,2,12,4,0,1,36,29,65
p_256,0,10,e_0,182,204,244,10,0,0,7,4,0,1,22,40,62
p_250,0,2,e_3,217,238,246,7,1,0,7,4,0,1,21,8,29
p_252,0,5,e_3,205,238,257,10,0,0,10,3,0,0,33,19,52
p_257,0,14,e_0,169,204,258,12,2,2,11,4,0,1,35,54,89
p_259,0,15,e_0,167,204,263,13,2,2,12,4,0,1,37,59,96
p_251,0,15,e_3,209,238,289,9,1,0,9,4,0,1,29,51,80
p_248,0,5,e_1,246,275,292,28,2,2,9,4,0,1,29,17,46
p_247,0,5,e_1,250,275,292,27,2,2,8,4,0,1,25,17,42
p_249,0,6,e_1,239,275,297,30,3,3,11,3,0,0,36,22,58
p_245,0,7,e_1,269,275,302,21,1,1,2,4,0,1,6,27,33
p_246,0,10,e_1,262,275,313,24,1,1,4,4,0,1,13,38,51
p_244,0,12,e_1,271,275,321,21,1,1,1,4,0,1,4,46,50
p_241,0,1,e_2,283,322,327,17,1,1,13,4,0,1,39,5,44
p_236,0,1,e_2,305,322,327,15,0,0,5,4,0,1,17,5,22
p_233,0,1,e_2,311,322,327,15,0,0,3,4,0,1,11,5,16
p_243,0,15,e_1,272,275,332,20,1,1,1,4,0,1,3,57,60
p_230,0,3,e_2,319,322,335,15,0,0,1,4,0,1,3,13,16
p_232,0,5,e_2,314,322,343,15,0,0,2,4,0,1,8,21,29
p_237,0,7,e_2,304,322,351,15,0,0,6,4,0,1,18,29,47
p_231,0,7,e_2,317,322,351,15,0,0,1,4,0,1,5,29,34
p_242,0,8,e_2,277,322,356,19,1,1,14,3,0,0,45,34,79
p_235,0,8,e_2,308,322,356,15,0,0,4,4,0,1,14,34,48
p_234,0,8,e_2,310,322,356,15,0,0,4,4,0,1,12,34,46
p_240,0,9,e_2,301,322,361,15,0,0,7,4,0,1,21,39,60
p_239,0,11,e_2,302,322,369,15,0,0,6,4,0,1,20,47,67
p_238,0,13,e_2,303,322,377,15,0,0,6,4,0,1,19,55,74
p_229,0,13,e_2,320,322,377,15,0,0,0,4,0,1,2,55,57
p_216,0,1,e_0,347,373,380,9,1,0,8,4,0,1,26,7,33
p_226,0,2,e_0,329,373,385,15,1,0,14,4,0,1,44,12,56
p_223,0,2,e_0,336,373,385,13,1,0,12,4,0,1,37,12,49
p_214,0,3,e_0,349,373,390,8,1,0,8,4,0,1,24,17,41
p_228,0,4,e_0,325,373,395,15,0,0,15,3,0,0,48,22,70
p_224,0,5,e_1,331,379,396,14,1,0,15,2,1,0,48,17,65
p_194,0,6,e_3,373,375,397,0,1,0,0,4,0,1,2,22,24
p_225,0,5,e_0,330,373,400,15,1,0,14,4,0,1,43,27,70
p_222,0,5,e_0,337,373,400,12,1,0,12,4,0,1,36,27,63
p_219,0,5,e_0,342,373,400,11,1,0,10,4,0,1,31,27,58
p_221,0,6,e_0,339,373,405,12,1,0,11,4,0,1,34,32,66
p_220,0,6,e_0,341,373,405,11,1,0,10,4,0,1,32,32,64
p_192,0,8,e_1,375,379,407,24,4,4,1,4,0,1,4,28,32
p_217,0,7,e_0,346,373,410,9,1,0,9,4,0,1,27,37,64
p_212,0,7,e_0,351,373,410,8,1,0,7,4,0,1,22,37,59
p_193,0,11,e_3,374,375,414,0,0,0,0,3,0,0,1,39,40
p_191,0,10,e_1,376,379,415,24,3,3,1,4,0,1,3,36,39
p_227,0,12,e_3,327,375,419,15,0,0,15,3,0,0,48,44,92
p_218,0,11,e_0,343,373,424,10,1,0,10,4,0,1,30,51,81
p_190,0,1,e_2,379,421,428,24,3,3,13,3,0,0,42,7,49
p_183,0,1,e_2,396,421,428,18,2,2,8,4,0,1,25,7,32
p_182,0,2,e_2,397,421,433,18,2,2,8,4,0,1,24,12,36
p_180,0,2,e_2,399,421,433,18,2,2,7,4,0,1,22,12,34
p_215,0,15,e_0,348,373,438,9,1,0,8,4,0,1,25,65,90
p_213,0,15,e_0,350,373,438,8,1,0,7,4,0,1,23,65,88
p_178,0,3,e_2,401,421,438,17,2,2,6,4,0,1,20,17,37
p_186,0,4,e_2,390,421,443,20,3,3,10,4,0,1,31,22,53
p_176,0,4,e_2,403,421,443,16,2,2,6,4,0,1,18,22,40
p_189,0,8,e_2,382,421,457,23,3,3,13,4,0,1,39,36,75
p_179,0,8,e_2,400,421,457,17,2,2,7,4,0,1,21,36,57
p_161,0,1,e_1,421,454,461,12,0,0,10,3,0,0,33,7,40
p_158,0,1,e_1,430,454,461,12,0,0,8,4,0,1,24,7,31
p_177,0,9,e_2,402,421,462,17,2,2,6,4,0,1,19,41,60
p_185,0,10,e_2,391,421,467,20,3,3,10,4,0,1,30,46,76
p_187,0,12,e_2,389,421,475,20,3,3,10,4,0,1,32,54,86
p_184,0,12,e_2,392,421,475,19,3,3,9,4,0,1,29,54,83
p_159,0,6,e_1,429,454,478,12,0,0,8,4,0,1,25,24,49
p_150,0,6,e_1,443,454,478,12,0,0,3,4,0,1,11,24,35
p_188,0,13,e_2,384,421,480,22,3,3,12,4,0,1,37,59,96
p_154,0,7,e_1,436,454,483,12,0,0,6,4,0,1,18,29,47
p_148,0,8,e_1,449,454,488,12,0,0,1,4,0,1,5,34,39
p_181,0,15,e_2,398,421,488,18,2,2,7,4,0,1,23,67,90
p_153,0,9,e_1,437,454,493,12,0,0,5,4,0,1,17,39,56
p_147,0,9,e_1,452,454,493,12,0,0,0,4,0,1,2,39,41
p_209,0,2,e_0,357,485,495,6,1,0,5,4,0,1,128,10,138
p_205,0,2,e_0,362,485,495,4,1,0,3,4,0,1,123,10,133
p_200,0,4,e_0,367,485,503,2,1,0,2,4,0,1,118,18,136
p_201,0,5,e_0,366,485,508,3,1,0,2,4,0,1,119,23,142
p_157,0,14,e_1,431,454,510,12,0,0,7,4,0,1,23,56,79
p_155,0,14,e_1,435,454,510,12,0,0,6,4,0,1,19,56,75
p_210,0,6,e_0,354,485,513,7,1,0,6,4,0,1,131,28,159
p_208,0,6,e_0,358,485,513,5,1,0,5,4,0,1,127,28,155
p_160,0,15,e_1,426,454,515,12,0,0,9,4,0,1,28,61,89
p_156,0,15,e_1,434,454,515,12,0,0,6,4,0,1,20,61,81
p_152,0,15,e_1,441,454,515,12,0,0,4,4,0,1,13,61,74
p_151,0,15,e_1,442,454,515,12,0,0,4,4,0,1,12,61,73
p_149,0,15,e_1,444,454,515,12,0,0,3,4,0,1,10,61,71
p_198,0,9,e_0,369,485,524,2,1,0,1,4,0,1,116,39,155
p_197,0,10,e_0,370,485,529,1,1,0,1,4,0,1,115,44,159
p_113,0,1,e_3,489,524,529,11,1,0,11,4,0,1,35,5,40
p_207,0,11,e_0,359,485,534,5,1,0,4,4,0,1,126,49,175
p_114,0,3,e_3,488,524,537,12,1,0,12,4,0,1,36,13,49
p_106,0,3,e_3,500,524,537,8,1,0,8,4,0,1,24,13,37
p_206,0,12,e_0,361,485,539,4,1,0,4,4,0,1,124,54,178
p_203,0,12,e_0,364,485,539,3,1,0,3,4,0,1,121,54,175
p_167,0,1,e_2,413,535,540,13,1,1,2,4,0,1,122,5,127
p_204,0,14,e_0,363,485,547,4,1,0,3,4,0,1,122,62,184
p_108,0,6,e_3,496,524,548,9,1,0,9,4,0,1,28,24,52
p_165,0,4,e_2,417,535,551,12,1,1,1,4,0,1,118,16,134
p_92,0,4,e_2,525,535,551,30,10,10,3,4,0,1,10,16,26
p_211,0,15,e_0,353,485,552,7,1,0,6,4,0,1,132,67,199
p_202,0,15,e_0,365,485,552,3,1,0,2,4,0,1,120,67,187
p_199,0,15,e_0,368,485,552,2,1,0,1,4,0,1,117,67,184
p_111,0,8,e_3,491,524,556,11,1,0,11,4,0,1,33,32,65
p_115,0,9,e_3,487,524,561,12,1,0,12,4,0,1,37,37,74
p_117,0,10,e_3,485,524,566,12,0,0,12,3,0,0,39,42,81
p_116,0,10,e_3,486,524,566,12,1,0,12,4,0,1,38,42,80
p_169,0,9,e_2,411,535,568,14,2,2,3,4,0,1,124,33,157
p_146,0,1,e_1,453,562,569,12,0,0,0,3,0,0,109,7,116
p_112,0,11,e_3,490,524,571,11,1,0,11,4,0,1,34,47,81
p_110,0,11,e_3,492,524,571,10,1,0,10,4,0,1,32,47,79
p_107,0,11,e_3,499,524,571,8,1,0,8,4,0,1,25,47,72
p_103,0,11,e_3,508,524,571,5,1,0,5,4,0,1,16,47,63
p_163,0,10,e_2,419,535,573,12,0,0,0,4,0,1,116,38,154
p_86,0,2,e_1,544,562,574,25,9,9,6,4,0,1,18,12,30
p_105,0,12,e_3,502,524,576,7,1,0,7,4,0,1,22,52,74
p_173,0,11,e_2,407,535,578,15,2,2,4,4,0,1,128,43,171
p_164,0,11,e_2,418,535,578,12,0,0,1,4,0,1,117,43,160
p_162,0,11,e_2,420,535,578,12,0,0,0,3,0,0,115,43,158
p_77,0,3,e_1,557,562,579,22,7,7,1,4,0,1,5,17,22
p_166,0,12,e_2,416,535,583,13,1,1,1,4,0,1,119,48,167
p_104,0,14,e_3,503,524,584,7,1,0,7,4,0,1,21,60,81
p_88,0,5,e_1,538,562,587,27,9,9,8,4,0,1,24,25,49
p_171,0,13,e_2,409,535,588,14,2,2,4,4,0,1,126,53,179
p_168,0,13,e_2,412,535,588,13,2,2,3,4,0,1,123,53,176
p_109,0,15,e_3,493,524,589,10,1,0,10,4,0,1,31,65,96
p_76,0,6,e_1,558,562,592,22,7,7,1,4,0,1,4,30,34
p_175,0,14,e_2,405,535,593,16,2,2,5,4,0,1,130,58,188
p_174,0,14,e_2,406,535,593,15,2,2,5,4,0,1,129,58,187
p_170,0,14,e_2,410,535,593,14,2,2,3,4,0,1,125,58,183
p_80,0,7,e_1,552,562,597,23,8,8,3,4,0,1,10,35,45
p_172,0,15,e_2,408,535,598,15,2,2,4,4,0,1,127,63,190
p_87,0,8,e_1,539,562,602,27,9,9,7,4,0,1,23,40,63
p_83,0,8,e_1,549,562,602,24,8,8,4,4,0,1,13,40,53
p_89,0,9,e_1,535,562,607,27,10,10,9,4,0,1,27,45,72
p_143,0,3,e_0,456,599,612,12,0,0,9,4,0,1,143,13,156
p_136,0,3,e_0,465,599,612,12,0,0,6,4,0,1,134,13,147
p_196,0,4,e_0,371,599,617,1,1,0,0,4,0,1,228,18,246
p_137,0,4,e_0,464,599,617,12,0,0,7,4,0,1,135,18,153
p_84,0,12,e_1,546,562,618,24,9,9,5,4,0,1,16,56,72
p_78,0,12,e_1,556,562,618,22,7,7,2,4,0,1,6,56,62
p_141,0,6,e_0,458,599,625,12,0,0,9,4,0,1,141,26,167
p_82,0,14,e_1,550,562,626,24,8,8,4,4,0,1,12,64,76
p_81,0,14,e_1,551,562,626,23,8,8,3,4,0,1,11,64,75
p_79,0,14,e_1,553,562,626,23,8,8,3,4,0,1,9,64,73
p_85,0,15,e_1,545,562,631,25,9,9,5,4,0,1,17,69,86
p_140,0,8,e_0,459,599,633,12,0,0,8,4,0,1,140,34,174
p_144,0,9,e_0,455,599,638,12,0,0,10,4,0,1,144,39,183
p_142,0,9,e_0,457,599,638,12,0,0,9,4,0,1,142,39,181
p_96,0,1,e_3,517,636,641,2,1,0,2,4,0,1,119,5,124
p_139,0,10,e_0,461,599,643,12,0,0,8,4,0,1,138,44,182
p_135,0,10,e_0,466,599,643,12,0,0,6,4,0,1,133,44,177
p_145,0,11,e_0,454,599,648,12,0,0,10,4,0,1,145,49,194
p_138,0,11,e_0,463,599,648,12,0,0,7,4,0,1,136,49,185
p_133,0,12,e_0,469,599,653,12,0,0,5,4,0,1,130,54,184
p_99,0,6,e_3,514,636,658,3,1,0,3,4,0,1,122,22,144
p_94,0,6,e_3,519,636,658,1,1,0,1,4,0,1,117,22,139
p_102,0,7,e_3,509,636,663,5,1,0,5,4,0,1,127,27,154
p_98,0,7,e_3,515,636,663,3,1,0,3,4,0,1,121,27,148
p_97,0,7,e_3,516,636,663,2,1,0,2,4,0,1,120,27,147
p_195,0,15,e_0,372,599,664,1,1,0,0,3,0,0,227,65,292
p_134,0,15,e_0,467,599,664,12,0,0,6,4,0,1,132,65,197
p_101,0,8,e_3,511,636,668,4,1,0,4,4,0,1,125,32,157
p_100,0,9,e_3,513,636,673,3,1,0,3,4,0,1,123,37,160
p_37,0,9,e_3,615,636,673,7,1,0,7,4,0,1,21,37,58
p_41,0,11,e_3,600,636,681,12,1,0,12,4,0,1,36,45,81
p_91,0,12,e_2,526,645,683,30,10,10,3,4,0,1,119,38,157
p_39,0,12,e_3,607,636,686,9,1,0,9,4,0,1,29,50,79
p_90,0,13,e_2,527,645,688,29,11,11,2,4,0,1,118,43,161
p_30,0,3,e_1,668,678,691,20,6,6,3,4,0,1,10,13,23
p_93,0,13,e_3,520,636,691,1,1,0,1,4,0,1,116,55,171
p_40,0,13,e_3,602,636,691,11,1,0,11,4,0,1,34,55,89
p_38,0,13,e_3,608,636,691,9,1,0,9,4,0,1,28,55,83
p_95,0,14,e_3,518,636,696,2,1,0,2,4,0,1,118,60,178
p_75,0,5,e_1,559,678,699,21,7,7,1,4,0,1,119,21,140
p_29,0,5,e_1,670,678,699,20,6,6,2,4,0,1,8,21,29
p_32,0,6,e_1,650,678,704,24,9,9,9,4,0,1,28,26,54
p_31,0,6,e_1,666,678,704,20,7,7,4,4,0,1,12,26,38
p_74,0,7,e_1,560,678,709,21,6,6,0,4,0,1,118,31,149
p_130,0,1,e_0,472,711,716,12,0,0,4,4,0,1,239,5,244
p_119,0,1,e_0,483,711,716,12,0,0,0,4,0,1,228,5,233
p_27,0,10,e_1,677,678,720,18,5,5,0,3,0,0,1,42,43
p_129,0,3,e_0,473,711,724,12,0,0,4,4,0,1,238,13,251
p_73,0,11,e_1,561,678,725,21,6,6,0,3,0,0,117,47,164
p_28,0,11,e_1,676,678,725,18,5,5,0,4,0,1,2,47,49
p_34,0,12,e_1,646,678,730,26,9,9,10,4,0,1,32,52,84
p_124,0,7,e_0,478,711,738,12,0,0,2,4,0,1,233,27,260
p_118,0,7,e_0,484,711,738,12,0,0,0,3,0,0,227,27,254
p_33,0,15,e_1,649,678,741,25,9,9,9,4,0,1,29,63,92
p_127,0,10,e_0,475,711,749,12,0,0,3,4,0,1,236,38,274
p_22,0,3,e_3,719,740,751,7,1,0,7,4,0,1,21,11,32
p_132,0,11,e_0,470,711,754,12,0,0,5,4,0,1,241,43,284
p_128,0,11,e_0,474,711,754,12,0,0,3,4,0,1,237,43,280
p_123,0,11,e_0,479,711,754,12,0,0,2,4,0,1,232,43,275
p_121,0,11,e_0,481,711,754,12,0,0,1,4,0,1,230,43,273
p_120,0,11,e_0,482,711,754,12,0,0,1,4,0,1,229,43,272
p_21,0,4,e_3,731,740,756,3,1,0,3,4,0,1,9,16,25
p_126,0,12,e_0,476,711,759,12,0,0,3,4,0,1,235,48,283
p_131,0,14,e_0,471,711,767,12,0,0,4,4,0,1,240,56,296
p_125,0,14,e_0,477,711,767,12,0,0,2,4,0,1,234,56,290
p_122,0,15,e_0,480,711,772,12,0,0,1,4,0,1,231,61,292
p_35,0,9,e_3,630,740,773,2,1,0,2,4,0,1,110,33,143
p_23,0,12,e_3,711,740,784,9,1,0,9,4,0,1,29,44,73
p_36,0,13,e_3,628,740,789,2,1,0,2,4,0,1,112,49,161
p_20,0,14,e_3,734,740,794,2,1,0,2,4,0,1,6,54,60
p_16,0,2,e_2,780,796,804,17,3,3,5,4,0,1,16,8,24
p_14,0,4,e_2,794,796,812,14,0,0,0,4,0,1,2,16,18
p_65,0,1,e_0,573,819,824,19,4,4,8,4,0,1,246,5,251
p_15,0,9,e_2,793,796,829,14,0,0,1,4,0,1,3,33,36
p_72,0,3,e_0,562,819,832,21,6,6,12,4,0,1,257,13,270
p_71,0,3,e_0,564,819,832,20,6,6,11,4,0,1,255,13,268
p_70,0,3,e_0,565,819,832,20,5,5,11,4,0,1,254,13,267
p_67,0,3,e_0,568,819,832,20,5,5,10,4,0,1,251,13,264
p_66,0,3,e_0,569,819,832,19,5,5,10,4,0,1,250,13,263
p_18,0,10,e_2,766,796,834,21,4,4,10,4,0,1,30,38,68
p_17,0,10,e_2,776,796,834,18,3,3,6,4,0,1,20,38,58
p_64,0,4,e_0,574,819,837,18,4,4,8,4,0,1,245,18,263
p_19,0,11,e_2,754,796,839,24,5,5,13,3,0,0,42,43,85
p_61,0,6,e_0,579,819,845,17,3,3,6,4,0,1,240,26,266
p_60,0,10,e_0,580,819,859,17,3,3,6,4,0,1,239,40,279
p_58,0,11,e_0,582,819,864,16,3,3,5,4,0,1,237,45,282
p_68,0,13,e_0,567,819,872,20,5,5,10,4,0,1,252,53,305
p_63,0,13,e_0,577,819,872,18,3,3,7,4,0,1,242,53,295
p_62,0,13,e_0,578,819,872,18,3,3,7,4,0,1,241,53,294
p_69,0,14,e_0,566,819,877,20,5,5,11,4,0,1,253,58,311
p_59,0,14,e_0,581,819,877,17,3,3,6,4,0,1,238,58,296
p_9,0,2,e_2,846,882,890,11,1,0,11,3,0,0,36,8,44
p_6,0,3,e_2,877,882,895,1,1,0,1,4,0,1,5,13,18
p_7,0,5,e_3,875,880,897,1,1,0,1,4,0,1,5,17,22
p_10,0,8,e_3,835,880,908,14,0,0,14,3,0,0,45,28,73
p_8,0,11,e_2,874,882,921,2,1,0,2,4,0,1,8,39,47
p_45,0,2,e_0,595,921,929,13,1,0,1,4,0,1,326,8,334
p_55,0,3,e_0,585,921,934,16,2,2,4,4,0,1,336,13,349
p_54,0,3,e_0,586,921,934,16,2,2,4,4,0,1,335,13,348
p_52,0,3,e_0,588,921,934,15,1,1,3,4,0,1,333,13,346
p_48,0,4,e_0,592,921,939,14,1,0,2,4,0,1,329,18,347
p_46,0,4,e_0,594,921,939,14,1,0,1,4,0,1,327,18,345
p_56,0,6,e_0,584,921,947,16,2,2,5,4,0,1,337,26,363
p_50,0,7,e_0,590,921,952,15,1,0,3,4,0,1,331,31,362
p_43,0,7,e_0,597,921,952,13,1,0,0,4,0,1,324,31,355
p_44,0,8,e_0,596,921,957,13,1,0,1,4,0,1,325,36,361
p_53,0,9,e_0,587,921,962,15,2,2,4,4,0,1,334,41,375
p_51,0,9,e_0,589,921,962,15,1,0,3,4,0,1,332,41,373
p_47,0,9,e_0,593,921,962,14,1,0,2,4,0,1,328,41,369
p_57,0,11,e_0,583,921,970,16,2,2,5,4,0,1,338,49,387
p_49,0,14,e_0,591,921,981,15,1,0,2,4,0,1,330,60,390
p_4,0,1,e_0,886,1025,1030,14,2,2,11,4,0,1,139,5,144
p_24,0,2,e_0,695,1025,1035,14,1,1,5,4,0,1,330,10,340
p_1,0,5,e_0,894,1025,1046,12,2,2,9,4,0,1,131,21,152
p_42,0,6,e_0,598,1025,1051,12,1,0,0,3,0,0,427,26,453
p_26,0,8,e_0,684,1025,1059,16,4,4,9,4,0,1,341,34,375
p_25,0,8,e_0,686,1025,1059,16,3,3,8,4,0,1,339,34,373
p_5,0,8,e_0,883,1025,1059,15,2,2,12,4,0,1,142,34,176
p_3,0,8,e_0,888,1025,1059,14,2,2,11,4,0,1,137,34,171
p_11,0,9,e_0,807,1025,1064,14,0,0,4,4,0,1,218,39,257
p_13,0,11,e_0,796,1025,1072,14,0,0,7,4,0,1,229,47,276
p_12,0,11,e_0,798,1025,1072,14,0,0,7,4,0,1,227,47,274
p_2,0,11,e_0,892,1025,1072,12,2,2,9,4,0,1,133,47,180
p_300,0,4,e_0,8,9,25,0,0,0,0,3,0,0,1,16,17
p_299,0,5,e_1,9,10,29,0,0,0,0,3,0,0,1,19,20
p_297,0,6,e_3,15,16,38,0,0,0,0,3,0,0,1,22,23
p_298,0,9,e_2,11,12,43,0,0,0,0,3,0,0,1,31,32
p_296,0,4,e_0,28,43,57,9,1,1,4,3,0,0,15,14,29
p_295,0,5,e_0,29,43,62,9,1,1,4,4,0,1,14,19,33
p_292,0,6,e_0,38,43,67,6,0,0,1,4,0,1,5,24,29
p_290,0,6,e_0,40,43,67,6,0,0,1,4,0,1,3,24,27
p_286,0,3,e_1,46,61,72,6,0,0,5,4,0,1,15,11,26
p_289,0,4,e_1,43,61,77,6,0,0,5,3,0,0,18,16,34
p_285,0,4,e_1,53,61,77,6,0,0,2,4,0,1,8,16,24
p_284,0,4,e_1,54,61,77,6,0,0,2,4,0,1,7,16,23
p_287,0,5,e_1,45,61,82,6,0,0,5,4,0,1,16,21,37
p_291,0,11,e_0,39,43,84,6,0,0,1,4,0,1,4,41,45
p_294,0,12,e_0,31,43,89,8,1,1,4,4,0,1,12,46,58
p_293,0,12,e_0,33,43,89,7,1,1,3,4,0,1,10,46,56
p_288,0,8,e_1,44,61,93,6,0,0,5,4,0,1,17,32,49
p_281,0,1,e_3,73,87,94,4,1,0,4,4,0,1,14,7,21
p_283,0,9,e_1,57,61,98,6,0,0,1,4,0,1,4,37,41
p_278,0,2,e_3,77,87,99,3,1,0,3,4,0,1,10,12,22
p_279,0,5,e_3,76,87,110,3,1,0,3,4,0,1,11,23,34
p_277,0,6,e_3,82,87,115,1,1,0,1,4,0,1,5,28,33
p_282,0,7,e_3,66,87,120,6,0,0,6,3,0,0,21,33,54
p_273,0,4,e_2,110,118,132,23,4,4,2,4,0,1,8,14,22
p_276,0,11,e_3,84,87,134,1,1,0,1,4,0,1,3,47,50
p_280,0,14,e_3,75,87,145,4,1,0,4,4,0,1,12,58,70
p_275,0,14,e_3,86,87,145,0,0,0,0,3,0,0,1,58,59
p_274,0,8,e_2,88,118,146,28,7,7,9,3,0,0,30,28,58
p_272,0,10,e_2,113,118,154,22,4,4,1,4,0,1,5,36,41
p_271,0,1,e_1,121,151,156,21,2,2,9,3,0,0,30,5,35
p_267,0,1,e_1,148,151,156,14,0,0,1,4,0,1,3,5,8
p_268,0,2,e_1,144,151,161,14,0,0,2,4,0,1,7,10,17
p_270,0,9,e_1,122,151,184,21,2,2,9,4,0,1,29,33,62
p_269,0,9,e_1,127,151,184,19,2,2,8,4,0,1,24,33,57
p_255,0,3,e_2,184,186,197,14,0,0,0,4,0,1,2,11,13
p_265,0,4,e_0,152,190,204,14,0,0,12,4,0,1,38,14,52
p_254,0,4,e_0,187,190,204,14,0,0,1,4,0,1,3,14,17
p_262,0,5,e_2,157,186,205,14,0,0,9,4,0,1,29,19,48
p_261,0,5,e_2,164,186,205,14,0,0,7,4,0,1,22,19,41
p_266,0,6,e_0,151,190,212,14,0,0,12,3,0,0,39,22,61
p_263,0,7,e_2,154,186,213,14,0,0,10,4,0,1,32,27,59
p_260,0,7,e_2,165,186,213,14,0,0,7,4,0,1,21,27,48
p_258,0,7,e_2,168,186,213,14,0,0,6,4,0,1,18,27,45
p_256,0,10,e_2,182,186,224,14,0,0,1,4,0,1,4,38,42
p_250,0,2,e_1,217,220,228,14,0,0,1,4,0,1,3,8,11
p_264,0,11,e_2,153,186,229,14,0,0,10,2,1,0,33,43,76
p_253,0,5,e_1,190,220,239,14,0,0,9,3,0,0,30,19,49
p_252,0,5,e_1,205,220,239,14,0,0,5,4,0,1,15,19,34
p_257,0,14,e_2,169,186,240,14,0,0,5,4,0,1,17,54,71
p_259,0,15,e_2,167,186,245,14,0,0,6,4,0,1,19,59,78
p_251,0,15,e_1,209,220,271,14,0,0,3,4,0,1,11,51,62
p_248,0,5,e_0,246,260,277,14,0,0,4,4,0,1,14,17,31
p_247,0,5,e_0,250,260,277,14,0,0,3,4,0,1,10,17,27
p_249,0,6,e_0,239,260,282,14,0,0,6,3,0,0,21,22,43
p_241,0,1,e_0,283,302,309,8,1,0,6,4,0,1,19,7,26
p_236,0,1,e_3,305,307,312,0,1,0,0,4,0,1,2,5,7
p_242,0,8,e_0,277,302,332,10,1,0,5,5,1,0,25,30,55
p_245,0,7,e_3,269,307,332,12,1,0,12,4,0,1,38,25,63
p_237,0,7,e_3,304,307,332,1,1,0,1,4,0,1,3,25,28
p_240,0,9,e_0,301,302,337,2,1,0,0,3,0,0,1,35,36
p_246,0,10,e_3,262,307,343,14,0,0,14,3,0,0,45,36,81
p_239,0,11,e_3,302,307,348,1,1,0,1,4,0,1,5,41,46
p_244,0,12,e_3,271,307,353,12,1,0,12,4,0,1,36,46,82
p_238,0,13,e_3,303,307,358,1,1,0,1,4,0,1,4,51,55
p_233,0,1,e_1,311,356,361,29,6,6,15,4,0,1,45,5,50
p_226,0,2,e_1,329,356,366,24,6,6,9,4,0,1,27,10,37
p_223,0,2,e_1,336,356,366,22,5,5,6,4,0,1,20,10,30
p_243,0,15,e_3,272,307,366,11,1,0,11,4,0,1,35,59,94
p_209,0,2,e_2,357,358,368,17,1,1,0,3,0,0,1,10,11
p_230,0,3,e_1,319,356,371,27,6,6,12,4,0,1,37,15,52
p_228,0,4,e_1,325,356,376,25,6,6,10,4,0,1,31,20,51
p_232,0,5,e_1,314,356,381,29,6,6,14,4,0,1,42,25,67
p_225,0,5,e_1,330,356,381,23,6,6,8,4,0,1,26,25,51
p_224,0,5,e_1,331,356,381,23,5,5,8,4,0,1,25,25,50
p_222,0,5,e_1,337,356,381,22,5,5,6,4,0,1,19,25,44
p_221,0,6,e_1,339,356,386,21,5,5,5,4,0,1,17,30,47
p_220,0,6,e_1,341,356,386,20,5,5,5,4,0,1,15,30,45
p_234,0,8,e_2,310,358,388,29,7,7,15,3,0,0,48,30,78
p_231,0,7,e_1,317,356,391,28,6,6,13,4,0,1,39,35,74
p_205,0,2,e_0,362,388,396,16,1,1,8,4,0,1,26,8,34
p_235,0,8,e_1,308,356,396,30,7,7,15,3,0,0,48,40,88
p_200,0,4,e_0,367,388,404,15,0,0,7,4,0,1,21,16,37
p_196,0,4,e_0,371,388,404,15,0,0,5,4,0,1,17,16,33
p_201,0,5,e_0,366,388,409,15,0,0,7,4,0,1,22,21,43
p_227,0,12,e_1,327,356,410,24,6,6,9,4,0,1,29,54,83
p_208,0,6,e_0,358,388,414,17,1,1,9,3,0,0,30,26,56
p_194,0,6,e_0,373,388,414,15,0,0,5,4,0,1,15,26,41
p_229,0,13,e_1,320,356,415,27,6,6,12,4,0,1,36,59,95
p_183,0,1,e_2,396,416,421,15,0,0,6,4,0,1,20,5,25
p_198,0,9,e_0,369,388,425,15,0,0,6,4,0,1,19,37,56
p_182,0,2,e_2,397,416,426,15,0,0,6,4,0,1,19,10,29
p_180,0,2,e_2,399,416,426,15,0,0,5,4,0,1,17,10,27
p_197,0,10,e_0,370,388,430,15,0,0,6,4,0,1,18,42,60
p_178,0,3,e_2,401,416,431,15,0,0,5,4,0,1,15,15,30
p_207,0,11,e_0,359,388,435,17,1,1,9,4,0,1,29,47,76
p_186,0,4,e_2,390,416,436,15,0,0,8,4,0,1,26,20,46
p_176,0,4,e_2,403,416,436,15,0,0,4,4,0,1,13,20,33
p_206,0,12,e_0,361,388,440,16,1,1,9,4,0,1,27,52,79
p_203,0,12,e_0,364,388,440,15,1,1,8,4,0,1,24,52,76
p_204,0,14,e_0,363,388,448,16,1,1,8,4,0,1,25,60,85
p_179,0,8,e_2,400,416,450,15,0,0,5,4,0,1,16,34,50
p_202,0,15,e_0,365,388,453,15,0,0,7,4,0,1,23,65,88
p_199,0,15,e_0,368,388,453,15,0,0,6,4,0,1,20,65,85
p_195,0,15,e_0,372,388,453,15,0,0,5,4,0,1,16,65,81
p_177,0,9,e_2,402,416,455,15,0,0,4,4,0,1,14,39,53
p_185,0,10,e_2,391,416,460,15,0,0,8,4,0,1,25,44,69
p_216,0,1,e_1,347,456,463,19,3,3,3,4,0,1,109,7,116
p_173,0,11,e_2,407,416,465,15,0,0,3,4,0,1,9,49,58
p_187,0,12,e_2,389,416,470,15,0,0,8,3,0,0,27,54,81
p_184,0,12,e_2,392,416,470,15,0,0,8,4,0,1,24,54,78
p_214,0,3,e_1,349,456,471,19,3,3,2,4,0,1,107,15,122
p_165,0,4,e_1,417,456,476,15,0,0,13,4,0,1,39,20,59
p_175,0,14,e_2,405,416,478,15,0,0,3,4,0,1,11,62,73
p_174,0,14,e_2,406,416,478,15,0,0,3,4,0,1,10,62,72
p_219,0,5,e_1,342,456,481,20,4,4,4,4,0,1,114,25,139
p_181,0,15,e_2,398,416,483,15,0,0,6,4,0,1,18,67,85
p_210,0,6,e_1,354,456,486,18,2,2,0,4,0,1,102,30,132
p_217,0,7,e_1,346,456,491,19,4,4,3,4,0,1,110,35,145
p_212,0,7,e_1,351,456,491,18,3,3,1,4,0,1,105,35,140
p_163,0,10,e_1,419,456,502,15,0,0,12,4,0,1,37,46,83
p_190,0,1,e_0,379,500,507,15,0,0,3,4,0,1,121,7,128
p_218,0,11,e_1,343,456,507,20,4,4,4,4,0,1,113,51,164
p_164,0,11,e_1,418,456,507,15,0,0,12,4,0,1,38,51,89
p_162,0,11,e_1,420,456,507,15,0,0,12,4,0,1,36,51,87
p_166,0,12,e_1,416,456,512,15,0,0,13,4,0,1,40,56,96
p_143,0,3,e_0,456,500,515,15,0,0,14,4,0,1,44,15,59
p_136,0,3,e_0,465,500,515,15,0,0,11,4,0,1,35,15,50
p_137,0,4,e_0,464,500,520,15,0,0,12,4,0,1,36,20,56
p_215,0,15,e_1,348,456,523,19,3,3,2,4,0,1,108,67,175
p_213,0,15,e_1,350,456,523,19,3,3,2,4,0,1,106,67,173
p_211,0,15,e_1,353,456,523,18,2,2,1,4,0,1,103,67,170
p_141,0,6,e_0,458,500,528,15,0,0,14,4,0,1,42,28,70
p_167,0,1,e_2,413,530,535,15,0,0,1,4,0,1,117,5,122
p_192,0,8,e_0,375,500,536,15,0,0,4,4,0,1,125,36,161
p_189,0,8,e_0,382,500,536,15,0,0,2,4,0,1,118,36,154
p_140,0,8,e_0,459,500,536,15,0,0,13,4,0,1,41,36,77
p_142,0,9,e_0,457,500,541,15,0,0,14,4,0,1,43,41,84
p_106,0,3,e_2,500,530,543,15,0,0,10,4,0,1,30,13,43
p_191,0,10,e_0,376,500,546,15,0,0,4,4,0,1,124,46,170
p_139,0,10,e_0,461,500,546,15,0,0,13,4,0,1,39,46,85
p_135,0,10,e_0,466,500,546,15,0,0,11,4,0,1,34,46,80
p_193,0,11,e_0,374,500,551,15,0,0,4,4,0,1,126,51,177
p_138,0,11,e_0,463,500,551,15,0,0,12,4,0,1,37,51,88
p_99,0,6,e_2,514,530,554,15,0,0,5,4,0,1,16,24,40
p_188,0,13,e_0,384,500,559,15,0,0,1,4,0,1,116,59,175
p_102,0,7,e_2,509,530,559,15,0,0,7,4,0,1,21,29,50
p_98,0,7,e_2,515,530,559,15,0,0,5,4,0,1,15,29,44
p_101,0,8,e_2,511,530,564,15,0,0,6,4,0,1,19,34,53
p_169,0,9,e_2,411,530,569,15,0,0,1,4,0,1,119,39,158
p_100,0,9,e_2,513,530,569,15,0,0,5,4,0,1,17,39,56
p_161,0,1,e_1,421,570,577,15,0,0,11,4,0,1,149,7,156
p_158,0,1,e_1,430,570,577,15,0,0,8,4,0,1,140,7,147
p_103,0,11,e_2,508,530,577,15,0,0,7,4,0,1,22,47,69
p_105,0,12,e_2,502,530,582,15,0,0,9,4,0,1,28,52,80
p_171,0,13,e_2,409,530,587,15,0,0,2,4,0,1,121,57,178
p_168,0,13,e_2,412,530,587,15,0,0,1,4,0,1,118,57,175
p_170,0,14,e_2,410,530,592,15,0,0,2,4,0,1,120,62,182
p_104,0,14,e_2,503,530,592,15,0,0,9,4,0,1,27,62,89
p_159,0,6,e_1,429,570,594,15,0,0,9,4,0,1,141,24,165
p_150,0,6,e_1,443,570,594,15,0,0,4,4,0,1,127,24,151
p_172,0,15,e_2,408,530,597,15,0,0,2,4,0,1,122,67,189
p_154,0,7,e_1,436,570,599,15,0,0,6,4,0,1,134,29,163
p_148,0,8,e_1,449,570,604,15,0,0,2,4,0,1,121,34,155
p_130,0,1,e_0,472,600,605,15,0,0,9,4,0,1,128,5,133
p_153,0,9,e_1,437,570,609,15,0,0,6,4,0,1,133,39,172
p_147,0,9,e_1,452,570,609,15,0,0,1,4,0,1,118,39,157
p_129,0,3,e_0,473,600,613,15,0,0,9,4,0,1,127,13,140
p_157,0,14,e_1,431,570,626,15,0,0,8,4,0,1,139,56,195
p_155,0,14,e_1,435,570,626,15,0,0,7,4,0,1,135,56,191
p_124,0,7,e_0,478,600,627,15,0,0,7,4,0,1,122,27,149
p_160,0,15,e_1,426,570,631,15,0,0,10,4,0,1,144,61,205
p_156,0,15,e_1,434,570,631,15,0,0,7,4,0,1,136,61,197
p_152,0,15,e_1,441,570,631,15,0,0,5,4,0,1,129,61,190
p_151,0,15,e_1,442,570,631,15,0,0,4,4,0,1,128,61,189
p_149,0,15,e_1,444,570,631,15,0,0,4,4,0,1,126,61,187
p_127,0,10,e_0,475,600,638,15,0,0,8,4,0,1,125,38,163
p_132,0,11,e_0,470,600,643,15,0,0,10,4,0,1,130,43,173
p_128,0,11,e_0,474,600,643,15,0,0,8,4,0,1,126,43,169
p_123,0,11,e_0,479,600,643,15,0,0,7,4,0,1,121,43,164
p_121,0,11,e_0,481,600,643,15,0,0,6,4,0,1,119,43,162
p_120,0,11,e_0,482,600,643,15,0,0,6,4,0,1,118,43,161
p_133,0,12,e_0,469,600,648,15,0,0,10,4,0,1,131,48,179
p_126,0,12,e_0,476,600,648,15,0,0,8,4,0,1,124,48,172
p_96,0,1,e_2,517,644,649,15,0,0,4,4,0,1,127,5,132
p_131,0,14,e_0,471,600,656,15,0,0,9,4,0,1,129,56,185
p_125,0,14,e_0,477,600,656,15,0,0,7,4,0,1,123,56,179
p_92,0,4,e_2,525,644,660,15,0,0,1,4,0,1,119,16,135
p_134,0,15,e_0,467,600,661,15,0,0,11,4,0,1,133,61,194
p_122,0,15,e_0,480,600,661,15,0,0,6,4,0,1,120,61,181
p_94,0,6,e_2,519,644,668,15,0,0,3,4,0,1,125,24,149
p_97,0,7,e_2,516,644,673,15,0,0,4,4,0,1,128,29,157
p_37,0,9,e_2,615,644,681,15,0,0,9,4,0,1,29,37,66
p_35,0,9,e_2,630,644,681,15,0,0,4,4,0,1,14,37,51
p_146,0,1,e_1,453,678,685,15,0,0,1,4,0,1,225,7,232
p_41,0,11,e_2,600,644,689,15,0,0,14,4,0,1,44,45,89
p_86,0,2,e_1,544,678,690,15,0,0,8,4,0,1,134,12,146
p_91,0,12,e_2,526,644,694,15,0,0,1,4,0,1,118,50,168
p_39,0,12,e_2,607,644,694,15,0,0,12,4,0,1,37,50,87
p_93,0,13,e_2,520,644,699,15,0,0,3,4,0,1,124,55,179
p_90,0,13,e_2,527,644,699,15,0,0,1,4,0,1,117,55,172
p_40,0,13,e_2,602,644,699,15,0,0,14,4,0,1,42,55,97
p_38,0,13,e_2,608,644,699,15,0,0,12,4,0,1,36,55,91
p_36,0,13,e_2,628,644,699,15,0,0,5,4,0,1,16,55,71
p_88,0,5,e_1,538,678,701,15,0,0,10,4,0,1,140,23,163
p_95,0,14,e_2,518,644,704,15,0,0,4,4,0,1,126,60,186
p_80,0,7,e_1,552,678,709,15,0,0,6,4,0,1,126,31,157
p_119,0,1,e_0,483,708,713,15,0,0,5,4,0,1,225,5,230
p_113,0,1,e_0,489,708,713,15,0,0,3,4,0,1,219,5,224
p_65,0,1,e_0,573,708,713,15,0,0,9,4,0,1,135,5,140
p_87,0,8,e_1,539,678,714,15,0,0,10,4,0,1,139,36,175
p_83,0,8,e_1,549,678,714,15,0,0,7,4,0,1,129,36,165
p_144,0,9,e_1,455,678,719,15,0,0,0,3,0,0,223,41,264
p_89,0,9,e_1,535,678,719,15,0,0,11,4,0,1,143,41,184
p_114,0,3,e_0,488,708,721,15,0,0,4,4,0,1,220,13,233
p_64,0,4,e_0,574,708,726,15,0,0,8,4,0,1,134,18,152
p_145,0,11,e_1,454,678,727,15,0,0,0,4,0,1,224,49,273
p_84,0,12,e_1,546,678,732,15,0,0,8,4,0,1,132,54,186
p_78,0,12,e_1,556,678,732,15,0,0,4,4,0,1,122,54,176
p_108,0,6,e_0,496,708,734,15,0,0,1,4,0,1,212,26,238
p_118,0,7,e_0,484,708,739,15,0,0,5,4,0,1,224,31,255
p_82,0,14,e_1,550,678,740,15,0,0,6,4,0,1,128,62,190
p_81,0,14,e_1,551,678,740,15,0,0,6,4,0,1,127,62,189
p_79,0,14,e_1,553,678,740,15,0,0,5,4,0,1,125,62,187
p_111,0,8,e_0,491,708,744,15,0,0,3,4,0,1,217,36,253
p_85,0,15,e_1,545,678,745,15,0,0,8,4,0,1,133,67,200
p_115,0,9,e_0,487,708,749,15,0,0,4,4,0,1,221,41,262
p_117,0,10,e_0,485,708,754,15,0,0,5,4,0,1,223,46,269
p_116,0,10,e_0,486,708,754,15,0,0,4,4,0,1,222,46,268
p_112,0,11,e_0,490,708,759,15,0,0,3,4,0,1,218,51,269
p_110,0,11,e_0,492,708,759,15,0,0,2,4,0,1,216,51,267
p_107,0,11,e_0,499,708,759,15,0,0,0,3,0,0,209,51,260
p_22,0,3,e_2,719,756,767,15,0,0,12,4,0,1,37,11,48
p_21,0,4,e_2,731,756,772,15,0,0,8,4,0,1,25,16,41
p_109,0,15,e_0,493,708,773,15,0,0,2,4,0,1,215,65,280
p_19,0,11,e_2,754,756,795,15,0,0,0,4,0,1,2,39,41
p_23,0,12,e_2,711,756,800,15,0,0,14,3,0,0,45,44,89
p_77,0,3,e_1,557,792,803,15,0,0,4,4,0,1,235,11,246
p_72,0,3,e_1,562,792,803,15,0,0,2,4,0,1,230,11,241
p_71,0,3,e_1,564,792,803,15,0,0,2,4,0,1,228,11,239
p_70,0,3,e_1,565,792,803,15,0,0,1,4,0,1,227,11,238
p_67,0,3,e_1,568,792,803,15,0,0,0,4,0,1,224,11,235
p_66,0,3,e_1,569,792,803,15,0,0,0,3,0,0,223,11,234
p_20,0,14,e_2,734,756,808,15,0,0,7,4,0,1,22,52,74
p_75,0,5,e_1,559,792,811,15,0,0,3,4,0,1,233,19,252
p_76,0,6,e_1,558,792,816,15,0,0,4,4,0,1,234,24,258
p_32,0,6,e_1,650,792,816,15,0,0,9,4,0,1,142,24,166
p_74,0,7,e_1,560,792,821,15,0,0,3,4,0,1,232,29,261
p_55,0,3,e_0,585,820,831,15,0,0,5,4,0,1,235,11,246
p_54,0,3,e_0,586,820,831,15,0,0,4,4,0,1,234,11,245
p_52,0,3,e_0,588,820,831,15,0,0,4,4,0,1,232,11,243
p_73,0,11,e_1,561,792,835,15,0,0,3,4,0,1,231,43,274
p_34,0,12,e_1,646,792,840,15,0,0,10,4,0,1,146,48,194
p_61,0,6,e_0,579,820,842,15,0,0,7,4,0,1,241,22,263
p_56,0,6,e_0,584,820,842,15,0,0,5,4,0,1,236,22,258
p_68,0,13,e_1,567,792,845,15,0,0,1,4,0,1,225,53,278
p_50,0,7,e_0,590,820,847,15,0,0,3,4,0,1,230,27,257
p_69,0,14,e_1,566,792,850,15,0,0,1,4,0,1,226,58,284
p_53,0,9,e_0,587,820,855,15,0,0,4,4,0,1,233,35,268
p_51,0,9,e_0,589,820,855,15,0,0,3,4,0,1,231,35,266
p_33,0,15,e_1,649,792,855,15,0,0,9,4,0,1,143,63,206
p_60,0,10,e_0,580,820,860,15,0,0,6,4,0,1,240,40,280
p_58,0,11,e_0,582,820,865,15,0,0,6,4,0,1,238,45,283
p_57,0,11,e_0,583,820,865,15,0,0,5,4,0,1,237,45,282
p_63,0,13,e_0,577,820,873,15,0,0,7,4,0,1,243,53,296
p_62,0,13,e_0,578,820,873,15,0,0,7,4,0,1,242,53,295
p_59,0,14,e_0,581,820,878,15,0,0,6,4,0,1,239,58,297
p_49,0,14,e_0,591,820,878,15,0,0,3,4,0,1,229,58,287
p_9,0,2,e_2,846,880,888,15,0,0,11,4,0,1,34,8,42
p_6,0,3,e_2,877,880,893,15,0,0,1,4,0,1,3,13,16
p_7,0,5,e_2,875,880,901,15,0,0,1,4,0,1,5,21,26
p_4,0,1,e_1,886,902,907,15,0,0,5,4,0,1,16,5,21
p_16,0,2,e_1,780,902,912,15,0,0,4,4,0,1,122,10,132
p_10,0,8,e_2,835,880,912,15,0,0,14,3,0,0,45,32,77
p_30,0,3,e_1,668,902,917,15,0,0,3,4,0,1,234,15,249
p_8,0,11,e_2,874,880,923,15,0,0,2,4,0,1,6,43,49
p_29,0,5,e_1,670,902,925,15,0,0,2,4,0,1,232,23,255
p_1,0,5,e_1,894,902,925,15,0,0,2,4,0,1,8,23,31
p_45,0,2,e_0,595,922,930,15,0,0,1,4,0,1,327,8,335
p_24,0,2,e_0,695,922,930,15,0,0,4,4,0,1,227,8,235
p_31,0,6,e_1,666,902,930,15,0,0,4,4,0,1,236,28,264
p_48,0,4,e_0,592,922,938,15,0,0,2,4,0,1,330,16,346
p_46,0,4,e_0,594,922,938,15,0,0,2,4,0,1,328,16,344
p_14,0,4,e_0,794,922,938,15,0,0,8,4,0,1,128,16,144
p_5,0,8,e_1,883,902,938,15,0,0,6,4,0,1,19,36,55
p_3,0,8,e_1,888,902,938,15,0,0,4,4,0,1,14,36,50
p_42,0,6,e_0,598,922,946,15,0,0,0,4,0,1,324,24,348
p_27,0,10,e_1,677,902,946,15,0,0,0,3,0,0,225,44,269
p_18,0,10,e_1,766,902,946,15,0,0,8,4,0,1,136,44,180
p_17,0,10,e_1,776,902,946,15,0,0,5,4,0,1,126,44,170
p_43,0,7,e_0,597,922,951,15,0,0,1,4,0,1,325,29,354
p_28,0,11,e_1,676,902,951,15,0,0,0,4,0,1,226,49,275
p_2,0,11,e_1,892,902,951,15,0,0,3,4,0,1,10,49,59
p_44,0,8,e_0,596,922,956,15,0,0,1,4,0,1,326,34,360
p_26,0,8,e_0,684,922,956,15,0,0,8,4,0,1,238,34,272
p_25,0,8,e_0,686,922,956,15,0,0,7,4,0,1,236,34,270
p_47,0,9,e_0,593,922,961,15,0,0,2,4,0,1,329,39,368
p_15,0,9,e_0,793,922,961,15,0,0,9,4,0,1,129,39,168
p_11,0,9,e_0,807,922,961,15,0,0,4,4,0,1,115,39,154
p_13,0,11,e_0,796,922,969,15,0,0,8,4,0,1,126,47,173
p_12,0,11,e_0,798,922,969,15,0,0,7,4,0,1,124,47,171
p_300,0,4,e_0,8,9,25,0,0,0,0,3,0,0,1,16,17
p_299,0,5,e_1,9,10,29,0,0,0,0,3,0,0,1,19,20
p_297,0,6,e_3,15,16,38,0,0,0,0,3,0,0,1,22,23
p_298,0,9,e_2,11,12,43,0,0,0,0,3,0,0,1,31,32
p_296,0,4,e_0,28,43,57,9,1,1,4,3,0,0,15,14,29
p_295,0,5,e_0,29,43,62,9,1,1,4,4,0,1,14,19,33
p_292,0,6,e_0,38,43,67,6,0,0,1,4,0,1,5,24,29
p_290,0,6,e_0,40,43,67,6,0,0,1,4,0,1,3,24,27
p_286,0,3,e_1,46,61,72,6,0,0,5,4,0,1,15,11,26
p_289,0,4,e_1,43,61,77,6,0,0,5,3,0,0,18,16,34
p_285,0,4,e_1,53,61,77,6,0,0,2,4,0,1,8,16,24
p_284,0,4,e_1,54,61,77,6,0,0,2,4,0,1,7,16,23
p_287,0,5,e_1,45,61,82,6,0,0,5,4,0,1,16,21,37
p_291,0,11,e_0,39,43,84,6,0,0,1,4,0,1,4,41,45
p_294,0,12,e_0,31,43,89,8,1,1,4,4,0,1,12,46,58
p_293,0,12,e_0,33,43,89,7,1,1,3,4,0,1,10,46,56
p_288,0,8,e_1,44,61,93,6,0,0,5,4,0,1,17,32,49
p_281,0,1,e_3,73,87,94,4,1,0,4,4,0,1,14,7,21
p_283,0,9,e_1,57,61,98,6,0,0,1,4,0,1,4,37,41
p_278,0,2,e_3,77,87,99,3,1,0,3,4,0,1,10,12,22
p_279,0,5,e_3,76,87,110,3,1,0,3,4,0,1,11,23,34
p_277,0,6,e_3,82,87,115,1,1,0,1,4,0,1,5,28,33
p_282,0,7,e_3,66,87,120,6,0,0,6,3,0,0,21,33,54
p_273,0,4,e_2,110,118,132,23,4,4,2,4,0,1,8,14,22
p_276,0,11,e_3,84,87,134,1,1,0,1,4,0,1,3,47,50
p_280,0,14,e_3,75,87,145,4,1,0,4,4,0,1,12,58,70
p_275,0,14,e_3,86,87,145,0,0,0,0,3,0,0,1,58,59
p_274,0,8,e_2,88,118,146,28,7,7,9,3,0,0,30,28,58
p_272,0,10,e_2,113,118,154,22,4,4,1,4,0,1,5,36,41
p_271,0,1,e_1,121,151,156,21,2,2,9,3,0,0,30,5,35
p_267,0,1,e_1,148,151,156,14,0,0,1,4,0,1,3,5,8
p_268,0,2,e_1,144,151,161,14,0,0,2,4,0,1,7,10,17
p_270,0,9,e_1,122,151,184,21,2,2,9,4,0,1,29,33,62
p_269,0,9,e_1,127,151,184,19,2,2,8,4,0,1,24,33,57
p_255,0,3,e_2,184,186,197,14,0,0,0,4,0,1,2,11,13
p_265,0,4,e_2,152,186,202,14,0,0,10,5,1,0,34,16,50
p_254,0,4,e_0,187,190,204,14,0,0,1,4,0,1,3,14,17
p_262,0,5,e_2,157,186,207,14,0,0,9,4,0,1,29,21,50
p_261,0,5,e_2,164,186,207,14,0,0,7,4,0,1,22,21,43
p_266,0,6,e_0,151,190,212,14,0,0,12,3,0,0,39,22,61
p_263,0,7,e_2,154,186,215,14,0,0,10,4,0,1,32,29,61
p_260,0,7,e_2,165,186,215,14,0,0,7,4,0,1,21,29,50
p_258,0,7,e_2,168,186,215,14,0,0,6,4,0,1,18,29,47
p_256,0,10,e_2,182,186,226,14,0,0,1,4,0,1,4,40,44
p_250,0,2,e_1,217,220,228,14,0,0,1,4,0,1,3,8,11
p_264,0,11,e_2,153,186,231,14,0,0,10,2,1,1,33,45,78
p_253,0,5,e_1,190,220,239,14,0,0,9,3,0,0,30,19,49
p_252,0,5,e_1,205,220,239,14,0,0,5,4,0,1,15,19,34
p_257,0,14,e_2,169,186,242,14,0,0,5,4,0,1,17,56,73
p_259,0,15,e_2,167,186,247,14,0,0,6,4,0,1,19,61,80
p_251,0,15,e_1,209,220,271,14,0,0,3,4,0,1,11,51,62
p_248,0,5,e_0,246,260,277,14,0,0,4,4,0,1,14,17,31
p_247,0,5,e_0,250,260,277,14,0,0,3,4,0,1,10,17,27
p_249,0,6,e_0,239,260,282,14,0,0,6,3,0,0,21,22,43
p_241,0,1,e_0,283,302,309,8,1,0,6,4,0,1,19,7,26
p_236,0,1,e_3,305,307,312,0,1,0,0,4,0,1,2,5,7
p_245,0,7,e_0,269,302,329,12,1,0,3,5,2,0,33,27,60
p_237,0,7,e_3,304,307,332,1,1,0,1,4,0,1,3,25,28
p_242,0,8,e_0,277,302,334,10,1,0,5,5,1,1,25,32,57
p_240,0,9,e_0,301,302,339,2,1,0,0,3,0,0,1,37,38
p_246,0,10,e_3,262,307,343,14,0,0,14,3,0,0,45,36,81
p_239,0,11,e_3,302,307,348,1,1,0,1,4,0,1,5,41,46
p_244,0,12,e_3,271,307,353,12,1,0,12,4,0,1,36,46,82
p_238,0,13,e_3,303,307,358,1,1,0,1,4,0,1,4,51,55
p_233,0,1,e_1,311,356,361,29,6,6,15,4,0,1,45,5,50
p_226,0,2,e_1,329,356,366,24,6,6,9,4,0,1,27,10,37
p_223,0,2,e_1,336,356,366,22,5,5,6,4,0,1,20,10,30
p_243,0,15,e_3,272,307,366,11,1,0,11,4,0,1,35,59,94
p_209,0,2,e_2,357,358,368,17,1,1,0,3,0,0,1,10,11
p_230,0,3,e_1,319,356,371,27,6,6,12,4,0,1,37,15,52
p_228,0,4,e_1,325,356,376,25,6,6,10,4,0,1,31,20,51
p_232,0,5,e_1,314,356,381,29,6,6,14,4,0,1,42,25,67
p_225,0,5,e_1,330,356,381,23,6,6,8,4,0,1,26,25,51
p_224,0,5,e_1,331,356,381,23,5,5,8,4,0,1,25,25,50
p_222,0,5,e_1,337,356,381,22,5,5,6,4,0,1,19,25,44
p_221,0,6,e_1,339,356,386,21,5,5,5,4,0,1,17,30,47
p_220,0,6,e_1,341,356,386,20,5,5,5,4,0,1,15,30,45
p_234,0,8,e_2,310,358,388,29,7,7,15,3,0,0,48,30,78
p_231,0,7,e_1,317,356,391,28,6,6,13,4,0,1,39,35,74
p_205,0,2,e_0,362,388,396,16,1,1,8,4,0,1,26,8,34
p_235,0,8,e_1,308,356,396,30,7,7,15,3,0,0,48,40,88
p_200,0,4,e_0,367,388,404,15,0,0,7,4,0,1,21,16,37
p_196,0,4,e_0,371,388,404,15,0,0,5,4,0,1,17,16,33
p_201,0,5,e_0,366,388,409,15,0,0,7,4,0,1,22,21,43
p_227,0,12,e_1,327,356,410,24,6,6,9,4,0,1,29,54,83
p_208,0,6,e_0,358,388,414,17,1,1,9,3,0,0,30,26,56
p_194,0,6,e_0,373,388,414,15,0,0,5,4,0,1,15,26,41
p_229,0,13,e_1,320,356,415,27,6,6,12,4,0,1,36,59,95
p_183,0,1,e_2,396,416,421,15,0,0,6,4,0,1,20,5,25
p_198,0,9,e_0,369,388,425,15,0,0,6,4,0,1,19,37,56
p_182,0,2,e_2,397,416,426,15,0,0,6,4,0,1,19,10,29
p_180,0,2,e_2,399,416,426,15,0,0,5,4,0,1,17,10,27
p_197,0,10,e_0,370,388,430,15,0,0,6,4,0,1,18,42,60
p_178,0,3,e_2,401,416,431,15,0,0,5,4,0,1,15,15,30
p_207,0,11,e_0,359,388,435,17,1,1,9,4,0,1,29,47,76
p_186,0,4,e_2,390,416,436,15,0,0,8,4,0,1,26,20,46
p_176,0,4,e_2,403,416,436,15,0,0,4,4,0,1,13,20,33
p_206,0,12,e_0,361,388,440,16,1,1,9,4,0,1,27,52,79
p_203,0,12,e_0,364,388,440,15,1,1,8,4,0,1,24,52,76
p_204,0,14,e_0,363,388,448,16,1,1,8,4,0,1,25,60,85
p_179,0,8,e_2,400,416,450,15,0,0,5,4,0,1,16,34,50
p_202,0,15,e_0,365,388,453,15,0,0,7,4,0,1,23,65,88
p_199,0,15,e_0,368,388,453,15,0,0,6,4,0,1,20,65,85
p_195,0,15,e_0,372,388,453,15,0,0,5,4,0,1,16,65,81
p_177,0,9,e_2,402,416,455,15,0,0,4,4,0,1,14,39,53
p_185,0,10,e_2,391,416,460,15,0,0,8,4,0,1,25,44,69
p_216,0,1,e_1,347,456,463,19,3,3,3,4,0,1,109,7,116
p_173,0,11,e_2,407,416,465,15,0,0,3,4,0,1,9,49,58
p_187,0,12,e_2,389,416,470,15,0,0,8,3,0,0,27,54,81
p_184,0,12,e_2,392,416,470,15,0,0,8,4,0,1,24,54,78
p_214,0,3,e_1,349,456,471,19,3,3,2,4,0,1,107,15,122
p_165,0,4,e_1,417,456,476,15,0,0,13,4,0,1,39,20,59
p_175,0,14,e_2,405,416,478,15,0,0,3,4,0,1,11,62,73
p_174,0,14,e_2,406,416,478,15,0,0,3,4,0,1,10,62,72
p_219,0,5,e_1,342,456,481,20,4,4,4,4,0,1,114,25,139
p_181,0,15,e_2,398,416,483,15,0,0,6,4,0,1,18,67,85
p_210,0,6,e_1,354,456,486,18,2,2,0,4,0,1,102,30,132
p_217,0,7,e_1,346,456,491,19,4,4,3,4,0,1,110,35,145
p_212,0,7,e_1,351,456,491,18,3,3,1,4,0,1,105,35,140
p_163,0,10,e_1,419,456,502,15,0,0,12,4,0,1,37,46,83
p_190,0,1,e_0,379,500,507,15,0,0,3,4,0,1,121,7,128
p_218,0,11,e_1,343,456,507,20,4,4,4,4,0,1,113,51,164
p_164,0,11,e_1,418,456,507,15,0,0,12,4,0,1,38,51,89
p_162,0,11,e_1,420,456,507,15,0,0,12,4,0,1,36,51,87
p_166,0,12,e_1,416,456,512,15,0,0,13,4,0,1,40,56,96
p_143,0,3,e_0,456,500,515,15,0,0,14,4,0,1,44,15,59
p_136,0,3,e_0,465,500,515,15,0,0,11,4,0,1,35,15,50
p_137,0,4,e_0,464,500,520,15,0,0,12,4,0,1,36,20,56
p_215,0,15,e_1,348,456,523,19,3,3,2,4,0,1,108,67,175
p_213,0,15,e_1,350,456,523,19,3,3,2,4,0,1,106,67,173
p_211,0,15,e_1,353,456,523,18,2,2,1,4,0,1,103,67,170
p_141,0,6,e_0,458,500,528,15,0,0,14,4,0,1,42,28,70
p_167,0,1,e_2,413,530,535,15,0,0,1,4,0,1,117,5,122
p_192,0,8,e_0,375,500,536,15,0,0,4,4,0,1,125,36,161
p_189,0,8,e_0,382,500,536,15,0,0,2,4,0,1,118,36,154
p_140,0,8,e_0,459,500,536,15,0,0,13,4,0,1,41,36,77
p_142,0,9,e_0,457,500,541,15,0,0,14,4,0,1,43,41,84
p_106,0,3,e_2,500,530,543,15,0,0,10,4,0,1,30,13,43
p_191,0,10,e_0,376,500,546,15,0,0,4,4,0,1,124,46,170
p_139,0,10,e_0,461,500,546,15,0,0,13,4,0,1,39,46,85
p_135,0,10,e_0,466,500,546,15,0,0,11,4,0,1,34,46,80
p_193,0,11,e_0,374,500,551,15,0,0,4,4,0,1,126,51,177
p_138,0,11,e_0,463,500,551,15,0,0,12,4,0,1,37,51,88
p_99,0,6,e_2,514,530,554,15,0,0,5,4,0,1,16,24,40
p_188,0,13,e_0,384,500,559,15,0,0,1,4,0,1,116,59,175
p_102,0,7,e_2,509,530,559,15,0,0,7,4,0,1,21,29,50
p_98,0,7,e_2,515,530,559,15,0,0,5,4,0,1,15,29,44
p_101,0,8,e_2,511,530,564,15,0,0,6,4,0,1,19,34,53
p_169,0,9,e_2,411,530,569,15,0,0,1,4,0,1,119,39,158
p_100,0,9,e_2,513,530,569,15,0,0,5,4,0,1,17,39,56
p_161,0,1,e_1,421,570,577,15,0,0,11,4,0,1,149,7,156
p_158,0,1,e_1,430,570,577,15,0,0,8,4,0,1,140,7,147
p_103,0,11,e_2,508,530,577,15,0,0,7,4,0,1,22,47,69
p_105,0,12,e_2,502,530,582,15,0,0,9,4,0,1,28,52,80
p_171,0,13,e_2,409,530,587,15,0,0,2,4,0,1,121,57,178
p_168,0,13,e_2,412,530,587,15,0,0,1,4,0,1,118,57,175
p_170,0,14,e_2,410,530,592,15,0,0,2,4,0,1,120,62,182
p_104,0,14,e_2,503,530,592,15,0,0,9,4,0,1,27,62,89
p_159,0,6,e_1,429,570,594,15,0,0,9,4,0,1,141,24,165
p_150,0,6,e_1,443,570,594,15,0,0,4,4,0,1,127,24,151
p_172,0,15,e_2,408,530,597,15,0,0,2,4,0,1,122,67,189
p_154,0,7,e_1,436,570,599,15,0,0,6,4,0,1,134,29,163
p_148,0,8,e_1,449,570,604,15,0,0,2,4,0,1,121,34,155
p_130,0,1,e_0,472,600,605,15,0,0,9,4,0,1,128,5,133
p_153,0,9,e_1,437,570,609,15,0,0,6,4,0,1,133,39,172
p_147,0,9,e_1,452,570,609,15,0,0,1,4,0,1,118,39,157
p_129,0,3,e_0,473,600,613,15,0,0,9,4,0,1,127,13,140
p_157,0,14,e_1,431,570,626,15,0,0,8,4,0,1,139,56,195
p_155,0,14,e_1,435,570,626,15,0,0,7,4,0,1,135,56,191
p_124,0,7,e_0,478,600,627,15,0,0,7,4,0,1,122,27,149
p_160,0,15,e_1,426,570,631,15,0,0,10,4,0,1,144,61,205
p_156,0,15,e_1,434,570,631,15,0,0,7,4,0,1,136,61,197
p_152,0,15,e_1,441,570,631,15,0,0,5,4,0,1,129,61,190
p_151,0,15,e_1,442,570,631,15,0,0,4,4,0,1,128,61,189
p_149,0,15,e_1,444,570,631,15,0,0,4,4,0,1,126,61,187
p_127,0,10,e_0,475,600,638,15,0,0,8,4,0,1,125,38,163
p_132,0,11,e_0,470,600,643,15,0,0,10,4,0,1,130,43,173
p_128,0,11,e_0,474,600,643,15,0,0,8,4,0,1,126,43,169
p_123,0,11,e_0,479,600,643,15,0,0,7,4,0,1,121,43,164
p_121,0,11,e_0,481,600,643,15,0,0,6,4,0,1,119,43,162
p_120,0,11,e_0,482,600,643,15,0,0,6,4,0,1,118,43,161
p_133,0,12,e_0,469,600,648,15,0,0,10,4,0,1,131,48,179
p_126,0,12,e_0,476,600,648,15,0,0,8,4,0,1,124,48,172
p_96,0,1,e_2,517,644,649,15,0,0,4,4,0,1,127,5,132
p_131,0,14,e_0,471,600,656,15,0,0,9,4,0,1,129,56,185
p_125,0,14,e_0,477,600,656,15,0,0,7,4,0,1,123,56,179
p_92,0,4,e_2,525,644,660,15,0,0,1,4,0,1,119,16,135
p_134,0,15,e_0,467,600,661,15,0,0,11,4,0,1,133,61,194
p_122,0,15,e_0,480,600,661,15,0,0,6,4,0,1,120,61,181
p_94,0,6,e_2,519,644,668,15,0,0,3,4,0,1,125,24,149
p_97,0,7,e_2,516,644,673,15,0,0,4,4,0,1,128,29,157
p_37,0,9,e_2,615,644,681,15,0,0,9,4,0,1,29,37,66
p_35,0,9,e_2,630,644,681,15,0,0,4,4,0,1,14,37,51
p_146,0,1,e_1,453,678,685,15,0,0,1,4,0,1,225,7,232
p_41,0,11,e_2,600,644,689,15,0,0,14,4,0,1,44,45,89
p_86,0,2,e_1,544,678,690,15,0,0,8,4,0,1,134,12,146
p_91,0,12,e_2,526,644,694,15,0,0,1,4,0,1,118,50,168
p_39,0,12,e_2,607,644,694,15,0,0,12,4,0,1,37,50,87
p_93,0,13,e_2,520,644,699,15,0,0,3,4,0,1,124,55,179
p_90,0,13,e_2,527,644,699,15,0,0,1,4,0,1,117,55,172
p_40,0,13,e_2,602,644,699,15,0,0,14,4,0,1,42,55,97
p_38,0,13,e_2,608,644,699,15,0,0,12,4,0,1,36,55,91
p_36,0,13,e_2,628,644,699,15,0,0,5,4,0,1,16,55,71
p_88,0,5,e_1,538,678,701,15,0,0,10,4,0,1,140,23,163
p_95,0,14,e_2,518,644,704,15,0,0,4,4,0,1,126,60,186
p_80,0,7,e_1,552,678,709,15,0,0,6,4,0,1,126,31,157
p_119,0,1,e_0,483,708,713,15,0,0,5,4,0,1,225,5,230
p_113,0,1,e_0,489,708,713,15,0,0,3,4,0,1,219,5,224
p_65,0,1,e_0,573,708,713,15,0,0,9,4,0,1,135,5,140
p_87,0,8,e_1,539,678,714,15,0,0,10,4,0,1,139,36,175
p_83,0,8,e_1,549,678,714,15,0,0,7,4,0,1,129,36,165
p_144,0,9,e_1,455,678,719,15,0,0,0,3,0,0,223,41,264
p_89,0,9,e_1,535,678,719,15,0,0,11,4,0,1,143,41,184
p_114,0,3,e_0,488,708,721,15,0,0,4,4,0,1,220,13,233
p_64,0,4,e_0,574,708,726,15,0,0,8,4,0,1,134,18,152
p_145,0,11,e_1,454,678,727,15,0,0,0,4,0,1,224,49,273
p_84,0,12,e_1,546,678,732,15,0,0,8,4,0,1,132,54,186
p_78,0,12,e_1,556,678,732,15,0,0,4,4,0,1,122,54,176
p_108,0,6,e_0,496,708,734,15,0,0,1,4,0,1,212,26,238
p_118,0,7,e_0,484,708,739,15,0,0,5,4,0,1,224,31,255
p_82,0,14,e_1,550,678,740,15,0,0,6,4,0,1,128,62,190
p_81,0,14,e_1,551,678,740,15,0,0,6,4,0,1,127,62,189
p_79,0,14,e_1,553,678,740,15,0,0,5,4,0,1,125,62,187
p_111,0,8,e_0,491,708,744,15,0,0,3,4,0,1,217,36,253
p_85,0,15,e_1,545,678,745,15,0,0,8,4,0,1,133,67,200
p_115,0,9,e_0,487,708,749,15,0,0,4,4,0,1,221,41,262
p_117,0,10,e_0,485,708,754,15,0,0,5,4,0,1,223,46,269
p_116,0,10,e_0,486,708,754,15,0,0,4,4,0,1,222,46,268
p_112,0,11,e_0,490,708,759,15,0,0,3,4,0,1,218,51,269
p_110,0,11,e_0,492,708,759,15,0,0,2,4,0,1,216,51,267
p_107,0,11,e_0,499,708,759,15,0,0,0,3,0,0,209,51,260
p_22,0,3,e_2,719,756,767,15,0,0,12,4,0,1,37,11,48
p_21,0,4,e_2,731,756,772,15,0,0,8,4,0,1,25,16,41
p_109,0,15,e_0,493,708,773,15,0,0,2,4,0,1,215,65,280
p_19,0,11,e_2,754,756,795,15,0,0,0,4,0,1,2,39,41
p_23,0,12,e_2,711,756,800,15,0,0,14,3,0,0,45,44,89
p_77,0,3,e_1,557,792,803,15,0,0,4,4,0,1,235,11,246
p_72,0,3,e_1,562,792,803,15,0,0,2,4,0,1,230,11,241
p_71,0,3,e_1,564,792,803,15,0,0,2,4,0,1,228,11,239
p_70,0,3,e_1,565,792,803,15,0,0,1,4,0,1,227,11,238
p_67,0,3,e_1,568,792,803,15,0,0,0,4,0,1,224,11,235
p_66,0,3,e_1,569,792,803,15,0,0,0,3,0,0,223,11,234
p_20,0,14,e_2,734,756,808,15,0,0,7,4,0,1,22,52,74
p_75,0,5,e_1,559,792,811,15,0,0,3,4,0,1,233,19,252
p_76,0,6,e_1,558,792,816,15,0,0,4,4,0,1,234,24,258
p_32,0,6,e_1,650,792,816,15,0,0,9,4,0,1,142,24,166
p_74,0,7,e_1,560,792,821,15,0,0,3,4,0,1,232,29,261
p_55,0,3,e_0,585,820,831,15,0,0,5,4,0,1,235,11,246
p_54,0,3,e_0,586,820,831,15,0,0,4,4,0,1,234,11,245
p_52,0,3,e_0,588,820,831,15,0,0,4,4,0,1,232,11,243
p_73,0,11,e_1,561,792,835,15,0,0,3,4,0,1,231,43,274
p_34,0,12,e_1,646,792,840,15,0,0,10,4,0,1,146,48,194
p_61,0,6,e_0,579,820,842,15,0,0,7,4,0,1,241,22,263
p_56,0,6,e_0,584,820,842,15,0,0,5,4,0,1,236,22,258
p_68,0,13,e_1,567,792,845,15,0,0,1,4,0,1,225,53,278
p_50,0,7,e_0,590,820,847,15,0,0,3,4,0,1,230,27,257
p_69,0,14,e_1,566,792,850,15,0,0,1,4,0,1,226,58,284
p_53,0,9,e_0,587,820,855,15,0,0,4,4,0,1,233,35,268
p_51,0,9,e_0,589,820,855,15,0,0,3,4,0,1,231,35,266
p_33,0,15,e_1,649,792,855,15,0,0,9,4,0,1,143,63,206
p_60,0,10,e_0,580,820,860,15,0,0,6,4,0,1,240,40,280
p_58,0,11,e_0,582,820,865,15,0,0,6,4,0,1,238,45,283
p_57,0,11,e_0,583,820,865,15,0,0,5,4,0,1,237,45,282
p_63,0,13,e_0,577,820,873,15,0,0,7,4,0,1,243,53,296
p_62,0,13,e_0,578,820,873,15,0,0,7,4,0,1,242,53,295
p_59,0,14,e_0,581,820,878,15,0,0,6,4,0,1,239,58,297
p_49,0,14,e_0,591,820,878,15,0,0,3,4,0,1,229,58,287
p_9,0,2,e_2,846,880,888,15,0,0,11,4,0,1,34,8,42
p_6,0,3,e_2,877,880,893,15,0,0,1,4,0,1,3,13,16
p_7,0,5,e_2,875,880,901,15,0,0,1,4,0,1,5,21,26
p_4,0,1,e_1,886,902,907,15,0,0,5,4,0,1,16,5,21
p_16,0,2,e_1,780,902,912,15,0,0,4,4,0,1,122,10,132
p_10,0,8,e_2,835,880,912,15,0,0,14,3,0,0,45,32,77
p_30,0,3,e_1,668,902,917,15,0,0,3,4,0,1,234,15,249
p_8,0,11,e_2,874,880,923,15,0,0,2,4,0,1,6,43,49
p_29,0,5,e_1,670,902,925,15,0,0,2,4,0,1,232,23,255
p_1,0,5,e_1,894,902,925,15,0,0,2,4,0,1,8,23,31
p_45,0,2,e_0,595,922,930,15,0,0,1,4,0,1,327,8,335
p_24,0,2,e_0,695,922,930,15,0,0,4,4,0,1,227,8,235
p_31,0,6,e_1,666,902,930,15,0,0,4,4,0,1,236,28,264
p_48,0,4,e_0,592,922,938,15,0,0,2,4,0,1,330,16,346
p_46,0,4,e_0,594,922,938,15,0,0,2,4,0,1,328,16,344
p_14,0,4,e_0,794,922,938,15,0,0,8,4,0,1,128,16,144
p_5,0,8,e_1,883,902,938,15,0,0,6,4,0,1,19,36,55
p_3,0,8,e_1,888,902,938,15,0,0,4,4,0,1,14,36,50
p_42,0,6,e_0,598,922,946,15,0,0,0,4,0,1,324,24,348
p_27,0,10,e_1,677,902,946,15,0,0,0,3,0,0,225,44,269
p_18,0,10,e_1,766,902,946,15,0,0,8,4,0,1,136,44,180
p_17,0,10,e_1,776,902,946,15,0,0,5,4,0,1,126,44,170
p_43,0,7,e_0,597,922,951,15,0,0,1,4,0,1,325,29,354
p_28,0,11,e_1,676,902,951,15,0,0,0,4,0,1,226,49,275
p_2,0,11,e_1,892,902,951,15,0,0,3,4,0,1,10,49,59
p_44,0,8,e_0,596,922,956,15,0,0,1,4,0,1,326,34,360
p_26,0,8,e_0,684,922,956,15,0,0,8,4,0,1,238,34,272
p_25,0,8,e_0,686,922,956,15,0,0,7,4,0,1,236,34,270
p_47,0,9,e_0,593,922,961,15,0,0,2,4,0,1,329,39,368
p_15,0,9,e_0,793,922,961,15,0,0,9,4,0,1,129,39,168
p_11,0,9,e_0,807,922,961,15,0,0,4,4,0,1,115,39,154
p_13,0,11,e_0,796,922,969,15,0,0,8,4,0,1,126,47,173
p_12,0,11,e_0,798,922,969,15,0,0,7,4,0,1,124,47,171
p_300,0,4,e_0,8,9,25,0,0,0,0,3,0,0,1,16,17
p_299,0,5,e_1,9,10,29,0,0,0,0,3,0,0,1,19,20
p_297,0,6,e_3,15,16,38,0,0,0,0,3,0,0,1,22,23
p_298,0,9,e_2,11,12,43,0,0,0,0,3,0,0,1,31,32
p_296,0,4,e_0,28,43,57,9,1,1,4,3,0,0,15,14,29
p_286,0,3,e_1,46,47,60,6,0,0,0,3,0,0,1,13,14
p_292,0,6,e_0,38,43,65,6,0,0,1,4,0,1,5,22,27
p_290,0,6,e_0,40,43,65,6,0,0,1,4,0,1,3,22,25
p_289,0,4,e_1,43,47,65,6,0,0,1,4,0,1,4,18,22
p_295,0,5,e_1,29,47,70,9,1,1,5,3,0,0,18,23,41
p_287,0,5,e_1,45,47,70,6,0,0,0,4,0,1,2,23,25
p_288,0,8,e_1,44,47,81,6,0,0,1,4,0,1,3,34,37
p_281,0,1,e_3,73,74,81,0,0,0,0,3,0,0,1,7,8
p_291,0,11,e_0,39,43,82,6,0,0,1,4,0,1,4,39,43
p_294,0,12,e_0,31,43,87,8,1,1,4,4,0,1,12,44,56
p_293,0,12,e_0,33,43,87,7,1,1,3,4,0,1,10,44,54
p_285,0,4,e_3,53,74,92,6,0,0,6,3,0,0,21,18,39
p_284,0,4,e_3,54,74,92,6,1,0,6,4,0,1,20,18,38
p_282,0,7,e_3,66,74,103,2,1,0,2,4,0,1,8,29,37
p_283,0,9,e_3,57,74,111,5,1,0,5,4,0,1,17,37,54
p_278,0,2,e_2,77,105,113,18,4,4,9,4,0,1,28,8,36
p_279,0,5,e_2,76,105,124,18,4,4,9,4,0,1,29,19,48
p_277,0,6,e_1,82,109,129,17,3,3,8,3,0,0,27,20,47
p_274,0,8,e_2,88,105,135,15,3,3,5,4,0,1,17,30,47
p_271,0,1,e_3,121,140,145,6,1,0,6,4,0,1,19,5,24
p_276,0,11,e_2,84,105,146,16,3,3,7,4,0,1,21,41,62
p_273,0,4,e_3,110,140,156,9,0,0,9,2,1,0,30,16,46
p_280,0,14,e_2,75,105,157,18,4,4,9,3,0,0,30,52,82
p_275,0,14,e_2,86,105,157,16,3,3,6,4,0,1,19,52,71
p_267,0,1,e_1,148,165,172,18,3,3,5,4,0,1,17,7,24
p_270,0,9,e_3,122,140,173,6,1,0,6,4,0,1,18,33,51
p_269,0,9,e_3,127,140,173,4,1,0,4,4,0,1,13,33,46
p_268,0,2,e_1,144,165,177,19,3,3,6,3,0,0,21,12,33
p_272,0,10,e_3,113,140,178,9,1,0,9,4,0,1,27,38,65
p_265,0,4,e_1,152,165,185,17,3,3,4,4,0,1,13,20,33
p_262,0,5,e_1,157,165,190,16,2,2,2,4,0,1,8,25,33
p_261,0,5,e_1,164,165,190,14,2,2,0,3,0,0,1,25,26
p_266,0,6,e_1,151,165,195,17,3,3,4,4,0,1,14,30,44
p_263,0,7,e_1,154,165,200,16,3,3,3,4,0,1,11,35,46
p_264,0,11,e_1,153,165,214,17,3,3,4,4,0,1,12,49,61
p_255,0,3,e_0,184,204,215,10,0,0,6,4,0,1,20,11,31
p_254,0,4,e_0,187,204,220,10,0,0,5,4,0,1,17,16,33
p_253,0,5,e_0,190,204,225,10,0,0,4,4,0,1,14,21,35
p_260,0,7,e_0,165,204,233,13,2,2,12,3,0,0,39,29,68
p_258,0,7,e_0,168,204,233,12,2,2,12,4,0,1,36,29,65
p_256,0,10,e_0,182,204,244,10,0,0,7,4,0,1,22,40,62
p_250,0,2,e_3,217,238,246,7,1,0,7,4,0,1,21,8,29
p_252,0,5,e_3,205,238,257,10,0,0,10,3,0,0,33,19,52
p_257,0,14,e_0,169,204,258,12,2,2,11,4,0,1,35,54,89
p_259,0,15,e_0,167,204,263,13,2,2,12,4,0,1,37,59,96
p_251,0,15,e_3,209,238,289,9,1,0,9,4,0,1,29,51,80
p_248,0,5,e_1,246,275,292,28,2,2,9,4,0,1,29,17,46
p_247,0,5,e_1,250,275,292,27,2,2,8,4,0,1,25,17,42
p_249,0,6,e_1,239,275,297,30,3,3,11,3,0,0,36,22,58
p_245,0,7,e_1,269,275,302,21,1,1,2,4,0,1,6,27,33
p_246,0,10,e_1,262,275,313,24,1,1,4,4,0,1,13,38,51
p_244,0,12,e_1,271,275,321,21,1,1,1,4,0,1,4,46,50
p_241,0,1,e_2,283,322,327,17,1,1,13,4,0,1,39,5,44
p_236,0,1,e_2,305,322,327,15,0,0,5,4,0,1,17,5,22
p_233,0,1,e_2,311,322,327,15,0,0,3,4,0,1,11,5,16
p_243,0,15,e_1,272,275,332,20,1,1,1,4,0,1,3,57,60
p_230,0,3,e_2,319,322,335,15,0,0,1,4,0,1,3,13,16
p_232,0,5,e_2,314,322,343,15,0,0,2,4,0,1,8,21,29
p_237,0,7,e_2,304,322,351,15,0,0,6,4,0,1,18,29,47
p_231,0,7,e_2,317,322,351,15,0,0,1,4,0,1,5,29,34
p_242,0,8,e_2,277,322,356,19,1,1,14,3,0,0,45,34,79
p_235,0,8,e_2,308,322,356,15,0,0,4,4,0,1,14,34,48
p_234,0,8,e_2,310,322,356,15,0,0,4,4,0,1,12,34,46
p_240,0,9,e_2,301,322,361,15,0,0,7,4,0,1,21,39,60
p_239,0,11,e_2,302,322,369,15,0,0,6,4,0,1,20,47,67
p_238,0,13,e_2,303,322,377,15,0,0,6,4,0,1,19,55,74
p_229,0,13,e_2,320,322,377,15,0,0,0,4,0,1,2,55,57
p_216,0,1,e_0,347,373,380,9,1,0,8,4,0,1,26,7,33
p_226,0,2,e_0,329,373,385,15,1,0,14,4,0,1,44,12,56
p_223,0,2,e_0,336,373,385,13,1,0,12,4,0,1,37,12,49
p_214,0,3,e_0,349,373,390,8,1,0,8,4,0,1,24,17,41
p_228,0,4,e_0,325,373,395,15,0,0,15,3,0,0,48,22,70
p_224,0,5,e_1,331,379,396,14,1,0,15,2,1,0,48,17,65
p_194,0,6,e_3,373,375,397,0,1,0,0,4,0,1,2,22,24
p_225,0,5,e_0,330,373,400,15,1,0,14,4,0,1,43,27,70
p_222,0,5,e_0,337,373,400,12,1,0,12,4,0,1,36,27,63
p_219,0,5,e_0,342,373,400,11,1,0,10,4,0,1,31,27,58
p_221,0,6,e_0,339,373,405,12,1,0,11,4,0,1,34,32,66
p_220,0,6,e_0,341,373,405,11,1,0,10,4,0,1,32,32,64
p_192,0,8,e_1,375,379,407,24,4,4,1,4,0,1,4,28,32
p_217,0,7,e_0,346,373,410,9,1,0,9,4,0,1,27,37,64
p_212,0,7,e_0,351,373,410,8,1,0,7,4,0,1,22,37,59
p_193,0,11,e_3,374,375,414,0,0,0,0,3,0,0,1,39,40
p_191,0,10,e_1,376,379,415,24,3,3,1,4,0,1,3,36,39
p_227,0,12,e_3,327,375,419,15,0,0,15,3,0,0,48,44,92
p_218,0,11,e_0,343,373,424,10,1,0,10,4,0,1,30,51,81
p_190,0,1,e_2,379,421,428,24,3,3,13,3,0,0,42,7,49
p_183,0,1,e_2,396,421,428,18,2,2,8,4,0,1,25,7,32
p_182,0,2,e_2,397,421,433,18,2,2,8,4,0,1,24,12,36
p_180,0,2,e_2,399,421,433,18,2,2,7,4,0,1,22,12,34
p_215,0,15,e_0,348,373,438,9,1,0,8,4,0,1,25,65,90
p_213,0,15,e_0,350,373,438,8,1,0,7,4,0,1,23,65,88
p_178,0,3,e_2,401,421,438,17,2,2,6,4,0,1,20,17,37
p_186,0,4,e_2,390,421,443,20,3,3,10,4,0,1,31,22,53
p_176,0,4,e_2,403,421,443,16,2,2,6,4,0,1,18,22,40
p_189,0,8,e_2,382,421,457,23,3,3,13,4,0,1,39,36,75
p_179,0,8,e_2,400,421,457,17,2,2,7,4,0,1,21,36,57
p_161,0,1,e_1,421,454,461,12,0,0,10,3,0,0,33,7,40
p_158,0,1,e_1,430,454,461,12,0,0,8,4,0,1,24,7,31
p_177,0,9,e_2,402,421,462,17,2,2,6,4,0,1,19,41,60
p_185,0,10,e_2,391,421,467,20,3,3,10,4,0,1,30,46,76
p_187,0,12,e_2,389,421,475,20,3,3,10,4,0,1,32,54,86
p_184,0,12,e_2,392,421,475,19,3,3,9,4,0,1,29,54,83
p_159,0,6,e_1,429,454,478,12,0,0,8,4,0,1,25,24,49
p_150,0,6,e_1,443,454,478,12,0,0,3,4,0,1,11,24,35
p_188,0,13,e_2,384,421,480,22,3,3,12,4,0,1,37,59,96
p_154,0,7,e_1,436,454,483,12,0,0,6,4,0,1,18,29,47
p_148,0,8,e_1,449,454,488,12,0,0,1,4,0,1,5,34,39
p_181,0,15,e_2,398,421,488,18,2,2,7,4,0,1,23,67,90
p_153,0,9,e_1,437,454,493,12,0,0,5,4,0,1,17,39,56
p_147,0,9,e_1,452,454,493,12,0,0,0,4,0,1,2,39,41
p_209,0,2,e_0,357,485,495,6,1,0,5,4,0,1,128,10,138
p_205,0,2,e_0,362,485,495,4,1,0,3,4,0,1,123,10,133
p_200,0,4,e_0,367,485,503,2,1,0,2,4,0,1,118,18,136
p_201,0,5,e_0,366,485,508,3,1,0,2,4,0,1,119,23,142
p_157,0,14,e_1,431,454,510,12,0,0,7,4,0,1,23,56,79
p_155,0,14,e_1,435,454,510,12,0,0,6,4,0,1,19,56,75
p_210,0,6,e_0,354,485,513,7,1,0,6,4,0,1,131,28,159
p_208,0,6,e_0,358,485,513,5,1,0,5,4,0,1,127,28,155
p_160,0,15,e_1,426,454,515,12,0,0,9,4,0,1,28,61,89
p_156,0,15,e_1,434,454,515,12,0,0,6,4,0,1,20,61,81
p_152,0,15,e_1,441,454,515,12,0,0,4,4,0,1,13,61,74
p_151,0,15,e_1,442,454,515,12,0,0,4,4,0,1,12,61,73
p_149,0,15,e_1,444,454,515,12,0,0,3,4,0,1,10,61,71
p_198,0,9,e_0,369,485,524,2,1,0,1,4,0,1,116,39,155
p_197,0,10,e_0,370,485,529,1,1,0,1,4,0,1,115,44,159
p_113,0,1,e_3,489,524,529,11,1,0,11,4,0,1,35,5,40
p_207,0,11,e_0,359,485,534,5,1,0,4,4,0,1,126,49,175
p_114,0,3,e_3,488,524,537,12,1,0,12,4,0,1,36,13,49
p_106,0,3,e_3,500,524,537,8,1,0,8,4,0,1,24,13,37
p_206,0,12,e_0,361,485,539,4,1,0,4,4,0,1,124,54,178
p_203,0,12,e_0,364,485,539,3,1,0,3,4,0,1,121,54,175
p_167,0,1,e_2,413,535,540,13,1,1,2,4,0,1,122,5,127
p_204,0,14,e_0,363,485,547,4,1,0,3,4,0,1,122,62,184
p_108,0,6,e_3,496,524,548,9,1,0,9,4,0,1,28,24,52
p_165,0,4,e_2,417,535,551,12,1,1,1,4,0,1,118,16,134
p_92,0,4,e_2,525,535,551,30,10,10,3,4,0,1,10,16,26
p_211,0,15,e_0,353,485,552,7,1,0,6,4,0,1,132,67,199
p_202,0,15,e_0,365,485,552,3,1,0,2,4,0,1,120,67,187
p_199,0,15,e_0,368,485,552,2,1,0,1,4,0,1,117,67,184
p_111,0,8,e_3,491,524,556,11,1,0,11,4,0,1,33,32,65
p_115,0,9,e_3,487,524,561,12,1,0,12,4,0,1,37,37,74
p_117,0,10,e_3,485,524,566,12,0,0,12,3,0,0,39,42,81
p_116,0,10,e_3,486,524,566,12,1,0,12,4,0,1,38,42,80
p_169,0,9,e_2,411,535,568,14,2,2,3,4,0,1,124,33,157
p_146,0,1,e_1,453,562,569,12,0,0,0,3,0,0,109,7,116
p_112,0,11,e_3,490,524,571,11,1,0,11,4,0,1,34,47,81
p_110,0,11,e_3,492,524,571,10,1,0,10,4,0,1,32,47,79
p_107,0,11,e_3,499,524,571,8,1,0,8,4,0,1,25,47,72
p_103,0,11,e_3,508,524,571,5,1,0,5,4,0,1,16,47,63
p_163,0,10,e_2,419,535,573,12,0,0,0,4,0,1,116,38,154
p_86,0,2,e_1,544,562,574,25,9,9,6,4,0,1,18,12,30
p_105,0,12,e_3,502,524,576,7,1,0,7,4,0,1,22,52,74
p_173,0,11,e_2,407,535,578,15,2,2,4,4,0,1,128,43,171
p_164,0,11,e_2,418,535,578,12,0,0,1,4,0,1,117,43,160
p_162,0,11,e_2,420,535,578,12,0,0,0,3,0,0,115,43,158
p_77,0,3,e_1,557,562,579,22,7,7,1,4,0,1,5,17,22
p_166,0,12,e_2,416,535,583,13,1,1,1,4,0,1,119,48,167
p_104,0,14,e_3,503,524,584,7,1,0,7,4,0,1,21,60,81
p_88,0,5,e_1,538,562,587,27,9,9,8,4,0,1,24,25,49
p_171,0,13,e_2,409,535,588,14,2,2,4,4,0,1,126,53,179
p_168,0,13,e_2,412,535,588,13,2,2,3,4,0,1,123,53,176
p_109,0,15,e_3,493,524,589,10,1,0,10,4,0,1,31,65,96
p_76,0,6,e_1,558,562,592,22,7,7,1,4,0,1,4,30,34
p_175,0,14,e_2,405,535,593,16,2,2,5,4,0,1,130,58,188
p_174,0,14,e_2,406,535,593,15,2,2,5,4,0,1,129,58,187
p_170,0,14,e_2,410,535,593,14,2,2,3,4,0,1,125,58,183
p_80,0,7,e_1,552,562,597,23,8,8,3,4,0,1,10,35,45
p_172,0,15,e_2,408,535,598,15,2,2,4,4,0,1,127,63,190
p_87,0,8,e_1,539,562,602,27,9,9,7,4,0,1,23,40,63
p_83,0,8,e_1,549,562,602,24,8,8,4,4,0,1,13,40,53
p_89,0,9,e_1,535,562,607,27,10,10,9,4,0,1,27,45,72
p_143,0,3,e_0,456,599,612,12,0,0,9,4,0,1,143,13,156
p_136,0,3,e_0,465,599,612,12,0,0,6,4,0,1,134,13,147
p_196,0,4,e_0,371,599,617,1,1,0,0,4,0,1,228,18,246
p_137,0,4,e_0,464,599,617,12,0,0,7,4,0,1,135,18,153
p_84,0,12,e_1,546,562,618,24,9,9,5,4,0,1,16,56,72
p_78,0,12,e_1,556,562,618,22,7,7,2,4,0,1,6,56,62
p_141,0,6,e_0,458,599,625,12,0,0,9,4,0,1,141,26,167
p_82,0,14,e_1,550,562,626,24,8,8,4,4,0,1,12,64,76
p_81,0,14,e_1,551,562,626,23,8,8,3,4,0,1,11,64,75
p_79,0,14,e_1,553,562,626,23,8,8,3,4,0,1,9,64,73
p_85,0,15,e_1,545,562,631,25,9,9,5,4,0,1,17,69,86
p_140,0,8,e_0,459,599,633,12,0,0,8,4,0,1,140,34,174
p_144,0,9,e_0,455,599,638,12,0,0,10,4,0,1,144,39,183
p_142,0,9,e_0,457,599,638,12,0,0,9,4,0,1,142,39,181
p_96,0,1,e_3,517,636,641,2,1,0,2,4,0,1,119,5,124
p_139,0,10,e_0,461,599,643,12,0,0,8,4,0,1,138,44,182
p_135,0,10,e_0,466,599,643,12,0,0,6,4,0,1,133,44,177
p_145,0,11,e_0,454,599,648,12,0,0,10,4,0,1,145,49,194
p_138,0,11,e_0,463,599,648,12,0,0,7,4,0,1,136,49,185
p_133,0,12,e_0,469,599,653,12,0,0,5,4,0,1,130,54,184
p_99,0,6,e_3,514,636,658,3,1,0,3,4,0,1,122,22,144
p_94,0,6,e_3,519,636,658,1,1,0,1,4,0,1,117,22,139
p_102,0,7,e_3,509,636,663,5,1,0,5,4,0,1,127,27,154
p_98,0,7,e_3,515,636,663,3,1,0,3,4,0,1,121,27,148
p_97,0,7,e_3,516,636,663,2,1,0,2,4,0,1,120,27,147
p_195,0,15,e_0,372,599,664,1,1,0,0,3,0,0,227,65,292
p_134,0,15,e_0,467,599,664,12,0,0,6,4,0,1,132,65,197
p_101,0,8,e_3,511,636,668,4,1,0,4,4,0,1,125,32,157
p_100,0,9,e_3,513,636,673,3,1,0,3,4,0,1,123,37,160
p_37,0,9,e_3,615,636,673,7,1,0,7,4,0,1,21,37,58
p_41,0,11,e_3,600,636,681,12,1,0,12,4,0,1,36,45,81
p_91,0,12,e_2,526,645,683,30,10,10,3,4,0,1,119,38,157
p_39,0,12,e_3,607,636,686,9,1,0,9,4,0,1,29,50,79
p_90,0,13,e_2,527,645,688,29,11,11,2,4,0,1,118,43,161
p_30,0,3,e_1,668,678,691,20,6,6,3,4,0,1,10,13,23
p_93,0,13,e_3,520,636,691,1,1,0,1,4,0,1,116,55,171
p_40,0,13,e_3,602,636,691,11,1,0,11,4,0,1,34,55,89
p_38,0,13,e_3,608,636,691,9,1,0,9,4,0,1,28,55,83
p_95,0,14,e_3,518,636,696,2,1,0,2,4,0,1,118,60,178
p_75,0,5,e_1,559,678,699,21,7,7,1,4,0,1,119,21,140
p_29,0,5,e_1,670,678,699,20,6,6,2,4,0,1,8,21,29
p_32,0,6,e_1,650,678,704,24,9,9,9,4,0,1,28,26,54
p_31,0,6,e_1,666,678,704,20,7,7,4,4,0,1,12,26,38
p_74,0,7,e_1,560,678,709,21,6,6,0,4,0,1,118,31,149
p_130,0,1,e_0,472,711,716,12,0,0,4,4,0,1,239,5,244
p_119,0,1,e_0,483,711,716,12,0,0,0,4,0,1,228,5,233
p_27,0,10,e_1,677,678,720,18,5,5,0,3,0,0,1,42,43
p_129,0,3,e_0,473,711,724,12,0,0,4,4,0,1,238,13,251
p_73,0,11,e_1,561,678,725,21,6,6,0,3,0,0,117,47,164
p_28,0,11,e_1,676,678,725,18,5,5,0,4,0,1,2,47,49
p_34,0,12,e_1,646,678,730,26,9,9,10,4,0,1,32,52,84
p_124,0,7,e_0,478,711,738,12,0,0,2,4,0,1,233,27,260
p_118,0,7,e_0,484,711,738,12,0,0,0,3,0,0,227,27,254
p_33,0,15,e_1,649,678,741,25,9,9,9,4,0,1,29,63,92
p_127,0,10,e_0,475,711,749,12,0,0,3,4,0,1,236,38,274
p_22,0,3,e_3,719,740,751,7,1,0,7,4,0,1,21,11,32
p_132,0,11,e_0,470,711,754,12,0,0,5,4,0,1,241,43,284
p_128,0,11,e_0,474,711,754,12,0,0,3,4,0,1,237,43,280
p_123,0,11,e_0,479,711,754,12,0,0,2,4,0,1,232,43,275
p_121,0,11,e_0,481,711,754,12,0,0,1,4,0,1,230,43,273
p_120,0,11,e_0,482,711,754,12,0,0,1,4,0,1,229,43,272
p_21,0,4,e_3,731,740,756,3,1,0,3,4,0,1,9,16,25
p_126,0,12,e_0,476,711,759,12,0,0,3,4,0,1,235,48,283
p_131,0,14,e_0,471,711,767,12,0,0,4,4,0,1,240,56,296
p_125,0,14,e_0,477,711,767,12,0,0,2,4,0,1,234,56,290
p_122,0,15,e_0,480,711,772,12,0,0,1,4,0,1,231,61,292
p_35,0,9,e_3,630,740,773,2,1,0,2,4,0,1,110,33,143
p_23,0,12,e_3,711,740,784,9,1,0,9,4,0,1,29,44,73
p_36,0,13,e_3,628,740,789,2,1,0,2,4,0,1,112,49,161
p_20,0,14,e_3,734,740,794,2,1,0,2,4,0,1,6,54,60
p_16,0,2,e_2,780,796,804,17,3,3,5,4,0,1,16,8,24
p_14,0,4,e_2,794,796,812,14,0,0,0,4,0,1,2,16,18
p_65,0,1,e_0,573,819,824,19,4,4,8,4,0,1,246,5,251
p_15,0,9,e_2,793,796,829,14,0,0,1,4,0,1,3,33,36
p_72,0,3,e_0,562,819,832,21,6,6,12,4,0,1,257,13,270
p_71,0,3,e_0,564,819,832,20,6,6,11,4,0,1,255,13,268
p_70,0,3,e_0,565,819,832,20,5,5,11,4,0,1,254,13,267
p_67,0,3,e_0,568,819,832,20,5,5,10,4,0,1,251,13,264
p_66,0,3,e_0,569,819,832,19,5,5,10,4,0,1,250,13,263
p_18,0,10,e_2,766,796,834,21,4,4,10,4,0,1,30,38,68
p_17,0,10,e_2,776,796,834,18,3,3,6,4,0,1,20,38,58
p_64,0,4,e_0,574,819,837,18,4,4,8,4,0,1,245,18,263
p_19,0,11,e_2,754,796,839,24,5,5,13,3,0,0,42,43,85
p_61,0,6,e_0,579,819,845,17,3,3,6,4,0,1,240,26,266
p_60,0,10,e_0,580,819,859,17,3,3,6,4,0,1,239,40,279
p_58,0,11,e_0,582,819,864,16,3,3,5,4,0,1,237,45,282
p_68,0,13,e_0,567,819,872,20,5,5,10,4,0,1,252,53,305
p_63,0,13,e_0,577,819,872,18,3,3,7,4,0,1,242,53,295
p_62,0,13,e_0,578,819,872,18,3,3,7,4,0,1,241,53,294
p_69,0,14,e_0,566,819,877,20,5,5,11,4,0,1,253,58,311
p_59,0,14,e_0,581,819,877,17,3,3,6,4,0,1,238,58,296
p_9,0,2,e_2,846,882,890,11,1,0,11,3,0,0,36,8,44
p_6,0,3,e_2,877,882,895,1,1,0,1,4,0,1,5,13,18
p_7,0,5,e_3,875,880,897,1,1,0,1,4,0,1,5,17,22
p_10,0,8,e_3,835,880,908,14,0,0,14,3,0,0,45,28,73
p_8,0,11,e_2,874,882,921,2,1,0,2,4,0,1,8,39,47
p_45,0,2,e_0,595,921,929,13,1,0,1,4,0,1,326,8,334
p_55,0,3,e_0,585,921,934,16,2,2,4,4,0,1,336,13,349
p_54,0,3,e_0,586,921,934,16,2,2,4,4,0,1,335,13,348
p_52,0,3,e_0,588,921,934,15,1,1,3,4,0,1,333,13,346
p_48,0,4,e_0,592,921,939,14,1,0,2,4,0,1,329,18,347
p_46,0,4,e_0,594,921,939,14,1,0,1,4,0,1,327,18,345
p_56,0,6,e_0,584,921,947,16,2,2,5,4,0,1,337,26,363
p_50,0,7,e_0,590,921,952,15,1,0,3,4,0,1,331,31,362
p_43,0,7,e_0,597,921,952,13,1,0,0,4,0,1,324,31,355
p_44,0,8,e_0,596,921,957,13,1,0,1,4,0,1,325,36,361
p_53,0,9,e_0,587,921,962,15,2,2,4,4,0,1,334,41,375
p_51,0,9,e_0,589,921,962,15,1,0,3,4,0,1,332,41,373
p_47,0,9,e_0,593,921,962,14,1,0,2,4,0,1,328,41,369
p_57,0,11,e_0,583,921,970,16,2,2,5,4,0,1,338,49,387
p_49,0,14,e_0,591,921,981,15,1,0,2,4,0,1,330,60,390
p_4,0,1,e_0,886,1025,1030,14,2,2,11,4,0,1,139,5,144
p_24,0,2,e_0,695,1025,1035,14,1,1,5,4,0,1,330,10,340
p_1,0,5,e_0,894,1025,1046,12,2,2,9,4,0,1,131,21,152
p_42,0,6,e_0,598,1025,1051,12,1,0,0,3,0,0,427,26,453
p_26,0,8,e_0,684,1025,1059,16,4,4,9,4,0,1,341,34,375
p_25,0,8,e_0,686,1025,1059,16,3,3,8,4,0,1,339,34,373
p_5,0,8,e_0,883,1025,1059,15,2,2,12,4,0,1,142,34,176
p_3,0,8,e_0,888,1025,1059,14,2,2,11,4,0,1,137,34,171
p_11,0,9,e_0,807,1025,1064,14,0,0,4,4,0,1,218,39,257
p_13,0,11,e_0,796,1025,1072,14,0,0,7,4,0,1,229,47,276
p_12,0,11,e_0,798,1025,1072,14,0,0,7,4,0,1,227,47,274
p_2,0,11,e_0,892,1025,1072,12,2,2,9,4,0,1,133,47,180
p_300,0,4,e_0,8,9,25,0,0,0,0,3,0,0,1,16,17
p_299,0,5,e_1,9,10,29,0,0,0,0,3,0,0,1,19,20
p_297,0,6,e_3,15,16,38,0,0,0,0,3,0,0,1,22,23
p_298,0,9,e_2,11,12,43,0,0,0,0,3,0,0,1,31,32
p_296,0,4,e_0,28,43,57,9,1,1,4,3,0,0,15,14,29
p_286,0,3,e_1,46,47,60,4,1,0,0,3,0,0,1,13,14
p_290,0,6,e_0,40,43,65,6,1,0,1,4,0,1,3,22,25
p_289,0,4,e_1,43,47,65,5,1,0,1,4,0,1,4,18,22
p_295,0,5,e_1,29,47,70,9,1,1,5,3,0,0,18,23,41
p_287,0,5,e_1,45,47,70,4,1,0,0,4,0,1,2,23,25
p_284,0,4,e_3,54,59,73,1,1,0,1,4,0,1,5,14,19
p_288,0,8,e_1,44,47,81,5,1,0,1,4,0,1,3,34,37
p_292,0,6,e_3,38,59,81,6,0,0,6,3,0,0,21,22,43
p_291,0,11,e_0,39,43,82,6,1,0,1,4,0,1,4,39,43
p_294,0,12,e_0,31,43,87,8,1,1,4,4,0,1,12,44,56
p_293,0,12,e_0,33,43,87,7,1,1,3,4,0,1,10,44,54
p_281,0,1,e_2,73,83,90,14,2,2,3,4,0,1,10,7,17
p_283,0,9,e_3,57,59,92,0,1,0,0,4,0,1,2,33,35
p_278,0,2,e_2,77,83,95,13,2,2,2,4,0,1,6,12,18
p_285,0,4,e_2,53,83,103,2,1,0,9,3,0,0,30,20,50
p_279,0,5,e_2,76,83,108,13,2,2,2,4,0,1,7,25,32
p_277,0,6,e_2,82,83,113,12,1,1,0,3,0,0,1,30,31
p_282,0,7,e_2,66,83,118,16,3,3,5,4,0,1,17,35,52
p_273,0,4,e_1,110,111,127,9,0,0,0,3,0,0,1,16,17
p_271,0,1,e_0,121,125,130,7,1,0,1,4,0,1,4,5,9
p_274,0,8,e_1,88,111,141,10,1,1,7,4,0,1,23,30,53
p_280,0,14,e_2,75,83,141,14,2,2,2,4,0,1,8,58,66
p_276,0,11,e_1,84,111,152,11,1,1,8,3,0,0,27,41,68
p_270,0,9,e_0,122,125,156,7,1,0,1,4,0,1,3,31,34
p_269,0,9,e_3,127,143,172,5,1,0,5,4,0,1,16,29,45
p_275,0,14,e_0,86,125,173,11,1,1,12,2,1,0,39,48,87
p_272,0,10,e_3,113,143,177,9,0,0,9,3,0,0,30,34,64
p_267,0,1,e_2,148,189,194,19,2,2,13,4,0,1,41,5,46
p_255,0,3,e_1,184,187,198,10,0,0,1,4,0,1,3,11,14
p_268,0,2,e_2,144,189,199,20,2,2,14,3,0,0,45,10,55
p_265,0,4,e_1,152,187,203,17,2,2,11,4,0,1,35,16,51
p_254,0,4,e_2,187,189,207,10,0,0,0,4,0,1,2,18,20
p_262,0,5,e_1,157,187,208,16,2,2,10,4,0,1,30,21,51
p_261,0,5,e_1,164,187,208,13,2,2,7,4,0,1,23,21,44
p_266,0,6,e_1,151,187,213,18,2,2,11,2,1,0,36,26,62
p_263,0,7,e_1,154,187,218,17,2,2,11,4,0,1,33,31,64
p_260,0,7,e_1,165,187,218,13,2,2,7,4,0,1,22,31,53
p_258,0,7,e_1,168,187,218,12,2,2,6,4,0,1,19,31,50
p_256,0,10,e_1,182,187,229,10,0,0,1,4,0,1,5,42,47
p_250,0,2,e_2,217,224,232,2,1,0,2,4,0,1,7,8,15
p_264,0,11,e_1,153,187,234,17,2,2,11,4,0,1,34,47,81
p_253,0,5,e_3,190,223,240,10,0,0,10,3,0,0,33,17,50
p_252,0,5,e_3,205,223,240,6,1,0,6,4,0,1,18,17,35
p_257,0,14,e_1,169,187,245,12,2,2,6,4,0,1,18,58,76
p_259,0,15,e_1,167,187,250,12,2,2,6,4,0,1,20,63,83
p_251,0,15,e_2,209,224,273,4,1,0,4,3,0,0,15,49,64
p_248,0,5,e_3,246,257,274,3,1,0,3,4,0,1,11,17,28
p_247,0,5,e_3,250,257,274,2,1,0,2,4,0,1,7,17,24
p_249,0,6,e_3,239,257,279,5,0,0,5,2,1,0,18,22,40
p_241,0,1,e_3,283,304,311,6,0,0,6,3,0,0,21,7,28
p_236,0,1,e_0,305,307,312,26,4,4,0,4,0,1,2,5,7
p_233,0,1,e_1,311,317,322,25,3,3,2,4,0,1,6,5,11
p_237,0,7,e_0,304,307,332,26,5,5,1,4,0,1,3,25,28
p_230,0,3,e_2,319,320,333,23,3,3,0,3,0,0,1,13,14
p_232,0,5,e_1,314,317,336,24,3,3,1,4,0,1,3,19,22
p_242,0,8,e_0,277,307,337,6,1,1,10,4,0,1,30,30,60
p_240,0,9,e_3,301,304,337,1,1,0,1,4,0,1,3,33,36
p_245,0,7,e_1,269,317,344,8,2,2,15,3,0,0,48,27,75
p_246,0,10,e_0,262,307,345,11,2,2,14,3,0,0,45,38,83
p_239,0,11,e_3,302,304,345,0,1,0,0,4,0,1,2,41,43
p_231,0,7,e_2,317,320,347,23,3,3,1,4,0,1,3,27,30
p_235,0,8,e_1,308,317,349,26,4,4,3,4,0,1,9,32,41
p_234,0,8,e_1,310,317,349,25,3,3,2,4,0,1,7,32,39
p_244,0,12,e_0,271,307,353,8,2,2,12,4,0,1,36,46,82
p_238,0,13,e_3,303,304,353,0,0,0,0,3,0,0,1,49,50
p_243,0,15,e_2,272,320,373,7,2,2,15,2,1,0,48,53,101
p_216,0,1,e_1,347,375,382,15,2,2,8,5,1,1,28,7,35
p_226,0,2,e_1,329,375,387,19,4,4,3,5,3,1,46,12,58
p_223,0,2,e_1,336,375,387,17,3,3,5,5,2,1,39,12,51
p_214,0,3,e_1,349,375,392,14,2,2,8,4,0,1,26,17,43
p_228,0,4,e_1,325,375,397,21,4,4,2,5,3,0,50,22,72
p_190,0,1,e_0,379,391,398,5,1,0,4,4,0,1,12,7,19
p_225,0,5,e_1,330,375,402,19,4,4,3,5,3,1,45,27,72
p_222,0,5,e_1,337,375,402,17,3,3,5,5,2,1,38,27,65
p_219,0,5,e_1,342,375,402,16,3,3,7,5,2,1,33,27,60
p_221,0,6,e_1,339,375,407,17,3,3,6,5,2,1,36,32,68
p_220,0,6,e_1,341,375,407,16,3,3,6,5,2,1,34,32,66
p_186,0,4,e_0,390,391,409,1,1,0,0,3,0,0,1,18,19
p_217,0,7,e_1,346,375,412,15,2,2,7,5,1,1,29,37,66
p_212,0,7,e_1,351,375,412,13,2,2,8,4,0,1,24,37,61
p_224,0,5,e_0,331,391,414,19,4,4,7,2,4,0,60,23,83
p_192,0,8,e_0,375,391,425,6,1,0,5,4,0,1,16,34,50
p_189,0,8,e_0,382,391,425,4,1,0,3,4,0,1,9,34,43
p_218,0,11,e_1,343,375,426,15,3,3,7,2,2,1,32,51,83
p_185,0,10,e_3,391,394,426,1,1,0,1,4,0,1,3,32,35
p_183,0,1,e_2,396,420,427,26,3,3,8,4,0,1,24,7,31
p_182,0,2,e_2,397,420,432,25,3,3,7,4,0,1,23,12,35
p_180,0,2,e_2,399,420,432,25,3,3,7,4,0,1,21,12,33
p_191,0,10,e_0,376,391,433,6,1,0,5,4,0,1,15,42,57
p_184,0,12,e_3,392,394,434,0,1,0,0,4,0,1,2,40,42
p_178,0,3,e_2,401,420,437,24,3,3,6,4,0,1,19,17,36
p_229,0,13,e_3,320,394,439,22,3,3,4,5,3,0,74,45,119
p_215,0,15,e_1,348,375,440,14,2,2,8,2,1,1,27,65,92
p_213,0,15,e_1,350,375,440,14,2,2,8,4,0,1,25,65,90
p_187,0,12,e_0,389,391,441,1,1,0,0,4,0,1,2,50,52
p_176,0,4,e_2,403,420,442,23,3,3,5,4,0,1,17,22,39
p_188,0,13,e_0,384,391,446,3,1,0,2,4,0,1,7,55,62
p_179,0,8,e_2,400,420,456,24,3,3,6,4,0,1,20,36,56
p_177,0,9,e_2,402,420,461,24,3,3,6,4,0,1,18,41,59
p_173,0,11,e_2,407,420,469,22,3,3,4,4,0,1,13,49,62
p_227,0,12,e_2,327,420,474,20,4,4,1,5,3,0,93,54,147
p_171,0,13,e_2,409,420,479,21,3,3,3,4,0,1,11,59,70
p_175,0,14,e_2,405,420,484,23,3,3,5,4,0,1,15,64,79
p_174,0,14,e_2,406,420,484,22,3,3,4,4,0,1,14,64,78
p_170,0,14,e_2,410,420,484,21,3,3,3,4,0,1,10,64,74
p_146,0,1,e_3,453,480,487,9,1,0,9,4,0,1,27,7,34
p_181,0,15,e_2,398,420,489,25,3,3,7,4,0,1,22,69,91
p_172,0,15,e_2,408,420,489,22,3,3,4,4,0,1,12,69,81
p_143,0,3,e_3,456,480,495,8,1,0,8,4,0,1,24,15,39
p_209,0,2,e_1,357,487,497,12,1,0,6,4,0,1,130,10,140
p_205,0,2,e_1,362,487,497,10,1,0,4,4,0,1,125,10,135
p_113,0,1,e_0,489,491,498,29,8,8,0,4,0,1,2,7,9
p_200,0,4,e_1,367,487,505,9,1,0,2,4,0,1,120,18,138
p_114,0,3,e_0,488,491,506,29,8,8,1,4,0,1,3,15,18
p_150,0,6,e_3,443,480,506,12,1,0,12,4,0,1,37,26,63
p_201,0,5,e_1,366,487,510,9,1,0,3,4,0,1,121,23,144
p_154,0,7,e_3,436,480,511,14,2,2,12,5,1,1,44,31,75
p_210,0,6,e_1,354,487,515,13,1,0,7,4,0,1,133,28,161
p_208,0,6,e_1,358,487,515,12,1,0,5,4,0,1,129,28,157
p_153,0,9,e_3,437,480,519,13,2,2,13,5,1,1,43,39,82
p_147,0,9,e_3,452,480,519,9,1,0,9,4,0,1,28,39,67
p_144,0,9,e_3,455,480,519,8,1,0,8,4,0,1,25,39,64
p_142,0,9,e_3,457,480,519,7,1,0,7,4,0,1,23,39,62
p_148,0,8,e_0,449,491,523,10,1,0,13,3,0,0,42,32,74
p_198,0,9,e_1,369,487,526,8,1,0,2,4,0,1,118,39,157
p_162,0,11,e_3,420,480,527,18,3,3,8,5,3,0,60,47,107
p_145,0,11,e_3,454,480,527,8,1,0,8,4,0,1,26,47,73
p_115,0,9,e_0,487,491,528,29,8,8,1,4,0,1,4,37,41
p_197,0,10,e_1,370,487,531,8,1,0,1,4,0,1,117,44,161
p_112,0,11,e_0,490,491,536,28,8,8,0,3,0,0,1,45,46
p_207,0,11,e_1,359,487,536,11,1,0,5,4,0,1,128,49,177
p_155,0,14,e_3,435,480,538,14,2,2,12,5,1,1,45,58,103
p_206,0,12,e_1,361,487,541,11,1,0,4,4,0,1,126,54,180
p_203,0,12,e_1,364,487,541,10,1,0,3,4,0,1,123,54,177
p_167,0,1,e_2,413,536,543,20,3,3,2,4,0,1,123,7,130
p_156,0,15,e_3,434,480,543,14,2,2,12,5,1,1,46,63,109
p_152,0,15,e_3,441,480,543,13,1,0,13,4,0,1,39,63,102
p_151,0,15,e_3,442,480,543,12,1,0,12,4,0,1,38,63,101
p_149,0,15,e_3,444,480,543,12,1,0,12,4,0,1,36,63,99
p_204,0,14,e_1,363,487,549,10,1,0,4,4,0,1,124,62,186
p_106,0,3,e_2,500,536,551,26,7,7,12,4,0,1,36,15,51
p_211,0,15,e_1,353,487,554,13,1,0,7,4,0,1,134,67,201
p_202,0,15,e_1,365,487,554,9,1,0,3,4,0,1,122,67,189
p_199,0,15,e_1,368,487,554,8,1,0,2,4,0,1,119,67,186
p_165,0,4,e_2,417,536,556,19,3,3,1,4,0,1,119,20,139
p_108,0,6,e_2,496,536,564,27,7,7,13,4,0,1,40,28,68
p_111,0,8,e_2,491,536,572,28,8,8,15,4,0,1,45,36,81
p_169,0,9,e_2,411,536,577,21,3,3,3,4,0,1,125,41,166
p_163,0,10,e_2,419,536,582,18,3,3,0,3,0,0,117,46,163
p_86,0,2,e_0,544,574,584,15,1,0,10,4,0,1,30,10,40
p_164,0,11,e_2,418,536,587,18,3,3,0,4,0,1,118,51,169
p_110,0,11,e_2,492,536,587,28,8,8,14,4,0,1,44,51,95
p_107,0,11,e_2,499,536,587,26,7,7,12,4,0,1,37,51,88
p_77,0,3,e_0,557,574,589,11,1,0,5,4,0,1,17,15,32
p_166,0,12,e_2,416,536,592,19,3,3,1,4,0,1,120,56,176
p_105,0,12,e_2,502,536,592,25,7,7,11,4,0,1,34,56,90
p_88,0,5,e_0,538,574,597,16,2,2,11,3,0,0,36,23,59
p_75,0,5,e_0,559,574,597,10,1,0,5,4,0,1,15,23,38
p_168,0,13,e_2,412,536,597,20,3,3,2,4,0,1,124,61,185
p_130,0,1,e_3,472,590,597,2,1,0,2,4,0,1,118,7,125
p_76,0,6,e_0,558,574,602,10,1,0,5,4,0,1,16,28,44
p_104,0,14,e_2,503,536,602,25,7,7,11,4,0,1,33,66,99
p_136,0,3,e_3,465,590,605,5,1,0,5,4,0,1,125,15,140
p_129,0,3,e_3,473,590,605,2,1,0,2,4,0,1,117,15,132
p_80,0,7,e_0,552,574,607,12,1,0,7,4,0,1,22,33,55
p_74,0,7,e_0,560,574,607,10,1,0,4,4,0,1,14,33,47
p_109,0,15,e_2,493,536,607,27,8,8,14,4,0,1,43,71,114
p_161,0,1,e_1,421,601,608,17,4,4,10,5,2,1,180,7,187
p_158,0,1,e_1,430,601,608,15,3,3,12,5,1,1,171,7,178
p_119,0,1,e_1,483,601,608,30,8,8,1,4,0,1,118,7,125
p_137,0,4,e_3,464,590,610,5,1,0,5,4,0,1,126,20,146
p_87,0,8,e_0,539,574,612,16,2,2,11,4,0,1,35,38,73
p_83,0,8,e_0,549,574,612,13,1,0,8,4,0,1,25,38,63
p_141,0,6,e_3,458,590,618,7,1,0,7,4,0,1,132,28,160
p_196,0,4,e_1,371,601,619,7,1,0,1,4,0,1,230,18,248
p_84,0,12,e_0,546,574,626,14,1,0,9,4,0,1,28,52,80
p_78,0,12,e_0,556,574,626,11,1,0,6,4,0,1,18,52,70
p_140,0,8,e_3,459,590,626,7,1,0,7,4,0,1,131,36,167
p_194,0,6,e_1,373,601,627,7,1,0,0,4,0,1,228,26,254
p_159,0,6,e_1,429,601,627,15,3,3,12,5,1,1,172,26,198
p_118,0,7,e_1,484,601,632,30,8,8,1,4,0,1,117,31,148
p_82,0,14,e_0,550,574,634,13,1,0,8,4,0,1,24,60,84
p_81,0,14,e_0,551,574,634,13,1,0,7,4,0,1,23,60,83
p_79,0,14,e_0,553,574,634,12,1,0,7,4,0,1,21,60,81
p_139,0,10,e_3,461,590,634,6,1,0,6,4,0,1,129,44,173
p_135,0,10,e_3,466,590,634,4,1,0,4,4,0,1,124,44,168
p_127,0,10,e_3,475,590,634,1,1,0,1,4,0,1,115,44,159
p_85,0,15,e_0,545,574,639,15,1,0,9,4,0,1,29,65,94
p_138,0,11,e_3,463,590,639,5,1,0,5,4,0,1,127,49,176
p_132,0,11,e_3,470,590,639,3,1,0,3,4,0,1,120,49,169
p_128,0,11,e_3,474,590,639,2,1,0,2,4,0,1,116,49,165
p_117,0,10,e_1,485,601,643,29,9,9,0,4,0,1,116,42,158
p_133,0,12,e_3,469,590,644,3,1,0,3,4,0,1,121,54,175
p_193,0,11,e_1,374,601,648,6,1,0,0,3,0,0,227,47,274
p_121,0,11,e_1,481,601,648,30,8,8,2,4,0,1,120,47,167
p_120,0,11,e_1,482,601,648,30,8,8,1,4,0,1,119,47,166
p_131,0,14,e_3,471,590,652,3,1,0,3,4,0,1,119,62,181
p_134,0,15,e_3,467,590,657,4,1,0,4,4,0,1,123,67,190
p_157,0,14,e_1,431,601,659,15,3,3,12,5,1,1,170,58,228
p_96,0,1,e_2,517,654,659,21,5,5,6,4,0,1,137,5,142
p_195,0,15,e_1,372,601,664,7,1,0,1,4,0,1,229,63,292
p_160,0,15,e_1,426,601,664,16,3,3,11,5,1,1,175,63,238
p_122,0,15,e_1,480,601,664,30,9,9,2,4,0,1,121,63,184
p_92,0,4,e_2,525,654,670,19,4,4,3,4,0,1,129,16,145
p_99,0,6,e_2,514,654,678,22,5,5,7,4,0,1,140,24,164
p_94,0,6,e_2,519,654,678,21,4,4,5,4,0,1,135,24,159
p_102,0,7,e_2,509,654,683,23,6,6,9,4,0,1,145,29,174
p_98,0,7,e_2,515,654,683,22,5,5,7,4,0,1,139,29,168
p_97,0,7,e_2,516,654,683,22,5,5,6,4,0,1,138,29,167
p_101,0,8,e_2,511,654,688,23,5,5,8,4,0,1,143,34,177
p_65,0,1,e_0,573,686,691,5,1,0,0,3,0,0,113,5,118
p_100,0,9,e_2,513,654,693,23,5,5,7,4,0,1,141,39,180
p_89,0,9,e_2,535,654,693,17,3,3,0,3,0,0,119,39,158
p_72,0,3,e_0,562,686,699,9,1,0,4,4,0,1,124,13,137
p_71,0,3,e_0,564,686,699,8,1,0,3,4,0,1,122,13,135
p_70,0,3,e_0,565,686,699,8,1,0,3,4,0,1,121,13,134
p_67,0,3,e_0,568,686,699,7,1,0,2,4,0,1,118,13,131
p_66,0,3,e_0,569,686,699,7,1,0,1,4,0,1,117,13,130
p_30,0,3,e_0,668,686,699,12,1,0,6,4,0,1,18,13,31
p_103,0,11,e_2,508,654,701,24,6,6,9,4,0,1,146,47,193
p_91,0,12,e_2,526,654,706,19,3,3,3,4,0,1,128,52,180
p_29,0,5,e_0,670,686,707,11,1,0,5,4,0,1,16,21,37
p_93,0,13,e_2,520,654,711,21,4,4,5,4,0,1,134,57,191
p_90,0,13,e_2,527,654,711,19,3,3,3,4,0,1,127,57,184
p_31,0,6,e_0,666,686,712,12,1,0,6,4,0,1,20,26,46
p_55,0,3,e_3,585,704,715,1,1,0,1,4,0,1,119,11,130
p_54,0,3,e_3,586,704,715,1,1,0,1,4,0,1,118,11,129
p_95,0,14,e_2,518,654,716,21,4,4,6,4,0,1,136,62,198
p_45,0,2,e_1,595,711,719,29,11,11,2,4,0,1,116,8,124
p_26,0,8,e_0,684,686,720,6,1,0,0,4,0,1,2,34,36
p_64,0,4,e_3,574,704,720,5,1,0,5,4,0,1,130,16,146
p_48,0,4,e_1,592,711,727,30,10,10,3,4,0,1,119,16,135
p_46,0,4,e_1,594,711,727,30,10,10,2,4,0,1,117,16,133
p_27,0,10,e_0,677,686,728,9,1,0,3,4,0,1,9,42,51
p_61,0,6,e_3,579,704,728,3,1,0,3,4,0,1,125,24,149
p_56,0,6,e_3,584,704,728,2,1,0,2,4,0,1,120,24,144
p_73,0,11,e_0,561,686,733,9,1,0,4,4,0,1,125,47,172
p_28,0,11,e_0,676,686,733,9,1,0,3,4,0,1,10,47,57
p_124,0,7,e_3,478,704,733,0,1,0,0,4,0,1,226,29,255
p_42,0,6,e_1,598,711,735,29,10,10,1,4,0,1,113,24,137
p_50,0,7,e_1,590,711,740,30,11,11,3,4,0,1,121,29,150
p_43,0,7,e_1,597,711,740,29,10,10,1,4,0,1,114,29,143
p_68,0,13,e_0,567,686,741,7,1,0,2,4,0,1,119,55,174
p_60,0,10,e_3,580,704,744,3,1,0,3,4,0,1,124,40,164
p_44,0,8,e_1,596,711,745,29,10,10,1,4,0,1,115,34,149
p_69,0,14,e_0,566,686,746,8,1,0,2,4,0,1,120,60,180
p_123,0,11,e_3,479,704,749,0,0,0,0,3,0,0,225,45,270
p_58,0,11,e_3,582,704,749,2,1,0,2,4,0,1,122,45,167
p_57,0,11,e_3,583,704,749,2,1,0,2,4,0,1,121,45,166
p_47,0,9,e_1,593,711,750,30,10,10,2,4,0,1,118,39,157
p_126,0,12,e_3,476,704,754,1,1,0,1,4,0,1,228,50,278
p_116,0,10,e_1,486,711,755,29,8,8,0,3,0,0,225,44,269
p_63,0,13,e_3,577,704,759,4,1,0,4,4,0,1,127,55,182
p_62,0,13,e_3,578,704,759,4,1,0,4,4,0,1,126,55,181
p_41,0,11,e_1,600,711,760,28,10,10,0,3,0,0,111,49,160
p_125,0,14,e_3,477,704,764,1,1,0,1,4,0,1,227,60,287
p_59,0,14,e_3,581,704,764,3,1,0,3,4,0,1,123,60,183
p_49,0,14,e_1,591,711,771,30,10,10,3,4,0,1,120,60,180
p_22,0,3,e_2,719,760,771,4,8,8,13,4,0,1,41,11,52
p_21,0,4,e_2,731,760,776,21,7,7,9,4,0,1,29,16,45
p_32,0,6,e_2,650,760,784,16,3,3,1,4,0,1,110,24,134
p_37,0,9,e_2,615,760,795,25,8,8,13,4,0,1,145,35,180
p_35,0,9,e_2,630,760,795,21,6,6,8,4,0,1,130,35,165
p_19,0,11,e_2,754,760,803,16,3,3,2,4,0,1,6,43,49
p_39,0,12,e_2,607,760,808,27,9,9,15,4,0,1,153,48,201
p_34,0,12,e_2,646,760,808,18,3,3,2,4,0,1,114,48,162
p_23,0,12,e_2,711,760,808,26,10,10,13,5,1,1,49,48,97
p_40,0,13,e_2,602,760,813,28,10,10,14,5,1,1,158,53,211
p_38,0,13,e_2,608,760,813,26,9,9,15,4,0,1,152,53,205
p_36,0,13,e_2,628,760,813,22,6,6,8,4,0,1,132,53,185
p_20,0,14,e_2,734,760,818,21,6,6,8,4,0,1,26,58,84
p_24,0,2,e_3,695,808,818,3,1,0,3,4,0,1,113,10,123
p_16,0,2,e_3,780,808,818,9,1,0,9,4,0,1,28,10,38
p_33,0,15,e_2,649,760,823,17,3,3,1,4,0,1,111,63,174
p_52,0,3,e_3,588,808,823,0,1,0,0,4,0,1,220,15,235
p_14,0,4,e_3,794,808,828,4,1,0,4,4,0,1,14,20,34
p_25,0,8,e_3,686,808,842,6,1,0,6,4,0,1,122,34,156
p_18,0,10,e_0,766,811,843,14,1,0,14,3,0,0,45,32,77
p_53,0,9,e_3,587,808,847,1,1,0,1,4,0,1,221,39,260
p_51,0,9,e_3,589,808,847,0,0,0,0,3,0,0,219,39,258
p_15,0,9,e_3,793,808,847,5,1,0,5,4,0,1,15,39,54
p_11,0,9,e_3,807,808,847,0,0,0,0,3,0,0,1,39,40
p_17,0,10,e_1,776,821,853,10,1,0,14,3,0,0,45,32,77
p_13,0,11,e_3,796,808,855,4,1,0,4,4,0,1,12,47,59
p_12,0,11,e_3,798,808,855,3,1,0,3,4,0,1,10,47,57
p_9,0,2,e_0,846,879,887,13,1,1,10,3,0,0,33,8,41
p_6,0,3,e_0,877,879,892,11,0,0,0,4,0,1,2,13,15
p_7,0,5,e_0,875,879,900,11,0,0,1,4,0,1,4,21,25
p_10,0,8,e_2,835,883,909,16,3,3,15,3,0,0,48,26,74
p_8,0,11,e_0,874,879,920,11,0,0,1,4,0,1,5,41,46
p_4,0,1,e_3,886,922,927,11,0,0,11,3,0,0,36,5,41
p_1,0,5,e_1,894,916,933,9,1,0,7,4,0,1,22,17,39
p_5,0,8,e_1,883,916,944,11,0,0,10,3,0,0,33,28,61
p_3,0,8,e_1,888,916,944,11,1,0,9,4,0,1,28,28,56
p_2,0,11,e_1,892,916,955,10,1,0,8,4,0,1,24,39,63
p_300,0,4,e_0,8,9,25,0,0,0,0,3,0,0,1,16,17
p_299,0,5,e_1,9,10,29,0,0,0,0,3,0,0,1,19,20
p_297,0,6,e_3,15,16,38,0,0,0,0,3,0,0,1,22,23
p_298,0,9,e_2,11,12,43,0,0,0,0,3,0,0,1,31,32
p_296,0,4,e_0,28,43,57,9,1,1,4,3,0,0,15,14,29
p_295,0,5,e_0,29,43,62,9,1,1,4,4,0,1,14,19,33
p_292,0,6,e_0,38,43,67,6,0,0,1,4,0,1,5,24,29
p_290,0,6,e_0,40,43,67,6,0,0,1,4,0,1,3,24,27
p_286,0,3,e_1,46,61,72,6,0,0,5,4,0,1,15,11,26
p_289,0,4,e_1,43,61,77,6,0,0,5,3,0,0,18,16,34
p_285,0,4,e_1,53,61,77,6,0,0,2,4,0,1,8,16,24
p_284,0,4,e_1,54,61,77,6,0,0,2,4,0,1,7,16,23
p_287,0,5,e_1,45,61,82,6,0,0,5,4,0,1,16,21,37
p_291,0,11,e_0,39,43,84,6,0,0,1,4,0,1,4,41,45
p_294,0,12,e_0,31,43,89,8,1,1,4,4,0,1,12,46,58
p_293,0,12,e_0,33,43,89,7,1,1,3,4,0,1,10,46,56
p_288,0,8,e_1,44,61,93,6,0,0,5,4,0,1,17,32,49
p_281,0,1,e_3,73,87,94,4,1,0,4,4,0,1,14,7,21
p_283,0,9,e_1,57,61,98,6,0,0,1,4,0,1,4,37,41
p_278,0,2,e_3,77,87,99,3,1,0,3,4,0,1,10,12,22
p_279,0,5,e_3,76,87,110,3,1,0,3,4,0,1,11,23,34
p_277,0,6,e_3,82,87,115,1,1,0,1,4,0,1,5,28,33
p_282,0,7,e_3,66,87,120,6,0,0,6,3,0,0,21,33,54
p_273,0,4,e_2,110,118,132,23,4,4,2,4,0,1,8,14,22
p_276,0,11,e_3,84,87,134,1,1,0,1,4,0,1,3,47,50
p_280,0,14,e_3,75,87,145,4,1,0,4,4,0,1,12,58,70
p_275,0,14,e_3,86,87,145,0,0,0,0,3,0,0,1,58,59
p_274,0,8,e_2,88,118,146,28,7,7,9,3,0,0,30,28,58
p_272,0,10,e_2,113,118,154,22,4,4,1,4,0,1,5,36,41
p_271,0,1,e_1,121,151,156,21,2,2,9,3,0,0,30,5,35
p_267,0,1,e_1,148,151,156,14,0,0,1,4,0,1,3,5,8
p_268,0,2,e_1,144,151,161,14,0,0,2,4,0,1,7,10,17
p_270,0,9,e_1,122,151,184,21,2,2,9,4,0,1,29,33,62
p_269,0,9,e_1,127,151,184,19,2,2,8,4,0,1,24,33,57
p_255,0,3,e_2,184,186,197,14,0,0,0,4,0,1,2,11,13
p_265,0,4,e_2,152,186,202,14,0,0,10,5,1,1,34,16,50
p_262,0,5,e_2,157,186,207,14,0,0,9,4,0,1,29,21,50
p_261,0,5,e_2,164,186,207,14,0,0,7,4,0,1,22,21,43
p_266,0,6,e_2,151,186,212,14,0,0,9,5,1,0,35,26,61
p_263,0,7,e_2,154,186,217,14,0,0,10,4,0,1,32,31,63
p_260,0,7,e_2,165,186,217,14,0,0,7,4,0,1,21,31,52
p_258,0,7,e_2,168,186,217,14,0,0,6,4,0,1,18,31,49
p_256,0,10,e_2,182,186,228,14,0,0,1,4,0,1,4,42,46
p_254,0,4,e_1,187,217,231,14,0,0,9,3,0,0,30,14,44
p_264,0,11,e_2,153,186,233,14,0,0,10,2,1,1,33,47,80
p_253,0,5,e_1,190,217,236,14,0,0,9,4,0,1,27,19,46
p_252,0,5,e_1,205,217,236,14,0,0,4,4,0,1,12,19,31
p_257,0,14,e_2,169,186,244,14,0,0,5,4,0,1,17,58,75
p_259,0,15,e_2,167,186,249,14,0,0,6,4,0,1,19,63,82
p_250,0,2,e_0,217,256,264,14,0,0,12,3,0,0,39,8,47
p_251,0,15,e_1,209,217,268,14,0,0,2,4,0,1,8,51,59
p_248,0,5,e_0,246,256,275,14,0,0,3,4,0,1,10,19,29
p_247,0,5,e_0,250,256,275,14,0,0,2,4,0,1,6,19,25
p_249,0,6,e_0,239,256,280,14,0,0,5,4,0,1,17,24,41
p_241,0,1,e_0,283,300,305,14,0,0,5,4,0,1,17,5,22
p_245,0,7,e_0,269,300,325,14,0,0,3,5,2,1,31,25,56
p_242,0,8,e_0,277,300,330,14,0,0,5,5,1,1,23,30,53
p_246,0,10,e_0,262,300,338,14,0,0,2,5,3,0,38,38,76
p_244,0,12,e_0,271,300,346,14,0,0,4,5,2,1,29,46,75
p_236,0,1,e_3,305,346,351,13,1,0,13,4,0,1,41,5,46
p_233,0,1,e_3,311,346,351,11,1,0,11,4,0,1,35,5,40
p_226,0,2,e_3,329,346,356,5,1,0,5,4,0,1,17,10,27
p_243,0,15,e_0,272,300,357,14,0,0,4,5,2,1,28,57,85
p_230,0,3,e_3,319,346,361,9,1,0,9,4,0,1,27,15,42
p_228,0,4,e_3,325,346,366,7,1,0,7,4,0,1,21,20,41
p_232,0,5,e_3,314,346,371,10,1,0,10,4,0,1,32,25,57
p_237,0,7,e_3,304,346,379,14,1,0,14,4,0,1,42,33,75
p_231,0,7,e_3,317,346,379,9,1,0,9,4,0,1,29,33,62
p_235,0,8,e_3,308,346,384,12,1,0,12,4,0,1,38,38,76
p_234,0,8,e_3,310,346,384,12,1,0,12,4,0,1,36,38,74
p_240,0,9,e_3,301,346,389,14,0,0,14,3,0,0,45,43,88
p_239,0,11,e_3,302,346,397,14,1,0,14,4,0,1,44,51,95
p_216,0,1,e_2,347,395,400,26,11,11,15,3,0,0,48,5,53
p_209,0,2,e_1,357,394,402,24,10,10,12,4,0,1,37,8,45
p_205,0,2,e_1,362,394,402,23,9,9,10,4,0,1,32,8,40
p_227,0,12,e_3,327,346,402,6,1,0,6,4,0,1,19,56,75
p_214,0,3,e_1,349,394,407,25,12,12,15,4,0,1,45,13,58
p_238,0,13,e_3,303,346,407,14,1,0,14,4,0,1,43,61,104
p_229,0,13,e_3,320,346,407,8,1,0,8,4,0,1,26,61,87
p_183,0,1,e_2,396,405,410,15,3,3,0,5,1,0,9,5,14
p_182,0,2,e_2,397,405,415,15,3,3,0,5,1,1,8,10,18
p_180,0,2,e_2,399,405,415,15,3,3,1,2,1,1,6,10,16
p_210,0,6,e_1,354,394,418,24,11,11,13,4,0,1,40,24,64
p_208,0,6,e_1,358,394,418,24,10,10,12,4,0,1,36,24,60
p_178,0,3,e_2,401,405,420,14,2,2,1,4,0,1,4,15,19
p_217,0,7,e_1,346,394,423,26,11,11,15,3,0,0,48,29,77
p_212,0,7,e_1,351,394,423,25,11,11,14,4,0,1,43,29,72
p_176,0,4,e_2,403,405,425,14,2,2,0,4,0,1,2,20,22
p_207,0,11,e_1,359,394,437,23,10,10,11,4,0,1,35,43,78
p_179,0,8,e_2,400,405,439,14,3,3,1,4,0,1,5,34,39
p_206,0,12,e_1,361,394,442,23,9,9,11,4,0,1,33,48,81
p_203,0,12,e_1,364,394,442,22,9,9,10,4,0,1,30,48,78
p_177,0,9,e_2,402,405,444,14,2,2,1,4,0,1,3,39,42
p_204,0,14,e_1,363,394,450,23,9,9,10,4,0,1,31,56,87
p_215,0,15,e_1,348,394,455,26,11,11,15,4,0,1,46,61,107
p_213,0,15,e_1,350,394,455,25,11,11,14,4,0,1,44,61,105
p_211,0,15,e_1,353,394,455,25,11,11,13,4,0,1,41,61,102
p_202,0,15,e_1,365,394,455,4,8,8,9,4,0,1,29,61,90
p_223,0,2,e_3,336,448,456,3,1,0,3,4,0,1,112,8,120
p_181,0,15,e_2,398,405,464,15,3,3,1,5,1,1,7,59,66
p_225,0,5,e_3,330,448,467,5,1,0,5,4,0,1,118,19,137
p_224,0,5,e_3,331,448,467,5,1,0,5,4,0,1,117,19,136
p_222,0,5,e_3,337,448,467,3,1,0,3,4,0,1,111,19,130
p_219,0,5,e_3,342,448,467,1,1,0,1,4,0,1,106,19,125
p_221,0,6,e_3,339,448,472,2,1,0,2,4,0,1,109,24,133
p_220,0,6,e_3,341,448,472,1,1,0,1,4,0,1,107,24,131
p_169,0,9,e_3,411,448,483,12,1,0,12,4,0,1,37,35,72
p_218,0,11,e_3,343,448,491,1,1,0,1,4,0,1,105,43,148
p_173,0,11,e_3,407,448,491,13,1,0,13,4,0,1,41,43,84
p_171,0,13,e_3,409,448,499,13,1,0,13,4,0,1,39,51,90
p_146,0,1,e_0,453,497,504,29,9,9,14,4,0,1,44,7,51
p_175,0,14,e_3,405,448,504,13,2,2,13,5,1,1,43,56,99
p_174,0,14,e_3,406,448,504,13,1,1,13,2,1,1,42,56,98
p_170,0,14,e_3,410,448,504,12,1,0,12,4,0,1,38,56,94
p_190,0,1,e_1,379,502,507,19,6,6,5,4,0,1,123,5,128
p_172,0,15,e_3,408,448,509,13,1,0,13,4,0,1,40,61,101
p_143,0,3,e_0,456,497,512,28,8,8,13,4,0,1,41,15,56
p_136,0,3,e_0,465,497,512,25,8,8,10,4,0,1,32,15,47
p_137,0,4,e_0,464,497,517,26,8,8,11,4,0,1,33,20,53
p_200,0,4,e_1,367,502,518,22,8,8,9,4,0,1,135,16,151
p_196,0,4,e_1,371,502,518,21,7,7,7,4,0,1,131,16,147
p_201,0,5,e_1,366,502,523,22,8,8,9,4,0,1,136,21,157
p_141,0,6,e_0,458,497,525,28,8,8,13,4,0,1,39,28,67
p_194,0,6,e_1,373,502,528,21,7,7,7,4,0,1,129,26,155
p_148,0,8,e_0,449,497,533,30,8,8,15,3,0,0,48,36,84
p_140,0,8,e_0,459,497,533,27,8,8,12,4,0,1,38,36,74
p_192,0,8,e_1,375,502,536,20,7,7,6,4,0,1,127,34,161
p_189,0,8,e_1,382,502,536,18,6,6,4,4,0,1,120,34,154
p_147,0,9,e_0,452,497,538,29,9,9,15,4,0,1,45,41,86
p_144,0,9,e_0,455,497,538,28,8,8,14,4,0,1,42,41,83
p_142,0,9,e_0,457,497,538,28,8,8,13,4,0,1,40,41,81
p_198,0,9,e_1,369,502,541,21,8,8,8,4,0,1,133,39,172
p_139,0,10,e_0,461,497,543,27,8,8,12,4,0,1,36,46,82
p_135,0,10,e_0,466,497,543,25,7,7,10,4,0,1,31,46,77
p_197,0,10,e_1,370,502,546,21,7,7,8,4,0,1,132,44,176
p_191,0,10,e_1,376,502,546,20,7,7,6,4,0,1,126,44,170
p_145,0,11,e_0,454,497,548,28,9,9,14,4,0,1,43,51,94
p_138,0,11,e_0,463,497,548,26,8,8,11,4,0,1,34,51,85
p_193,0,11,e_1,374,502,551,20,7,7,6,4,0,1,128,49,177
p_187,0,12,e_1,389,502,556,17,4,4,1,4,0,1,113,54,167
p_96,0,1,e_2,517,550,557,13,1,0,11,4,0,1,33,7,40
p_188,0,13,e_1,384,502,561,18,5,5,3,4,0,1,118,59,177
p_167,0,1,e_3,413,556,561,11,1,0,11,4,0,1,143,5,148
p_161,0,1,e_3,421,556,561,9,1,0,9,4,0,1,135,5,140
p_158,0,1,e_3,430,556,561,6,1,0,6,4,0,1,126,5,131
p_134,0,15,e_0,467,497,562,25,7,7,10,4,0,1,30,65,95
p_92,0,4,e_2,525,550,568,10,1,0,8,4,0,1,25,18,43
p_199,0,15,e_1,368,502,569,22,8,8,8,4,0,1,134,67,201
p_195,0,15,e_1,372,502,569,21,7,7,7,4,0,1,130,67,197
p_165,0,4,e_3,417,556,572,10,1,0,10,4,0,1,139,16,155
p_99,0,6,e_2,514,550,576,14,1,0,12,4,0,1,36,26,62
p_94,0,6,e_2,519,550,576,12,1,0,10,4,0,1,31,26,57
p_159,0,6,e_3,429,556,580,6,1,0,6,4,0,1,127,24,151
p_102,0,7,e_2,509,550,581,15,1,0,13,4,0,1,41,31,72
p_98,0,7,e_2,515,550,581,13,1,0,11,4,0,1,35,31,66
p_154,0,7,e_3,436,556,585,4,1,0,4,4,0,1,120,29,149
p_101,0,8,e_2,511,550,586,15,1,0,13,4,0,1,39,36,75
p_100,0,9,e_2,513,550,591,14,1,0,12,4,0,1,37,41,78
p_163,0,10,e_3,419,556,596,9,1,0,9,4,0,1,137,40,177
p_103,0,11,e_2,508,550,599,15,1,1,14,4,0,1,42,49,91
p_164,0,11,e_3,418,556,601,10,1,0,10,4,0,1,138,45,183
p_162,0,11,e_3,420,556,601,9,1,0,9,4,0,1,136,45,181
p_105,0,12,e_2,502,550,604,16,3,3,15,3,0,0,48,54,102
p_91,0,12,e_2,526,550,604,10,1,0,8,4,0,1,24,54,78
p_166,0,12,e_3,416,556,606,10,1,0,10,4,0,1,140,50,190
p_93,0,13,e_2,520,550,609,12,1,0,10,4,0,1,30,59,89
p_90,0,13,e_2,527,550,609,9,1,0,7,4,0,1,23,59,82
p_168,0,13,e_3,412,556,611,12,1,0,12,4,0,1,144,55,199
p_104,0,14,e_2,503,550,614,16,2,2,15,4,0,1,47,64,111
p_95,0,14,e_2,518,550,614,12,1,0,10,4,0,1,32,64,96
p_130,0,1,e_0,472,609,616,24,6,6,8,4,0,1,137,7,144
p_119,0,1,e_0,483,609,616,21,5,5,4,4,0,1,126,7,133
p_157,0,14,e_3,431,556,616,5,1,0,5,4,0,1,125,60,185
p_155,0,14,e_3,435,556,616,4,1,0,4,4,0,1,121,60,181
p_160,0,15,e_3,426,556,621,7,1,0,7,4,0,1,130,65,195
p_156,0,15,e_3,434,556,621,4,1,0,4,4,0,1,122,65,187
p_129,0,3,e_0,473,609,624,24,6,6,8,4,0,1,136,15,151
p_106,0,3,e_1,500,616,629,17,3,3,0,4,0,1,116,13,129
p_186,0,4,e_1,390,616,634,17,4,4,1,4,0,1,226,18,244
p_124,0,7,e_0,478,609,638,22,6,6,6,4,0,1,131,29,160
p_127,0,10,e_0,475,609,649,23,6,6,7,4,0,1,134,40,174
p_37,0,9,e_1,615,616,651,16,2,2,0,3,0,0,1,35,36
p_132,0,11,e_0,470,609,654,24,7,7,9,4,0,1,139,45,184
p_128,0,11,e_0,474,609,654,24,6,6,7,4,0,1,135,45,180
p_123,0,11,e_0,479,609,654,22,6,6,6,4,0,1,130,45,175
p_121,0,11,e_0,481,609,654,21,6,6,5,4,0,1,128,45,173
p_120,0,11,e_0,482,609,654,21,5,5,5,4,0,1,127,45,172
p_185,0,10,e_1,391,616,656,17,4,4,1,4,0,1,225,40,265
p_133,0,12,e_0,469,609,659,25,7,7,9,4,0,1,140,50,190
p_126,0,12,e_0,476,609,659,23,6,6,7,4,0,1,133,50,183
p_107,0,11,e_1,499,616,661,17,3,3,1,4,0,1,117,45,162
p_184,0,12,e_1,392,616,666,16,4,4,0,4,0,1,224,50,274
p_86,0,2,e_2,544,658,666,4,1,0,2,4,0,1,114,8,122
p_131,0,14,e_0,471,609,667,24,6,6,8,4,0,1,138,58,196
p_125,0,14,e_0,477,609,667,23,6,6,6,4,0,1,132,58,190
p_122,0,15,e_0,480,609,672,22,6,6,5,4,0,1,129,63,192
p_88,0,5,e_2,538,658,677,6,1,0,4,4,0,1,120,19,139
p_32,0,6,e_2,650,658,682,6,1,0,2,4,0,1,8,24,32
p_150,0,6,e_3,443,668,688,1,1,0,1,4,0,1,225,20,245
p_31,0,6,e_3,666,668,688,0,1,0,0,4,0,1,2,20,22
p_87,0,8,e_2,539,658,690,5,1,0,3,4,0,1,119,32,151
p_83,0,8,e_2,549,658,690,2,1,0,0,3,0,0,109,32,141
p_80,0,7,e_3,552,668,693,1,1,0,1,4,0,1,116,25,141
p_89,0,9,e_2,535,658,695,7,1,0,5,4,0,1,123,37,160
p_35,0,9,e_2,630,658,695,12,1,0,9,4,0,1,28,37,65
p_153,0,9,e_3,437,668,701,3,1,0,3,4,0,1,231,33,264
p_84,0,12,e_2,546,658,706,3,1,0,1,4,0,1,112,48,160
p_34,0,12,e_2,646,658,706,7,1,0,4,4,0,1,12,48,60
p_68,0,13,e_2,567,658,711,27,10,10,4,3,9,1,91,53,144
p_36,0,13,e_2,628,658,711,13,1,0,10,4,0,1,30,53,83
p_24,0,2,e_1,695,707,715,23,3,3,4,4,0,1,12,8,20
p_82,0,14,e_3,550,668,718,2,1,0,2,4,0,1,118,50,168
p_81,0,14,e_3,551,668,718,1,1,0,1,4,0,1,117,50,167
p_79,0,14,e_3,553,668,718,1,1,0,1,4,0,1,115,50,165
p_85,0,15,e_2,545,658,719,3,1,0,1,4,0,1,113,61,174
p_33,0,15,e_2,649,658,719,6,1,0,3,4,0,1,9,61,70
p_30,0,3,e_1,668,707,720,30,5,5,12,3,0,0,39,13,52
p_152,0,15,e_3,441,668,723,2,1,0,2,4,0,1,227,55,282
p_151,0,15,e_3,442,668,723,2,1,0,2,4,0,1,226,55,281
p_149,0,15,e_3,444,668,723,1,1,0,1,4,0,1,224,55,279
p_113,0,1,e_0,489,719,724,19,5,5,2,4,0,1,230,5,235
p_29,0,5,e_1,670,707,728,30,5,5,12,4,0,1,37,21,58
p_114,0,3,e_0,488,719,732,20,5,5,3,4,0,1,231,13,244
p_77,0,3,e_0,557,719,732,30,10,10,14,5,1,1,162,13,175
p_26,0,8,e_1,684,707,739,25,5,5,7,4,0,1,23,32,55
p_25,0,8,e_1,686,707,739,24,5,5,7,4,0,1,21,32,53
p_108,0,6,e_0,496,719,743,18,4,4,0,3,0,0,223,24,247
p_76,0,6,e_0,558,719,743,30,10,10,14,5,1,1,161,24,185
p_27,0,10,e_1,677,707,747,27,5,5,10,4,0,1,30,40,70
p_118,0,7,e_0,484,719,748,21,5,5,4,4,0,1,235,29,264
p_97,0,7,e_0,516,719,748,13,1,0,4,3,7,1,203,29,232
p_28,0,11,e_1,676,707,752,28,5,5,10,4,0,1,31,45,76
p_111,0,8,e_0,491,719,753,19,4,4,2,4,0,1,228,34,262
p_115,0,9,e_0,487,719,758,20,5,5,3,4,0,1,232,39,271
p_117,0,10,e_0,485,719,763,21,5,5,4,4,0,1,234,44,278
p_116,0,10,e_0,486,719,763,20,5,5,3,4,0,1,233,44,277
p_112,0,11,e_0,490,719,768,19,4,4,2,4,0,1,229,49,278
p_110,0,11,e_0,492,719,768,19,4,4,1,4,0,1,227,49,276
p_78,0,12,e_0,556,719,773,30,10,10,13,5,1,1,163,54,217
p_22,0,3,e_2,719,767,780,16,1,1,15,3,0,0,48,13,61
p_109,0,15,e_0,493,719,784,19,4,4,1,4,0,1,226,65,291
p_21,0,4,e_2,731,767,785,15,0,0,12,4,0,1,36,18,54
p_18,0,10,e_2,766,767,805,15,0,0,0,3,0,0,1,38,39
p_19,0,11,e_2,754,767,810,15,0,0,4,4,0,1,13,43,56
p_16,0,2,e_1,780,812,820,15,0,0,10,4,0,1,32,8,40
p_20,0,14,e_2,734,767,821,15,0,0,11,4,0,1,33,54,87
p_14,0,4,e_1,794,812,828,15,0,0,6,4,0,1,18,16,34
p_65,0,1,e_0,573,831,836,26,9,9,12,4,0,1,258,5,263
p_72,0,3,e_0,562,831,844,29,10,10,15,4,0,1,269,13,282
p_71,0,3,e_0,564,831,844,28,10,10,15,4,0,1,267,13,280
p_70,0,3,e_0,565,831,844,28,10,10,14,4,0,1,266,13,279
p_67,0,3,e_0,568,831,844,27,10,10,13,4,0,1,263,13,276
p_66,0,3,e_0,569,831,844,27,10,10,13,4,0,1,262,13,275
p_15,0,9,e_1,793,812,845,15,0,0,6,4,0,1,19,33,52
p_11,0,9,e_1,807,812,845,15,0,0,1,4,0,1,5,33,38
p_64,0,4,e_0,574,831,849,26,9,9,11,4,0,1,257,18,275
p_17,0,10,e_1,776,812,850,15,0,0,11,3,0,0,36,38,74
p_75,0,5,e_0,559,831,854,29,11,11,14,5,1,1,272,23,295
p_13,0,11,e_1,796,812,855,15,0,0,5,4,0,1,16,43,59
p_12,0,11,e_1,798,812,855,15,0,0,4,4,0,1,14,43,57
p_61,0,6,e_0,579,831,859,24,8,8,10,4,0,1,252,28,280
p_74,0,7,e_0,560,831,864,29,10,10,15,5,1,1,271,33,304
p_60,0,10,e_0,580,831,875,24,8,8,9,4,0,1,251,44,295
p_73,0,11,e_0,561,831,880,29,10,10,15,2,1,1,270,49,319
p_63,0,13,e_0,577,831,888,25,9,9,10,4,0,1,254,57,311
p_62,0,13,e_0,578,831,888,24,9,9,10,4,0,1,253,57,310
p_9,0,2,e_2,846,880,888,15,0,0,11,4,0,1,34,8,42
p_69,0,14,e_0,566,831,893,28,10,10,14,4,0,1,265,62,327
p_6,0,3,e_2,877,880,893,15,0,0,1,4,0,1,3,13,16
p_7,0,5,e_2,875,880,901,15,0,0,1,4,0,1,5,21,26
p_10,0,8,e_2,835,880,912,15,0,0,14,3,0,0,45,32,77
p_8,0,11,e_2,874,880,923,15,0,0,2,4,0,1,6,43,49
p_4,0,1,e_1,886,919,924,15,0,0,11,4,0,1,33,5,38
p_1,0,5,e_1,894,919,938,15,0,0,8,4,0,1,25,19,44
p_45,0,2,e_0,595,937,945,20,6,6,4,4,0,1,342,8,350
p_5,0,8,e_1,883,919,949,15,0,0,11,3,0,0,36,30,66
p_3,0,8,e_1,888,919,949,15,0,0,10,4,0,1,31,30,61
p_55,0,3,e_0,585,937,950,23,7,7,8,4,0,1,352,13,365
p_54,0,3,e_0,586,937,950,23,7,7,7,4,0,1,351,13,364
p_52,0,3,e_0,588,937,950,22,7,7,7,4,0,1,349,13,362
p_48,0,4,e_0,592,937,955,21,7,7,5,4,0,1,345,18,363
p_46,0,4,e_0,594,937,955,20,7,7,5,4,0,1,343,18,361
p_2,0,11,e_1,892,919,960,15,0,0,9,4,0,1,27,41,68
p_56,0,6,e_0,584,937,963,23,7,7,8,4,0,1,353,26,379
p_50,0,7,e_0,590,937,968,22,7,7,6,4,0,1,347,31,378
p_53,0,9,e_0,587,937,976,23,7,7,7,4,0,1,350,39,389
p_51,0,9,e_0,589,937,976,22,7,7,6,4,0,1,348,39,387
p_47,0,9,e_0,593,937,976,21,7,7,5,4,0,1,344,39,383
p_58,0,11,e_0,582,937,984,24,8,8,9,4,0,1,355,47,402
p_57,0,11,e_0,583,937,984,23,8,8,8,4,0,1,354,47,401
p_59,0,14,e_0,581,937,995,24,8,8,9,4,0,1,356,58,414
p_49,0,14,e_0,591,937,995,21,7,7,6,4,0,1,346,58,404
p_42,0,6,e_0,598,1039,1059,20,6,6,3,4,0,1,441,20,461
p_43,0,7,e_0,597,1039,1064,20,6,6,4,4,0,1,442,25,467
p_44,0,8,e_0,596,1039,1069,20,6,6,4,4,0,1,443,30,473
p_41,0,11,e_0,600,1039,1080,19,5,5,3,4,0,1,439,41,480
p_39,0,12,e_0,607,1039,1085,18,4,4,0,4,0,1,432,46,478
p_23,0,12,e_0,711,1039,1085,18,2,2,2,4,0,1,328,46,374
p_40,0,13,e_0,602,1039,1090,19,5,5,2,4,0,1,437,51,488
p_38,0,13,e_0,608,1039,1090,18,4,4,0,3,0,0,431,51,482
p_300,0,4,e_0,8,9,25,0,0,0,0,3,0,0,1,16,17
p_299,0,5,e_1,9,10,29,0,0,0,0,3,0,0,1,19,20
p_297,0,6,e_3,15,16,38,0,0,0,0,3,0,0,1,22,23
p_298,0,9,e_2,11,12,43,0,0,0,0,3,0,0,1,31,32
p_296,0,4,e_0,28,43,57,9,1,1,4,3,0,0,15,14,29
p_295,0,5,e_0,29,43,62,9,1,1,4,4,0,1,14,19,33
p_292,0,6,e_0,38,43,67,6,0,0,1,4,0,1,5,24,29
p_290,0,6,e_0,40,43,67,6,0,0,1,4,0,1,3,24,27
p_286,0,3,e_1,46,61,72,6,0,0,5,4,0,1,15,11,26
p_289,0,4,e_1,43,61,77,6,0,0,5,3,0,0,18,16,34
p_285,0,4,e_1,53,61,77,6,0,0,2,4,0,1,8,16,24
p_284,0,4,e_1,54,61,77,6,0,0,2,4,0,1,7,16,23
p_287,0,5,e_1,45,61,82,6,0,0,5,4,0,1,16,21,37
p_291,0,11,e_0,39,43,84,6,0,0,1,4,0,1,4,41,45
p_294,0,12,e_0,31,43,89,8,1,1,4,4,0,1,12,46,58
p_293,0,12,e_0,33,43,89,7,1,1,3,4,0,1,10,46,56
p_288,0,8,e_1,44,61,93,6,0,0,5,4,0,1,17,32,49
p_281,0,1,e_3,73,87,94,4,1,0,4,4,0,1,14,7,21
p_283,0,9,e_1,57,61,98,6,0,0,1,4,0,1,4,37,41
p_278,0,2,e_3,77,87,99,3,1,0,3,4,0,1,10,12,22
p_279,0,5,e_3,76,87,110,3,1,0,3,4,0,1,11,23,34
p_277,0,6,e_3,82,87,115,1,1,0,1,4,0,1,5,28,33
p_282,0,7,e_3,66,87,120,6,0,0,6,3,0,0,21,33,54
p_273,0,4,e_2,110,118,132,23,4,4,2,4,0,1,8,14,22
p_276,0,11,e_3,84,87,134,1,1,0,1,4,0,1,3,47,50
p_280,0,14,e_3,75,87,145,4,1,0,4,4,0,1,12,58,70
p_275,0,14,e_3,86,87,145,0,0,0,0,3,0,0,1,58,59
p_274,0,8,e_2,88,118,146,28,7,7,9,3,0,0,30,28,58
p_272,0,10,e_2,113,118,154,22,4,4,1,4,0,1,5,36,41
p_271,0,1,e_1,121,151,156,21,2,2,9,3,0,0,30,5,35
p_267,0,1,e_1,148,151,156,14,0,0,1,4,0,1,3,5,8
p_268,0,2,e_1,144,151,161,14,0,0,2,4,0,1,7,10,17
p_270,0,9,e_1,122,151,184,21,2,2,9,4,0,1,29,33,62
p_269,0,9,e_1,127,151,184,19,2,2,8,4,0,1,24,33,57
p_255,0,3,e_2,184,186,197,14,0,0,0,4,0,1,2,11,13
p_265,0,4,e_2,152,186,202,14,0,0,10,5,1,0,34,16,50
p_254,0,4,e_0,187,190,204,14,0,0,1,4,0,1,3,14,17
p_262,0,5,e_2,157,186,207,14,0,0,9,4,0,1,29,21,50
p_261,0,5,e_2,164,186,207,14,0,0,7,4,0,1,22,21,43
p_266,0,6,e_0,151,190,212,14,0,0,12,3,0,0,39,22,61
p_263,0,7,e_2,154,186,215,14,0,0,10,4,0,1,32,29,61
p_260,0,7,e_2,165,186,215,14,0,0,7,4,0,1,21,29,50
p_258,0,7,e_2,168,186,215,14,0,0,6,4,0,1,18,29,47
p_256,0,10,e_2,182,186,226,14,0,0,1,4,0,1,4,40,44
p_250,0,2,e_1,217,220,228,14,0,0,1,4,0,1,3,8,11
p_264,0,11,e_2,153,186,231,14,0,0,10,2,1,1,33,45,78
p_253,0,5,e_1,190,220,239,14,0,0,9,3,0,0,30,19,49
p_252,0,5,e_1,205,220,239,14,0,0,5,4,0,1,15,19,34
p_257,0,14,e_2,169,186,242,14,0,0,5,4,0,1,17,56,73
p_259,0,15,e_2,167,186,247,14,0,0,6,4,0,1,19,61,80
p_251,0,15,e_1,209,220,271,14,0,0,3,4,0,1,11,51,62
p_248,0,5,e_0,246,260,277,14,0,0,4,4,0,1,14,17,31
p_247,0,5,e_0,250,260,277,14,0,0,3,4,0,1,10,17,27
p_249,0,6,e_0,239,260,282,14,0,0,6,3,0,0,21,22,43
p_241,0,1,e_0,283,302,309,8,1,0,6,4,0,1,19,7,26
p_236,0,1,e_3,305,307,312,0,1,0,0,4,0,1,2,5,7
p_245,0,7,e_0,269,302,329,12,1,0,3,5,2,0,33,27,60
p_237,0,7,e_3,304,307,332,1,1,0,1,4,0,1,3,25,28
p_242,0,8,e_0,277,302,334,10,1,0,5,5,1,1,25,32,57
p_240,0,9,e_0,301,302,339,2,1,0,0,3,0,0,1,37,38
p_246,0,10,e_3,262,307,343,14,0,0,14,3,0,0,45,36,81
p_239,0,11,e_3,302,307,348,1,1,0,1,4,0,1,5,41,46
p_244,0,12,e_0,271,302,350,12,1,0,3,5,2,1,31,48,79
p_238,0,13,e_3,303,307,356,1,1,0,1,4,0,1,4,49,53
p_243,0,15,e_0,272,302,361,11,1,0,4,5,2,1,30,59,89
p_233,0,1,e_1,311,356,361,25,4,4,15,4,0,1,45,5,50
p_226,0,2,e_1,329,356,366,20,4,4,9,4,0,1,27,10,37
p_223,0,2,e_1,336,356,366,18,3,3,6,4,0,1,20,10,30
p_209,0,2,e_2,357,358,368,13,0,0,0,3,0,0,1,10,11
p_230,0,3,e_1,319,356,371,23,4,4,12,4,0,1,37,15,52
p_228,0,4,e_1,325,356,376,21,4,4,10,4,0,1,31,20,51
p_232,0,5,e_1,314,356,381,25,4,4,14,4,0,1,42,25,67
p_225,0,5,e_1,330,356,381,19,4,4,8,4,0,1,26,25,51
p_224,0,5,e_1,331,356,381,19,3,3,8,4,0,1,25,25,50
p_222,0,5,e_1,337,356,381,18,3,3,6,4,0,1,19,25,44
p_221,0,6,e_1,339,356,386,17,3,3,5,4,0,1,17,30,47
p_220,0,6,e_1,341,356,386,16,3,3,5,4,0,1,15,30,45
p_234,0,8,e_2,310,358,388,25,5,5,15,3,0,0,48,30,78
p_231,0,7,e_1,317,356,391,24,4,4,13,4,0,1,39,35,74
p_235,0,8,e_1,308,356,396,26,5,5,15,3,0,0,48,40,88
p_227,0,12,e_1,327,356,410,20,4,4,9,4,0,1,29,54,83
p_205,0,2,e_3,362,400,410,12,1,0,12,4,0,1,38,10,48
p_229,0,13,e_1,320,356,415,23,4,4,12,4,0,1,36,59,95
p_200,0,4,e_3,367,400,418,11,1,0,11,4,0,1,33,18,51
p_196,0,4,e_3,371,400,418,9,1,0,9,4,0,1,29,18,47
p_201,0,5,e_3,366,400,423,11,1,0,11,4,0,1,34,23,57
p_208,0,6,e_3,358,400,428,13,0,0,13,3,0,0,42,28,70
p_194,0,6,e_3,373,400,428,9,1,0,9,4,0,1,27,28,55
p_167,0,1,e_2,413,427,434,27,10,10,4,4,0,1,14,7,21
p_198,0,9,e_3,369,400,439,10,1,0,10,4,0,1,31,39,70
p_178,0,3,e_2,401,427,442,30,10,10,8,4,0,1,26,15,41
p_197,0,10,e_3,370,400,444,10,1,0,10,4,0,1,30,44,74
p_176,0,4,e_2,403,427,447,30,10,10,8,4,0,1,24,20,44
p_165,0,4,e_2,417,427,447,4,9,9,3,4,0,1,10,20,30
p_207,0,11,e_3,359,400,449,13,1,0,13,4,0,1,41,49,90
p_206,0,12,e_3,361,400,454,13,1,0,13,4,0,1,39,54,93
p_203,0,12,e_3,364,400,454,12,1,0,12,4,0,1,36,54,90
p_179,0,8,e_2,400,427,461,30,11,11,8,3,0,0,27,34,61
p_204,0,14,e_3,363,400,462,12,1,0,12,4,0,1,37,62,99
p_216,0,1,e_1,347,456,463,15,1,1,3,4,0,1,109,7,116
p_158,0,1,e_1,430,456,463,24,7,7,8,4,0,1,26,7,33
p_177,0,9,e_2,402,427,466,30,10,10,8,4,0,1,25,39,64
p_169,0,9,e_2,411,427,466,28,10,10,5,4,0,1,16,39,55
p_202,0,15,e_3,365,400,467,11,1,0,11,4,0,1,35,67,102
p_199,0,15,e_3,368,400,467,10,1,0,10,4,0,1,32,67,99
p_195,0,15,e_3,372,400,467,9,1,0,9,4,0,1,28,67,95
p_214,0,3,e_1,349,456,471,15,1,1,2,4,0,1,107,15,122
p_173,0,11,e_2,407,427,474,29,11,11,6,4,0,1,20,47,67
p_219,0,5,e_1,342,456,479,16,2,2,4,4,0,1,114,23,137
p_166,0,12,e_2,416,427,479,26,10,10,3,4,0,1,11,52,63
p_210,0,6,e_1,354,456,484,13,1,1,0,4,0,1,102,28,130
p_159,0,6,e_1,429,456,484,24,7,7,9,4,0,1,27,28,55
p_171,0,13,e_2,409,427,484,28,10,10,6,4,0,1,18,57,75
p_168,0,13,e_2,412,427,484,28,10,10,5,4,0,1,15,57,72
p_217,0,7,e_1,346,456,489,15,2,2,3,4,0,1,110,33,143
p_212,0,7,e_1,351,456,489,14,1,1,1,4,0,1,105,33,138
p_175,0,14,e_2,405,427,489,29,11,11,7,4,0,1,22,62,84
p_174,0,14,e_2,406,427,489,29,11,11,7,4,0,1,21,62,83
p_170,0,14,e_2,410,427,489,28,10,10,5,4,0,1,17,62,79
p_172,0,15,e_2,408,427,494,28,11,11,6,4,0,1,19,67,86
p_218,0,11,e_1,343,456,503,16,2,2,4,4,0,1,113,47,160
p_130,0,1,e_0,472,504,511,14,1,0,10,4,0,1,32,7,39
p_157,0,14,e_1,431,456,514,23,7,7,8,4,0,1,25,58,83
p_155,0,14,e_1,435,456,514,22,7,7,7,4,0,1,21,58,79
p_143,0,3,e_0,456,504,519,18,3,3,15,3,0,0,48,15,63
p_136,0,3,e_0,465,504,519,15,2,2,13,4,0,1,39,15,54
p_129,0,3,e_0,473,504,519,13,1,0,10,4,0,1,31,15,46
p_215,0,15,e_1,348,456,519,15,1,1,2,4,0,1,108,63,171
p_213,0,15,e_1,350,456,519,15,1,1,2,4,0,1,106,63,169
p_211,0,15,e_1,353,456,519,14,1,1,1,4,0,1,103,63,166
p_156,0,15,e_1,434,456,519,22,7,7,7,4,0,1,22,63,85
p_190,0,1,e_3,379,514,521,7,1,0,7,4,0,1,135,7,142
p_183,0,1,e_3,396,514,521,1,1,0,1,4,0,1,118,7,125
p_137,0,4,e_0,464,504,524,16,2,2,13,4,0,1,40,20,60
p_182,0,2,e_3,397,514,526,1,1,0,1,4,0,1,117,12,129
p_180,0,2,e_3,399,514,526,0,0,0,0,3,0,0,115,12,127
p_141,0,6,e_0,458,504,532,17,3,3,15,4,0,1,46,28,74
p_186,0,4,e_3,390,514,534,3,1,0,3,4,0,1,124,20,144
p_140,0,8,e_0,459,504,540,17,3,3,15,4,0,1,45,36,81
p_142,0,9,e_0,457,504,545,17,3,3,15,4,0,1,47,41,88
p_161,0,1,e_2,421,541,546,25,9,9,2,4,0,1,120,5,125
p_96,0,1,e_2,517,541,546,30,9,9,8,4,0,1,24,5,29
p_192,0,8,e_3,375,514,548,8,1,0,8,4,0,1,139,34,173
p_189,0,8,e_3,382,514,548,6,1,0,6,4,0,1,132,34,166
p_139,0,10,e_0,461,504,550,16,2,2,14,4,0,1,43,46,89
p_135,0,10,e_0,466,504,550,15,1,1,12,4,0,1,38,46,84
p_138,0,11,e_0,463,504,555,16,2,2,13,4,0,1,41,51,92
p_132,0,11,e_0,470,504,555,14,1,0,11,4,0,1,34,51,85
p_191,0,10,e_3,376,514,556,8,1,0,8,4,0,1,138,42,180
p_185,0,10,e_3,391,514,556,3,1,0,3,4,0,1,123,42,165
p_92,0,4,e_2,525,541,557,28,8,8,5,4,0,1,16,16,32
p_133,0,12,e_0,469,504,560,15,1,0,11,4,0,1,35,56,91
p_193,0,11,e_3,374,514,561,8,1,0,8,4,0,1,140,47,187
p_103,0,11,e_3,508,514,561,2,1,0,2,4,0,1,6,47,53
p_99,0,6,e_2,514,541,565,30,10,10,9,4,0,1,27,24,51
p_94,0,6,e_2,519,541,565,29,10,10,7,4,0,1,22,24,46
p_187,0,12,e_3,389,514,566,3,1,0,3,4,0,1,125,52,177
p_184,0,12,e_3,392,514,566,2,1,0,2,4,0,1,122,52,174
p_131,0,14,e_0,471,504,568,14,1,0,11,4,0,1,33,64,97
p_98,0,7,e_2,515,541,570,30,9,9,8,4,0,1,26,29,55
p_97,0,7,e_2,516,541,570,30,9,9,8,4,0,1,25,29,54
p_188,0,13,e_3,384,514,571,5,1,0,5,4,0,1,130,57,187
p_134,0,15,e_0,467,504,573,15,1,0,12,4,0,1,37,69,106
p_146,0,1,e_1,453,566,573,18,3,3,1,4,0,1,113,7,120
p_86,0,2,e_1,544,566,578,23,7,7,7,4,0,1,22,12,34
p_181,0,15,e_3,398,514,579,0,1,0,0,4,0,1,116,65,181
p_163,0,10,e_2,419,541,581,26,9,9,2,4,0,1,122,40,162
p_164,0,11,e_2,418,541,586,26,9,9,3,4,0,1,123,45,168
p_162,0,11,e_2,420,541,586,26,9,9,2,4,0,1,121,45,166
p_91,0,12,e_2,526,541,591,28,8,8,5,4,0,1,15,50,65
p_150,0,6,e_1,443,566,592,20,5,5,4,4,0,1,123,26,149
p_93,0,13,e_2,520,541,596,29,9,9,7,4,0,1,21,55,76
p_90,0,13,e_2,527,541,596,28,8,8,4,4,0,1,14,55,69
p_154,0,7,e_1,436,566,597,22,7,7,6,4,0,1,130,31,161
p_95,0,14,e_2,518,541,601,30,9,9,7,4,0,1,23,60,83
p_148,0,8,e_1,449,566,602,19,4,4,2,4,0,1,117,36,153
p_83,0,8,e_1,549,566,602,22,6,6,5,4,0,1,17,36,53
p_160,0,15,e_2,426,541,606,24,8,8,0,3,0,0,115,65,180
p_153,0,9,e_1,437,566,607,21,7,7,6,4,0,1,129,41,170
p_147,0,9,e_1,452,566,607,18,4,4,1,4,0,1,114,41,155
p_144,0,9,e_1,455,566,607,18,3,3,0,3,0,0,111,41,152
p_145,0,11,e_1,454,566,615,18,3,3,0,4,0,1,112,49,161
p_84,0,12,e_1,546,566,620,22,7,7,6,4,0,1,20,54,74
p_119,0,1,e_0,483,620,625,10,1,0,7,4,0,1,137,5,142
p_152,0,15,e_1,441,566,631,21,6,6,5,4,0,1,125,65,190
p_151,0,15,e_1,442,566,631,20,6,6,4,4,0,1,124,65,189
p_149,0,15,e_1,444,566,631,20,5,5,4,4,0,1,122,65,187
p_85,0,15,e_1,545,566,631,23,7,7,7,4,0,1,21,65,86
p_114,0,3,e_0,488,620,633,8,1,0,5,4,0,1,132,13,145
p_124,0,7,e_0,478,620,647,12,1,0,8,4,0,1,142,27,169
p_118,0,7,e_0,484,620,647,10,1,0,6,4,0,1,136,27,163
p_102,0,7,e_3,509,626,649,1,1,0,1,4,0,1,117,23,140
p_101,0,8,e_3,511,626,654,1,1,0,1,4,0,1,115,28,143
p_115,0,9,e_0,487,620,655,9,1,0,5,4,0,1,133,35,168
p_100,0,9,e_3,513,626,659,0,0,0,0,3,0,0,113,33,146
p_127,0,10,e_0,475,620,660,13,1,0,9,4,0,1,145,40,185
p_117,0,10,e_0,485,620,660,9,1,0,6,4,0,1,135,40,175
p_116,0,10,e_0,486,620,660,9,1,0,6,4,0,1,134,40,174
p_128,0,11,e_0,474,620,665,13,1,0,10,4,0,1,146,45,191
p_123,0,11,e_0,479,620,665,11,1,0,8,4,0,1,141,45,186
p_121,0,11,e_0,481,620,665,11,1,0,7,4,0,1,139,45,184
p_120,0,11,e_0,482,620,665,10,1,0,7,4,0,1,138,45,183
p_126,0,12,e_0,476,620,670,12,1,0,9,4,0,1,144,50,194
p_88,0,5,e_2,538,653,670,25,7,7,1,4,0,1,115,17,132
p_32,0,6,e_2,650,653,675,11,2,2,1,4,0,1,3,22,25
p_125,0,14,e_0,477,620,678,12,1,0,9,4,0,1,143,58,201
p_122,0,15,e_0,480,620,683,11,1,0,8,4,0,1,140,63,203
p_87,0,8,e_2,539,653,683,25,7,7,0,4,0,1,114,30,144
p_89,0,9,e_2,535,653,688,26,7,7,2,4,0,1,118,35,153
p_35,0,9,e_2,630,653,688,17,3,3,7,4,0,1,23,35,58
p_77,0,3,e_1,557,678,691,20,5,5,3,4,0,1,121,13,134
p_72,0,3,e_1,562,678,691,19,4,4,1,4,0,1,116,13,129
p_71,0,3,e_1,564,678,691,18,4,4,0,4,0,1,114,13,127
p_70,0,3,e_1,565,678,691,18,3,3,0,3,0,0,113,13,126
p_30,0,3,e_1,668,678,691,9,0,0,3,4,0,1,10,13,23
p_75,0,5,e_1,559,678,699,19,5,5,2,4,0,1,119,21,140
p_34,0,12,e_2,646,653,699,12,3,3,2,4,0,1,7,46,53
p_76,0,6,e_1,558,678,704,20,5,5,2,4,0,1,120,26,146
p_31,0,6,e_1,666,678,704,9,0,0,4,4,0,1,12,26,38
p_36,0,13,e_2,628,653,704,18,3,3,8,4,0,1,25,51,76
p_80,0,7,e_1,552,678,709,21,6,6,4,4,0,1,126,31,157
p_74,0,7,e_1,560,678,709,19,4,4,2,4,0,1,118,31,149
p_33,0,15,e_2,649,653,712,11,2,2,1,4,0,1,4,59,63
p_24,0,2,e_3,695,714,722,6,1,0,6,4,0,1,19,8,27
p_73,0,11,e_1,561,678,723,19,4,4,1,4,0,1,117,45,162
p_78,0,12,e_1,556,678,728,20,5,5,3,4,0,1,122,50,172
p_113,0,1,e_0,489,730,735,8,1,0,5,4,0,1,241,5,246
p_65,0,1,e_0,573,730,735,17,2,2,15,4,0,1,157,5,162
p_82,0,14,e_1,550,678,736,22,6,6,5,4,0,1,128,58,186
p_81,0,14,e_1,551,678,736,21,6,6,5,4,0,1,127,58,185
p_79,0,14,e_1,553,678,736,21,6,6,4,4,0,1,125,58,183
p_26,0,8,e_3,684,714,742,9,0,0,9,3,0,0,30,28,58
p_25,0,8,e_3,686,714,742,9,1,0,9,4,0,1,28,28,56
p_106,0,3,e_0,500,730,743,4,1,0,1,4,0,1,230,13,243
p_67,0,3,e_0,568,730,743,18,3,3,14,5,1,1,162,13,175
p_66,0,3,e_0,569,730,743,17,3,3,14,5,1,1,161,13,174
p_108,0,6,e_0,496,730,754,6,1,0,2,4,0,1,234,24,258
p_23,0,12,e_3,711,714,756,1,1,0,1,4,0,1,3,42,45
p_111,0,8,e_0,491,730,762,7,1,0,4,4,0,1,239,32,271
p_112,0,11,e_0,490,730,773,8,1,0,4,4,0,1,240,43,283
p_110,0,11,e_0,492,730,773,7,1,0,4,4,0,1,238,43,281
p_107,0,11,e_0,499,730,773,5,1,0,1,4,0,1,231,43,274
p_105,0,12,e_0,502,730,778,4,1,0,0,4,0,1,228,48,276
p_68,0,13,e_0,567,730,783,18,3,3,14,2,2,1,163,53,216
p_104,0,14,e_0,503,730,788,3,1,0,0,3,0,0,227,58,285
p_69,0,14,e_0,566,730,788,18,3,3,14,5,2,1,164,58,222
p_109,0,15,e_0,493,730,793,7,1,0,3,4,0,1,237,63,300
p_21,0,4,e_2,731,779,793,19,2,2,15,3,0,0,48,14,62
p_29,0,5,e_1,670,780,797,9,0,0,2,4,0,1,110,17,127
p_27,0,10,e_1,677,780,814,9,0,0,0,3,0,0,103,34,137
p_18,0,10,e_1,766,780,814,12,0,0,4,4,0,1,14,34,48
p_17,0,10,e_1,776,780,814,12,0,0,1,4,0,1,4,34,38
p_28,0,11,e_1,676,780,819,9,0,0,0,4,0,1,104,39,143
p_19,0,11,e_1,754,780,819,12,1,1,8,4,0,1,26,39,65
p_20,0,14,e_2,734,779,825,18,2,2,15,4,0,1,45,46,91
p_16,0,2,e_3,780,819,827,12,0,0,12,3,0,0,39,8,47
p_14,0,4,e_3,794,819,835,8,1,0,8,4,0,1,25,16,41
p_55,0,3,e_0,585,840,851,13,1,0,11,4,0,1,255,11,266
p_54,0,3,e_0,586,840,851,13,1,0,11,4,0,1,254,11,265
p_52,0,3,e_0,588,840,851,12,1,0,10,4,0,1,252,11,263
p_15,0,9,e_3,793,819,852,8,1,0,8,4,0,1,26,33,59
p_11,0,9,e_3,807,819,852,4,1,0,4,4,0,1,12,33,45
p_64,0,4,e_0,574,840,856,16,2,2,15,4,0,1,266,16,282
p_13,0,11,e_3,796,819,860,7,1,0,7,4,0,1,23,41,64
p_12,0,11,e_3,798,819,860,7,1,0,7,4,0,1,21,41,62
p_61,0,6,e_0,579,840,864,15,1,0,13,4,0,1,261,24,285
p_56,0,6,e_0,584,840,864,14,1,0,12,4,0,1,256,24,280
p_50,0,7,e_0,590,840,869,12,1,0,10,4,0,1,250,29,279
p_53,0,9,e_0,587,840,877,13,1,0,11,4,0,1,253,37,290
p_51,0,9,e_0,589,840,877,12,1,0,10,4,0,1,251,37,288
p_60,0,10,e_0,580,840,882,15,1,0,13,4,0,1,260,42,302
p_58,0,11,e_0,582,840,887,14,1,0,12,4,0,1,258,47,305
p_57,0,11,e_0,583,840,887,14,1,0,12,4,0,1,257,47,304
p_9,0,2,e_1,846,882,890,15,2,2,11,3,0,0,36,8,44
p_63,0,13,e_0,577,840,895,15,2,2,14,4,0,1,263,55,318
p_62,0,13,e_0,578,840,895,15,1,1,14,4,0,1,262,55,317
p_6,0,3,e_1,877,882,895,11,0,0,1,4,0,1,5,13,18
p_59,0,14,e_0,581,840,900,15,1,0,13,4,0,1,259,60,319
p_7,0,5,e_1,875,882,903,11,0,0,2,4,0,1,7,21,28
p_8,0,11,e_1,874,882,923,11,0,0,2,4,0,1,8,41,49
p_4,0,1,e_3,886,919,924,11,1,0,11,4,0,1,33,5,38
p_1,0,5,e_3,894,919,938,8,1,0,8,4,0,1,25,19,44
p_5,0,8,e_3,883,919,949,11,0,0,11,3,0,0,36,30,66
p_3,0,8,e_3,888,919,949,10,1,0,10,4,0,1,31,30,61
p_45,0,2,e_0,595,944,952,10,1,0,8,4,0,1,349,8,357
p_22,0,3,e_0,719,944,957,23,3,3,3,4,0,1,225,13,238
p_2,0,11,e_3,892,919,960,9,1,0,9,4,0,1,27,41,68
p_48,0,4,e_0,592,944,962,11,1,0,9,4,0,1,352,18,370
p_46,0,4,e_0,594,944,962,10,1,0,8,4,0,1,350,18,368
p_42,0,6,e_0,598,944,970,9,1,0,7,4,0,1,346,26,372
p_43,0,7,e_0,597,944,975,9,1,0,7,4,0,1,347,31,378
p_44,0,8,e_0,596,944,980,10,1,0,8,4,0,1,348,36,384
p_10,0,8,e_0,835,944,980,18,2,2,1,4,0,1,109,36,145
p_47,0,9,e_0,593,944,985,11,1,0,9,4,0,1,351,41,392
p_37,0,9,e_0,615,944,985,3,1,0,1,4,0,1,329,41,370
p_41,0,11,e_0,600,944,993,8,1,0,6,4,0,1,344,49,393
p_39,0,12,e_0,607,944,998,6,1,0,4,4,0,1,337,54,391
p_40,0,13,e_0,602,944,1003,8,1,0,6,4,0,1,342,59,401
p_38,0,13,e_0,608,944,1003,6,1,0,4,4,0,1,336,59,395
p_49,0,14,e_0,591,944,1008,11,1,0,9,4,0,1,353,64,417
p_300,0,4,e_0,8,9,25,0,0,0,0,3,0,0,1,16,17
p_299,0,5,e_1,9,10,29,0,0,0,0,3,0,0,1,19,20
p_297,0,6,e_3,15,16,38,0,0,0,0,3,0,0,1,22,23
p_298,0,9,e_2,11,12,43,0,0,0,0,3,0,0,1,31,32
p_296,0,4,e_0,28,43,57,9,1,1,4,3,0,0,15,14,29
p_295,0,5,e_0,29,43,62,9,1,1,4,4,0,1,14,19,33
p_292,0,6,e_0,38,43,67,6,0,0,1,4,0,1,5,24,29
p_290,0,6,e_0,40,43,67,6,0,0,1,4,0,1,3,24,27
p_286,0,3,e_1,46,61,72,6,0,0,5,4,0,1,15,11,26
p_289,0,4,e_1,43,61,77,6,0,0,5,3,0,0,18,16,34
p_285,0,4,e_1,53,61,77,6,0,0,2,4,0,1,8,16,24
p_284,0,4,e_1,54,61,77,6,0,0,2,4,0,1,7,16,23
p_287,0,5,e_1,45,61,82,6,0,0,5,4,0,1,16,21,37
p_291,0,11,e_0,39,43,84,6,0,0,1,4,0,1,4,41,45
p_294,0,12,e_0,31,43,89,8,1,1,4,4,0,1,12,46,58
p_293,0,12,e_0,33,43,89,7,1,1,3,4,0,1,10,46,56
p_288,0,8,e_1,44,61,93,6,0,0,5,4,0,1,17,32,49
p_281,0,1,e_3,73,87,94,4,1,0,4,4,0,1,14,7,21
p_283,0,9,e_1,57,61,98,6,0,0,1,4,0,1,4,37,41
p_278,0,2,e_3,77,87,99,3,1,0,3,4,0,1,10,12,22
p_279,0,5,e_3,76,87,110,3,1,0,3,4,0,1,11,23,34
p_277,0,6,e_3,82,87,115,1,1,0,1,4,0,1,5,28,33
p_282,0,7,e_3,66,87,120,6,0,0,6,3,0,0,21,33,54
p_273,0,4,e_2,110,118,132,23,4,4,2,4,0,1,8,14,22
p_276,0,11,e_3,84,87,134,1,1,0,1,4,0,1,3,47,50
p_280,0,14,e_3,75,87,145,4,1,0,4,4,0,1,12,58,70
p_275,0,14,e_3,86,87,145,0,0,0,0,3,0,0,1,58,59
p_274,0,8,e_2,88,118,146,28,7,7,9,3,0,0,30,28,58
p_272,0,10,e_2,113,118,154,22,4,4,1,4,0,1,5,36,41
p_271,0,1,e_1,121,151,156,21,2,2,9,3,0,0,30,5,35
p_267,0,1,e_1,148,151,156,14,0,0,1,4,0,1,3,5,8
p_268,0,2,e_1,144,151,161,14,0,0,2,4,0,1,7,10,17
p_270,0,9,e_1,122,151,184,21,2,2,9,4,0,1,29,33,62
p_269,0,9,e_1,127,151,184,19,2,2,8,4,0,1,24,33,57
p_255,0,3,e_2,184,186,197,14,0,0,0,4,0,1,2,11,13
p_265,0,4,e_2,152,186,202,14,0,0,10,5,1,0,34,16,50
p_254,0,4,e_0,187,190,204,14,0,0,1,4,0,1,3,14,17
p_262,0,5,e_2,157,186,207,14,0,0,9,4,0,1,29,21,50
p_261,0,5,e_2,164,186,207,14,0,0,7,4,0,1,22,21,43
p_266,0,6,e_0,151,190,212,14,0,0,12,3,0,0,39,22,61
p_263,0,7,e_2,154,186,215,14,0,0,10,4,0,1,32,29,61
p_260,0,7,e_2,165,186,215,14,0,0,7,4,0,1,21,29,50
p_258,0,7,e_2,168,186,215,14,0,0,6,4,0,1,18,29,47
p_256,0,10,e_2,182,186,226,14,0,0,1,4,0,1,4,40,44
p_250,0,2,e_1,217,220,228,14,0,0,1,4,0,1,3,8,11
p_264,0,11,e_2,153,186,231,14,0,0,10,2,1,1,33,45,78
p_253,0,5,e_1,190,220,239,14,0,0,9,3,0,0,30,19,49
p_252,0,5,e_1,205,220,239,14,0,0,5,4,0,1,15,19,34
p_257,0,14,e_2,169,186,242,14,0,0,5,4,0,1,17,56,73
p_259,0,15,e_2,167,186,247,14,0,0,6,4,0,1,19,61,80
p_251,0,15,e_1,209,220,271,14,0,0,3,4,0,1,11,51,62
p_248,0,5,e_0,246,260,277,14,0,0,4,4,0,1,14,17,31
p_247,0,5,e_0,250,260,277,14,0,0,3,4,0,1,10,17,27
p_249,0,6,e_0,239,260,282,14,0,0,6,3,0,0,21,22,43
p_241,0,1,e_0,283,302,309,8,1,0,6,4,0,1,19,7,26
p_236,0,1,e_3,305,307,312,0,1,0,0,4,0,1,2,5,7
p_245,0,7,e_0,269,302,329,12,1,0,3,5,2,0,33,27,60
p_237,0,7,e_3,304,307,332,1,1,0,1,4,0,1,3,25,28
p_242,0,8,e_0,277,302,334,10,1,0,5,5,1,1,25,32,57
p_240,0,9,e_0,301,302,339,2,1,0,0,3,0,0,1,37,38
p_246,0,10,e_3,262,307,343,14,0,0,14,3,0,0,45,36,81
p_239,0,11,e_3,302,307,348,1,1,0,1,4,0,1,5,41,46
p_244,0,12,e_3,271,307,353,12,1,0,12,4,0,1,36,46,82
p_238,0,13,e_3,303,307,358,1,1,0,1,4,0,1,4,51,55
p_233,0,1,e_1,311,356,361,29,6,6,15,4,0,1,45,5,50
p_226,0,2,e_1,329,356,366,24,6,6,9,4,0,1,27,10,37
p_223,0,2,e_1,336,356,366,22,5,5,6,4,0,1,20,10,30
p_243,0,15,e_3,272,307,366,11,1,0,11,4,0,1,35,59,94
p_209,0,2,e_2,357,358,368,17,1,1,0,3,0,0,1,10,11
p_230,0,3,e_1,319,356,371,27,6,6,12,4,0,1,37,15,52
p_228,0,4,e_1,325,356,376,25,6,6,10,4,0,1,31,20,51
p_232,0,5,e_1,314,356,381,29,6,6,14,4,0,1,42,25,67
p_225,0,5,e_1,330,356,381,23,6,6,8,4,0,1,26,25,51
p_224,0,5,e_1,331,356,381,23,5,5,8,4,0,1,25,25,50
p_222,0,5,e_1,337,356,381,22,5,5,6,4,0,1,19,25,44
p_221,0,6,e_1,339,356,386,21,5,5,5,4,0,1,17,30,47
p_220,0,6,e_1,341,356,386,20,5,5,5,4,0,1,15,30,45
p_234,0,8,e_2,310,358,388,29,7,7,15,3,0,0,48,30,78
p_231,0,7,e_1,317,356,391,28,6,6,13,4,0,1,39,35,74
p_205,0,2,e_0,362,388,396,16,1,1,8,4,0,1,26,8,34
p_235,0,8,e_1,308,356,396,30,7,7,15,3,0,0,48,40,88
p_200,0,4,e_0,367,388,404,15,0,0,7,4,0,1,21,16,37
p_196,0,4,e_0,371,388,404,15,0,0,5,4,0,1,17,16,33
p_201,0,5,e_0,366,388,409,15,0,0,7,4,0,1,22,21,43
p_227,0,12,e_1,327,356,410,24,6,6,9,4,0,1,29,54,83
p_208,0,6,e_0,358,388,414,17,1,1,9,3,0,0,30,26,56
p_194,0,6,e_0,373,388,414,15,0,0,5,4,0,1,15,26,41
p_229,0,13,e_1,320,356,415,27,6,6,12,4,0,1,36,59,95
p_183,0,1,e_2,396,416,421,15,0,0,6,4,0,1,20,5,25
p_198,0,9,e_0,369,388,425,15,0,0,6,4,0,1,19,37,56
p_182,0,2,e_2,397,416,426,15,0,0,6,4,0,1,19,10,29
p_180,0,2,e_2,399,416,426,15,0,0,5,4,0,1,17,10,27
p_197,0,10,e_0,370,388,430,15,0,0,6,4,0,1,18,42,60
p_178,0,3,e_2,401,416,431,15,0,0,5,4,0,1,15,15,30
p_207,0,11,e_0,359,388,435,17,1,1,9,4,0,1,29,47,76
p_186,0,4,e_2,390,416,436,15,0,0,8,4,0,1,26,20,46
p_176,0,4,e_2,403,416,436,15,0,0,4,4,0,1,13,20,33
p_206,0,12,e_0,361,388,440,16,1,1,9,4,0,1,27,52,79
p_203,0,12,e_0,364,388,440,15,1,1,8,4,0,1,24,52,76
p_204,0,14,e_0,363,388,448,16,1,1,8,4,0,1,25,60,85
p_179,0,8,e_2,400,416,450,15,0,0,5,4,0,1,16,34,50
p_202,0,15,e_0,365,388,453,15,0,0,7,4,0,1,23,65,88
p_199,0,15,e_0,368,388,453,15,0,0,6,4,0,1,20,65,85
p_195,0,15,e_0,372,388,453,15,0,0,5,4,0,1,16,65,81
p_177,0,9,e_2,402,416,455,15,0,0,4,4,0,1,14,39,53
p_185,0,10,e_2,391,416,460,15,0,0,8,4,0,1,25,44,69
p_216,0,1,e_1,347,456,463,19,3,3,3,4,0,1,109,7,116
p_173,0,11,e_2,407,416,465,15,0,0,3,4,0,1,9,49,58
p_187,0,12,e_2,389,416,470,15,0,0,8,3,0,0,27,54,81
p_184,0,12,e_2,392,416,470,15,0,0,8,4,0,1,24,54,78
p_214,0,3,e_1,349,456,471,19,3,3,2,4,0,1,107,15,122
p_165,0,4,e_1,417,456,476,15,0,0,13,4,0,1,39,20,59
p_175,0,14,e_2,405,416,478,15,0,0,3,4,0,1,11,62,73
p_174,0,14,e_2,406,416,478,15,0,0,3,4,0,1,10,62,72
p_219,0,5,e_1,342,456,481,20,4,4,4,4,0,1,114,25,139
p_181,0,15,e_2,398,416,483,15,0,0,6,4,0,1,18,67,85
p_210,0,6,e_1,354,456,486,18,2,2,0,4,0,1,102,30,132
p_217,0,7,e_1,346,456,491,19,4,4,3,4,0,1,110,35,145
p_212,0,7,e_1,351,456,491,18,3,3,1,4,0,1,105,35,140
p_163,0,10,e_1,419,456,502,15,0,0,12,4,0,1,37,46,83
p_190,0,1,e_0,379,500,507,15,0,0,3,4,0,1,121,7,128
p_218,0,11,e_1,343,456,507,20,4,4,4,4,0,1,113,51,164
p_164,0,11,e_1,418,456,507,15,0,0,12,4,0,1,38,51,89
p_162,0,11,e_1,420,456,507,15,0,0,12,4,0,1,36,51,87
p_166,0,12,e_1,416,456,512,15,0,0,13,4,0,1,40,56,96
p_143,0,3,e_0,456,500,515,15,0,0,14,4,0,1,44,15,59
p_136,0,3,e_0,465,500,515,15,0,0,11,4,0,1,35,15,50
p_137,0,4,e_0,464,500,520,15,0,0,12,4,0,1,36,20,56
p_215,0,15,e_1,348,456,523,19,3,3,2,4,0,1,108,67,175
p_213,0,15,e_1,350,456,523,19,3,3,2,4,0,1,106,67,173
p_211,0,15,e_1,353,456,523,18,2,2,1,4,0,1,103,67,170
p_141,0,6,e_0,458,500,528,15,0,0,14,4,0,1,42,28,70
p_167,0,1,e_2,413,530,535,15,0,0,1,4,0,1,117,5,122
p_192,0,8,e_0,375,500,536,15,0,0,4,4,0,1,125,36,161
p_189,0,8,e_0,382,500,536,15,0,0,2,4,0,1,118,36,154
p_140,0,8,e_0,459,500,536,15,0,0,13,4,0,1,41,36,77
p_142,0,9,e_0,457,500,541,15,0,0,14,4,0,1,43,41,84
p_106,0,3,e_2,500,530,543,15,0,0,10,4,0,1,30,13,43
p_191,0,10,e_0,376,500,546,15,0,0,4,4,0,1,124,46,170
p_139,0,10,e_0,461,500,546,15,0,0,13,4,0,1,39,46,85
p_135,0,10,e_0,466,500,546,15,0,0,11,4,0,1,34,46,80
p_193,0,11,e_0,374,500,551,15,0,0,4,4,0,1,126,51,177
p_138,0,11,e_0,463,500,551,15,0,0,12,4,0,1,37,51,88
p_99,0,6,e_2,514,530,554,15,0,0,5,4,0,1,16,24,40
p_188,0,13,e_0,384,500,559,15,0,0,1,4,0,1,116,59,175
p_102,0,7,e_2,509,530,559,15,0,0,7,4,0,1,21,29,50
p_98,0,7,e_2,515,530,559,15,0,0,5,4,0,1,15,29,44
p_101,0,8,e_2,511,530,564,15,0,0,6,4,0,1,19,34,53
p_169,0,9,e_2,411,530,569,15,0,0,1,4,0,1,119,39,158
p_100,0,9,e_2,513,530,569,15,0,0,5,4,0,1,17,39,56
p_161,0,1,e_1,421,570,577,15,0,0,11,4,0,1,149,7,156
p_158,0,1,e_1,430,570,577,15,0,0,8,4,0,1,140,7,147
p_103,0,11,e_2,508,530,577,15,0,0,7,4,0,1,22,47,69
p_105,0,12,e_2,502,530,582,15,0,0,9,4,0,1,28,52,80
p_171,0,13,e_2,409,530,587,15,0,0,2,4,0,1,121,57,178
p_168,0,13,e_2,412,530,587,15,0,0,1,4,0,1,118,57,175
p_170,0,14,e_2,410,530,592,15,0,0,2,4,0,1,120,62,182
p_104,0,14,e_2,503,530,592,15,0,0,9,4,0,1,27,62,89
p_159,0,6,e_1,429,570,594,15,0,0,9,4,0,1,141,24,165
p_150,0,6,e_1,443,570,594,15,0,0,4,4,0,1,127,24,151
p_172,0,15,e_2,408,530,597,15,0,0,2,4,0,1,122,67,189
p_154,0,7,e_1,436,570,599,15,0,0,6,4,0,1,134,29,163
p_148,0,8,e_1,449,570,604,15,0,0,2,4,0,1,121,34,155
p_130,0,1,e_0,472,600,605,15,0,0,9,4,0,1,128,5,133
p_153,0,9,e_1,437,570,609,15,0,0,6,4,0,1,133,39,172
p_147,0,9,e_1,452,570,609,15,0,0,1,4,0,1,118,39,157
p_129,0,3,e_0,473,600,613,15,0,0,9,4,0,1,127,13,140
p_157,0,14,e_1,431,570,626,15,0,0,8,4,0,1,139,56,195
p_155,0,14,e_1,435,570,626,15,0,0,7,4,0,1,135,56,191
p_124,0,7,e_0,478,600,627,15,0,0,7,4,0,1,122,27,149
p_160,0,15,e_1,426,570,631,15,0,0,10,4,0,1,144,61,205
p_156,0,15,e_1,434,570,631,15,0,0,7,4,0,1,136,61,197
p_152,0,15,e_1,441,570,631,15,0,0,5,4,0,1,129,61,190
p_151,0,15,e_1,442,570,631,15,0,0,4,4,0,1,128,61,189
p_149,0,15,e_1,444,570,631,15,0,0,4,4,0,1,126,61,187
p_127,0,10,e_0,475,600,638,15,0,0,8,4,0,1,125,38,163
p_132,0,11,e_0,470,600,643,15,0,0,10,4,0,1,130,43,173
p_128,0,11,e_0,474,600,643,15,0,0,8,4,0,1,126,43,169
p_123,0,11,e_0,479,600,643,15,0,0,7,4,0,1,121,43,164
p_121,0,11,e_0,481,600,643,15,0,0,6,4,0,1,119,43,162
p_120,0,11,e_0,482,600,643,15,0,0,6,4,0,1,118,43,161
p_133,0,12,e_0,469,600,648,15,0,0,10,4,0,1,131,48,179
p_126,0,12,e_0,476,600,648,15,0,0,8,4,0,1,124,48,172
p_96,0,1,e_2,517,644,649,15,0,0,4,4,0,1,127,5,132
p_131,0,14,e_0,471,600,656,15,0,0,9,4,0,1,129,56,185
p_125,0,14,e_0,477,600,656,15,0,0,7,4,0,1,123,56,179
p_92,0,4,e_2,525,644,660,15,0,0,1,4,0,1,119,16,135
p_134,0,15,e_0,467,600,661,15,0,0,11,4,0,1,133,61,194
p_122,0,15,e_0,480,600,661,15,0,0,6,4,0,1,120,61,181
p_94,0,6,e_2,519,644,668,15,0,0,3,4,0,1,125,24,149
p_97,0,7,e_2,516,644,673,15,0,0,4,4,0,1,128,29,157
p_37,0,9,e_2,615,644,681,15,0,0,9,4,0,1,29,37,66
p_35,0,9,e_2,630,644,681,15,0,0,4,4,0,1,14,37,51
p_146,0,1,e_1,453,678,685,15,0,0,1,4,0,1,225,7,232
p_41,0,11,e_2,600,644,689,15,0,0,14,4,0,1,44,45,89
p_86,0,2,e_1,544,678,690,15,0,0,8,4,0,1,134,12,146
p_91,0,12,e_2,526,644,694,15,0,0,1,4,0,1,118,50,168
p_39,0,12,e_2,607,644,694,15,0,0,12,4,0,1,37,50,87
p_93,0,13,e_2,520,644,699,15,0,0,3,4,0,1,124,55,179
p_90,0,13,e_2,527,644,699,15,0,0,1,4,0,1,117,55,172
p_40,0,13,e_2,602,644,699,15,0,0,14,4,0,1,42,55,97
p_38,0,13,e_2,608,644,699,15,0,0,12,4,0,1,36,55,91
p_36,0,13,e_2,628,644,699,15,0,0,5,4,0,1,16,55,71
p_88,0,5,e_1,538,678,701,15,0,0,10,4,0,1,140,23,163
p_95,0,14,e_2,518,644,704,15,0,0,4,4,0,1,126,60,186
p_80,0,7,e_1,552,678,709,15,0,0,6,4,0,1,126,31,157
p_119,0,1,e_0,483,708,713,15,0,0,5,4,0,1,225,5,230
p_113,0,1,e_0,489,708,713,15,0,0,3,4,0,1,219,5,224
p_65,0,1,e_0,573,708,713,15,0,0,9,4,0,1,135,5,140
p_87,0,8,e_1,539,678,714,15,0,0,10,4,0,1,139,36,175
p_83,0,8,e_1,549,678,714,15,0,0,7,4,0,1,129,36,165
p_144,0,9,e_1,455,678,719,15,0,0,0,3,0,0,223,41,264
p_89,0,9,e_1,535,678,719,15,0,0,11,4,0,1,143,41,184
p_114,0,3,e_0,488,708,721,15,0,0,4,4,0,1,220,13,233
p_64,0,4,e_0,574,708,726,15,0,0,8,4,0,1,134,18,152
p_145,0,11,e_1,454,678,727,15,0,0,0,4,0,1,224,49,273
p_84,0,12,e_1,546,678,732,15,0,0,8,4,0,1,132,54,186
p_78,0,12,e_1,556,678,732,15,0,0,4,4,0,1,122,54,176
p_108,0,6,e_0,496,708,734,15,0,0,1,4,0,1,212,26,238
p_118,0,7,e_0,484,708,739,15,0,0,5,4,0,1,224,31,255
p_82,0,14,e_1,550,678,740,15,0,0,6,4,0,1,128,62,190
p_81,0,14,e_1,551,678,740,15,0,0,6,4,0,1,127,62,189
p_79,0,14,e_1,553,678,740,15,0,0,5,4,0,1,125,62,187
p_111,0,8,e_0,491,708,744,15,0,0,3,4,0,1,217,36,253
p_85,0,15,e_1,545,678,745,15,0,0,8,4,0,1,133,67,200
p_115,0,9,e_0,487,708,749,15,0,0,4,4,0,1,221,41,262
p_117,0,10,e_0,485,708,754,15,0,0,5,4,0,1,223,46,269
p_116,0,10,e_0,486,708,754,15,0,0,4,4,0,1,222,46,268
p_112,0,11,e_0,490,708,759,15,0,0,3,4,0,1,218,51,269
p_110,0,11,e_0,492,708,759,15,0,0,2,4,0,1,216,51,267
p_107,0,11,e_0,499,708,759,15,0,0,0,3,0,0,209,51,260
p_22,0,3,e_2,719,756,767,15,0,0,12,4,0,1,37,11,48
p_21,0,4,e_2,731,756,772,15,0,0,8,4,0,1,25,16,41
p_109,0,15,e_0,493,708,773,15,0,0,2,4,0,1,215,65,280
p_19,0,11,e_2,754,756,795,15,0,0,0,4,0,1,2,39,41
p_23,0,12,e_2,711,756,800,15,0,0,14,3,0,0,45,44,89
p_77,0,3,e_1,557,792,803,15,0,0,4,4,0,1,235,11,246
p_72,0,3,e_1,562,792,803,15,0,0,2,4,0,1,230,11,241
p_71,0,3,e_1,564,792,803,15,0,0,2,4,0,1,228,11,239
p_70,0,3,e_1,565,792,803,15,0,0,1,4,0,1,227,11,238
p_67,0,3,e_1,568,792,803,15,0,0,0,4,0,1,224,11,235
p_66,0,3,e_1,569,792,803,15,0,0,0,3,0,0,223,11,234
p_20,0,14,e_2,734,756,808,15,0,0,7,4,0,1,22,52,74
p_75,0,5,e_1,559,792,811,15,0,0,3,4,0,1,233,19,252
p_76,0,6,e_1,558,792,816,15,0,0,4,4,0,1,234,24,258
p_32,0,6,e_1,650,792,816,15,0,0,9,4,0,1,142,24,166
p_74,0,7,e_1,560,792,821,15,0,0,3,4,0,1,232,29,261
p_55,0,3,e_0,585,820,831,15,0,0,5,4,0,1,235,11,246
p_54,0,3,e_0,586,820,831,15,0,0,4,4,0,1,234,11,245
p_52,0,3,e_0,588,820,831,15,0,0,4,4,0,1,232,11,243
p_73,0,11,e_1,561,792,835,15,0,0,3,4,0,1,231,43,274
p_34,0,12,e_1,646,792,840,15,0,0,10,4,0,1,146,48,194
p_61,0,6,e_0,579,820,842,15,0,0,7,4,0,1,241,22,263
p_56,0,6,e_0,584,820,842,15,0,0,5,4,0,1,236,22,258
p_68,0,13,e_1,567,792,845,15,0,0,1,4,0,1,225,53,278
p_50,0,7,e_0,590,820,847,15,0,0,3,4,0,1,230,27,257
p_69,0,14,e_1,566,792,850,15,0,0,1,4,0,1,226,58,284
p_53,0,9,e_0,587,820,855,15,0,0,4,4,0,1,233,35,268
p_51,0,9,e_0,589,820,855,15,0,0,3,4,0,1,231,35,266
p_33,0,15,e_1,649,792,855,15,0,0,9,4,0,1,143,63,206
p_60,0,10,e_0,580,820,860,15,0,0,6,4,0,1,240,40,280
p_58,0,11,e_0,582,820,865,15,0,0,6,4,0,1,238,45,283
p_57,0,11,e_0,583,820,865,15,0,0,5,4,0,1,237,45,282
p_63,0,13,e_0,577,820,873,15,0,0,7,4,0,1,243,53,296
p_62,0,13,e_0,578,820,873,15,0,0,7,4,0,1,242,53,295
p_59,0,14,e_0,581,820,878,15,0,0,6,4,0,1,239,58,297
p_49,0,14,e_0,591,820,878,15,0,0,3,4,0,1,229,58,287
p_9,0,2,e_2,846,880,888,15,0,0,11,4,0,1,34,8,42
p_6,0,3,e_2,877,880,893,15,0,0,1,4,0,1,3,13,16
p_7,0,5,e_2,875,880,901,15,0,0,1,4,0,1,5,21,26
p_4,0,1,e_1,886,902,907,15,0,0,5,4,0,1,16,5,21
p_16,0,2,e_1,780,902,912,15,0,0,4,4,0,1,122,10,132
p_10,0,8,e_2,835,880,912,15,0,0,14,3,0,0,45,32,77
p_30,0,3,e_1,668,902,917,15,0,0,3,4,0,1,234,15,249
p_8,0,11,e_2,874,880,923,15,0,0,2,4,0,1,6,43,49
p_29,0,5,e_1,670,902,925,15,0,0,2,4,0,1,232,23,255
p_1,0,5,e_1,894,902,925,15,0,0,2,4,0,1,8,23,31
p_45,0,2,e_0,595,922,930,15,0,0,1,4,0,1,327,8,335
p_24,0,2,e_0,695,922,930,15,0,0,4,4,0,1,227,8,235
p_31,0,6,e_1,666,902,930,15,0,0,4,4,0,1,236,28,264
p_48,0,4,e_0,592,922,938,15,0,0,2,4,0,1,330,16,346
p_46,0,4,e_0,594,922,938,15,0,0,2,4,0,1,328,16,344
p_14,0,4,e_0,794,922,938,15,0,0,8,4,0,1,128,16,144
p_5,0,8,e_1,883,902,938,15,0,0,6,4,0,1,19,36,55
p_3,0,8,e_1,888,902,938,15,0,0,4,4,0,1,14,36,50
p_42,0,6,e_0,598,922,946,15,0,0,0,4,0,1,324,24,348
p_27,0,10,e_1,677,902,946,15,0,0,0,3,0,0,225,44,269
p_18,0,10,e_1,766,902,946,15,0,0,8,4,0,1,136,44,180
p_17,0,10,e_1,776,902,946,15,0,0,5,4,0,1,126,44,170
p_43,0,7,e_0,597,922,951,15,0,0,1,4,0,1,325,29,354
p_28,0,11,e_1,676,902,951,15,0,0,0,4,0,1,226,49,275
p_2,0,11,e_1,892,902,951,15,0,0,3,4,0,1,10,49,59
p_44,0,8,e_0,596,922,956,15,0,0,1,4,0,1,326,34,360
p_26,0,8,e_0,684,922,956,15,0,0,8,4,0,1,238,34,272
p_25,0,8,e_0,686,922,956,15,0,0,7,4,0,1,236,34,270
p_47,0,9,e_0,593,922,961,15,0,0,2,4,0,1,329,39,368
p_15,0,9,e_0,793,922,961,15,0,0,9,4,0,1,129,39,168
p_11,0,9,e_0,807,922,961,15,0,0,4,4,0,1,115,39,154
p_13,0,11,e_0,796,922,969,15,0,0,8,4,0,1,126,47,173
p_12,0,11,e_0,798,922,969,15,0,0,7,4,0,1,124,47,171
p_300,0,4,e_0,8,9,25,0,0,0,0,3,0,0,1,16,17
p_299,0,5,e_1,9,10,29,0,0,0,0,3,0,0,1,19,20
p_297,0,6,e_3,15,16,38,0,0,0,0,3,0,0,1,22,23
p_298,0,9,e_2,11,12,43,0,0,0,0,3,0,0,1,31,32
p_296,0,4,e_0,28,43,57,9,1,1,4,3,0,0,15,14,29
p_295,0,5,e_0,29,43,62,9,1,1,4,4,0,1,14,19,33
p_292,0,6,e_0,38,43,67,6,0,0,1,4,0,1,5,24,29
p_290,0,6,e_0,40,43,67,6,0,0,1,4,0,1,3,24,27
p_286,0,3,e_1,46,61,72,6,0,0,5,4,0,1,15,11,26
p_289,0,4,e_1,43,61,77,6,0,0,5,3,0,0,18,16,34
p_285,0,4,e_1,53,61,77,6,0,0,2,4,0,1,8,16,24
p_284,0,4,e_1,54,61,77,6,0,0,2,4,0,1,7,16,23
p_287,0,5,e_1,45,61,82,6,0,0,5,4,0,1,16,21,37
p_291,0,11,e_0,39,43,84,6,0,0,1,4,0,1,4,41,45
p_294,0,12,e_0,31,43,89,8,1,1,4,4,0,1,12,46,58
p_293,0,12,e_0,33,43,89,7,1,1,3,4,0,1,10,46,56
p_288,0,8,e_1,44,61,93,6,0,0,5,4,0,1,17,32,49
p_281,0,1,e_3,73,87,94,4,1,0,4,4,0,1,14,7,21
p_283,0,9,e_1,57,61,98,6,0,0,1,4,0,1,4,37,41
p_278,0,2,e_3,77,87,99,3,1,0,3,4,0,1,10,12,22
p_279,0,5,e_3,76,87,110,3,1,0,3,4,0,1,11,23,34
p_277,0,6,e_3,82,87,115,1,1,0,1,4,0,1,5,28,33
p_282,0,7,e_3,66,87,120,6,0,0,6,3,0,0,21,33,54
p_273,0,4,e_2,110,118,132,23,4,4,2,4,0,1,8,14,22
p_276,0,11,e_3,84,87,134,1,1,0,1,4,0,1,3,47,50
p_280,0,14,e_3,75,87,145,4,1,0,4,4,0,1,12,58,70
p_275,0,14,e_3,86,87,145,0,0,0,0,3,0,0,1,58,59
p_274,0,8,e_2,88,118,146,28,7,7,9,3,0,0,30,28,58
p_272,0,10,e_2,113,118,154,22,4,4,1,4,0,1,5,36,41
p_271,0,1,e_1,121,151,156,21,2,2,9,3,0,0,30,5,35
p_267,0,1,e_1,148,151,156,14,0,0,1,4,0,1,3,5,8
p_268,0,2,e_1,144,151,161,14,0,0,2,4,0,1,7,10,17
p_270,0,9,e_1,122,151,184,21,2,2,9,4,0,1,29,33,62
p_269,0,9,e_1,127,151,184,19,2,2,8,4,0,1,24,33,57
p_255,0,3,e_2,184,186,197,14,0,0,0,4,0,1,2,11,13
p_265,0,4,e_2,152,186,202,14,0,0,10,5,1,0,34,16,50
p_254,0,4,e_0,187,190,204,14,0,0,1,4,0,1,3,14,17
p_262,0,5,e_2,157,186,207,14,0,0,9,4,0,1,29,21,50
p_261,0,5,e_2,164,186,207,14,0,0,7,4,0,1,22,21,43
p_266,0,6,e_0,151,190,212,14,0,0,12,3,0,0,39,22,61
p_263,0,7,e_2,154,186,215,14,0,0,10,4,0,1,32,29,61
p_260,0,7,e_2,165,186,215,14,0,0,7,4,0,1,21,29,50
p_258,0,7,e_2,168,186,215,14,0,0,6,4,0,1,18,29,47
p_256,0,10,e_2,182,186,226,14,0,0,1,4,0,1,4,40,44
p_250,0,2,e_1,217,220,228,14,0,0,1,4,0,1,3,8,11
p_264,0,11,e_2,153,186,231,14,0,0,10,2,1,1,33,45,78
p_253,0,5,e_1,190,220,239,14,0,0,9,3,0,0,30,19,49
p_252,0,5,e_1,205,220,239,14,0,0,5,4,0,1,15,19,34
p_257,0,14,e_2,169,186,242,14,0,0,5,4,0,1,17,56,73
p_259,0,15,e_2,167,186,247,14,0,0,6,4,0,1,19,61,80
p_251,0,15,e_1,209,220,271,14,0,0,3,4,0,1,11,51,62
p_248,0,5,e_0,246,260,277,14,0,0,4,4,0,1,14,17,31
p_247,0,5,e_0,250,260,277,14,0,0,3,4,0,1,10,17,27
p_249,0,6,e_0,239,260,282,14,0,0,6,3,0,0,21,22,43
p_241,0,1,e_0,283,302,309,8,1,0,6,4,0,1,19,7,26
p_236,0,1,e_3,305,307,312,0,1,0,0,4,0,1,2,5,7
p_242,0,8,e_0,277,302,332,10,1,0,5,5,1,0,25,30,55
p_245,0,7,e_3,269,307,332,12,1,0,12,4,0,1,38,25,63
p_237,0,7,e_3,304,307,332,1,1,0,1,4,0,1,3,25,28
p_240,0,9,e_0,301,302,337,2,1,0,0,3,0,0,1,35,36
p_246,0,10,e_3,262,307,343,14,0,0,14,3,0,0,45,36,81
p_239,0,11,e_3,302,307,348,1,1,0,1,4,0,1,5,41,46
p_244,0,12,e_3,271,307,353,12,1,0,12,4,0,1,36,46,82
p_238,0,13,e_3,303,307,358,1,1,0,1,4,0,1,4,51,55
p_233,0,1,e_1,311,356,361,29,6,6,15,4,0,1,45,5,50
p_226,0,2,e_1,329,356,366,24,6,6,9,4,0,1,27,10,37
p_223,0,2,e_1,336,356,366,22,5,5,6,4,0,1,20,10,30
p_243,0,15,e_3,272,307,366,11,1,0,11,4,0,1,35,59,94
p_209,0,2,e_2,357,358,368,17,1,1,0,3,0,0,1,10,11
p_230,0,3,e_1,319,356,371,27,6,6,12,4,0,1,37,15,52
p_228,0,4,e_1,325,356,376,25,6,6,10,4,0,1,31,20,51
p_232,0,5,e_1,314,356,381,29,6,6,14,4,0,1,42,25,67
p_225,0,5,e_1,330,356,381,23,6,6,8,4,0,1,26,25,51
p_224,0,5,e_1,331,356,381,23,5,5,8,4,0,1,25,25,50
p_222,0,5,e_1,337,356,381,22,5,5,6,4,0,1,19,25,44
p_221,0,6,e_1,339,356,386,21,5,5,5,4,0,1,17,30,47
p_220,0,6,e_1,341,356,386,20,5,5,5,4,0,1,15,30,45
p_234,0,8,e_2,310,358,388,29,7,7,15,3,0,0,48,30,78
p_231,0,7,e_1,317,356,391,28,6,6,13,4,0,1,39,35,74
p_205,0,2,e_0,362,388,396,16,1,1,8,4,0,1,26,8,34
p_235,0,8,e_1,308,356,396,30,7,7,15,3,0,0,48,40,88
p_200,0,4,e_0,367,388,404,15,0,0,7,4,0,1,21,16,37
p_196,0,4,e_0,371,388,404,15,0,0,5,4,0,1,17,16,33
p_201,0,5,e_0,366,388,409,15,0,0,7,4,0,1,22,21,43
p_227,0,12,e_1,327,356,410,24,6,6,9,4,0,1,29,54,83
p_208,0,6,e_0,358,388,414,17,1,1,9,3,0,0,30,26,56
p_194,0,6,e_0,373,388,414,15,0,0,5,4,0,1,15,26,41
p_229,0,13,e_1,320,356,415,27,6,6,12,4,0,1,36,59,95
p_183,0,1,e_2,396,416,421,15,0,0,6,4,0,1,20,5,25
p_198,0,9,e_0,369,388,425,15,0,0,6,4,0,1,19,37,56
p_182,0,2,e_2,397,416,426,15,0,0,6,4,0,1,19,10,29
p_180,0,2,e_2,399,416,426,15,0,0,5,4,0,1,17,10,27
p_197,0,10,e_0,370,388,430,15,0,0,6,4,0,1,18,42,60
p_178,0,3,e_2,401,416,431,15,0,0,5,4,0,1,15,15,30
p_207,0,11,e_0,359,388,435,17,1,1,9,4,0,1,29,47,76
p_186,0,4,e_2,390,416,436,15,0,0,8,4,0,1,26,20,46
p_176,0,4,e_2,403,416,436,15,0,0,4,4,0,1,13,20,33
p_206,0,12,e_0,361,388,440,16,1,1,9,4,0,1,27,52,79
p_203,0,12,e_0,364,388,440,15,1,1,8,4,0,1,24,52,76
p_204,0,14,e_0,363,388,448,16,1,1,8,4,0,1,25,60,85
p_179,0,8,e_2,400,416,450,15,0,0,5,4,0,1,16,34,50
p_202,0,15,e_0,365,388,453,15,0,0,7,4,0,1,23,65,88
p_199,0,15,e_0,368,388,453,15,0,0,6,4,0,1,20,65,85
p_195,0,15,e_0,372,388,453,15,0,0,5,4,0,1,16,65,81
p_177,0,9,e_2,402,416,455,15,0,0,4,4,0,1,14,39,53
p_185,0,10,e_2,391,416,460,15,0,0,8,4,0,1,25,44,69
p_216,0,1,e_1,347,456,463,19,3,3,3,4,0,1,109,7,116
p_173,0,11,e_2,407,416,465,15,0,0,3,4,0,1,9,49,58
p_187,0,12,e_2,389,416,470,15,0,0,8,3,0,0,27,54,81
p_184,0,12,e_2,392,416,470,15,0,0,8,4,0,1,24,54,78
p_214,0,3,e_1,349,456,471,19,3,3,2,4,0,1,107,15,122
p_165,0,4,e_1,417,456,476,15,0,0,13,4,0,1,39,20,59
p_175,0,14,e_2,405,416,478,15,0,0,3,4,0,1,11,62,73
p_174,0,14,e_2,406,416,478,15,0,0,3,4,0,1,10,62,72
p_219,0,5,e_1,342,456,481,20,4,4,4,4,0,1,114,25,139
p_181,0,15,e_2,398,416,483,15,0,0,6,4,0,1,18,67,85
p_210,0,6,e_1,354,456,486,18,2,2,0,4,0,1,102,30,132
p_217,0,7,e_1,346,456,491,19,4,4,3,4,0,1,110,35,145
p_212,0,7,e_1,351,456,491,18,3,3,1,4,0,1,105,35,140
p_163,0,10,e_1,419,456,502,15,0,0,12,4,0,1,37,46,83
p_190,0,1,e_0,379,500,507,15,0,0,3,4,0,1,121,7,128
p_218,0,11,e_1,343,456,507,20,4,4,4,4,0,1,113,51,164
p_164,0,11,e_1,418,456,507,15,0,0,12,4,0,1,38,51,89
p_162,0,11,e_1,420,456,507,15,0,0,12,4,0,1,36,51,87
p_166,0,12,e_1,416,456,512,15,0,0,13,4,0,1,40,56,96
p_143,0,3,e_0,456,500,515,15,0,0,14,4,0,1,44,15,59
p_136,0,3,e_0,465,500,515,15,0,0,11,4,0,1,35,15,50
p_137,0,4,e_0,464,500,520,15,0,0,12,4,0,1,36,20,56
p_215,0,15,e_1,348,456,523,19,3,3,2,4,0,1,108,67,175
p_213,0,15,e_1,350,456,523,19,3,3,2,4,0,1,106,67,173
p_211,0,15,e_1,353,456,523,18,2,2,1,4,0,1,103,67,170
p_141,0,6,e_0,458,500,528,15,0,0,14,4,0,1,42,28,70
p_167,0,1,e_2,413,530,535,15,0,0,1,4,0,1,117,5,122
p_192,0,8,e_0,375,500,536,15,0,0,4,4,0,1,125,36,161
p_189,0,8,e_0,382,500,536,15,0,0,2,4,0,1,118,36,154
p_140,0,8,e_0,459,500,536,15,0,0,13,4,0,1,41,36,77
p_142,0,9,e_0,457,500,541,15,0,0,14,4,0,1,43,41,84
p_106,0,3,e_2,500,530,543,15,0,0,10,4,0,1,30,13,43
p_191,0,10,e_0,376,500,546,15,0,0,4,4,0,1,124,46,170
p_139,0,10,e_0,461,500,546,15,0,0,13,4,0,1,39,46,85
p_135,0,10,e_0,466,500,546,15,0,0,11,4,0,1,34,46,80
p_193,0,11,e_0,374,500,551,15,0,0,4,4,0,1,126,51,177
p_138,0,11,e_0,463,500,551,15,0,0,12,4,0,1,37,51,88
p_99,0,6,e_2,514,530,554,15,0,0,5,4,0,1,16,24,40
p_188,0,13,e_0,384,500,559,15,0,0,1,4,0,1,116,59,175
p_102,0,7,e_2,509,530,559,15,0,0,7,4,0,1,21,29,50
p_98,0,7,e_2,515,530,559,15,0,0,5,4,0,1,15,29,44
p_101,0,8,e_2,511,530,564,15,0,0,6,4,0,1,19,34,53
p_169,0,9,e_2,411,530,569,15,0,0,1,4,0,1,119,39,158
p_100,0,9,e_2,513,530,569,15,0,0,5,4,0,1,17,39,56
p_161,0,1,e_1,421,570,577,15,0,0,11,4,0,1,149,7,156
p_158,0,1,e_1,430,570,577,15,0,0,8,4,0,1,140,7,147
p_103,0,11,e_2,508,530,577,15,0,0,7,4,0,1,22,47,69
p_105,0,12,e_2,502,530,582,15,0,0,9,4,0,1,28,52,80
p_171,0,13,e_2,409,530,587,15,0,0,2,4,0,1,121,57,178
p_168,0,13,e_2,412,530,587,15,0,0,1,4,0,1,118,57,175
p_170,0,14,e_2,410,530,592,15,0,0,2,4,0,1,120,62,182
p_104,0,14,e_2,503,530,592,15,0,0,9,4,0,1,27,62,89
p_159,0,6,e_1,429,570,594,15,0,0,9,4,0,1,141,24,165
p_150,0,6,e_1,443,570,594,15,0,0,4,4,0,1,127,24,151
p_172,0,15,e_2,408,530,597,15,0,0,2,4,0,1,122,67,189
p_154,0,7,e_1,436,570,599,15,0,0,6,4,0,1,134,29,163
p_148,0,8,e_1,449,570,604,15,0,0,2,4,0,1,121,34,155
p_130,0,1,e_0,472,600,605,15,0,0,9,4,0,1,128,5,133
p_153,0,9,e_1,437,570,609,15,0,0,6,4,0,1,133,39,172
p_147,0,9,e_1,452,570,609,15,0,0,1,4,0,1,118,39,157
p_129,0,3,e_0,473,600,613,15,0,0,9,4,0,1,127,13,140
p_157,0,14,e_1,431,570,626,15,0,0,8,4,0,1,139,56,195
p_155,0,14,e_1,435,570,626,15,0,0,7,4,0,1,135,56,191
p_124,0,7,e_0,478,600,627,15,0,0,7,4,0,1,122,27,149
p_160,0,15,e_1,426,570,631,15,0,0,10,4,0,1,144,61,205
p_156,0,15,e_1,434,570,631,15,0,0,7,4,0,1,136,61,197
p_152,0,15,e_1,441,570,631,15,0,0,5,4,0,1,129,61,190
p_151,0,15,e_1,442,570,631,15,0,0,4,4,0,1,128,61,189
p_149,0,15,e_1,444,570,631,15,0,0,4,4,0,1,126,61,187
p_127,0,10,e_0,475,600,638,15,0,0,8,4,0,1,125,38,163
p_132,0,11,e_0,470,600,643,15,0,0,10,4,0,1,130,43,173
p_128,0,11,e_0,474,600,643,15,0,0,8,4,0,1,126,43,169
p_123,0,11,e_0,479,600,643,15,0,0,7,4,0,1,121,43,164
p_121,0,11,e_0,481,600,643,15,0,0,6,4,0,1,119,43,162
p_120,0,11,e_0,482,600,643,15,0,0,6,4,0,1,118,43,161
p_133,0,12,e_0,469,600,648,15,0,0,10,4,0,1,131,48,179
p_126,0,12,e_0,476,600,648,15,0,0,8,4,0,1,124,48,172
p_96,0,1,e_2,517,644,649,15,0,0,4,4,0,1,127,5,132
p_131,0,14,e_0,471,600,656,15,0,0,9,4,0,1,129,56,185
p_125,0,14,e_0,477,600,656,15,0,0,7,4,0,1,123,56,179
p_92,0,4,e_2,525,644,660,15,0,0,1,4,0,1,119,16,135
p_134,0,15,e_0,467,600,661,15,0,0,11,4,0,1,133,61,194
p_122,0,15,e_0,480,600,661,15,0,0,6,4,0,1,120,61,181
p_94,0,6,e_2,519,644,668,15,0,0,3,4,0,1,125,24,149
p_97,0,7,e_2,516,644,673,15,0,0,4,4,0,1,128,29,157
p_37,0,9,e_2,615,644,681,15,0,0,9,4,0,1,29,37,66
p_35,0,9,e_2,630,644,681,15,0,0,4,4,0,1,14,37,51
p_146,0,1,e_1,453,678,685,15,0,0,1,4,0,1,225,7,232
p_41,0,11,e_2,600,644,689,15,0,0,14,4,0,1,44,45,89
p_86,0,2,e_1,544,678,690,15,0,0,8,4,0,1,134,12,146
p_91,0,12,e_2,526,644,694,15,0,0,1,4,0,1,118,50,168
p_39,0,12,e_2,607,644,694,15,0,0,12,4,0,1,37,50,87
p_93,0,13,e_2,520,644,699,15,0,0,3,4,0,1,124,55,179
p_90,0,13,e_2,527,644,699,15,0,0,1,4,0,1,117,55,172
p_40,0,13,e_2,602,644,699,15,0,0,14,4,0,1,42,55,97
p_38,0,13,e_2,608,644,699,15,0,0,12,4,0,1,36,55,91
p_36,0,13,e_2,628,644,699,15,0,0,5,4,0,1,16,55,71
p_88,0,5,e_1,538,678,701,15,0,0,10,4,0,1,140,23,163
p_95,0,14,e_2,518,644,704,15,0,0,4,4,0,1,126,60,186
p_80,0,7,e_1,552,678,709,15,0,0,6,4,0,1,126,31,157
p_119,0,1,e_0,483,708,713,15,0,0,5,4,0,1,225,5,230
p_113,0,1,e_0,489,708,713,15,0,0,3,4,0,1,219,5,224
p_65,0,1,e_0,573,708,713,15,0,0,9,4,0,1,135,5,140
p_87,0,8,e_1,539,678,714,15,0,0,10,4,0,1,139,36,175
p_83,0,8,e_1,549,678,714,15,0,0,7,4,0,1,129,36,165
p_144,0,9,e_1,455,678,719,15,0,0,0,3,0,0,223,41,264
p_89,0,9,e_1,535,678,719,15,0,0,11,4,0,1,143,41,184
p_114,0,3,e_0,488,708,721,15,0,0,4,4,0,1,220,13,233
p_64,0,4,e_0,574,708,726,15,0,0,8,4,0,1,134,18,152
p_145,0,11,e_1,454,678,727,15,0,0,0,4,0,1,224,49,273
p_84,0,12,e_1,546,678,732,15,0,0,8,4,0,1,132,54,186
p_78,0,12,e_1,556,678,732,15,0,0,4,4,0,1,122,54,176
p_108,0,6,e_0,496,708,734,15,0,0,1,4,0,1,212,26,238
p_118,0,7,e_0,484,708,739,15,0,0,5,4,0,1,224,31,255
p_82,0,14,e_1,550,678,740,15,0,0,6,4,0,1,128,62,190
p_81,0,14,e_1,551,678,740,15,0,0,6,4,0,1,127,62,189
p_79,0,14,e_1,553,678,740,15,0,0,5,4,0,1,125,62,187
p_111,0,8,e_0,491,708,744,15,0,0,3,4,0,1,217,36,253
p_85,0,15,e_1,545,678,745,15,0,0,8,4,0,1,133,67,200
p_115,0,9,e_0,487,708,749,15,0,0,4,4,0,1,221,41,262
p_117,0,10,e_0,485,708,754,15,0,0,5,4,0,1,223,46,269
p_116,0,10,e_0,486,708,754,15,0,0,4,4,0,1,222,46,268
p_112,0,11,e_0,490,708,759,15,0,0,3,4,0,1,218,51,269
p_110,0,11,e_0,492,708,759,15,0,0,2,4,0,1,216,51,267
p_107,0,11,e_0,499,708,759,15,0,0,0,3,0,0,209,51,260
p_22,0,3,e_2,719,756,767,15,0,0,12,4,0,1,37,11,48
p_21,0,4,e_2,731,756,772,15,0,0,8,4,0,1,25,16,41
p_109,0,15,e_0,493,708,773,15,0,0,2,4,0,1,215,65,280
p_19,0,11,e_2,754,756,795,15,0,0,0,4,0,1,2,39,41
p_23,0,12,e_2,711,756,800,15,0,0,14,3,0,0,45,44,89
p_77,0,3,e_1,557,792,803,15,0,0,4,4,0,1,235,11,246
p_72,0,3,e_1,562,792,803,15,0,0,2,4,0,1,230,11,241
p_71,0,3,e_1,564,792,803,15,0,0,2,4,0,1,228,11,239
p_70,0,3,e_1,565,792,803,15,0,0,1,4,0,1,227,11,238
p_67,0,3,e_1,568,792,803,15,0,0,0,4,0,1,224,11,235
p_66,0,3,e_1,569,792,803,15,0,0,0,3,0,0,223,11,234
p_20,0,14,e_2,734,756,808,15,0,0,7,4,0,1,22,52,74
p_75,0,5,e_1,559,792,811,15,0,0,3,4,0,1,233,19,252
p_76,0,6,e_1,558,792,816,15,0,0,4,4,0,1,234,24,258
p_32,0,6,e_1,650,792,816,15,0,0,9,4,0,1,142,24,166
p_74,0,7,e_1,560,792,821,15,0,0,3,4,0,1,232,29,261
p_55,0,3,e_0,585,820,831,15,0,0,5,4,0,1,235,11,246
p_54,0,3,e_0,586,820,831,15,0,0,4,4,0,1,234,11,245
p_52,0,3,e_0,588,820,831,15,0,0,4,4,0,1,232,11,243
p_73,0,11,e_1,561,792,835,15,0,0,3,4,0,1,231,43,274
p_34,0,12,e_1,646,792,840,15,0,0,10,4,0,1,146,48,194
p_61,0,6,e_0,579,820,842,15,0,0,7,4,0,1,241,22,263
p_56,0,6,e_0,584,820,842,15,0,0,5,4,0,1,236,22,258
p_68,0,13,e_1,567,792,845,15,0,0,1,4,0,1,225,53,278
p_50,0,7,e_0,590,820,847,15,0,0,3,4,0,1,230,27,257
p_69,0,14,e_1,566,792,850,15,0,0,1,4,0,1,226,58,284
p_53,0,9,e_0,587,820,855,15,0,0,4,4,0,1,233,35,268
p_51,0,9,e_0,589,820,855,15,0,0,3,4,0,1,231,35,266
p_33,0,15,e_1,649,792,855,15,0,0,9,4,0,1,143,63,206
p_60,0,10,e_0,580,820,860,15,0,0,6,4,0,1,240,40,280
p_58,0,11,e_0,582,820,865,15,0,0,6,4,0,1,238,45,283
p_57,0,11,e_0,583,820,865,15,0,0,5,4,0,1,237,45,282
p_63,0,13,e_0,577,820,873,15,0,0,7,4,0,1,243,53,296
p_62,0,13,e_0,578,820,873,15,0,0,7,4,0,1,242,53,295
p_59,0,14,e_0,581,820,878,15,0,0,6,4,0,1,239,58,297
p_49,0,14,e_0,591,820,878,15,0,0,3,4,0,1,229,58,287
p_9,0,2,e_2,846,880,888,15,0,0,11,4,0,1,34,8,42
p_6,0,3,e_2,877,880,893,15,0,0,1,4,0,1,3,13,16
p_7,0,5,e_2,875,880,901,15,0,0,1,4,0,1,5,21,26
p_4,0,1,e_1,886,902,907,15,0,0,5,4,0,1,16,5,21
p_16,0,2,e_1,780,902,912,15,0,0,4,4,0,1,122,10,132
p_10,0,8,e_2,835,880,912,15,0,0,14,3,0,0,45,32,77
p_30,0,3,e_1,668,902,917,15,0,0,3,4,0,1,234,15,249
p_8,0,11,e_2,874,880,923,15,0,0,2,4,0,1,6,43,49
p_29,0,5,e_1,670,902,925,15,0,0,2,4,0,1,232,23,255
p_1,0,5,e_1,894,902,925,15,0,0,2,4,0,1,8,23,31
p_45,0,2,e_0,595,922,930,15,0,0,1,4,0,1,327,8,335
p_24,0,2,e_0,695,922,930,15,0,0,4,4,0,1,227,8,235
p_31,0,6,e_1,666,902,930,15,0,0,4,4,0,1,236,28,264
p_48,0,4,e_0,592,922,938,15,0,0,2,4,0,1,330,16,346
p_46,0,4,e_0,594,922,938,15,0,0,2,4,0,1,328,16,344
p_14,0,4,e_0,794,922,938,15,0,0,8,4,0,1,128,16,144
p_5,0,8,e_1,883,902,938,15,0,0,6,4,0,1,19,36,55
p_3,0,8,e_1,888,902,938,15,0,0,4,4,0,1,14,36,50
p_42,0,6,e_0,598,922,946,15,0,0,0,4,0,1,324,24,348
p_27,0,10,e_1,677,902,946,15,0,0,0,3,0,0,225,44,269
p_18,0,10,e_1,766,902,946,15,0,0,8,4,0,1,136,44,180
p_17,0,10,e_1,776,902,946,15,0,0,5,4,0,1,126,44,170
p_43,0,7,e_0,597,922,951,15,0,0,1,4,0,1,325,29,354
p_28,0,11,e_1,676,902,951,15,0,0,0,4,0,1,226,49,275
p_2,0,11,e_1,892,902,951,15,0,0,3,4,0,1,10,49,59
p_44,0,8,e_0,596,922,956,15,0,0,1,4,0,1,326,34,360
p_26,0,8,e_0,684,922,956,15,0,0,8,4,0,1,238,34,272
p_25,0,8,e_0,686,922,956,15,0,0,7,4,0,1,236,34,270
p_47,0,9,e_0,593,922,961,15,0,0,2,4,0,1,329,39,368
p_15,0,9,e_0,793,922,961,15,0,0,9,4,0,1,129,39,168
p_11,0,9,e_0,807,922,961,15,0,0,4,4,0,1,115,39,154
p_13,0,11,e_0,796,922,969,15,0,0,8,4,0,1,126,47,173
p_12,0,11,e_0,798,922,969,15,0,0,7,4,0,1,124,47,171
p_300,0,4,e_0,8,9,25,0,0,0,0,3,0,0,1,16,17
p_299,0,5,e_1,9,10,29,0,0,0,0,3,0,0,1,19,20
p_297,0,6,e_3,15,16,38,0,0,0,0,3,0,0,1,22,23
p_298,0,9,e_2,11,12,43,0,0,0,0,3,0,0,1,31,32
p_296,0,4,e_0,28,43,57,9,1,1,4,3,0,0,15,14,29
p_295,0,5,e_0,29,43,62,9,1,1,4,4,0,1,14,19,33
p_292,0,6,e_0,38,43,67,6,0,0,1,4,0,1,5,24,29
p_290,0,6,e_0,40,43,67,6,0,0,1,4,0,1,3,24,27
p_286,0,3,e_1,46,61,72,6,0,0,5,4,0,1,15,11,26
p_289,0,4,e_1,43,61,77,6,0,0,5,3,0,0,18,16,34
p_285,0,4,e_1,53,61,77,6,0,0,2,4,0,1,8,16,24
p_284,0,4,e_1,54,61,77,6,0,0,2,4,0,1,7,16,23
p_287,0,5,e_1,45,61,82,6,0,0,5,4,0,1,16,21,37
p_291,0,11,e_0,39,43,84,6,0,0,1,4,0,1,4,41,45
p_294,0,12,e_0,31,43,89,8,1,1,4,4,0,1,12,46,58
p_293,0,12,e_0,33,43,89,7,1,1,3,4,0,1,10,46,56
p_288,0,8,e_1,44,61,93,6,0,0,5,4,0,1,17,32,49
p_281,0,1,e_3,73,87,94,4,1,0,4,4,0,1,14,7,21
p_283,0,9,e_1,57,61,98,6,0,0,1,4,0,1,4,37,41
p_278,0,2,e_3,77,87,99,3,1,0,3,4,0,1,10,12,22
p_279,0,5,e_3,76,87,110,3,1,0,3,4,0,1,11,23,34
p_277,0,6,e_3,82,87,115,1,1,0,1,4,0,1,5,28,33
p_282,0,7,e_3,66,87,120,6,0,0,6,3,0,0,21,33,54
p_273,0,4,e_2,110,118,132,23,4,4,2,4,0,1,8,14,22
p_276,0,11,e_3,84,87,134,1,1,0,1,4,0,1,3,47,50
p_280,0,14,e_3,75,87,145,4,1,0,4,4,0,1,12,58,70
p_275,0,14,e_3,86,87,145,0,0,0,0,3,0,0,1,58,59
p_274,0,8,e_2,88,118,146,28,7,7,9,3,0,0,30,28,58
p_272,0,10,e_2,113,118,154,22,4,4,1,4,0,1,5,36,41
p_271,0,1,e_1,121,151,156,21,2,2,9,3,0,0,30,5,35
p_267,0,1,e_1,148,151,156,14,0,0,1,4,0,1,3,5,8
p_268,0,2,e_1,144,151,161,14,0,0,2,4,0,1,7,10,17
p_270,0,9,e_1,122,151,184,21,2,2,9,4,0,1,29,33,62
p_269,0,9,e_1,127,151,184,19,2,2,8,4,0,1,24,33,57
p_255,0,3,e_2,184,186,197,14,0,0,0,4,0,1,2,11,13
p_265,0,4,e_2,152,186,202,14,0,0,10,5,1,0,34,16,50
p_254,0,4,e_0,187,190,204,14,0,0,1,4,0,1,3,14,17
p_262,0,5,e_2,157,186,207,14,0,0,9,4,0,1,29,21,50
p_261,0,5,e_2,164,186,207,14,0,0,7,4,0,1,22,21,43
p_266,0,6,e_0,151,190,212,14,0,0,12,3,0,0,39,22,61
p_263,0,7,e_2,154,186,215,14,0,0,10,4,0,1,32,29,61
p_260,0,7,e_2,165,186,215,14,0,0,7,4,0,1,21,29,50
p_258,0,7,e_2,168,186,215,14,0,0,6,4,0,1,18,29,47
p_256,0,10,e_2,182,186,226,14,0,0,1,4,0,1,4,40,44
p_250,0,2,e_1,217,220,228,14,0,0,1,4,0,1,3,8,11
p_264,0,11,e_2,153,186,231,14,0,0,10,2,1,1,33,45,78
p_253,0,5,e_1,190,220,239,14,0,0,9,3,0,0,30,19,49
p_252,0,5,e_1,205,220,239,14,0,0,5,4,0,1,15,19,34
p_257,0,14,e_2,169,186,242,14,0,0,5,4,0,1,17,56,73
p_259,0,15,e_2,167,186,247,14,0,0,6,4,0,1,19,61,80
p_251,0,15,e_1,209,220,271,14,0,0,3,4,0,1,11,51,62
p_248,0,5,e_0,246,260,277,14,0,0,4,4,0,1,14,17,31
p_247,0,5,e_0,250,260,277,14,0,0,3,4,0,1,10,17,27
p_249,0,6,e_0,239,260,282,14,0,0,6,3,0,0,21,22,43
p_241,0,1,e_0,283,302,309,8,1,0,6,4,0,1,19,7,26
p_236,0,1,e_3,305,307,312,0,1,0,0,4,0,1,2,5,7
p_242,0,8,e_0,277,302,332,10,1,0,5,5,1,0,25,30,55
p_245,0,7,e_3,269,307,332,12,1,0,12,4,0,1,38,25,63
p_237,0,7,e_3,304,307,332,1,1,0,1,4,0,1,3,25,28
p_240,0,9,e_0,301,302,337,2,1,0,0,3,0,0,1,35,36
p_246,0,10,e_3,262,307,343,14,0,0,14,3,0,0,45,36,81
p_239,0,11,e_3,302,307,348,1,1,0,1,4,0,1,5,41,46
p_244,0,12,e_3,271,307,353,12,1,0,12,4,0,1,36,46,82
p_238,0,13,e_3,303,307,358,1,1,0,1,4,0,1,4,51,55
p_233,0,1,e_1,311,356,361,29,6,6,15,4,0,1,45,5,50
p_226,0,2,e_1,329,356,366,24,6,6,9,4,0,1,27,10,37
p_223,0,2,e_1,336,356,366,22,5,5,6,4,0,1,20,10,30
p_243,0,15,e_3,272,307,366,11,1,0,11,4,0,1,35,59,94
p_209,0,2,e_2,357,358,368,17,1,1,0,3,0,0,1,10,11
p_230,0,3,e_1,319,356,371,27,6,6,12,4,0,1,37,15,52
p_228,0,4,e_1,325,356,376,25,6,6,10,4,0,1,31,20,51
p_232,0,5,e_1,314,356,381,29,6,6,14,4,0,1,42,25,67
p_225,0,5,e_1,330,356,381,23,6,6,8,4,0,1,26,25,51
p_224,0,5,e_1,331,356,381,23,5,5,8,4,0,1,25,25,50
p_222,0,5,e_1,337,356,381,22,5,5,6,4,0,1,19,25,44
p_221,0,6,e_1,339,356,386,21,5,5,5,4,0,1,17,30,47
p_220,0,6,e_1,341,356,386,20,5,5,5,4,0,1,15,30,45
p_234,0,8,e_2,310,358,388,29,7,7,15,3,0,0,48,30,78
p_231,0,7,e_1,317,356,391,28,6,6,13,4,0,1,39,35,74
p_205,0,2,e_0,362,388,396,16,1,1,8,4,0,1,26,8,34
p_235,0,8,e_1,308,356,396,30,7,7,15,3,0,0,48,40,88
p_200,0,4,e_0,367,388,404,15,0,0,7,4,0,1,21,16,37
p_196,0,4,e_0,371,388,404,15,0,0,5,4,0,1,17,16,33
p_201,0,5,e_0,366,388,409,15,0,0,7,4,0,1,22,21,43
p_227,0,12,e_1,327,356,410,24,6,6,9,4,0,1,29,54,83
p_208,0,6,e_0,358,388,414,17,1,1,9,3,0,0,30,26,56
p_194,0,6,e_0,373,388,414,15,0,0,5,4,0,1,15,26,41
p_229,0,13,e_1,320,356,415,27,6,6,12,4,0,1,36,59,95
p_183,0,1,e_2,396,416,421,15,0,0,6,4,0,1,20,5,25
p_198,0,9,e_0,369,388,425,15,0,0,6,4,0,1,19,37,56
p_182,0,2,e_2,397,416,426,15,0,0,6,4,0,1,19,10,29
p_180,0,2,e_2,399,416,426,15,0,0,5,4,0,1,17,10,27
p_197,0,10,e_0,370,388,430,15,0,0,6,4,0,1,18,42,60
p_178,0,3,e_2,401,416,431,15,0,0,5,4,0,1,15,15,30
p_207,0,11,e_0,359,388,435,17,1,1,9,4,0,1,29,47,76
p_186,0,4,e_2,390,416,436,15,0,0,8,4,0,1,26,20,46
p_176,0,4,e_2,403,416,436,15,0,0,4,4,0,1,13,20,33
p_206,0,12,e_0,361,388,440,16,1,1,9,4,0,1,27,52,79
p_203,0,12,e_0,364,388,440,15,1,1,8,4,0,1,24,52,76
p_204,0,14,e_0,363,388,448,16,1,1,8,4,0,1,25,60,85
p_179,0,8,e_2,400,416,450,15,0,0,5,4,0,1,16,34,50
p_202,0,15,e_0,365,388,453,15,0,0,7,4,0,1,23,65,88
p_199,0,15,e_0,368,388,453,15,0,0,6,4,0,1,20,65,85
p_195,0,15,e_0,372,388,453,15,0,0,5,4,0,1,16,65,81
p_177,0,9,e_2,402,416,455,15,0,0,4,4,0,1,14,39,53
p_185,0,10,e_2,391,416,460,15,0,0,8,4,0,1,25,44,69
p_216,0,1,e_1,347,456,463,19,3,3,3,4,0,1,109,7,116
p_173,0,11,e_2,407,416,465,15,0,0,3,4,0,1,9,49,58
p_187,0,12,e_2,389,416,470,15,0,0,8,3,0,0,27,54,81
p_184,0,12,e_2,392,416,470,15,0,0,8,4,0,1,24,54,78
p_214,0,3,e_1,349,456,471,19,3,3,2,4,0,1,107,15,122
p_165,0,4,e_1,417,456,476,15,0,0,13,4,0,1,39,20,59
p_175,0,14,e_2,405,416,478,15,0,0,3,4,0,1,11,62,73
p_174,0,14,e_2,406,416,478,15,0,0,3,4,0,1,10,62,72
p_219,0,5,e_1,342,456,481,20,4,4,4,4,0,1,114,25,139
p_181,0,15,e_2,398,416,483,15,0,0,6,4,0,1,18,67,85
p_210,0,6,e_1,354,456,486,18,2,2,0,4,0,1,102,30,132
p_217,0,7,e_1,346,456,491,19,4,4,3,4,0,1,110,35,145
p_212,0,7,e_1,351,456,491,18,3,3,1,4,0,1,105,35,140
p_163,0,10,e_1,419,456,502,15,0,0,12,4,0,1,37,46,83
p_190,0,1,e_0,379,500,507,15,0,0,3,4,0,1,121,7,128
p_218,0,11,e_1,343,456,507,20,4,4,4,4,0,1,113,51,164
p_164,0,11,e_1,418,456,507,15,0,0,12,4,0,1,38,51,89
p_162,0,11,e_1,420,456,507,15,0,0,12,4,0,1,36,51,87
p_166,0,12,e_1,416,456,512,15,0,0,13,4,0,1,40,56,96
p_143,0,3,e_0,456,500,515,15,0,0,14,4,0,1,44,15,59
p_136,0,3,e_0,465,500,515,15,0,0,11,4,0,1,35,15,50
p_137,0,4,e_0,464,500,520,15,0,0,12,4,0,1,36,20,56
p_215,0,15,e_1,348,456,523,19,3,3,2,4,0,1,108,67,175
p_213,0,15,e_1,350,456,523,19,3,3,2,4,0,1,106,67,173
p_211,0,15,e_1,353,456,523,18,2,2,1,4,0,1,103,67,170
p_141,0,6,e_0,458,500,528,15,0,0,14,4,0,1,42,28,70
p_167,0,1,e_2,413,530,535,15,0,0,1,4,0,1,117,5,122
p_192,0,8,e_0,375,500,536,15,0,0,4,4,0,1,125,36,161
p_189,0,8,e_0,382,500,536,15,0,0,2,4,0,1,118,36,154
p_140,0,8,e_0,459,500,536,15,0,0,13,4,0,1,41,36,77
p_142,0,9,e_0,457,500,541,15,0,0,14,4,0,1,43,41,84
p_106,0,3,e_2,500,530,543,15,0,0,10,4,0,1,30,13,43
p_191,0,10,e_0,376,500,546,15,0,0,4,4,0,1,124,46,170
p_139,0,10,e_0,461,500,546,15,0,0,13,4,0,1,39,46,85
p_135,0,10,e_0,466,500,546,15,0,0,11,4,0,1,34,46,80
p_193,0,11,e_0,374,500,551,15,0,0,4,4,0,1,126,51,177
p_138,0,11,e_0,463,500,551,15,0,0,12,4,0,1,37,51,88
p_99,0,6,e_2,514,530,554,15,0,0,5,4,0,1,16,24,40
p_188,0,13,e_0,384,500,559,15,0,0,1,4,0,1,116,59,175
p_102,0,7,e_2,509,530,559,15,0,0,7,4,0,1,21,29,50
p_98,0,7,e_2,515,530,559,15,0,0,5,4,0,1,15,29,44
p_101,0,8,e_2,511,530,564,15,0,0,6,4,0,1,19,34,53
p_169,0,9,e_2,411,530,569,15,0,0,1,4,0,1,119,39,158
p_100,0,9,e_2,513,530,569,15,0,0,5,4,0,1,17,39,56
p_161,0,1,e_1,421,570,577,15,0,0,11,4,0,1,149,7,156
p_158,0,1,e_1,430,570,577,15,0,0,8,4,0,1,140,7,147
p_103,0,11,e_2,508,530,577,15,0,0,7,4,0,1,22,47,69
p_105,0,12,e_2,502,530,582,15,0,0,9,4,0,1,28,52,80
p_171,0,13,e_2,409,530,587,15,0,0,2,4,0,1,121,57,178
p_168,0,13,e_2,412,530,587,15,0,0,1,4,0,1,118,57,175
p_170,0,14,e_2,410,530,592,15,0,0,2,4,0,1,120,62,182
p_104,0,14,e_2,503,530,592,15,0,0,9,4,0,1,27,62,89
p_159,0,6,e_1,429,570,594,15,0,0,9,4,0,1,141,24,165
p_150,0,6,e_1,443,570,594,15,0,0,4,4,0,1,127,24,151
p_172,0,15,e_2,408,530,597,15,0,0,2,4,0,1,122,67,189
p_154,0,7,e_1,436,570,599,15,0,0,6,4,0,1,134,29,163
p_148,0,8,e_1,449,570,604,15,0,0,2,4,0,1,121,34,155
p_130,0,1,e_0,472,600,605,15,0,0,9,4,0,1,128,5,133
p_153,0,9,e_1,437,570,609,15,0,0,6,4,0,1,133,39,172
p_147,0,9,e_1,452,570,609,15,0,0,1,4,0,1,118,39,157
p_129,0,3,e_0,473,600,613,15,0,0,9,4,0,1,127,13,140
p_157,0,14,e_1,431,570,626,15,0,0,8,4,0,1,139,56,195
p_155,0,14,e_1,435,570,626,15,0,0,7,4,0,1,135,56,191
p_124,0,7,e_0,478,600,627,15,0,0,7,4,0,1,122,27,149
p_160,0,15,e_1,426,570,631,15,0,0,10,4,0,1,144,61,205
p_156,0,15,e_1,434,570,631,15,0,0,7,4,0,1,136,61,197
p_152,0,15,e_1,441,570,631,15,0,0,5,4,0,1,129,61,190
p_151,0,15,e_1,442,570,631,15,0,0,4,4,0,1,128,61,189
p_149,0,15,e_1,444,570,631,15,0,0,4,4,0,1,126,61,187
p_127,0,10,e_0,475,600,638,15,0,0,8,4,0,1,125,38,163
p_132,0,11,e_0,470,600,643,15,0,0,10,4,0,1,130,43,173
p_128,0,11,e_0,474,600,643,15,0,0,8,4,0,1,126,43,169
p_123,0,11,e_0,479,600,643,15,0,0,7,4,0,1,121,43,164
p_121,0,11,e_0,481,600,643,15,0,0,6,4,0,1,119,43,162
p_120,0,11,e_0,482,600,643,15,0,0,6,4,0,1,118,43,161
p_133,0,12,e_0,469,600,648,15,0,0,10,4,0,1,131,48,179
p_126,0,12,e_0,476,600,648,15,0,0,8,4,0,1,124,48,172
p_96,0,1,e_2,517,644,649,15,0,0,4,4,0,1,127,5,132
p_131,0,14,e_0,471,600,656,15,0,0,9,4,0,1,129,56,185
p_125,0,14,e_0,477,600,656,15,0,0,7,4,0,1,123,56,179
p_92,0,4,e_2,525,644,660,15,0,0,1,4,0,1,119,16,135
p_134,0,15,e_0,467,600,661,15,0,0,11,4,0,1,133,61,194
p_122,0,15,e_0,480,600,661,15,0,0,6,4,0,1,120,61,181
p_94,0,6,e_2,519,644,668,15,0,0,3,4,0,1,125,24,149
p_97,0,7,e_2,516,644,673,15,0,0,4,4,0,1,128,29,157
p_37,0,9,e_2,615,644,681,15,0,0,9,4,0,1,29,37,66
p_35,0,9,e_2,630,644,681,15,0,0,4,4,0,1,14,37,51
p_146,0,1,e_1,453,678,685,15,0,0,1,4,0,1,225,7,232
p_41,0,11,e_2,600,644,689,15,0,0,14,4,0,1,44,45,89
p_86,0,2,e_1,544,678,690,15,0,0,8,4,0,1,134,12,146
p_91,0,12,e_2,526,644,694,15,0,0,1,4,0,1,118,50,168
p_39,0,12,e_2,607,644,694,15,0,0,12,4,0,1,37,50,87
p_93,0,13,e_2,520,644,699,15,0,0,3,4,0,1,124,55,179
p_90,0,13,e_2,527,644,699,15,0,0,1,4,0,1,117,55,172
p_40,0,13,e_2,602,644,699,15,0,0,14,4,0,1,42,55,97
p_38,0,13,e_2,608,644,699,15,0,0,12,4,0,1,36,55,91
p_36,0,13,e_2,628,644,699,15,0,0,5,4,0,1,16,55,71
p_88,0,5,e_1,538,678,701,15,0,0,10,4,0,1,140,23,163
p_95,0,14,e_2,518,644,704,15,0,0,4,4,0,1,126,60,186
p_80,0,7,e_1,552,678,709,15,0,0,6,4,0,1,126,31,157
p_119,0,1,e_0,483,708,713,15,0,0,5,4,0,1,225,5,230
p_113,0,1,e_0,489,708,713,15,0,0,3,4,0,1,219,5,224
p_65,0,1,e_0,573,708,713,15,0,0,9,4,0,1,135,5,140
p_87,0,8,e_1,539,678,714,15,0,0,10,4,0,1,139,36,175
p_83,0,8,e_1,549,678,714,15,0,0,7,4,0,1,129,36,165
p_144,0,9,e_1,455,678,719,15,0,0,0,3,0,0,223,41,264
p_89,0,9,e_1,535,678,719,15,0,0,11,4,0,1,143,41,184
p_114,0,3,e_0,488,708,721,15,0,0,4,4,0,1,220,13,233
p_64,0,4,e_0,574,708,726,15,0,0,8,4,0,1,134,18,152
p_145,0,11,e_1,454,678,727,15,0,0,0,4,0,1,224,49,273
p_84,0,12,e_1,546,678,732,15,0,0,8,4,0,1,132,54,186
p_78,0,12,e_1,556,678,732,15,0,0,4,4,0,1,122,54,176
p_108,0,6,e_0,496,708,734,15,0,0,1,4,0,1,212,26,238
p_118,0,7,e_0,484,708,739,15,0,0,5,4,0,1,224,31,255
p_82,0,14,e_1,550,678,740,15,0,0,6,4,0,1,128,62,190
p_81,0,14,e_1,551,678,740,15,0,0,6,4,0,1,127,62,189
p_79,0,14,e_1,553,678,740,15,0,0,5,4,0,1,125,62,187
p_111,0,8,e_0,491,708,744,15,0,0,3,4,0,1,217,36,253
p_85,0,15,e_1,545,678,745,15,0,0,8,4,0,1,133,67,200
p_115,0,9,e_0,487,708,749,15,0,0,4,4,0,1,221,41,262
p_117,0,10,e_0,485,708,754,15,0,0,5,4,0,1,223,46,269
p_116,0,10,e_0,486,708,754,15,0,0,4,4,0,1,222,46,268
p_112,0,11,e_0,490,708,759,15,0,0,3,4,0,1,218,51,269
p_110,0,11,e_0,492,708,759,15,0,0,2,4,0,1,216,51,267
p_107,0,11,e_0,499,708,759,15,0,0,0,3,0,0,209,51,260
p_22,0,3,e_2,719,756,767,15,0,0,12,4,0,1,37,11,48
p_21,0,4,e_2,731,756,772,15,0,0,8,4,0,1,25,16,41
p_109,0,15,e_0,493,708,773,15,0,0,2,4,0,1,215,65,280
p_19,0,11,e_2,754,756,795,15,0,0,0,4,0,1,2,39,41
p_23,0,12,e_2,711,756,800,15,0,0,14,3,0,0,45,44,89
p_77,0,3,e_1,557,792,803,15,0,0,4,4,0,1,235,11,246
p_72,0,3,e_1,562,792,803,15,0,0,2,4,0,1,230,11,241
p_71,0,3,e_1,564,792,803,15,0,0,2,4,0,1,228,11,239
p_70,0,3,e_1,565,792,803,15,0,0,1,4,0,1,227,11,238
p_67,0,3,e_1,568,792,803,15,0,0,0,4,0,1,224,11,235
p_66,0,3,e_1,569,792,803,15,0,0,0,3,0,0,223,11,234
p_20,0,14,e_2,734,756,808,15,0,0,7,4,0,1,22,52,74
p_75,0,5,e_1,559,792,811,15,0,0,3,4,0,1,233,19,252
p_76,0,6,e_1,558,792,816,15,0,0,4,4,0,1,234,24,258
p_32,0,6,e_1,650,792,816,15,0,0,9,4,0,1,142,24,166
p_74,0,7,e_1,560,792,821,15,0,0,3,4,0,1,232,29,261
p_55,0,3,e_0,585,820,831,15,0,0,5,4,0,1,235,11,246
p_54,0,3,e_0,586,820,831,15,0,0,4,4,0,1,234,11,245
p_52,0,3,e_0,588,820,831,15,0,0,4,4,0,1,232,11,243
p_73,0,11,e_1,561,792,835,15,0,0,3,4,0,1,231,43,274
p_34,0,12,e_1,646,792,840,15,0,0,10,4,0,1,146,48,194
p_61,0,6,e_0,579,820,842,15,0,0,7,4,0,1,241,22,263
p_56,0,6,e_0,584,820,842,15,0,0,5,4,0,1,236,22,258
p_68,0,13,e_1,567,792,845,15,0,0,1,4,0,1,225,53,278
p_50,0,7,e_0,590,820,847,15,0,0,3,4,0,1,230,27,257
p_69,0,14,e_1,566,792,850,15,0,0,1,4,0,1,226,58,284
p_53,0,9,e_0,587,820,855,15,0,0,4,4,0,1,233,35,268
p_51,0,9,e_0,589,820,855,15,0,0,3,4,0,1,231,35,266
p_33,0,15,e_1,649,792,855,15,0,0,9,4,0,1,143,63,206
p_60,0,10,e_0,580,820,860,15,0,0,6,4,0,1,240,40,280
p_58,0,11,e_0,582,820,865,15,0,0,6,4,0,1,238,45,283
p_57,0,11,e_0,583,820,865,15,0,0,5,4,0,1,237,45,282
p_63,0,13,e_0,577,820,873,15,0,0,7,4,0,1,243,53,296
p_62,0,13,e_0,578,820,873,15,0,0,7,4,0,1,242,53,295
p_59,0,14,e_0,581,820,878,15,0,0,6,4,0,1,239,58,297
p_49,0,14,e_0,591,820,878,15,0,0,3,4,0,1,229,58,287
p_9,0,2,e_2,846,880,888,15,0,0,11,4,0,1,34,8,42
p_6,0,3,e_2,877,880,893,15,0,0,1,4,0,1,3,13,16
p_7,0,5,e_2,875,880,901,15,0,0,1,4,0,1,5,21,26
p_4,0,1,e_1,886,902,907,15,0,0,5,4,0,1,16,5,21
p_16,0,2,e_1,780,902,912,15,0,0,4,4,0,1,122,10,132
p_10,0,8,e_2,835,880,912,15,0,0,14,3,0,0,45,32,77
p_30,0,3,e_1,668,902,917,15,0,0,3,4,0,1,234,15,249
p_8,0,11,e_2,874,880,923,15,0,0,2,4,0,1,6,43,49
p_29,0,5,e_1,670,902,925,15,0,0,2,4,0,1,232,23,255
p_1,0,5,e_1,894,902,925,15,0,0,2,4,0,1,8,23,31
p_45,0,2,e_0,595,922,930,15,0,0,1,4,0,1,327,8,335
p_24,0,2,e_0,695,922,930,15,0,0,4,4,0,1,227,8,235
p_31,0,6,e_1,666,902,930,15,0,0,4,4,0,1,236,28,264
p_48,0,4,e_0,592,922,938,15,0,0,2,4,0,1,330,16,346
p_46,0,4,e_0,594,922,938,15,0,0,2,4,0,1,328,16,344
p_14,0,4,e_0,794,922,938,15,0,0,8,4,0,1,128,16,144
p_5,0,8,e_1,883,902,938,15,0,0,6,4,0,1,19,36,55
p_3,0,8,e_1,888,902,938,15,0,0,4,4,0,1,14,36,50
p_42,0,6,e_0,598,922,946,15,0,0,0,4,0,1,324,24,348
p_27,0,10,e_1,677,902,946,15,0,0,0,3,0,0,225,44,269
p_18,0,10,e_1,766,902,946,15,0,0,8,4,0,1,136,44,180
p_17,0,10,e_1,776,902,946,15,0,0,5,4,0,1,126,44,170
p_43,0,7,e_0,597,922,951,15,0,0,1,4,0,1,325,29,354
p_28,0,11,e_1,676,902,951,15,0,0,0,4,0,1,226,49,275
p_2,0,11,e_1,892,902,951,15,0,0,3,4,0,1,10,49,59
p_44,0,8,e_0,596,922,956,15,0,0,1,4,0,1,326,34,360
p_26,0,8,e_0,684,922,956,15,0,0,8,4,0,1,238,34,272
p_25,0,8,e_0,686,922,956,15,0,0,7,4,0,1,236,34,270
p_47,0,9,e_0,593,922,961,15,0,0,2,4,0,1,329,39,368
p_15,0,9,e_0,793,922,961,15,0,0,9,4,0,1,129,39,168
p_11,0,9,e_0,807,922,961,15,0,0,4,4,0,1,115,39,154
p_13,0,11,e_0,796,922,969,15,0,0,8,4,0,1,126,47,173
p_12,0,11,e_0,798,922,969,15,0,0,7,4,0,1,124,47,171
p_300,0,4,e_0,8,9,25,0,0,0,0,3,0,0,1,16,17
p_299,0,5,e_1,9,10,29,0,0,0,0,3,0,0,1,19,20
p_297,0,6,e_3,15,16,38,0,0,0,0,3,0,0,1,22,23
p_298,0,9,e_2,11,12,43,0,0,0,0,3,0,0,1,31,32
p_296,0,4,e_0,28,43,57,9,1,1,4,3,0,0,15,14,29
p_286,0,3,e_1,46,47,60,6,0,0,0,3,0,0,1,13,14
p_292,0,6,e_0,38,43,65,6,0,0,1,4,0,1,5,22,27
p_290,0,6,e_0,40,43,65,6,0,0,1,4,0,1,3,22,25
p_289,0,4,e_1,43,47,65,6,0,0,1,4,0,1,4,18,22
p_295,0,5,e_1,29,47,70,9,1,1,5,3,0,0,18,23,41
p_287,0,5,e_1,45,47,70,6,0,0,0,4,0,1,2,23,25
p_288,0,8,e_1,44,47,81,6,0,0,1,4,0,1,3,34,37
p_281,0,1,e_3,73,74,81,0,0,0,0,3,0,0,1,7,8
p_291,0,11,e_0,39,43,82,6,0,0,1,4,0,1,4,39,43
p_294,0,12,e_0,31,43,87,8,1,1,4,4,0,1,12,44,56
p_293,0,12,e_0,33,43,87,7,1,1,3,4,0,1,10,44,54
p_278,0,2,e_2,77,84,92,18,4,4,2,4,0,1,7,8,15
p_285,0,4,e_3,53,74,92,6,0,0,6,3,0,0,21,18,39
p_284,0,4,e_2,54,84,100,6,1,0,9,3,0,0,30,16,46
p_282,0,7,e_3,66,74,103,2,1,0,2,4,0,1,8,29,37
p_279,0,5,e_2,76,84,105,18,4,4,2,4,0,1,8,21,29
p_277,0,6,e_2,82,84,110,17,3,3,0,4,0,1,2,26,28
p_283,0,9,e_3,57,74,111,5,1,0,5,4,0,1,17,37,54
p_273,0,4,e_1,110,111,127,9,0,0,0,3,0,0,1,16,17
p_271,0,1,e_0,121,125,130,9,0,0,1,4,0,1,4,5,9
p_280,0,14,e_2,75,84,136,18,4,4,3,4,0,1,9,52,61
p_274,0,8,e_1,88,111,141,15,3,3,7,4,0,1,23,30,53
p_276,0,11,e_1,84,111,152,16,3,3,8,3,0,0,27,41,68
p_270,0,9,e_0,122,125,156,9,0,0,1,4,0,1,3,31,34
p_272,0,10,e_0,113,125,161,9,0,0,4,4,0,1,12,36,48
p_267,0,1,e_3,148,157,162,3,1,0,3,4,0,1,9,5,14
p_268,0,2,e_3,144,157,167,4,1,0,4,4,0,1,13,10,23
p_275,0,14,e_0,86,125,175,16,3,3,12,2,1,0,39,50,89
p_265,0,4,e_3,152,157,175,1,1,0,1,4,0,1,5,18,23
p_266,0,6,e_3,151,157,183,2,1,0,2,4,0,1,6,26,32
p_263,0,7,e_3,154,157,188,1,1,0,1,4,0,1,3,31,34
p_269,0,9,e_3,127,157,196,9,0,0,9,3,0,0,30,39,69
p_255,0,3,e_1,184,193,204,16,3,3,3,4,0,1,9,11,20
p_264,0,11,e_3,153,157,204,1,1,0,1,4,0,1,4,47,51
p_254,0,4,e_1,187,193,209,15,2,2,2,4,0,1,6,16,22
p_262,0,5,e_1,157,193,214,22,7,7,11,3,0,0,36,21,57
p_261,0,5,e_1,164,193,214,21,6,6,9,4,0,1,29,21,50
p_253,0,5,e_1,190,193,214,15,2,2,1,4,0,1,3,21,24
p_260,0,7,e_1,165,193,222,20,6,6,9,4,0,1,28,29,57
p_258,0,7,e_1,168,193,222,20,5,5,8,4,0,1,25,29,54
p_256,0,10,e_1,182,193,233,16,3,3,3,4,0,1,11,40,51
p_257,0,14,e_1,169,193,247,20,5,5,8,4,0,1,24,54,78
p_250,0,2,e_3,217,241,249,8,1,0,8,4,0,1,24,8,32
p_259,0,15,e_1,167,193,252,20,5,5,8,4,0,1,26,59,85
p_252,0,5,e_3,205,241,260,11,0,0,11,3,0,0,36,19,55
p_249,0,6,e_3,239,241,265,0,1,0,0,4,0,1,2,24,26
p_248,0,5,e_0,246,254,271,11,3,3,2,4,0,1,8,17,25
p_247,0,5,e_0,250,254,271,10,2,2,1,4,0,1,4,17,21
p_241,0,1,e_3,283,290,295,2,1,0,2,4,0,1,7,5,12
p_251,0,15,e_0,209,254,303,10,1,0,14,3,0,0,45,49,94
p_236,0,1,e_2,305,307,312,26,4,4,0,4,0,1,2,5,7
p_245,0,7,e_3,269,290,315,6,0,0,6,3,0,0,21,25,46
p_242,0,8,e_3,277,290,320,4,1,0,4,4,0,1,13,30,43
p_237,0,7,e_2,304,307,332,26,4,4,1,4,0,1,3,25,28
p_244,0,12,e_3,271,290,334,6,1,0,6,4,0,1,19,44,63
p_240,0,9,e_2,301,307,340,27,4,4,2,4,0,1,6,33,39
p_246,0,10,e_2,262,307,345,7,1,1,14,3,0,0,45,38,83
p_243,0,15,e_3,272,290,345,6,1,0,6,4,0,1,18,55,73
p_239,0,11,e_2,302,307,350,27,4,4,1,4,0,1,5,43,48
p_238,0,13,e_2,303,307,358,27,4,4,1,4,0,1,4,51,55
p_233,0,1,e_0,311,356,361,24,4,4,15,4,0,1,45,5,50
p_226,0,2,e_0,329,356,366,19,2,2,9,4,0,1,27,10,37
p_223,0,2,e_0,336,356,366,18,1,1,6,4,0,1,20,10,30
p_209,0,2,e_1,357,358,368,15,0,0,0,3,0,0,1,10,11
p_230,0,3,e_0,319,356,371,22,2,2,12,4,0,1,37,15,52
p_228,0,4,e_0,325,356,376,21,2,2,10,4,0,1,31,20,51
p_232,0,5,e_0,314,356,381,23,3,3,14,4,0,1,42,25,67
p_225,0,5,e_0,330,356,381,19,2,2,8,4,0,1,26,25,51
p_224,0,5,e_0,331,356,381,19,2,2,8,4,0,1,25,25,50
p_222,0,5,e_0,337,356,381,17,1,1,6,4,0,1,19,25,44
p_221,0,6,e_0,339,356,386,17,1,1,5,4,0,1,17,30,47
p_220,0,6,e_0,341,356,386,16,1,1,5,4,0,1,15,30,45
p_234,0,8,e_1,310,358,388,24,4,4,15,3,0,0,48,30,78
p_231,0,7,e_0,317,356,391,23,3,3,13,4,0,1,39,35,74
p_235,0,8,e_0,308,356,396,25,4,4,15,3,0,0,48,40,88
p_227,0,12,e_0,327,356,410,20,2,2,9,4,0,1,29,54,83
p_205,0,2,e_2,362,400,410,15,1,0,12,4,0,1,38,10,48
p_229,0,13,e_0,320,356,415,22,2,2,12,4,0,1,36,59,95
p_200,0,4,e_2,367,400,418,13,1,0,11,4,0,1,33,18,51
p_196,0,4,e_2,371,400,418,12,1,0,9,4,0,1,29,18,47
p_178,0,3,e_3,401,407,420,2,1,0,2,4,0,1,6,13,19
p_201,0,5,e_2,366,400,423,13,1,0,11,4,0,1,34,23,57
p_176,0,4,e_3,403,407,425,1,1,0,1,4,0,1,4,18,22
p_208,0,6,e_2,358,400,428,15,0,0,13,3,0,0,42,28,70
p_194,0,6,e_2,373,400,428,11,1,0,9,4,0,1,27,28,55
p_167,0,1,e_1,413,434,439,27,6,6,7,4,0,1,21,5,26
p_161,0,1,e_1,421,434,439,25,5,5,4,4,0,1,13,5,18
p_198,0,9,e_2,369,400,439,12,1,0,10,4,0,1,31,39,70
p_179,0,8,e_3,400,407,439,2,1,0,2,4,0,1,7,32,39
p_197,0,10,e_2,370,400,444,12,1,0,10,4,0,1,30,44,74
p_177,0,9,e_3,402,407,444,1,1,0,1,4,0,1,5,37,42
p_193,0,11,e_2,374,400,449,11,1,0,8,4,0,1,26,49,75
p_165,0,4,e_1,417,434,450,26,6,6,5,4,0,1,17,16,33
p_207,0,11,e_3,359,407,452,15,0,0,15,3,0,0,48,45,93
p_206,0,12,e_2,361,400,454,15,1,0,13,4,0,1,39,54,93
p_203,0,12,e_2,364,400,454,14,1,0,12,4,0,1,36,54,90
p_159,0,6,e_1,429,434,458,23,4,4,1,4,0,1,5,24,29
p_204,0,14,e_2,363,400,462,14,1,0,12,4,0,1,37,62,99
p_216,0,1,e_0,347,456,463,15,0,0,3,4,0,1,109,7,116
p_175,0,14,e_3,405,407,463,0,1,0,0,4,0,1,2,56,58
p_174,0,14,e_3,406,407,463,0,0,0,0,3,0,0,1,56,57
p_202,0,15,e_2,365,400,467,14,1,0,11,4,0,1,35,67,102
p_199,0,15,e_2,368,400,467,13,1,0,10,4,0,1,32,67,99
p_195,0,15,e_2,372,400,467,11,1,0,9,4,0,1,28,67,95
p_169,0,9,e_1,411,434,469,28,6,6,7,4,0,1,23,35,58
p_214,0,3,e_0,349,456,471,15,0,0,2,4,0,1,107,15,122
p_163,0,10,e_1,419,434,474,25,5,5,5,4,0,1,15,40,55
p_219,0,5,e_0,342,456,479,16,1,1,4,4,0,1,114,23,137
p_173,0,11,e_1,407,434,479,28,7,7,8,3,0,0,27,45,72
p_164,0,11,e_1,418,434,479,25,6,6,5,4,0,1,16,45,61
p_162,0,11,e_1,420,434,479,25,5,5,4,4,0,1,14,45,59
p_210,0,6,e_0,354,456,484,15,0,0,0,4,0,1,102,28,130
p_166,0,12,e_1,416,434,484,26,6,6,6,4,0,1,18,50,68
p_217,0,7,e_0,346,456,489,15,0,0,3,4,0,1,110,33,143
p_212,0,7,e_0,351,456,489,15,0,0,1,4,0,1,105,33,138
p_154,0,7,e_0,436,456,489,21,4,4,6,4,0,1,20,33,53
p_171,0,13,e_1,409,434,489,28,6,6,8,4,0,1,25,55,80
p_168,0,13,e_1,412,434,489,27,6,6,7,4,0,1,22,55,77
p_170,0,14,e_1,410,434,494,28,6,6,8,4,0,1,24,60,84
p_153,0,9,e_0,437,456,497,20,4,4,6,4,0,1,19,41,60
p_172,0,15,e_1,408,434,499,28,6,6,8,4,0,1,26,65,91
p_160,0,15,e_1,426,434,499,24,4,4,2,4,0,1,8,65,73
p_218,0,11,e_0,343,456,505,15,1,1,4,4,0,1,113,49,162
p_130,0,1,e_3,472,507,512,11,1,0,11,4,0,1,35,5,40
p_155,0,14,e_0,435,456,516,21,4,4,7,4,0,1,21,60,81
p_143,0,3,e_3,456,507,520,16,1,1,12,5,1,0,51,13,64
p_136,0,3,e_3,465,507,520,14,1,0,14,4,0,1,42,13,55
p_129,0,3,e_3,473,507,520,11,1,0,11,4,0,1,34,13,47
p_215,0,15,e_0,348,456,521,15,0,0,2,4,0,1,108,65,173
p_213,0,15,e_0,350,456,521,15,0,0,2,4,0,1,106,65,171
p_211,0,15,e_0,353,456,521,15,0,0,1,4,0,1,103,65,168
p_156,0,15,e_0,434,456,521,21,4,4,7,4,0,1,22,65,87
p_152,0,15,e_0,441,456,521,20,3,3,5,4,0,1,15,65,80
p_190,0,1,e_2,379,514,521,9,1,0,7,4,0,1,135,7,142
p_183,0,1,e_2,396,514,521,3,1,0,1,4,0,1,118,7,125
p_137,0,4,e_3,464,507,525,14,1,0,14,4,0,1,43,18,61
p_182,0,2,e_2,397,514,526,3,1,0,1,4,0,1,117,12,129
p_180,0,2,e_2,399,514,526,2,1,0,0,3,0,0,115,12,127
p_141,0,6,e_3,458,507,533,15,2,2,13,5,1,1,49,26,75
p_186,0,4,e_2,390,514,534,5,1,0,3,4,0,1,124,20,144
p_140,0,8,e_3,459,507,541,15,2,2,13,5,1,1,48,34,82
p_102,0,7,e_2,509,514,545,30,11,11,1,4,0,1,5,31,36
p_142,0,9,e_3,457,507,546,16,2,2,12,5,1,1,50,39,89
p_192,0,8,e_2,375,514,550,10,1,0,8,4,0,1,139,36,175
p_189,0,8,e_2,382,514,550,8,1,0,6,4,0,1,132,36,168
p_139,0,10,e_3,461,507,551,14,2,2,14,5,1,1,46,44,90
p_135,0,10,e_3,466,507,551,13,1,0,13,4,0,1,41,44,85
p_158,0,1,e_1,430,546,553,23,4,4,1,4,0,1,116,7,123
p_96,0,1,e_1,517,546,553,28,11,11,9,4,0,1,29,7,36
p_138,0,11,e_3,463,507,556,14,1,0,14,4,0,1,44,49,93
p_132,0,11,e_3,470,507,556,12,1,0,12,4,0,1,37,49,86
p_191,0,10,e_2,376,514,558,10,1,0,8,4,0,1,138,44,182
p_185,0,10,e_2,391,514,558,5,1,0,3,4,0,1,123,44,167
p_133,0,12,e_3,469,507,561,12,1,0,12,4,0,1,38,54,92
p_103,0,11,e_2,508,514,563,30,11,11,2,4,0,1,6,49,55
p_92,0,4,e_1,525,546,564,26,9,9,7,4,0,1,21,18,39
p_187,0,12,e_2,389,514,568,6,1,0,3,4,0,1,125,54,179
p_184,0,12,e_2,392,514,568,5,1,0,2,4,0,1,122,54,176
p_88,0,5,e_1,538,546,569,23,8,8,2,4,0,1,8,23,31
p_131,0,14,e_3,471,507,569,12,1,0,12,4,0,1,36,62,98
p_188,0,13,e_2,384,514,573,7,1,0,5,4,0,1,130,59,189
p_99,0,6,e_1,514,546,574,29,11,11,10,4,0,1,32,28,60
p_94,0,6,e_1,519,546,574,27,10,10,9,4,0,1,27,28,55
p_134,0,15,e_3,467,507,574,13,1,0,13,4,0,1,40,67,107
p_146,0,1,e_0,453,568,575,17,1,1,1,4,0,1,115,7,122
p_98,0,7,e_1,515,546,579,28,11,11,10,4,0,1,31,33,64
p_97,0,7,e_1,516,546,579,28,11,11,10,4,0,1,30,33,63
p_181,0,15,e_2,398,514,581,3,1,0,0,4,0,1,116,67,183
p_87,0,8,e_1,539,546,584,22,8,8,2,4,0,1,7,38,45
p_89,0,9,e_1,535,546,589,24,8,8,3,4,0,1,11,43,54
p_150,0,6,e_0,443,568,592,19,2,2,4,4,0,1,125,24,149
p_80,0,7,e_0,552,568,597,20,5,5,5,4,0,1,16,29,45
p_91,0,12,e_1,526,546,600,26,9,9,6,4,0,1,20,54,74
p_148,0,8,e_0,449,568,602,18,2,2,2,4,0,1,119,34,153
p_83,0,8,e_0,549,568,602,20,6,6,6,4,0,1,19,34,53
p_93,0,13,e_1,520,546,605,27,10,10,8,4,0,1,26,59,85
p_90,0,13,e_1,527,546,605,26,9,9,6,4,0,1,19,59,78
p_147,0,9,e_0,452,568,607,17,1,1,1,4,0,1,116,39,155
p_144,0,9,e_0,455,568,607,16,1,1,0,3,0,0,113,39,152
p_157,0,14,e_1,431,546,610,22,4,4,1,4,0,1,115,64,179
p_95,0,14,e_1,518,546,610,27,11,11,9,4,0,1,28,64,92
p_145,0,11,e_0,454,568,615,17,1,1,0,4,0,1,114,47,161
p_84,0,12,e_0,546,568,620,21,6,6,7,4,0,1,22,52,74
p_78,0,12,e_0,556,568,620,19,4,4,4,4,0,1,12,52,64
p_119,0,1,e_3,483,621,626,8,1,0,8,4,0,1,138,5,143
p_82,0,14,e_0,550,568,628,20,5,5,6,4,0,1,18,60,78
p_81,0,14,e_0,551,568,628,20,5,5,5,4,0,1,17,60,77
p_79,0,14,e_0,553,568,628,20,5,5,5,4,0,1,15,60,75
p_151,0,15,e_0,442,568,633,19,3,3,4,4,0,1,126,65,191
p_149,0,15,e_0,444,568,633,19,2,2,4,4,0,1,124,65,189
p_114,0,3,e_3,488,621,634,6,1,0,6,4,0,1,133,13,146
p_124,0,7,e_3,478,621,648,9,1,0,9,4,0,1,143,27,170
p_118,0,7,e_3,484,621,648,7,1,0,7,4,0,1,137,27,164
p_101,0,8,e_2,511,628,654,29,11,11,1,4,0,1,117,26,143
p_115,0,9,e_3,487,621,656,6,1,0,6,4,0,1,134,35,169
p_100,0,9,e_2,513,628,659,29,11,11,0,3,0,0,115,31,146
p_127,0,10,e_3,475,621,661,10,1,0,10,4,0,1,146,40,186
p_117,0,10,e_3,485,621,661,7,1,0,7,4,0,1,136,40,176
p_116,0,10,e_3,486,621,661,7,1,0,7,4,0,1,135,40,175
p_86,0,2,e_1,544,654,662,21,7,7,0,4,0,1,110,8,118
p_128,0,11,e_3,474,621,666,11,1,0,11,4,0,1,147,45,192
p_123,0,11,e_3,479,621,666,9,1,0,9,4,0,1,142,45,187
p_121,0,11,e_3,481,621,666,8,1,0,8,4,0,1,140,45,185
p_120,0,11,e_3,482,621,666,8,1,0,8,4,0,1,139,45,184
p_126,0,12,e_3,476,621,671,10,1,0,10,4,0,1,145,50,195
p_32,0,6,e_1,650,654,676,23,7,7,1,4,0,1,4,22,26
p_125,0,14,e_3,477,621,679,10,1,0,10,4,0,1,144,58,202
p_122,0,15,e_3,480,621,684,9,1,0,9,4,0,1,141,63,204
p_35,0,9,e_1,630,654,687,28,9,9,8,4,0,1,24,33,57
p_77,0,3,e_0,557,680,691,19,4,4,3,4,0,1,123,11,134
p_72,0,3,e_0,562,680,691,18,3,3,2,4,0,1,118,11,129
p_71,0,3,e_0,564,680,691,17,3,3,1,4,0,1,116,11,127
p_70,0,3,e_0,565,680,691,17,3,3,1,4,0,1,115,11,126
p_30,0,3,e_0,668,680,691,19,4,4,4,4,0,1,12,11,23
p_34,0,12,e_1,646,654,698,23,8,8,2,4,0,1,8,44,52
p_75,0,5,e_0,559,680,699,18,4,4,3,4,0,1,121,19,140
p_29,0,5,e_0,670,680,699,18,3,3,3,4,0,1,10,19,29
p_36,0,13,e_1,628,654,703,29,9,9,8,4,0,1,26,49,75
p_76,0,6,e_0,558,680,704,19,4,4,3,4,0,1,122,24,146
p_31,0,6,e_0,666,680,704,19,4,4,4,4,0,1,14,24,38
p_74,0,7,e_0,560,680,709,18,3,3,2,4,0,1,120,29,149
p_85,0,15,e_1,545,654,711,21,6,6,0,3,0,0,109,57,166
p_33,0,15,e_1,649,654,711,23,7,7,1,4,0,1,5,57,62
p_27,0,10,e_0,677,680,720,16,3,3,1,4,0,1,3,40,43
p_24,0,2,e_2,695,714,722,12,1,0,6,4,0,1,19,8,27
p_73,0,11,e_0,561,680,725,18,3,3,2,4,0,1,119,45,164
p_28,0,11,e_0,676,680,725,17,3,3,1,4,0,1,4,45,49
p_68,0,13,e_0,567,680,733,16,3,3,0,3,0,0,113,53,166
p_113,0,1,e_3,489,731,736,6,1,0,6,4,0,1,242,5,247
p_65,0,1,e_3,573,731,736,15,1,1,15,2,1,1,158,5,163
p_69,0,14,e_0,566,680,738,17,3,3,0,4,0,1,114,58,172
p_26,0,8,e_2,684,714,742,15,1,0,9,3,0,0,30,28,58
p_25,0,8,e_2,686,714,742,15,1,0,9,4,0,1,28,28,56
p_106,0,3,e_3,500,731,744,2,1,0,2,4,0,1,231,13,244
p_67,0,3,e_3,568,731,744,16,2,2,14,2,2,1,163,13,176
p_66,0,3,e_3,569,731,744,16,2,2,14,5,1,1,162,13,175
p_64,0,4,e_3,574,731,749,15,1,0,15,4,0,1,157,18,175
p_23,0,12,e_2,711,714,756,6,1,0,1,4,0,1,3,42,45
p_108,0,6,e_3,496,731,757,3,1,0,3,4,0,1,235,26,261
p_111,0,8,e_3,491,731,765,5,1,0,5,4,0,1,240,34,274
p_112,0,11,e_3,490,731,776,5,1,0,5,4,0,1,241,45,286
p_110,0,11,e_3,492,731,776,5,1,0,5,4,0,1,239,45,284
p_107,0,11,e_3,499,731,776,2,1,0,2,4,0,1,232,45,277
p_105,0,12,e_3,502,731,781,1,1,0,1,4,0,1,229,50,279
p_63,0,13,e_3,577,731,786,14,1,0,14,4,0,1,154,55,209
p_104,0,14,e_3,503,731,791,1,1,0,1,4,0,1,228,60,288
p_21,0,4,e_1,731,779,793,30,10,10,15,3,0,0,48,14,62
p_109,0,15,e_3,493,731,796,4,1,0,4,4,0,1,238,65,303
p_18,0,10,e_1,766,779,813,22,6,6,4,4,0,1,13,34,47
p_17,0,10,e_1,776,779,813,19,5,5,1,4,0,1,3,34,37
p_19,0,11,e_1,754,779,818,25,8,8,8,4,0,1,25,39,64
p_16,0,2,e_2,780,819,827,18,4,4,12,3,0,0,39,8,47
p_20,0,14,e_1,734,779,829,29,11,11,15,4,0,1,45,50,95
p_14,0,4,e_2,794,819,835,15,2,2,8,4,0,1,25,16,41
p_15,0,9,e_2,793,819,852,16,2,2,8,4,0,1,26,33,59
p_11,0,9,e_2,807,819,852,12,1,0,4,4,0,1,12,33,45
p_55,0,3,e_3,585,843,854,12,1,0,12,4,0,1,258,11,269
p_54,0,3,e_3,586,843,854,11,1,0,11,4,0,1,257,11,268
p_52,0,3,e_3,588,843,854,11,1,0,11,4,0,1,255,11,266
p_48,0,4,e_3,592,843,859,9,1,0,9,4,0,1,251,16,267
p_13,0,11,e_2,796,819,860,15,1,0,7,4,0,1,23,41,64
p_12,0,11,e_2,798,819,860,15,1,0,7,4,0,1,21,41,62
p_61,0,6,e_3,579,843,867,14,1,0,14,4,0,1,264,24,288
p_56,0,6,e_3,584,843,867,12,1,0,12,4,0,1,259,24,283
p_50,0,7,e_3,590,843,872,10,1,0,10,4,0,1,253,29,282
p_53,0,9,e_3,587,843,880,11,1,0,11,4,0,1,256,37,293
p_51,0,9,e_3,589,843,880,10,1,0,10,4,0,1,254,37,291
p_60,0,10,e_3,580,843,885,13,1,0,13,4,0,1,263,42,305
p_58,0,11,e_3,582,843,890,13,1,0,13,4,0,1,261,47,308
p_57,0,11,e_3,583,843,890,12,1,0,12,4,0,1,260,47,307
p_4,0,1,e_0,886,891,896,18,4,4,1,4,0,1,5,5,10
p_62,0,13,e_3,578,843,898,14,1,0,14,4,0,1,265,55,320
p_9,0,2,e_0,846,891,901,27,10,10,14,3,0,0,45,10,55
p_59,0,14,e_3,581,843,903,13,1,0,13,4,0,1,262,60,322
p_49,0,14,e_3,591,843,903,10,1,0,10,4,0,1,252,60,312
p_6,0,3,e_0,877,891,906,20,6,6,4,4,0,1,14,15,29
p_7,0,5,e_0,875,891,914,20,6,6,5,4,0,1,16,23,39
p_5,0,8,e_0,883,891,925,18,5,5,2,4,0,1,8,34,42
p_3,0,8,e_0,888,891,925,17,4,4,1,4,0,1,3,34,37
p_8,0,11,e_0,874,891,936,21,6,6,5,4,0,1,17,45,62
p_45,0,2,e_3,595,947,955,8,1,0,8,4,0,1,352,8,360
p_1,0,5,e_1,894,939,956,16,3,3,14,3,0,0,45,17,62
p_22,0,3,e_3,719,947,960,4,1,0,4,4,0,1,228,13,241
p_2,0,11,e_2,892,928,963,17,3,3,11,3,0,0,36,35,71
p_46,0,4,e_3,594,947,965,9,1,0,9,4,0,1,353,18,371
p_42,0,6,e_3,598,947,973,7,1,0,7,4,0,1,349,26,375
p_43,0,7,e_3,597,947,978,8,1,0,8,4,0,1,350,31,381
p_44,0,8,e_3,596,947,983,8,1,0,8,4,0,1,351,36,387
p_10,0,8,e_3,835,947,983,2,1,0,2,4,0,1,112,36,148
p_47,0,9,e_3,593,947,988,9,1,0,9,4,0,1,354,41,395
p_37,0,9,e_3,615,947,988,2,1,0,2,4,0,1,332,41,373
p_41,0,11,e_3,600,947,996,7,1,0,7,4,0,1,347,49,396
p_39,0,12,e_3,607,947,1001,4,1,0,4,4,0,1,340,54,394
p_40,0,13,e_3,602,947,1006,6,1,0,6,4,0,1,345,59,404
p_38,0,13,e_3,608,947,1006,4,1,0,4,4,0,1,339,59,398
p_300,0,4,e_0,8,9,25,0,0,0,0,3,0,0,1,16,17
p_299,0,5,e_1,9,10,29,0,0,0,0,3,0,0,1,19,20
p_297,0,6,e_3,15,16,38,0,0,0,0,3,0,0,1,22,23
p_298,0,9,e_2,11,12,43,0,0,0,0,3,0,0,1,31,32
p_296,0,4,e_0,28,43,57,9,1,1,4,3,0,0,15,14,29
p_295,0,5,e_0,29,43,62,9,1,1,4,4,0,1,14,19,33
p_292,0,6,e_0,38,43,67,6,0,0,1,4,0,1,5,24,29
p_290,0,6,e_0,40,43,67,6,0,0,1,4,0,1,3,24,27
p_286,0,3,e_1,46,61,72,6,0,0,5,4,0,1,15,11,26
p_289,0,4,e_1,43,61,77,6,0,0,5,3,0,0,18,16,34
p_285,0,4,e_1,53,61,77,6,0,0,2,4,0,1,8,16,24
p_284,0,4,e_1,54,61,77,6,0,0,2,4,0,1,7,16,23
p_287,0,5,e_1,45,61,82,6,0,0,5,4,0,1,16,21,37
p_291,0,11,e_0,39,43,84,6,0,0,1,4,0,1,4,41,45
p_294,0,12,e_0,31,43,89,8,1,1,4,4,0,1,12,46,58
p_293,0,12,e_0,33,43,89,7,1,1,3,4,0,1,10,46,56
p_288,0,8,e_1,44,61,93,6,0,0,5,4,0,1,17,32,49
p_281,0,1,e_3,73,87,94,4,1,0,4,4,0,1,14,7,21
p_283,0,9,e_1,57,61,98,6,0,0,1,4,0,1,4,37,41
p_278,0,2,e_3,77,87,99,3,1,0,3,4,0,1,10,12,22
p_279,0,5,e_3,76,87,110,3,1,0,3,4,0,1,11,23,34
p_277,0,6,e_3,82,87,115,1,1,0,1,4,0,1,5,28,33
p_282,0,7,e_3,66,87,120,6,0,0,6,3,0,0,21,33,54
p_273,0,4,e_2,110,118,132,23,4,4,2,4,0,1,8,14,22
p_276,0,11,e_3,84,87,134,1,1,0,1,4,0,1,3,47,50
p_280,0,14,e_3,75,87,145,4,1,0,4,4,0,1,12,58,70
p_275,0,14,e_3,86,87,145,0,0,0,0,3,0,0,1,58,59
p_274,0,8,e_2,88,118,146,28,7,7,9,3,0,0,30,28,58
p_272,0,10,e_2,113,118,154,22,4,4,1,4,0,1,5,36,41
p_271,0,1,e_1,121,151,156,21,2,2,9,3,0,0,30,5,35
p_267,0,1,e_1,148,151,156,14,0,0,1,4,0,1,3,5,8
p_268,0,2,e_1,144,151,161,14,0,0,2,4,0,1,7,10,17
p_270,0,9,e_1,122,151,184,21,2,2,9,4,0,1,29,33,62
p_269,0,9,e_1,127,151,184,19,2,2,8,4,0,1,24,33,57
p_255,0,3,e_2,184,186,197,14,0,0,0,4,0,1,2,11,13
p_265,0,4,e_2,152,186,202,14,0,0,10,5,1,0,34,16,50
p_254,0,4,e_0,187,190,204,14,0,0,1,4,0,1,3,14,17
p_262,0,5,e_2,157,186,207,14,0,0,9,4,0,1,29,21,50
p_261,0,5,e_2,164,186,207,14,0,0,7,4,0,1,22,21,43
p_266,0,6,e_0,151,190,212,14,0,0,12,3,0,0,39,22,61
p_263,0,7,e_2,154,186,215,14,0,0,10,4,0,1,32,29,61
p_260,0,7,e_2,165,186,215,14,0,0,7,4,0,1,21,29,50
p_258,0,7,e_2,168,186,215,14,0,0,6,4,0,1,18,29,47
p_256,0,10,e_2,182,186,226,14,0,0,1,4,0,1,4,40,44
p_250,0,2,e_1,217,220,228,14,0,0,1,4,0,1,3,8,11
p_264,0,11,e_2,153,186,231,14,0,0,10,2,1,1,33,45,78
p_253,0,5,e_1,190,220,239,14,0,0,9,3,0,0,30,19,49
p_252,0,5,e_1,205,220,239,14,0,0,5,4,0,1,15,19,34
p_257,0,14,e_2,169,186,242,14,0,0,5,4,0,1,17,56,73
p_259,0,15,e_2,167,186,247,14,0,0,6,4,0,1,19,61,80
p_251,0,15,e_1,209,220,271,14,0,0,3,4,0,1,11,51,62
p_248,0,5,e_0,246,260,277,14,0,0,4,4,0,1,14,17,31
p_247,0,5,e_0,250,260,277,14,0,0,3,4,0,1,10,17,27
p_249,0,6,e_0,239,260,282,14,0,0,6,3,0,0,21,22,43
p_241,0,1,e_0,283,302,309,8,1,0,6,4,0,1,19,7,26
p_236,0,1,e_3,305,307,312,0,1,0,0,4,0,1,2,5,7
p_245,0,7,e_0,269,302,329,12,1,0,3,5,2,0,33,27,60
p_237,0,7,e_3,304,307,332,1,1,0,1,4,0,1,3,25,28
p_242,0,8,e_0,277,302,334,10,1,0,5,5,1,1,25,32,57
p_240,0,9,e_0,301,302,339,2,1,0,0,3,0,0,1,37,38
p_246,0,10,e_3,262,307,343,14,0,0,14,3,0,0,45,36,81
p_239,0,11,e_3,302,307,348,1,1,0,1,4,0,1,5,41,46
p_244,0,12,e_3,271,307,353,12,1,0,12,4,0,1,36,46,82
p_238,0,13,e_3,303,307,358,1,1,0,1,4,0,1,4,51,55
p_233,0,1,e_1,311,356,361,29,6,6,15,4,0,1,45,5,50
p_226,0,2,e_1,329,356,366,24,6,6,9,4,0,1,27,10,37
p_223,0,2,e_1,336,356,366,22,5,5,6,4,0,1,20,10,30
p_243,0,15,e_3,272,307,366,11,1,0,11,4,0,1,35,59,94
p_209,0,2,e_2,357,358,368,17,1,1,0,3,0,0,1,10,11
p_230,0,3,e_1,319,356,371,27,6,6,12,4,0,1,37,15,52
p_228,0,4,e_1,325,356,376,25,6,6,10,4,0,1,31,20,51
p_232,0,5,e_1,314,356,381,29,6,6,14,4,0,1,42,25,67
p_225,0,5,e_1,330,356,381,23,6,6,8,4,0,1,26,25,51
p_224,0,5,e_1,331,356,381,23,5,5,8,4,0,1,25,25,50
p_222,0,5,e_1,337,356,381,22,5,5,6,4,0,1,19,25,44
p_221,0,6,e_1,339,356,386,21,5,5,5,4,0,1,17,30,47
p_220,0,6,e_1,341,356,386,20,5,5,5,4,0,1,15,30,45
p_234,0,8,e_2,310,358,388,29,7,7,15,3,0,0,48,30,78
p_231,0,7,e_1,317,356,391,28,6,6,13,4,0,1,39,35,74
p_205,0,2,e_0,362,388,396,16,1,1,8,4,0,1,26,8,34
p_235,0,8,e_1,308,356,396,30,7,7,15,3,0,0,48,40,88
p_200,0,4,e_0,367,388,404,15,0,0,7,4,0,1,21,16,37
p_196,0,4,e_0,371,388,404,15,0,0,5,4,0,1,17,16,33
p_201,0,5,e_0,366,388,409,15,0,0,7,4,0,1,22,21,43
p_227,0,12,e_1,327,356,410,24,6,6,9,4,0,1,29,54,83
p_208,0,6,e_0,358,388,414,17,1,1,9,3,0,0,30,26,56
p_194,0,6,e_0,373,388,414,15,0,0,5,4,0,1,15,26,41
p_229,0,13,e_1,320,356,415,27,6,6,12,4,0,1,36,59,95
p_183,0,1,e_2,396,416,421,15,0,0,6,4,0,1,20,5,25
p_198,0,9,e_0,369,388,425,15,0,0,6,4,0,1,19,37,56
p_182,0,2,e_2,397,416,426,15,0,0,6,4,0,1,19,10,29
p_180,0,2,e_2,399,416,426,15,0,0,5,4,0,1,17,10,27
p_197,0,10,e_0,370,388,430,15,0,0,6,4,0,1,18,42,60
p_178,0,3,e_2,401,416,431,15,0,0,5,4,0,1,15,15,30
p_207,0,11,e_0,359,388,435,17,1,1,9,4,0,1,29,47,76
p_186,0,4,e_2,390,416,436,15,0,0,8,4,0,1,26,20,46
p_176,0,4,e_2,403,416,436,15,0,0,4,4,0,1,13,20,33
p_206,0,12,e_0,361,388,440,16,1,1,9,4,0,1,27,52,79
p_203,0,12,e_0,364,388,440,15,1,1,8,4,0,1,24,52,76
p_204,0,14,e_0,363,388,448,16,1,1,8,4,0,1,25,60,85
p_179,0,8,e_2,400,416,450,15,0,0,5,4,0,1,16,34,50
p_202,0,15,e_0,365,388,453,15,0,0,7,4,0,1,23,65,88
p_199,0,15,e_0,368,388,453,15,0,0,6,4,0,1,20,65,85
p_195,0,15,e_0,372,388,453,15,0,0,5,4,0,1,16,65,81
p_177,0,9,e_2,402,416,455,15,0,0,4,4,0,1,14,39,53
p_185,0,10,e_2,391,416,460,15,0,0,8,4,0,1,25,44,69
p_216,0,1,e_1,347,456,463,19,3,3,3,4,0,1,109,7,116
p_173,0,11,e_2,407,416,465,15,0,0,3,4,0,1,9,49,58
p_187,0,12,e_2,389,416,470,15,0,0,8,3,0,0,27,54,81
p_184,0,12,e_2,392,416,470,15,0,0,8,4,0,1,24,54,78
p_214,0,3,e_1,349,456,471,19,3,3,2,4,0,1,107,15,122
p_165,0,4,e_1,417,456,476,15,0,0,13,4,0,1,39,20,59
p_175,0,14,e_2,405,416,478,15,0,0,3,4,0,1,11,62,73
p_174,0,14,e_2,406,416,478,15,0,0,3,4,0,1,10,62,72
p_219,0,5,e_1,342,456,481,20,4,4,4,4,0,1,114,25,139
p_181,0,15,e_2,398,416,483,15,0,0,6,4,0,1,18,67,85
p_210,0,6,e_1,354,456,486,18,2,2,0,4,0,1,102,30,132
p_217,0,7,e_1,346,456,491,19,4,4,3,4,0,1,110,35,145
p_212,0,7,e_1,351,456,491,18,3,3,1,4,0,1,105,35,140
p_163,0,10,e_1,419,456,502,15,0,0,12,4,0,1,37,46,83
p_190,0,1,e_0,379,500,507,15,0,0,3,4,0,1,121,7,128
p_218,0,11,e_1,343,456,507,20,4,4,4,4,0,1,113,51,164
p_164,0,11,e_1,418,456,507,15,0,0,12,4,0,1,38,51,89
p_162,0,11,e_1,420,456,507,15,0,0,12,4,0,1,36,51,87
p_166,0,12,e_1,416,456,512,15,0,0,13,4,0,1,40,56,96
p_143,0,3,e_0,456,500,515,15,0,0,14,4,0,1,44,15,59
p_136,0,3,e_0,465,500,515,15,0,0,11,4,0,1,35,15,50
p_137,0,4,e_0,464,500,520,15,0,0,12,4,0,1,36,20,56
p_215,0,15,e_1,348,456,523,19,3,3,2,4,0,1,108,67,175
p_213,0,15,e_1,350,456,523,19,3,3,2,4,0,1,106,67,173
p_211,0,15,e_1,353,456,523,18,2,2,1,4,0,1,103,67,170
p_141,0,6,e_0,458,500,528,15,0,0,14,4,0,1,42,28,70
p_167,0,1,e_2,413,530,535,15,0,0,1,4,0,1,117,5,122
p_192,0,8,e_0,375,500,536,15,0,0,4,4,0,1,125,36,161
p_189,0,8,e_0,382,500,536,15,0,0,2,4,0,1,118,36,154
p_140,0,8,e_0,459,500,536,15,0,0,13,4,0,1,41,36,77
p_142,0,9,e_0,457,500,541,15,0,0,14,4,0,1,43,41,84
p_106,0,3,e_2,500,530,543,15,0,0,10,4,0,1,30,13,43
p_191,0,10,e_0,376,500,546,15,0,0,4,4,0,1,124,46,170
p_139,0,10,e_0,461,500,546,15,0,0,13,4,0,1,39,46,85
p_135,0,10,e_0,466,500,546,15,0,0,11,4,0,1,34,46,80
p_193,0,11,e_0,374,500,551,15,0,0,4,4,0,1,126,51,177
p_138,0,11,e_0,463,500,551,15,0,0,12,4,0,1,37,51,88
p_99,0,6,e_2,514,530,554,15,0,0,5,4,0,1,16,24,40
p_188,0,13,e_0,384,500,559,15,0,0,1,4,0,1,116,59,175
p_102,0,7,e_2,509,530,559,15,0,0,7,4,0,1,21,29,50
p_98,0,7,e_2,515,530,559,15,0,0,5,4,0,1,15,29,44
p_101,0,8,e_2,511,530,564,15,0,0,6,4,0,1,19,34,53
p_169,0,9,e_2,411,530,569,15,0,0,1,4,0,1,119,39,158
p_100,0,9,e_2,513,530,569,15,0,0,5,4,0,1,17,39,56
p_161,0,1,e_1,421,570,577,15,0,0,11,4,0,1,149,7,156
p_158,0,1,e_1,430,570,577,15,0,0,8,4,0,1,140,7,147
p_103,0,11,e_2,508,530,577,15,0,0,7,4,0,1,22,47,69
p_105,0,12,e_2,502,530,582,15,0,0,9,4,0,1,28,52,80
p_171,0,13,e_2,409,530,587,15,0,0,2,4,0,1,121,57,178
p_168,0,13,e_2,412,530,587,15,0,0,1,4,0,1,118,57,175
p_170,0,14,e_2,410,530,592,15,0,0,2,4,0,1,120,62,182
p_104,0,14,e_2,503,530,592,15,0,0,9,4,0,1,27,62,89
p_159,0,6,e_1,429,570,594,15,0,0,9,4,0,1,141,24,165
p_150,0,6,e_1,443,570,594,15,0,0,4,4,0,1,127,24,151
p_172,0,15,e_2,408,530,597,15,0,0,2,4,0,1,122,67,189
p_154,0,7,e_1,436,570,599,15,0,0,6,4,0,1,134,29,163
p_148,0,8,e_1,449,570,604,15,0,0,2,4,0,1,121,34,155
p_130,0,1,e_0,472,600,605,15,0,0,9,4,0,1,128,5,133
p_153,0,9,e_1,437,570,609,15,0,0,6,4,0,1,133,39,172
p_147,0,9,e_1,452,570,609,15,0,0,1,4,0,1,118,39,157
p_129,0,3,e_0,473,600,613,15,0,0,9,4,0,1,127,13,140
p_157,0,14,e_1,431,570,626,15,0,0,8,4,0,1,139,56,195
p_155,0,14,e_1,435,570,626,15,0,0,7,4,0,1,135,56,191
p_124,0,7,e_0,478,600,627,15,0,0,7,4,0,1,122,27,149
p_160,0,15,e_1,426,570,631,15,0,0,10,4,0,1,144,61,205
p_156,0,15,e_1,434,570,631,15,0,0,7,4,0,1,136,61,197
p_152,0,15,e_1,441,570,631,15,0,0,5,4,0,1,129,61,190
p_151,0,15,e_1,442,570,631,15,0,0,4,4,0,1,128,61,189
p_149,0,15,e_1,444,570,631,15,0,0,4,4,0,1,126,61,187
p_127,0,10,e_0,475,600,638,15,0,0,8,4,0,1,125,38,163
p_132,0,11,e_0,470,600,643,15,0,0,10,4,0,1,130,43,173
p_128,0,11,e_0,474,600,643,15,0,0,8,4,0,1,126,43,169
p_123,0,11,e_0,479,600,643,15,0,0,7,4,0,1,121,43,164
p_121,0,11,e_0,481,600,643,15,0,0,6,4,0,1,119,43,162
p_120,0,11,e_0,482,600,643,15,0,0,6,4,0,1,118,43,161
p_133,0,12,e_0,469,600,648,15,0,0,10,4,0,1,131,48,179
p_126,0,12,e_0,476,600,648,15,0,0,8,4,0,1,124,48,172
p_96,0,1,e_2,517,644,649,15,0,0,4,4,0,1,127,5,132
p_131,0,14,e_0,471,600,656,15,0,0,9,4,0,1,129,56,185
p_125,0,14,e_0,477,600,656,15,0,0,7,4,0,1,123,56,179
p_92,0,4,e_2,525,644,660,15,0,0,1,4,0,1,119,16,135
p_134,0,15,e_0,467,600,661,15,0,0,11,4,0,1,133,61,194
p_122,0,15,e_0,480,600,661,15,0,0,6,4,0,1,120,61,181
p_94,0,6,e_2,519,644,668,15,0,0,3,4,0,1,125,24,149
p_97,0,7,e_2,516,644,673,15,0,0,4,4,0,1,128,29,157
p_37,0,9,e_2,615,644,681,15,0,0,9,4,0,1,29,37,66
p_35,0,9,e_2,630,644,681,15,0,0,4,4,0,1,14,37,51
p_146,0,1,e_1,453,678,685,15,0,0,1,4,0,1,225,7,232
p_41,0,11,e_2,600,644,689,15,0,0,14,4,0,1,44,45,89
p_86,0,2,e_1,544,678,690,15,0,0,8,4,0,1,134,12,146
p_91,0,12,e_2,526,644,694,15,0,0,1,4,0,1,118,50,168
p_39,0,12,e_2,607,644,694,15,0,0,12,4,0,1,37,50,87
p_93,0,13,e_2,520,644,699,15,0,0,3,4,0,1,124,55,179
p_90,0,13,e_2,527,644,699,15,0,0,1,4,0,1,117,55,172
p_40,0,13,e_2,602,644,699,15,0,0,14,4,0,1,42,55,97
p_38,0,13,e_2,608,644,699,15,0,0,12,4,0,1,36,55,91
p_36,0,13,e_2,628,644,699,15,0,0,5,4,0,1,16,55,71
p_88,0,5,e_1,538,678,701,15,0,0,10,4,0,1,140,23,163
p_95,0,14,e_2,518,644,704,15,0,0,4,4,0,1,126,60,186
p_80,0,7,e_1,552,678,709,15,0,0,6,4,0,1,126,31,157
p_119,0,1,e_0,483,708,713,15,0,0,5,4,0,1,225,5,230
p_113,0,1,e_0,489,708,713,15,0,0,3,4,0,1,219,5,224
p_65,0,1,e_0,573,708,713,15,0,0,9,4,0,1,135,5,140
p_87,0,8,e_1,539,678,714,15,0,0,10,4,0,1,139,36,175
p_83,0,8,e_1,549,678,714,15,0,0,7,4,0,1,129,36,165
p_144,0,9,e_1,455,678,719,15,0,0,0,3,0,0,223,41,264
p_89,0,9,e_1,535,678,719,15,0,0,11,4,0,1,143,41,184
p_114,0,3,e_0,488,708,721,15,0,0,4,4,0,1,220,13,233
p_64,0,4,e_0,574,708,726,15,0,0,8,4,0,1,134,18,152
p_145,0,11,e_1,454,678,727,15,0,0,0,4,0,1,224,49,273
p_84,0,12,e_1,546,678,732,15,0,0,8,4,0,1,132,54,186
p_78,0,12,e_1,556,678,732,15,0,0,4,4,0,1,122,54,176
p_108,0,6,e_0,496,708,734,15,0,0,1,4,0,1,212,26,238
p_118,0,7,e_0,484,708,739,15,0,0,5,4,0,1,224,31,255
p_82,0,14,e_1,550,678,740,15,0,0,6,4,0,1,128,62,190
p_81,0,14,e_1,551,678,740,15,0,0,6,4,0,1,127,62,189
p_79,0,14,e_1,553,678,740,15,0,0,5,4,0,1,125,62,187
p_111,0,8,e_0,491,708,744,15,0,0,3,4,0,1,217,36,253
p_85,0,15,e_1,545,678,745,15,0,0,8,4,0,1,133,67,200
p_115,0,9,e_0,487,708,749,15,0,0,4,4,0,1,221,41,262
p_117,0,10,e_0,485,708,754,15,0,0,5,4,0,1,223,46,269
p_116,0,10,e_0,486,708,754,15,0,0,4,4,0,1,222,46,268
p_112,0,11,e_0,490,708,759,15,0,0,3,4,0,1,218,51,269
p_110,0,11,e_0,492,708,759,15,0,0,2,4,0,1,216,51,267
p_107,0,11,e_0,499,708,759,15,0,0,0,3,0,0,209,51,260
p_22,0,3,e_2,719,756,767,15,0,0,12,4,0,1,37,11,48
p_21,0,4,e_2,731,756,772,15,0,0,8,4,0,1,25,16,41
p_109,0,15,e_0,493,708,773,15,0,0,2,4,0,1,215,65,280
p_19,0,11,e_2,754,756,795,15,0,0,0,4,0,1,2,39,41
p_23,0,12,e_2,711,756,800,15,0,0,14,3,0,0,45,44,89
p_77,0,3,e_1,557,792,803,15,0,0,4,4,0,1,235,11,246
p_72,0,3,e_1,562,792,803,15,0,0,2,4,0,1,230,11,241
p_71,0,3,e_1,564,792,803,15,0,0,2,4,0,1,228,11,239
p_70,0,3,e_1,565,792,803,15,0,0,1,4,0,1,227,11,238
p_67,0,3,e_1,568,792,803,15,0,0,0,4,0,1,224,11,235
p_66,0,3,e_1,569,792,803,15,0,0,0,3,0,0,223,11,234
p_20,0,14,e_2,734,756,808,15,0,0,7,4,0,1,22,52,74
p_75,0,5,e_1,559,792,811,15,0,0,3,4,0,1,233,19,252
p_76,0,6,e_1,558,792,816,15,0,0,4,4,0,1,234,24,258
p_32,0,6,e_1,650,792,816,15,0,0,9,4,0,1,142,24,166
p_74,0,7,e_1,560,792,821,15,0,0,3,4,0,1,232,29,261
p_55,0,3,e_0,585,820,831,15,0,0,5,4,0,1,235,11,246
p_54,0,3,e_0,586,820,831,15,0,0,4,4,0,1,234,11,245
p_52,0,3,e_0,588,820,831,15,0,0,4,4,0,1,232,11,243
p_73,0,11,e_1,561,792,835,15,0,0,3,4,0,1,231,43,274
p_34,0,12,e_1,646,792,840,15,0,0,10,4,0,1,146,48,194
p_61,0,6,e_0,579,820,842,15,0,0,7,4,0,1,241,22,263
p_56,0,6,e_0,584,820,842,15,0,0,5,4,0,1,236,22,258
p_68,0,13,e_1,567,792,845,15,0,0,1,4,0,1,225,53,278
p_50,0,7,e_0,590,820,847,15,0,0,3,4,0,1,230,27,257
p_69,0,14,e_1,566,792,850,15,0,0,1,4,0,1,226,58,284
p_53,0,9,e_0,587,820,855,15,0,0,4,4,0,1,233,35,268
p_51,0,9,e_0,589,820,855,15,0,0,3,4,0,1,231,35,266
p_33,0,15,e_1,649,792,855,15,0,0,9,4,0,1,143,63,206
p_60,0,10,e_0,580,820,860,15,0,0,6,4,0,1,240,40,280
p_58,0,11,e_0,582,820,865,15,0,0,6,4,0,1,238,45,283
p_57,0,11,e_0,583,820,865,15,0,0,5,4,0,1,237,45,282
p_63,0,13,e_0,577,820,873,15,0,0,7,4,0,1,243,53,296
p_62,0,13,e_0,578,820,873,15,0,0,7,4,0,1,242,53,295
p_59,0,14,e_0,581,820,878,15,0,0,6,4,0,1,239,58,297
p_49,0,14,e_0,591,820,878,15,0,0,3,4,0,1,229,58,287
p_9,0,2,e_2,846,880,888,15,0,0,11,4,0,1,34,8,42
p_6,0,3,e_2,877,880,893,15,0,0,1,4,0,1,3,13,16
p_7,0,5,e_2,875,880,901,15,0,0,1,4,0,1,5,21,26
p_4,0,1,e_1,886,902,907,15,0,0,5,4,0,1,16,5,21
p_16,0,2,e_1,780,902,912,15,0,0,4,4,0,1,122,10,132
p_10,0,8,e_2,835,880,912,15,0,0,14,3,0,0,45,32,77
p_30,0,3,e_1,668,902,917,15,0,0,3,4,0,1,234,15,249
p_8,0,11,e_2,874,880,923,15,0,0,2,4,0,1,6,43,49
p_29,0,5,e_1,670,902,925,15,0,0,2,4,0,1,232,23,255
p_1,0,5,e_1,894,902,925,15,0,0,2,4,0,1,8,23,31
p_45,0,2,e_0,595,922,930,15,0,0,1,4,0,1,327,8,335
p_24,0,2,e_0,695,922,930,15,0,0,4,4,0,1,227,8,235
p_31,0,6,e_1,666,902,930,15,0,0,4,4,0,1,236,28,264
p_48,0,4,e_0,592,922,938,15,0,0,2,4,0,1,330,16,346
p_46,0,4,e_0,594,922,938,15,0,0,2,4,0,1,328,16,344
p_14,0,4,e_0,794,922,938,15,0,0,8,4,0,1,128,16,144
p_5,0,8,e_1,883,902,938,15,0,0,6,4,0,1,19,36,55
p_3,0,8,e_1,888,902,938,15,0,0,4,4,0,1,14,36,50
p_42,0,6,e_0,598,922,946,15,0,0,0,4,0,1,324,24,348
p_27,0,10,e_1,677,902,946,15,0,0,0,3,0,0,225,44,269
p_18,0,10,e_1,766,902,946,15,0,0,8,4,0,1,136,44,180
p_17,0,10,e_1,776,902,946,15,0,0,5,4,0,1,126,44,170
p_43,0,7,e_0,597,922,951,15,0,0,1,4,0,1,325,29,354
p_28,0,11,e_1,676,902,951,15,0,0,0,4,0,1,226,49,275
p_2,0,11,e_1,892,902,951,15,0,0,3,4,0,1,10,49,59
p_44,0,8,e_0,596,922,956,15,0,0,1,4,0,1,326,34,360
p_26,0,8,e_0,684,922,956,15,0,0,8,4,0,1,238,34,272
p_25,0,8,e_0,686,922,956,15,0,0,7,4,0,1,236,34,270
p_47,0,9,e_0,593,922,961,15,0,0,2,4,0,1,329,39,368
p_15,0,9,e_0,793,922,961,15,0,0,9,4,0,1,129,39,168
p_11,0,9,e_0,807,922,961,15,0,0,4,4,0,1,115,39,154
p_13,0,11,e_0,796,922,969,15,0,0,8,4,0,1,126,47,173
p_12,0,11,e_0,798,922,969,15,0,0,7,4,0,1,124,47,171
p_300,0,4,e_0,8,9,25,0,0,0,0,3,0,0,1,16,17
p_299,0,5,e_1,9,10,29,0,0,0,0,3,0,0,1,19,20
p_297,0,6,e_3,15,16,38,0,0,0,0,3,0,0,1,22,23
p_298,0,9,e_2,11,12,43,0,0,0,0,3,0,0,1,31,32
p_296,0,4,e_0,28,43,57,9,1,1,4,3,0,0,15,14,29
p_286,0,3,e_1,46,47,60,6,0,0,0,3,0,0,1,13,14
p_292,0,6,e_0,38,43,65,6,0,0,1,4,0,1,5,22,27
p_290,0,6,e_0,40,43,65,6,0,0,1,4,0,1,3,22,25
p_289,0,4,e_1,43,47,65,6,0,0,1,4,0,1,4,18,22
p_295,0,5,e_1,29,47,70,9,1,1,5,3,0,0,18,23,41
p_287,0,5,e_1,45,47,70,6,0,0,0,4,0,1,2,23,25
p_288,0,8,e_1,44,47,81,6,0,0,1,4,0,1,3,34,37
p_281,0,1,e_3,73,74,81,0,0,0,0,3,0,0,1,7,8
p_291,0,11,e_0,39,43,82,6,0,0,1,4,0,1,4,39,43
p_294,0,12,e_0,31,43,87,8,1,1,4,4,0,1,12,44,56
p_293,0,12,e_0,33,43,87,7,1,1,3,4,0,1,10,44,54
p_285,0,4,e_3,53,74,92,6,0,0,6,3,0,0,21,18,39
p_284,0,4,e_3,54,74,92,6,1,0,6,4,0,1,20,18,38
p_282,0,7,e_3,66,74,103,2,1,0,2,4,0,1,8,29,37
p_283,0,9,e_3,57,74,111,5,1,0,5,4,0,1,17,37,54
p_278,0,2,e_2,77,105,113,18,4,4,9,4,0,1,28,8,36
p_279,0,5,e_2,76,105,124,18,4,4,9,4,0,1,29,19,48
p_277,0,6,e_1,82,109,129,17,3,3,8,3,0,0,27,20,47
p_274,0,8,e_2,88,105,135,15,3,3,5,4,0,1,17,30,47
p_271,0,1,e_3,121,140,145,6,1,0,6,4,0,1,19,5,24
p_276,0,11,e_2,84,105,146,16,3,3,7,4,0,1,21,41,62
p_273,0,4,e_3,110,140,156,9,0,0,9,2,1,0,30,16,46
p_280,0,14,e_2,75,105,157,18,4,4,9,3,0,0,30,52,82
p_275,0,14,e_2,86,105,157,16,3,3,6,4,0,1,19,52,71
p_267,0,1,e_1,148,165,172,18,3,3,5,4,0,1,17,7,24
p_270,0,9,e_3,122,140,173,6,1,0,6,4,0,1,18,33,51
p_269,0,9,e_3,127,140,173,4,1,0,4,4,0,1,13,33,46
p_268,0,2,e_1,144,165,177,19,3,3,6,3,0,0,21,12,33
p_272,0,10,e_3,113,140,178,9,1,0,9,4,0,1,27,38,65
p_265,0,4,e_1,152,165,185,17,3,3,4,4,0,1,13,20,33
p_262,0,5,e_1,157,165,190,16,2,2,2,4,0,1,8,25,33
p_261,0,5,e_1,164,165,190,14,2,2,0,3,0,0,1,25,26
p_266,0,6,e_1,151,165,195,17,3,3,4,4,0,1,14,30,44
p_263,0,7,e_1,154,165,200,16,3,3,3,4,0,1,11,35,46
p_264,0,11,e_1,153,165,214,17,3,3,4,4,0,1,12,49,61
p_255,0,3,e_0,184,204,215,10,0,0,6,4,0,1,20,11,31
p_254,0,4,e_0,187,204,220,10,0,0,5,4,0,1,17,16,33
p_253,0,5,e_0,190,204,225,10,0,0,4,4,0,1,14,21,35
p_260,0,7,e_0,165,204,233,13,2,2,12,3,0,0,39,29,68
p_258,0,7,e_0,168,204,233,12,2,2,12,4,0,1,36,29,65
p_256,0,10,e_0,182,204,244,10,0,0,7,4,0,1,22,40,62
p_250,0,2,e_3,217,238,246,7,1,0,7,4,0,1,21,8,29
p_252,0,5,e_3,205,238,257,10,0,0,10,3,0,0,33,19,52
p_257,0,14,e_0,169,204,258,12,2,2,11,4,0,1,35,54,89
p_259,0,15,e_0,167,204,263,13,2,2,12,4,0,1,37,59,96
p_251,0,15,e_3,209,238,289,9,1,0,9,4,0,1,29,51,80
p_248,0,5,e_1,246,275,292,28,2,2,9,4,0,1,29,17,46
p_247,0,5,e_1,250,275,292,27,2,2,8,4,0,1,25,17,42
p_249,0,6,e_1,239,275,297,30,3,3,11,3,0,0,36,22,58
p_245,0,7,e_1,269,275,302,21,1,1,2,4,0,1,6,27,33
p_246,0,10,e_1,262,275,313,24,1,1,4,4,0,1,13,38,51
p_244,0,12,e_1,271,275,321,21,1,1,1,4,0,1,4,46,50
p_241,0,1,e_2,283,322,327,17,1,1,13,4,0,1,39,5,44
p_236,0,1,e_2,305,322,327,15,0,0,5,4,0,1,17,5,22
p_233,0,1,e_2,311,322,327,15,0,0,3,4,0,1,11,5,16
p_243,0,15,e_1,272,275,332,20,1,1,1,4,0,1,3,57,60
p_230,0,3,e_2,319,322,335,15,0,0,1,4,0,1,3,13,16
p_232,0,5,e_2,314,322,343,15,0,0,2,4,0,1,8,21,29
p_237,0,7,e_2,304,322,351,15,0,0,6,4,0,1,18,29,47
p_231,0,7,e_2,317,322,351,15,0,0,1,4,0,1,5,29,34
p_242,0,8,e_2,277,322,356,19,1,1,14,3,0,0,45,34,79
p_235,0,8,e_2,308,322,356,15,0,0,4,4,0,1,14,34,48
p_234,0,8,e_2,310,322,356,15,0,0,4,4,0,1,12,34,46
p_240,0,9,e_2,301,322,361,15,0,0,7,4,0,1,21,39,60
p_239,0,11,e_2,302,322,369,15,0,0,6,4,0,1,20,47,67
p_238,0,13,e_2,303,322,377,15,0,0,6,4,0,1,19,55,74
p_229,0,13,e_2,320,322,377,15,0,0,0,4,0,1,2,55,57
p_216,0,1,e_0,347,373,380,9,1,0,8,4,0,1,26,7,33
p_226,0,2,e_0,329,373,385,15,1,0,14,4,0,1,44,12,56
p_223,0,2,e_0,336,373,385,13,1,0,12,4,0,1,37,12,49
p_214,0,3,e_0,349,373,390,8,1,0,8,4,0,1,24,17,41
p_228,0,4,e_0,325,373,395,15,0,0,15,3,0,0,48,22,70
p_224,0,5,e_1,331,379,396,14,1,0,15,2,1,0,48,17,65
p_194,0,6,e_3,373,375,397,0,1,0,0,4,0,1,2,22,24
p_225,0,5,e_0,330,373,400,15,1,0,14,4,0,1,43,27,70
p_222,0,5,e_0,337,373,400,12,1,0,12,4,0,1,36,27,63
p_219,0,5,e_0,342,373,400,11,1,0,10,4,0,1,31,27,58
p_221,0,6,e_0,339,373,405,12,1,0,11,4,0,1,34,32,66
p_220,0,6,e_0,341,373,405,11,1,0,10,4,0,1,32,32,64
p_192,0,8,e_1,375,379,407,24,4,4,1,4,0,1,4,28,32
p_217,0,7,e_0,346,373,410,9,1,0,9,4,0,1,27,37,64
p_212,0,7,e_0,351,373,410,8,1,0,7,4,0,1,22,37,59
p_193,0,11,e_3,374,375,414,0,0,0,0,3,0,0,1,39,40
p_191,0,10,e_1,376,379,415,24,3,3,1,4,0,1,3,36,39
p_227,0,12,e_3,327,375,419,15,0,0,15,3,0,0,48,44,92
p_218,0,11,e_0,343,373,424,10,1,0,10,4,0,1,30,51,81
p_190,0,1,e_2,379,421,428,24,3,3,13,3,0,0,42,7,49
p_183,0,1,e_2,396,421,428,18,2,2,8,4,0,1,25,7,32
p_182,0,2,e_2,397,421,433,18,2,2,8,4,0,1,24,12,36
p_180,0,2,e_2,399,421,433,18,2,2,7,4,0,1,22,12,34
p_215,0,15,e_0,348,373,438,9,1,0,8,4,0,1,25,65,90
p_213,0,15,e_0,350,373,438,8,1,0,7,4,0,1,23,65,88
p_178,0,3,e_2,401,421,438,17,2,2,6,4,0,1,20,17,37
p_186,0,4,e_2,390,421,443,20,3,3,10,4,0,1,31,22,53
p_176,0,4,e_2,403,421,443,16,2,2,6,4,0,1,18,22,40
p_189,0,8,e_2,382,421,457,23,3,3,13,4,0,1,39,36,75
p_179,0,8,e_2,400,421,457,17,2,2,7,4,0,1,21,36,57
p_161,0,1,e_1,421,454,461,12,0,0,10,3,0,0,33,7,40
p_158,0,1,e_1,430,454,461,12,0,0,8,4,0,1,24,7,31
p_177,0,9,e_2,402,421,462,17,2,2,6,4,0,1,19,41,60
p_185,0,10,e_2,391,421,467,20,3,3,10,4,0,1,30,46,76
p_187,0,12,e_2,389,421,475,20,3,3,10,4,0,1,32,54,86
p_184,0,12,e_2,392,421,475,19,3,3,9,4,0,1,29,54,83
p_159,0,6,e_1,429,454,478,12,0,0,8,4,0,1,25,24,49
p_150,0,6,e_1,443,454,478,12,0,0,3,4,0,1,11,24,35
p_188,0,13,e_2,384,421,480,22,3,3,12,4,0,1,37,59,96
p_154,0,7,e_1,436,454,483,12,0,0,6,4,0,1,18,29,47
p_148,0,8,e_1,449,454,488,12,0,0,1,4,0,1,5,34,39
p_181,0,15,e_2,398,421,488,18,2,2,7,4,0,1,23,67,90
p_153,0,9,e_1,437,454,493,12,0,0,5,4,0,1,17,39,56
p_147,0,9,e_1,452,454,493,12,0,0,0,4,0,1,2,39,41
p_209,0,2,e_0,357,485,495,6,1,0,5,4,0,1,128,10,138
p_205,0,2,e_0,362,485,495,4,1,0,3,4,0,1,123,10,133
p_200,0,4,e_0,367,485,503,2,1,0,2,4,0,1,118,18,136
p_201,0,5,e_0,366,485,508,3,1,0,2,4,0,1,119,23,142
p_157,0,14,e_1,431,454,510,12,0,0,7,4,0,1,23,56,79
p_155,0,14,e_1,435,454,510,12,0,0,6,4,0,1,19,56,75
p_210,0,6,e_0,354,485,513,7,1,0,6,4,0,1,131,28,159
p_208,0,6,e_0,358,485,513,5,1,0,5,4,0,1,127,28,155
p_160,0,15,e_1,426,454,515,12,0,0,9,4,0,1,28,61,89
p_156,0,15,e_1,434,454,515,12,0,0,6,4,0,1,20,61,81
p_152,0,15,e_1,441,454,515,12,0,0,4,4,0,1,13,61,74
p_151,0,15,e_1,442,454,515,12,0,0,4,4,0,1,12,61,73
p_149,0,15,e_1,444,454,515,12,0,0,3,4,0,1,10,61,71
p_198,0,9,e_0,369,485,524,2,1,0,1,4,0,1,116,39,155
p_197,0,10,e_0,370,485,529,1,1,0,1,4,0,1,115,44,159
p_113,0,1,e_3,489,524,529,11,1,0,11,4,0,1,35,5,40
p_207,0,11,e_0,359,485,534,5,1,0,4,4,0,1,126,49,175
p_114,0,3,e_3,488,524,537,12,1,0,12,4,0,1,36,13,49
p_106,0,3,e_3,500,524,537,8,1,0,8,4,0,1,24,13,37
p_206,0,12,e_0,361,485,539,4,1,0,4,4,0,1,124,54,178
p_203,0,12,e_0,364,485,539,3,1,0,3,4,0,1,121,54,175
p_167,0,1,e_2,413,535,540,13,1,1,2,4,0,1,122,5,127
p_204,0,14,e_0,363,485,547,4,1,0,3,4,0,1,122,62,184
p_108,0,6,e_3,496,524,548,9,1,0,9,4,0,1,28,24,52
p_165,0,4,e_2,417,535,551,12,1,1,1,4,0,1,118,16,134
p_92,0,4,e_2,525,535,551,30,10,10,3,4,0,1,10,16,26
p_211,0,15,e_0,353,485,552,7,1,0,6,4,0,1,132,67,199
p_202,0,15,e_0,365,485,552,3,1,0,2,4,0,1,120,67,187
p_199,0,15,e_0,368,485,552,2,1,0,1,4,0,1,117,67,184
p_111,0,8,e_3,491,524,556,11,1,0,11,4,0,1,33,32,65
p_115,0,9,e_3,487,524,561,12,1,0,12,4,0,1,37,37,74
p_117,0,10,e_3,485,524,566,12,0,0,12,3,0,0,39,42,81
p_116,0,10,e_3,486,524,566,12,1,0,12,4,0,1,38,42,80
p_169,0,9,e_2,411,535,568,14,2,2,3,4,0,1,124,33,157
p_146,0,1,e_1,453,562,569,12,0,0,0,3,0,0,109,7,116
p_112,0,11,e_3,490,524,571,11,1,0,11,4,0,1,34,47,81
p_110,0,11,e_3,492,524,571,10,1,0,10,4,0,1,32,47,79
p_107,0,11,e_3,499,524,571,8,1,0,8,4,0,1,25,47,72
p_103,0,11,e_3,508,524,571,5,1,0,5,4,0,1,16,47,63
p_163,0,10,e_2,419,535,573,12,0,0,0,4,0,1,116,38,154
p_86,0,2,e_1,544,562,574,25,9,9,6,4,0,1,18,12,30
p_105,0,12,e_3,502,524,576,7,1,0,7,4,0,1,22,52,74
p_173,0,11,e_2,407,535,578,15,2,2,4,4,0,1,128,43,171
p_164,0,11,e_2,418,535,578,12,0,0,1,4,0,1,117,43,160
p_162,0,11,e_2,420,535,578,12,0,0,0,3,0,0,115,43,158
p_77,0,3,e_1,557,562,579,22,7,7,1,4,0,1,5,17,22
p_166,0,12,e_2,416,535,583,13,1,1,1,4,0,1,119,48,167
p_104,0,14,e_3,503,524,584,7,1,0,7,4,0,1,21,60,81
p_88,0,5,e_1,538,562,587,27,9,9,8,4,0,1,24,25,49
p_171,0,13,e_2,409,535,588,14,2,2,4,4,0,1,126,53,179
p_168,0,13,e_2,412,535,588,13,2,2,3,4,0,1,123,53,176
p_109,0,15,e_3,493,524,589,10,1,0,10,4,0,1,31,65,96
p_76,0,6,e_1,558,562,592,22,7,7,1,4,0,1,4,30,34
p_175,0,14,e_2,405,535,593,16,2,2,5,4,0,1,130,58,188
p_174,0,14,e_2,406,535,593,15,2,2,5,4,0,1,129,58,187
p_170,0,14,e_2,410,535,593,14,2,2,3,4,0,1,125,58,183
p_80,0,7,e_1,552,562,597,23,8,8,3,4,0,1,10,35,45
p_172,0,15,e_2,408,535,598,15,2,2,4,4,0,1,127,63,190
p_87,0,8,e_1,539,562,602,27,9,9,7,4,0,1,23,40,63
p_83,0,8,e_1,549,562,602,24,8,8,4,4,0,1,13,40,53
p_89,0,9,e_1,535,562,607,27,10,10,9,4,0,1,27,45,72
p_143,0,3,e_0,456,599,612,12,0,0,9,4,0,1,143,13,156
p_136,0,3,e_0,465,599,612,12,0,0,6,4,0,1,134,13,147
p_196,0,4,e_0,371,599,617,1,1,0,0,4,0,1,228,18,246
p_137,0,4,e_0,464,599,617,12,0,0,7,4,0,1,135,18,153
p_84,0,12,e_1,546,562,618,24,9,9,5,4,0,1,16,56,72
p_78,0,12,e_1,556,562,618,22,7,7,2,4,0,1,6,56,62
p_141,0,6,e_0,458,599,625,12,0,0,9,4,0,1,141,26,167
p_82,0,14,e_1,550,562,626,24,8,8,4,4,0,1,12,64,76
p_81,0,14,e_1,551,562,626,23,8,8,3,4,0,1,11,64,75
p_79,0,14,e_1,553,562,626,23,8,8,3,4,0,1,9,64,73
p_85,0,15,e_1,545,562,631,25,9,9,5,4,0,1,17,69,86
p_140,0,8,e_0,459,599,633,12,0,0,8,4,0,1,140,34,174
p_144,0,9,e_0,455,599,638,12,0,0,10,4,0,1,144,39,183
p_142,0,9,e_0,457,599,638,12,0,0,9,4,0,1,142,39,181
p_96,0,1,e_3,517,636,641,2,1,0,2,4,0,1,119,5,124
p_139,0,10,e_0,461,599,643,12,0,0,8,4,0,1,138,44,182
p_135,0,10,e_0,466,599,643,12,0,0,6,4,0,1,133,44,177
p_145,0,11,e_0,454,599,648,12,0,0,10,4,0,1,145,49,194
p_138,0,11,e_0,463,599,648,12,0,0,7,4,0,1,136,49,185
p_133,0,12,e_0,469,599,653,12,0,0,5,4,0,1,130,54,184
p_99,0,6,e_3,514,636,658,3,1,0,3,4,0,1,122,22,144
p_94,0,6,e_3,519,636,658,1,1,0,1,4,0,1,117,22,139
p_102,0,7,e_3,509,636,663,5,1,0,5,4,0,1,127,27,154
p_98,0,7,e_3,515,636,663,3,1,0,3,4,0,1,121,27,148
p_97,0,7,e_3,516,636,663,2,1,0,2,4,0,1,120,27,147
p_195,0,15,e_0,372,599,664,1,1,0,0,3,0,0,227,65,292
p_134,0,15,e_0,467,599,664,12,0,0,6,4,0,1,132,65,197
p_101,0,8,e_3,511,636,668,4,1,0,4,4,0,1,125,32,157
p_100,0,9,e_3,513,636,673,3,1,0,3,4,0,1,123,37,160
p_37,0,9,e_3,615,636,673,7,1,0,7,4,0,1,21,37,58
p_41,0,11,e_3,600,636,681,12,1,0,12,4,0,1,36,45,81
p_91,0,12,e_2,526,645,683,30,10,10,3,4,0,1,119,38,157
p_39,0,12,e_3,607,636,686,9,1,0,9,4,0,1,29,50,79
p_90,0,13,e_2,527,645,688,29,11,11,2,4,0,1,118,43,161
p_30,0,3,e_1,668,678,691,20,6,6,3,4,0,1,10,13,23
p_93,0,13,e_3,520,636,691,1,1,0,1,4,0,1,116,55,171
p_40,0,13,e_3,602,636,691,11,1,0,11,4,0,1,34,55,89
p_38,0,13,e_3,608,636,691,9,1,0,9,4,0,1,28,55,83
p_95,0,14,e_3,518,636,696,2,1,0,2,4,0,1,118,60,178
p_75,0,5,e_1,559,678,699,21,7,7,1,4,0,1,119,21,140
p_29,0,5,e_1,670,678,699,20,6,6,2,4,0,1,8,21,29
p_32,0,6,e_1,650,678,704,24,9,9,9,4,0,1,28,26,54
p_31,0,6,e_1,666,678,704,20,7,7,4,4,0,1,12,26,38
p_74,0,7,e_1,560,678,709,21,6,6,0,4,0,1,118,31,149
p_130,0,1,e_0,472,711,716,12,0,0,4,4,0,1,239,5,244
p_119,0,1,e_0,483,711,716,12,0,0,0,4,0,1,228,5,233
p_27,0,10,e_1,677,678,720,18,5,5,0,3,0,0,1,42,43
p_129,0,3,e_0,473,711,724,12,0,0,4,4,0,1,238,13,251
p_73,0,11,e_1,561,678,725,21,6,6,0,3,0,0,117,47,164
p_28,0,11,e_1,676,678,725,18,5,5,0,4,0,1,2,47,49
p_34,0,12,e_1,646,678,730,26,9,9,10,4,0,1,32,52,84
p_124,0,7,e_0,478,711,738,12,0,0,2,4,0,1,233,27,260
p_118,0,7,e_0,484,711,738,12,0,0,0,3,0,0,227,27,254
p_33,0,15,e_1,649,678,741,25,9,9,9,4,0,1,29,63,92
p_127,0,10,e_0,475,711,749,12,0,0,3,4,0,1,236,38,274
p_22,0,3,e_3,719,740,751,7,1,0,7,4,0,1,21,11,32
p_132,0,11,e_0,470,711,754,12,0,0,5,4,0,1,241,43,284
p_128,0,11,e_0,474,711,754,12,0,0,3,4,0,1,237,43,280
p_123,0,11,e_0,479,711,754,12,0,0,2,4,0,1,232,43,275
p_121,0,11,e_0,481,711,754,12,0,0,1,4,0,1,230,43,273
p_120,0,11,e_0,482,711,754,12,0,0,1,4,0,1,229,43,272
p_21,0,4,e_3,731,740,756,3,1,0,3,4,0,1,9,16,25
p_126,0,12,e_0,476,711,759,12,0,0,3,4,0,1,235,48,283
p_131,0,14,e_0,471,711,767,12,0,0,4,4,0,1,240,56,296
p_125,0,14,e_0,477,711,767,12,0,0,2,4,0,1,234,56,290
p_122,0,15,e_0,480,711,772,12,0,0,1,4,0,1,231,61,292
p_35,0,9,e_3,630,740,773,2,1,0,2,4,0,1,110,33,143
p_23,0,12,e_3,711,740,784,9,1,0,9,4,0,1,29,44,73
p_36,0,13,e_3,628,740,789,2,1,0,2,4,0,1,112,49,161
p_20,0,14,e_3,734,740,794,2,1,0,2,4,0,1,6,54,60
p_16,0,2,e_2,780,796,804,17,3,3,5,4,0,1,16,8,24
p_14,0,4,e_2,794,796,812,14,0,0,0,4,0,1,2,16,18
p_65,0,1,e_0,573,819,824,19,4,4,8,4,0,1,246,5,251
p_15,0,9,e_2,793,796,829,14,0,0,1,4,0,1,3,33,36
p_72,0,3,e_0,562,819,832,21,6,6,12,4,0,1,257,13,270
p_71,0,3,e_0,564,819,832,20,6,6,11,4,0,1,255,13,268
p_70,0,3,e_0,565,819,832,20,5,5,11,4,0,1,254,13,267
p_67,0,3,e_0,568,819,832,20,5,5,10,4,0,1,251,13,264
p_66,0,3,e_0,569,819,832,19,5,5,10,4,0,1,250,13,263
p_18,0,10,e_2,766,796,834,21,4,4,10,4,0,1,30,38,68
p_17,0,10,e_2,776,796,834,18,3,3,6,4,0,1,20,38,58
p_64,0,4,e_0,574,819,837,18,4,4,8,4,0,1,245,18,263
p_19,0,11,e_2,754,796,839,24,5,5,13,3,0,0,42,43,85
p_61,0,6,e_0,579,819,845,17,3,3,6,4,0,1,240,26,266
p_60,0,10,e_0,580,819,859,17,3,3,6,4,0,1,239,40,279
p_58,0,11,e_0,582,819,864,16,3,3,5,4,0,1,237,45,282
p_68,0,13,e_0,567,819,872,20,5,5,10,4,0,1,252,53,305
p_63,0,13,e_0,577,819,872,18,3,3,7,4,0,1,242,53,295
p_62,0,13,e_0,578,819,872,18,3,3,7,4,0,1,241,53,294
p_69,0,14,e_0,566,819,877,20,5,5,11,4,0,1,253,58,311
p_59,0,14,e_0,581,819,877,17,3,3,6,4,0,1,238,58,296
p_9,0,2,e_2,846,882,890,11,1,0,11,3,0,0,36,8,44
p_6,0,3,e_2,877,882,895,1,1,0,1,4,0,1,5,13,18
p_7,0,5,e_3,875,880,897,1,1,0,1,4,0,1,5,17,22
p_10,0,8,e_3,835,880,908,14,0,0,14,3,0,0,45,28,73
p_8,0,11,e_2,874,882,921,2,1,0,2,4,0,1,8,39,47
p_45,0,2,e_0,595,921,929,13,1,0,1,4,0,1,326,8,334
p_55,0,3,e_0,585,921,934,16,2,2,4,4,0,1,336,13,349
p_54,0,3,e_0,586,921,934,16,2,2,4,4,0,1,335,13,348
p_52,0,3,e_0,588,921,934,15,1,1,3,4,0,1,333,13,346
p_48,0,4,e_0,592,921,939,14,1,0,2,4,0,1,329,18,347
p_46,0,4,e_0,594,921,939,14,1,0,1,4,0,1,327,18,345
p_56,0,6,e_0,584,921,947,16,2,2,5,4,0,1,337,26,363
p_50,0,7,e_0,590,921,952,15,1,0,3,4,0,1,331,31,362
p_43,0,7,e_0,597,921,952,13,1,0,0,4,0,1,324,31,355
p_44,0,8,e_0,596,921,957,13,1,0,1,4,0,1,325,36,361
p_53,0,9,e_0,587,921,962,15,2,2,4,4,0,1,334,41,375
p_51,0,9,e_0,589,921,962,15,1,0,3,4,0,1,332,41,373
p_47,0,9,e_0,593,921,962,14,1,0,2,4,0,1,328,41,369
p_57,0,11,e_0,583,921,970,16,2,2,5,4,0,1,338,49,387
p_49,0,14,e_0,591,921,981,15,1,0,2,4,0,1,330,60,390
p_4,0,1,e_0,886,1025,1030,14,2,2,11,4,0,1,139,5,144
p_24,0,2,e_0,695,1025,1035,14,1,1,5,4,0,1,330,10,340
p_1,0,5,e_0,894,1025,1046,12,2,2,9,4,0,1,131,21,152
p_42,0,6,e_0,598,1025,1051,12,1,0,0,3,0,0,427,26,453
p_26,0,8,e_0,684,1025,1059,16,4,4,9,4,0,1,341,34,375
p_25,0,8,e_0,686,1025,1059,16,3,3,8,4,0,1,339,34,373
p_5,0,8,e_0,883,1025,1059,15,2,2,12,4,0,1,142,34,176
p_3,0,8,e_0,888,1025,1059,14,2,2,11,4,0,1,137,34,171
p_11,0,9,e_0,807,1025,1064,14,0,0,4,4,0,1,218,39,257
p_13,0,11,e_0,796,1025,1072,14,0,0,7,4,0,1,229,47,276
p_12,0,11,e_0,798,1025,1072,14,0,0,7,4,0,1,227,47,274
p_2,0,11,e_0,892,1025,1072,12,2,2,9,4,0,1,133,47,180
p_300,0,4,e_0,8,9,25,0,0,0,0,3,0,0,1,16,17
p_299,0,5,e_1,9,10,29,0,0,0,0,3,0,0,1,19,20
p_297,0,6,e_3,15,16,38,0,0,0,0,3,0,0,1,22,23
p_298,0,9,e_2,11,12,43,0,0,0,0,3,0,0,1,31,32
p_296,0,4,e_0,28,43,57,9,1,1,4,3,0,0,15,14,29
p_286,0,3,e_1,46,47,60,6,0,0,0,3,0,0,1,13,14
p_292,0,6,e_0,38,43,65,6,0,0,1,4,0,1,5,22,27
p_290,0,6,e_0,40,43,65,6,0,0,1,4,0,1,3,22,25
p_289,0,4,e_1,43,47,65,6,0,0,1,4,0,1,4,18,22
p_295,0,5,e_1,29,47,70,9,1,1,5,3,0,0,18,23,41
p_287,0,5,e_1,45,47,70,6,0,0,0,4,0,1,2,23,25
p_288,0,8,e_1,44,47,81,6,0,0,1,4,0,1,3,34,37
p_281,0,1,e_3,73,74,81,0,0,0,0,3,0,0,1,7,8
p_291,0,11,e_0,39,43,82,6,0,0,1,4,0,1,4,39,43
p_294,0,12,e_0,31,43,87,8,1,1,4,4,0,1,12,44,56
p_293,0,12,e_0,33,43,87,7,1,1,3,4,0,1,10,44,54
p_285,0,4,e_3,53,74,92,6,0,0,6,3,0,0,21,18,39
p_284,0,4,e_3,54,74,92,6,1,0,6,4,0,1,20,18,38
p_282,0,7,e_3,66,74,103,2,1,0,2,4,0,1,8,29,37
p_283,0,9,e_3,57,74,111,5,1,0,5,4,0,1,17,37,54
p_278,0,2,e_2,77,105,113,18,4,4,9,4,0,1,28,8,36
p_279,0,5,e_2,76,105,124,18,4,4,9,4,0,1,29,19,48
p_277,0,6,e_1,82,109,129,17,3,3,8,3,0,0,27,20,47
p_274,0,8,e_2,88,105,135,15,3,3,5,4,0,1,17,30,47
p_271,0,1,e_3,121,140,145,6,1,0,6,4,0,1,19,5,24
p_276,0,11,e_2,84,105,146,16,3,3,7,4,0,1,21,41,62
p_273,0,4,e_3,110,140,156,9,0,0,9,2,1,0,30,16,46
p_280,0,14,e_2,75,105,157,18,4,4,9,3,0,0,30,52,82
p_275,0,14,e_2,86,105,157,16,3,3,6,4,0,1,19,52,71
p_267,0,1,e_1,148,165,172,18,3,3,5,4,0,1,17,7,24
p_270,0,9,e_3,122,140,173,6,1,0,6,4,0,1,18,33,51
p_269,0,9,e_3,127,140,173,4,1,0,4,4,0,1,13,33,46
p_268,0,2,e_1,144,165,177,19,3,3,6,3,0,0,21,12,33
p_272,0,10,e_3,113,140,178,9,1,0,9,4,0,1,27,38,65
p_265,0,4,e_1,152,165,185,17,3,3,4,4,0,1,13,20,33
p_262,0,5,e_1,157,165,190,16,2,2,2,4,0,1,8,25,33
p_261,0,5,e_1,164,165,190,14,2,2,0,3,0,0,1,25,26
p_266,0,6,e_1,151,165,195,17,3,3,4,4,0,1,14,30,44
p_263,0,7,e_1,154,165,200,16,3,3,3,4,0,1,11,35,46
p_264,0,11,e_1,153,165,214,17,3,3,4,4,0,1,12,49,61
p_255,0,3,e_0,184,204,215,10,0,0,6,4,0,1,20,11,31
p_254,0,4,e_0,187,204,220,10,0,0,5,4,0,1,17,16,33
p_253,0,5,e_0,190,204,225,10,0,0,4,4,0,1,14,21,35
p_252,0,5,e_2,205,212,229,10,0,0,2,4,0,1,7,17,24
p_260,0,7,e_0,165,204,233,13,2,2,12,3,0,0,39,29,68
p_258,0,7,e_0,168,204,233,12,2,2,12,4,0,1,36,29,65
p_256,0,10,e_0,182,204,244,10,0,0,7,4,0,1,22,40,62
p_257,0,14,e_0,169,204,258,12,2,2,11,4,0,1,35,54,89
p_250,0,2,e_3,217,250,258,10,0,0,10,3,0,0,33,8,41
p_259,0,15,e_2,167,212,261,13,2,2,14,3,0,0,45,49,94
p_251,0,15,e_2,209,212,261,10,0,0,1,4,0,1,3,49,52
p_248,0,5,e_3,246,250,269,1,1,0,1,4,0,1,4,19,23
p_249,0,6,e_3,239,250,274,3,1,0,3,4,0,1,11,24,35
p_241,0,1,e_1,283,286,291,6,0,0,1,4,0,1,3,5,8
p_247,0,5,e_1,250,286,305,12,3,3,11,3,0,0,36,19,55
p_245,0,7,e_1,269,286,313,7,1,1,5,4,0,1,17,27,44
p_242,0,8,e_1,277,286,318,6,0,0,3,4,0,1,9,32,41
p_246,0,10,e_1,262,286,326,9,2,2,8,4,0,1,24,40,64
p_236,0,1,e_3,305,322,327,5,1,0,5,4,0,1,17,5,22
p_233,0,1,e_3,311,322,327,3,1,0,3,4,0,1,11,5,16
p_244,0,12,e_1,271,286,334,7,1,1,5,4,0,1,15,48,63
p_230,0,3,e_3,319,322,335,1,1,0,1,4,0,1,3,13,16
p_232,0,5,e_3,314,322,343,2,1,0,2,4,0,1,8,21,29
p_243,0,15,e_1,272,286,345,6,1,1,4,4,0,1,14,59,73
p_237,0,7,e_3,304,322,351,6,1,0,6,4,0,1,18,29,47
p_231,0,7,e_3,317,322,351,1,1,0,1,4,0,1,5,29,34
p_235,0,8,e_3,308,322,356,4,1,0,4,4,0,1,14,34,48
p_234,0,8,e_3,310,322,356,4,1,0,4,4,0,1,12,34,46
p_240,0,9,e_3,301,322,361,6,0,0,6,3,0,0,21,39,60
p_239,0,11,e_3,302,322,369,6,1,0,6,4,0,1,20,47,67
p_216,0,1,e_0,347,370,377,20,5,5,7,4,0,1,23,7,30
p_238,0,13,e_3,303,322,377,6,1,0,6,4,0,1,19,55,74
p_229,0,13,e_3,320,322,377,0,1,0,0,4,0,1,2,55,57
p_226,0,2,e_0,329,370,382,25,7,7,13,4,0,1,41,12,53
p_223,0,2,e_0,336,370,382,23,6,6,11,4,0,1,34,12,46
p_214,0,3,e_0,349,370,387,19,5,5,7,4,0,1,21,17,38
p_196,0,4,e_2,371,375,391,15,1,1,1,4,0,1,4,16,20
p_228,0,4,e_0,325,370,392,25,8,8,14,3,0,0,45,22,67
p_225,0,5,e_0,330,370,397,24,7,7,13,4,0,1,40,27,67
p_224,0,5,e_0,331,370,397,24,7,7,13,4,0,1,39,27,66
p_222,0,5,e_0,337,370,397,23,6,6,11,4,0,1,33,27,60
p_219,0,5,e_0,342,370,397,21,5,5,9,4,0,1,28,27,55
p_194,0,6,e_2,373,375,399,14,1,1,0,4,0,1,2,24,26
p_221,0,6,e_0,339,370,402,22,6,6,10,4,0,1,31,32,63
p_220,0,6,e_0,341,370,402,21,6,6,9,4,0,1,29,32,61
p_217,0,7,e_0,346,370,407,20,5,5,8,4,0,1,24,37,61
p_197,0,10,e_2,370,375,413,15,1,1,1,4,0,1,5,38,43
p_193,0,11,e_2,374,375,418,14,1,1,0,3,0,0,1,43,44
p_218,0,11,e_0,343,370,421,21,5,5,9,4,0,1,27,51,78
p_227,0,12,e_2,327,375,423,25,7,7,15,3,0,0,48,48,96
p_190,0,1,e_3,379,418,425,13,1,0,13,4,0,1,39,7,46
p_183,0,1,e_3,396,418,425,7,1,0,7,4,0,1,22,7,29
p_161,0,1,e_1,421,423,428,30,10,10,0,4,0,1,2,5,7
p_182,0,2,e_3,397,418,430,7,1,0,7,4,0,1,21,12,33
p_180,0,2,e_3,399,418,430,6,1,0,6,4,0,1,19,12,31
p_195,0,15,e_2,372,375,434,14,1,1,1,4,0,1,3,59,62
p_215,0,15,e_0,348,370,435,20,5,5,7,4,0,1,22,65,87
p_213,0,15,e_0,350,370,435,19,4,4,6,4,0,1,20,65,85
p_178,0,3,e_3,401,418,435,5,1,0,5,4,0,1,17,17,34
p_186,0,4,e_3,390,418,440,9,1,0,9,4,0,1,28,22,50
p_192,0,8,e_1,375,423,451,13,1,1,15,3,0,0,48,28,76
p_189,0,8,e_3,382,418,454,12,1,0,12,4,0,1,36,36,72
p_179,0,8,e_3,400,418,454,6,1,0,6,4,0,1,18,36,54
p_163,0,10,e_1,419,423,459,30,10,10,1,4,0,1,4,36,40
p_177,0,9,e_3,402,418,459,5,1,0,5,4,0,1,16,41,57
p_164,0,11,e_1,418,423,464,30,11,11,1,4,0,1,5,41,46
p_162,0,11,e_1,420,423,464,30,10,10,1,4,0,1,3,41,44
p_191,0,10,e_3,376,418,464,13,0,0,13,2,1,0,42,46,88
p_185,0,10,e_3,391,418,464,9,1,0,9,4,0,1,27,46,73
p_187,0,12,e_3,389,418,472,9,1,0,9,4,0,1,29,54,83
p_184,0,12,e_3,392,418,472,8,1,0,8,4,0,1,26,54,80
p_188,0,13,e_3,384,418,477,11,1,0,11,4,0,1,34,59,93
p_181,0,15,e_3,398,418,485,6,1,0,6,4,0,1,20,67,87
p_209,0,2,e_0,357,482,492,18,3,3,4,4,0,1,125,10,135
p_205,0,2,e_0,362,482,492,17,2,2,2,4,0,1,120,10,130
p_129,0,3,e_2,473,481,494,18,3,3,2,4,0,1,8,13,21
p_137,0,4,e_2,464,481,499,20,4,4,5,4,0,1,17,18,35
p_200,0,4,e_0,367,482,500,15,2,2,1,4,0,1,115,18,133
p_201,0,5,e_0,366,482,505,16,2,2,1,4,0,1,116,23,139
p_159,0,6,e_2,429,481,507,28,9,9,14,5,1,1,52,26,78
p_150,0,6,e_2,443,481,507,25,7,7,12,4,0,1,38,26,64
p_141,0,6,e_2,458,481,507,21,5,5,7,4,0,1,23,26,49
p_210,0,6,e_0,354,482,510,18,4,4,5,4,0,1,128,28,156
p_208,0,6,e_0,358,482,510,18,3,3,4,4,0,1,124,28,152
p_212,0,7,e_0,351,482,515,19,4,4,6,4,0,1,131,33,164
p_148,0,8,e_2,449,481,515,23,7,7,10,4,0,1,32,34,66
p_153,0,9,e_2,437,481,520,27,8,8,14,4,0,1,44,39,83
p_147,0,9,e_2,452,481,520,22,7,7,9,4,0,1,29,39,68
p_144,0,9,e_2,455,481,520,22,6,6,8,4,0,1,26,39,65
p_198,0,9,e_0,369,482,523,15,1,1,0,3,0,0,113,41,154
p_119,0,1,e_1,483,518,525,15,2,2,11,4,0,1,35,7,42
p_113,0,1,e_1,489,518,525,14,1,0,9,4,0,1,29,7,36
p_139,0,10,e_2,461,481,525,21,5,5,6,4,0,1,20,44,64
p_132,0,11,e_2,470,481,530,18,4,4,3,4,0,1,11,49,60
p_207,0,11,e_0,359,482,531,17,3,3,3,4,0,1,123,49,172
p_114,0,3,e_1,488,518,533,14,1,0,10,4,0,1,30,15,45
p_106,0,3,e_1,500,518,533,10,1,0,6,4,0,1,18,15,33
p_126,0,12,e_2,476,481,535,17,2,2,1,4,0,1,5,54,59
p_206,0,12,e_0,361,482,536,17,2,2,3,4,0,1,121,54,175
p_203,0,12,e_0,364,482,536,16,2,2,2,4,0,1,118,54,172
p_167,0,1,e_3,413,532,537,1,1,0,1,4,0,1,119,5,124
p_204,0,14,e_0,363,482,544,17,2,2,2,4,0,1,119,62,181
p_108,0,6,e_1,496,518,544,12,1,0,7,4,0,1,22,26,48
p_160,0,15,e_2,426,481,546,29,10,10,13,5,1,0,55,65,120
p_156,0,15,e_2,434,481,546,27,8,8,15,4,0,1,47,65,112
p_134,0,15,e_2,467,481,546,19,4,4,4,4,0,1,14,65,79
p_176,0,4,e_3,403,532,548,5,1,0,5,4,0,1,129,16,145
p_165,0,4,e_3,417,532,548,0,0,0,0,3,0,0,115,16,131
p_211,0,15,e_0,353,482,549,19,4,4,5,4,0,1,129,67,196
p_202,0,15,e_0,365,482,549,16,2,2,1,4,0,1,117,67,184
p_199,0,15,e_0,368,482,549,15,1,1,0,4,0,1,114,67,181
p_118,0,7,e_1,484,518,549,15,1,1,11,4,0,1,34,31,65
p_111,0,8,e_1,491,518,554,13,1,0,9,4,0,1,27,36,63
p_94,0,6,e_3,519,532,556,4,1,0,4,4,0,1,13,24,37
p_115,0,9,e_1,487,518,559,15,1,0,10,4,0,1,31,41,72
p_117,0,10,e_1,485,518,564,15,1,0,11,4,0,1,33,46,79
p_116,0,10,e_1,486,518,564,15,1,0,10,4,0,1,32,46,78
p_169,0,9,e_3,411,532,567,2,1,0,2,4,0,1,121,35,156
p_120,0,11,e_1,482,518,569,16,2,2,11,3,0,0,36,51,87
p_112,0,11,e_1,490,518,569,14,1,0,9,4,0,1,28,51,79
p_110,0,11,e_1,492,518,569,13,1,0,8,4,0,1,26,51,77
p_107,0,11,e_1,499,518,569,11,1,0,6,4,0,1,19,51,70
p_173,0,11,e_3,407,532,575,3,1,0,3,4,0,1,125,43,168
p_166,0,12,e_3,416,532,580,0,1,0,0,4,0,1,116,48,164
p_109,0,15,e_1,493,518,583,13,1,0,8,4,0,1,25,65,90
p_171,0,13,e_3,409,532,585,3,1,0,3,4,0,1,123,53,176
p_168,0,13,e_3,412,532,585,2,1,0,2,4,0,1,120,53,173
p_93,0,13,e_3,520,532,585,4,1,0,4,4,0,1,12,53,65
p_175,0,14,e_3,405,532,590,4,1,0,4,4,0,1,127,58,185
p_174,0,14,e_3,406,532,590,4,1,0,4,4,0,1,126,58,184
p_170,0,14,e_3,410,532,590,2,1,0,2,4,0,1,122,58,180
p_95,0,14,e_3,518,532,590,4,1,0,4,4,0,1,14,58,72
p_172,0,15,e_3,408,532,595,3,1,0,3,4,0,1,124,63,187
p_158,0,1,e_0,430,596,603,28,9,9,14,5,1,1,166,7,173
p_146,0,1,e_0,453,596,603,22,6,6,9,4,0,1,143,7,150
p_86,0,2,e_2,544,593,603,27,9,9,15,5,1,1,49,10,59
p_77,0,3,e_2,557,593,608,24,7,7,12,4,0,1,36,15,51
p_143,0,3,e_0,456,596,611,22,6,6,8,4,0,1,140,15,155
p_136,0,3,e_0,465,596,611,20,4,4,5,4,0,1,131,15,146
p_88,0,5,e_2,538,593,616,29,9,9,13,5,1,1,55,23,78
p_80,0,7,e_2,552,593,624,25,8,8,13,4,0,1,41,31,72
p_154,0,7,e_0,436,596,625,27,8,8,15,4,0,1,160,29,189
p_87,0,8,e_2,539,593,629,29,9,9,13,5,1,1,54,36,90
p_83,0,8,e_2,549,593,629,26,8,8,14,4,0,1,44,36,80
p_140,0,8,e_0,459,596,630,21,5,5,7,4,0,1,137,34,171
p_89,0,9,e_2,535,593,634,29,10,10,12,5,1,1,58,41,99
p_142,0,9,e_0,457,596,635,21,6,6,8,4,0,1,139,39,178
p_96,0,1,e_1,517,630,635,5,1,0,0,3,0,0,113,5,118
p_135,0,10,e_0,466,596,640,20,4,4,5,4,0,1,130,44,174
p_123,0,11,e_2,479,593,642,17,2,2,0,4,0,1,114,49,163
p_145,0,11,e_0,454,596,645,22,6,6,9,4,0,1,142,49,191
p_138,0,11,e_0,463,596,645,20,4,4,6,4,0,1,133,49,182
p_84,0,12,e_2,546,593,647,26,9,9,15,4,0,1,47,54,101
p_78,0,12,e_2,556,593,647,24,7,7,12,4,0,1,37,54,91
p_99,0,6,e_1,514,630,652,6,1,0,1,4,0,1,116,22,138
p_42,0,6,e_1,598,630,652,14,1,0,10,4,0,1,32,22,54
p_82,0,14,e_2,550,593,655,26,8,8,14,4,0,1,43,62,105
p_81,0,14,e_2,551,593,655,25,8,8,14,4,0,1,42,62,104
p_79,0,14,e_2,553,593,655,25,8,8,13,4,0,1,40,62,102
p_157,0,14,e_0,431,596,656,28,9,9,14,5,1,1,165,60,225
p_155,0,14,e_0,435,596,656,27,8,8,15,4,0,1,161,60,221
p_92,0,4,e_3,525,642,656,2,1,0,2,4,0,1,117,14,131
p_102,0,7,e_1,509,630,657,7,1,0,3,4,0,1,121,27,148
p_98,0,7,e_1,515,630,657,5,1,0,1,4,0,1,115,27,142
p_97,0,7,e_1,516,630,657,5,1,0,0,4,0,1,114,27,141
p_43,0,7,e_1,597,630,657,15,1,0,11,4,0,1,33,27,60
p_122,0,15,e_2,480,593,660,16,2,2,0,3,0,0,113,67,180
p_85,0,15,e_2,545,593,660,27,9,9,15,2,1,1,48,67,115
p_152,0,15,e_0,441,596,661,26,7,7,13,4,0,1,155,65,220
p_151,0,15,e_0,442,596,661,26,7,7,13,4,0,1,154,65,219
p_149,0,15,e_0,444,596,661,25,7,7,12,4,0,1,152,65,217
p_101,0,8,e_1,511,630,662,7,1,0,2,4,0,1,119,32,151
p_44,0,8,e_1,596,630,662,15,1,0,11,4,0,1,34,32,66
p_100,0,9,e_1,513,630,667,6,1,0,1,4,0,1,117,37,154
p_35,0,9,e_3,630,642,673,4,1,0,4,4,0,1,12,31,43
p_103,0,11,e_1,508,630,675,8,1,0,3,4,0,1,122,45,167
p_41,0,11,e_1,600,630,675,14,1,0,10,4,0,1,30,45,75
p_105,0,12,e_1,502,630,680,10,1,0,5,4,0,1,128,50,178
p_91,0,12,e_3,526,642,684,2,1,0,2,4,0,1,116,42,158
p_40,0,13,e_1,602,630,685,13,1,0,9,4,0,1,28,55,83
p_90,0,13,e_3,527,642,689,1,1,0,1,4,0,1,115,47,162
p_104,0,14,e_1,503,630,690,9,1,0,5,4,0,1,127,60,187
p_65,0,1,e_2,573,707,712,19,6,6,6,4,0,1,134,5,139
p_130,0,1,e_0,472,708,713,18,3,3,3,4,0,1,236,5,241
p_45,0,2,e_0,595,708,718,15,1,0,0,3,0,0,113,10,123
p_72,0,3,e_2,562,707,720,22,7,7,10,4,0,1,145,13,158
p_71,0,3,e_2,564,707,720,22,7,7,9,4,0,1,143,13,156
p_70,0,3,e_2,565,707,720,21,7,7,9,4,0,1,142,13,155
p_67,0,3,e_2,568,707,720,21,6,6,8,4,0,1,139,13,152
p_66,0,3,e_2,569,707,720,21,6,6,8,4,0,1,138,13,151
p_30,0,3,e_0,668,708,723,18,3,3,13,4,0,1,40,15,55
p_64,0,4,e_2,574,707,725,19,5,5,6,4,0,1,133,18,151
p_46,0,4,e_0,594,708,728,15,1,1,0,4,0,1,114,20,134
p_75,0,5,e_2,559,707,730,23,7,7,11,4,0,1,148,23,171
p_29,0,5,e_0,670,708,733,18,3,3,12,4,0,1,38,25,63
p_76,0,6,e_2,558,707,735,24,7,7,11,4,0,1,149,28,177
p_74,0,7,e_2,560,707,740,23,7,7,11,4,0,1,147,33,180
p_124,0,7,e_0,478,708,741,17,2,2,1,4,0,1,230,33,263
p_22,0,3,e_1,719,734,745,13,0,0,5,4,0,1,15,11,26
p_47,0,9,e_0,593,708,749,15,2,2,1,4,0,1,115,41,156
p_21,0,4,e_1,731,734,750,13,0,0,1,4,0,1,3,16,19
p_127,0,10,e_0,475,708,754,17,3,3,2,4,0,1,233,46,279
p_73,0,11,e_2,561,707,754,23,7,7,10,4,0,1,146,47,193
p_128,0,11,e_0,474,708,759,18,3,3,2,4,0,1,234,51,285
p_121,0,11,e_0,481,708,759,16,2,2,0,3,0,0,227,51,278
p_28,0,11,e_0,676,708,759,16,2,2,10,4,0,1,32,51,83
p_68,0,13,e_2,567,707,762,21,6,6,8,4,0,1,140,55,195
p_63,0,13,e_2,577,707,762,19,5,5,5,4,0,1,130,55,185
p_62,0,13,e_2,578,707,762,18,5,5,5,4,0,1,129,55,184
p_133,0,12,e_0,469,708,764,19,4,4,4,4,0,1,239,56,295
p_37,0,9,e_1,615,734,767,9,1,0,5,4,0,1,119,33,152
p_69,0,14,e_2,566,707,767,21,6,6,9,4,0,1,141,60,201
p_131,0,14,e_0,471,708,772,18,3,3,3,4,0,1,237,64,301
p_125,0,14,e_0,477,708,772,17,2,2,1,4,0,1,231,64,295
p_33,0,15,e_0,649,708,777,24,4,4,12,5,2,1,59,69,128
p_39,0,12,e_1,607,734,778,11,1,0,7,4,0,1,127,44,171
p_23,0,12,e_1,711,734,778,13,0,0,7,4,0,1,23,44,67
p_38,0,13,e_1,608,734,783,11,1,0,7,4,0,1,126,49,175
p_36,0,13,e_1,628,734,783,4,1,0,0,4,0,1,106,49,155
p_18,0,10,e_3,766,776,808,3,1,0,3,4,0,1,10,32,42
p_19,0,11,e_3,754,776,813,7,1,0,7,4,0,1,22,37,59
p_55,0,3,e_2,585,811,822,17,3,3,2,4,0,1,226,11,237
p_54,0,3,e_2,586,811,822,17,3,3,2,4,0,1,225,11,236
p_52,0,3,e_2,588,811,822,16,3,3,1,4,0,1,223,11,234
p_20,0,14,e_3,734,776,824,13,0,0,13,3,0,0,42,48,90
p_48,0,4,e_2,592,811,827,16,2,2,0,3,0,0,219,16,235
p_24,0,2,e_0,695,824,832,13,0,0,4,4,0,1,129,8,137
p_61,0,6,e_2,579,811,835,18,4,4,4,4,0,1,232,24,256
p_56,0,6,e_2,584,811,835,17,3,3,3,4,0,1,227,24,251
p_50,0,7,e_2,590,811,840,16,2,2,1,4,0,1,221,29,250
p_53,0,9,e_2,587,811,848,17,3,3,2,4,0,1,224,37,261
p_51,0,9,e_2,589,811,848,16,2,2,1,4,0,1,222,37,259
p_25,0,8,e_0,686,824,852,14,1,1,7,4,0,1,138,28,166
p_60,0,10,e_2,580,811,853,18,4,4,4,4,0,1,231,42,273
p_58,0,11,e_2,582,811,858,18,4,4,3,4,0,1,229,47,276
p_57,0,11,e_2,583,811,858,17,4,4,3,4,0,1,228,47,275
p_27,0,10,e_0,677,824,860,16,2,2,10,4,0,1,147,36,183
p_34,0,12,e_2,646,811,863,25,4,4,12,2,3,1,165,52,217
p_59,0,14,e_2,581,811,871,18,4,4,4,4,0,1,230,60,290
p_49,0,14,e_2,591,811,871,16,2,2,0,4,0,1,220,60,280
p_9,0,2,e_1,846,877,885,14,0,0,10,4,0,1,31,8,39
p_7,0,5,e_1,875,877,896,14,0,0,0,4,0,1,2,19,21
p_10,0,8,e_1,835,877,907,14,0,0,13,3,0,0,42,30,72
p_4,0,1,e_0,886,910,915,14,0,0,8,4,0,1,24,5,29
p_8,0,11,e_1,874,877,918,14,0,0,1,4,0,1,3,41,44
p_6,0,3,e_0,877,910,923,14,0,0,10,3,0,0,33,13,46
p_16,0,2,e_2,780,915,923,27,3,3,10,4,0,1,135,8,143
p_1,0,5,e_0,894,910,931,14,0,0,5,4,0,1,16,21,37
p_14,0,4,e_2,794,915,931,22,3,3,5,4,0,1,121,16,137
p_32,0,6,e_2,650,915,939,24,4,4,13,5,2,1,265,24,289
p_31,0,6,e_2,666,915,939,19,3,3,13,4,0,1,249,24,273
p_5,0,8,e_0,883,910,942,14,0,0,9,4,0,1,27,32,59
p_3,0,8,e_0,888,910,942,14,0,0,7,4,0,1,22,32,54
p_26,0,8,e_2,684,915,947,14,1,1,7,4,0,1,231,32,263
p_15,0,9,e_2,793,915,952,23,3,3,6,4,0,1,122,37,159
p_11,0,9,e_2,807,915,952,18,2,2,1,4,0,1,108,37,145
p_2,0,11,e_0,892,910,953,14,0,0,6,4,0,1,18,43,61
p_17,0,10,e_2,776,915,957,28,3,3,11,4,0,1,139,42,181
p_13,0,11,e_2,796,915,962,22,3,3,5,4,0,1,119,47,166
p_12,0,11,e_2,798,915,962,21,3,3,4,4,0,1,117,47,164
p_300,0,4,e_0,8,9,25,0,0,0,0,3,0,0,1,16,17
p_299,0,5,e_1,9,10,29,0,0,0,0,3,0,0,1,19,20
p_297,0,6,e_3,15,16,38,0,0,0,0,3,0,0,1,22,23
p_298,0,9,e_2,11,12,43,0,0,0,0,3,0,0,1,31,32
p_296,0,4,e_0,28,43,57,9,1,1,4,3,0,0,15,14,29
p_286,0,3,e_1,46,47,60,6,0,0,0,3,0,0,1,13,14
p_292,0,6,e_0,38,43,65,6,0,0,1,4,0,1,5,22,27
p_290,0,6,e_0,40,43,65,6,0,0,1,4,0,1,3,22,25
p_289,0,4,e_1,43,47,65,6,0,0,1,4,0,1,4,18,22
p_295,0,5,e_1,29,47,70,9,1,1,5,3,0,0,18,23,41
p_287,0,5,e_1,45,47,70,6,0,0,0,4,0,1,2,23,25
p_288,0,8,e_1,44,47,81,6,0,0,1,4,0,1,3,34,37
p_281,0,1,e_3,73,74,81,0,0,0,0,3,0,0,1,7,8
p_291,0,11,e_0,39,43,82,6,0,0,1,4,0,1,4,39,43
p_294,0,12,e_0,31,43,87,8,1,1,4,4,0,1,12,44,56
p_293,0,12,e_0,33,43,87,7,1,1,3,4,0,1,10,44,54
p_285,0,4,e_3,53,74,92,6,0,0,6,3,0,0,21,18,39
p_284,0,4,e_3,54,74,92,6,1,0,6,4,0,1,20,18,38
p_282,0,7,e_3,66,74,103,2,1,0,2,4,0,1,8,29,37
p_283,0,9,e_3,57,74,111,5,1,0,5,4,0,1,17,37,54
p_278,0,2,e_2,77,105,113,18,4,4,9,4,0,1,28,8,36
p_279,0,5,e_2,76,105,124,18,4,4,9,4,0,1,29,19,48
p_277,0,6,e_1,82,109,129,17,3,3,8,3,0,0,27,20,47
p_274,0,8,e_2,88,105,135,15,3,3,5,4,0,1,17,30,47
p_271,0,1,e_3,121,140,145,6,1,0,6,4,0,1,19,5,24
p_276,0,11,e_2,84,105,146,16,3,3,7,4,0,1,21,41,62
p_273,0,4,e_3,110,140,156,9,0,0,9,2,1,0,30,16,46
p_280,0,14,e_2,75,105,157,18,4,4,9,3,0,0,30,52,82
p_275,0,14,e_2,86,105,157,16,3,3,6,4,0,1,19,52,71
p_267,0,1,e_1,148,165,172,18,3,3,5,4,0,1,17,7,24
p_270,0,9,e_3,122,140,173,6,1,0,6,4,0,1,18,33,51
p_269,0,9,e_3,127,140,173,4,1,0,4,4,0,1,13,33,46
p_268,0,2,e_1,144,165,177,19,3,3,6,3,0,0,21,12,33
p_272,0,10,e_3,113,140,178,9,1,0,9,4,0,1,27,38,65
p_265,0,4,e_1,152,165,185,17,3,3,4,4,0,1,13,20,33
p_262,0,5,e_1,157,165,190,16,2,2,2,4,0,1,8,25,33
p_261,0,5,e_1,164,165,190,14,2,2,0,3,0,0,1,25,26
p_266,0,6,e_1,151,165,195,17,3,3,4,4,0,1,14,30,44
p_263,0,7,e_1,154,165,200,16,3,3,3,4,0,1,11,35,46
p_264,0,11,e_1,153,165,214,17,3,3,4,4,0,1,12,49,61
p_255,0,3,e_0,184,204,215,10,0,0,6,4,0,1,20,11,31
p_254,0,4,e_0,187,204,220,10,0,0,5,4,0,1,17,16,33
p_253,0,5,e_0,190,204,225,10,0,0,4,4,0,1,14,21,35
p_260,0,7,e_0,165,204,233,13,2,2,12,3,0,0,39,29,68
p_258,0,7,e_0,168,204,233,12,2,2,12,4,0,1,36,29,65
p_256,0,10,e_0,182,204,244,10,0,0,7,4,0,1,22,40,62
p_250,0,2,e_3,217,238,246,7,1,0,7,4,0,1,21,8,29
p_252,0,5,e_3,205,238,257,10,0,0,10,3,0,0,33,19,52
p_257,0,14,e_0,169,204,258,12,2,2,11,4,0,1,35,54,89
p_259,0,15,e_0,167,204,263,13,2,2,12,4,0,1,37,59,96
p_251,0,15,e_3,209,238,289,9,1,0,9,4,0,1,29,51,80
p_248,0,5,e_1,246,275,292,28,2,2,9,4,0,1,29,17,46
p_247,0,5,e_1,250,275,292,27,2,2,8,4,0,1,25,17,42
p_249,0,6,e_1,239,275,297,30,3,3,11,3,0,0,36,22,58
p_245,0,7,e_1,269,275,302,21,1,1,2,4,0,1,6,27,33
p_246,0,10,e_1,262,275,313,24,1,1,4,4,0,1,13,38,51
p_244,0,12,e_1,271,275,321,21,1,1,1,4,0,1,4,46,50
p_241,0,1,e_2,283,322,327,17,1,1,13,4,0,1,39,5,44
p_236,0,1,e_2,305,322,327,15,0,0,5,4,0,1,17,5,22
p_233,0,1,e_2,311,322,327,15,0,0,3,4,0,1,11,5,16
p_243,0,15,e_1,272,275,332,20,1,1,1,4,0,1,3,57,60
p_230,0,3,e_2,319,322,335,15,0,0,1,4,0,1,3,13,16
p_232,0,5,e_2,314,322,343,15,0,0,2,4,0,1,8,21,29
p_237,0,7,e_2,304,322,351,15,0,0,6,4,0,1,18,29,47
p_231,0,7,e_2,317,322,351,15,0,0,1,4,0,1,5,29,34
p_242,0,8,e_2,277,322,356,19,1,1,14,3,0,0,45,34,79
p_235,0,8,e_2,308,322,356,15,0,0,4,4,0,1,14,34,48
p_234,0,8,e_2,310,322,356,15,0,0,4,4,0,1,12,34,46
p_240,0,9,e_2,301,322,361,15,0,0,7,4,0,1,21,39,60
p_239,0,11,e_2,302,322,369,15,0,0,6,4,0,1,20,47,67
p_238,0,13,e_2,303,322,377,15,0,0,6,4,0,1,19,55,74
p_229,0,13,e_2,320,322,377,15,0,0,0,4,0,1,2,55,57
p_216,0,1,e_0,347,373,380,9,1,0,8,4,0,1,26,7,33
p_226,0,2,e_0,329,373,385,15,1,0,14,4,0,1,44,12,56
p_223,0,2,e_0,336,373,385,13,1,0,12,4,0,1,37,12,49
p_214,0,3,e_0,349,373,390,8,1,0,8,4,0,1,24,17,41
p_228,0,4,e_0,325,373,395,15,0,0,15,3,0,0,48,22,70
p_224,0,5,e_1,331,379,396,14,1,0,15,2,1,0,48,17,65
p_194,0,6,e_3,373,375,397,0,1,0,0,4,0,1,2,22,24
p_225,0,5,e_0,330,373,400,15,1,0,14,4,0,1,43,27,70
p_222,0,5,e_0,337,373,400,12,1,0,12,4,0,1,36,27,63
p_219,0,5,e_0,342,373,400,11,1,0,10,4,0,1,31,27,58
p_221,0,6,e_0,339,373,405,12,1,0,11,4,0,1,34,32,66
p_220,0,6,e_0,341,373,405,11,1,0,10,4,0,1,32,32,64
p_192,0,8,e_1,375,379,407,24,4,4,1,4,0,1,4,28,32
p_217,0,7,e_0,346,373,410,9,1,0,9,4,0,1,27,37,64
p_212,0,7,e_0,351,373,410,8,1,0,7,4,0,1,22,37,59
p_193,0,11,e_3,374,375,414,0,0,0,0,3,0,0,1,39,40
p_191,0,10,e_1,376,379,415,24,3,3,1,4,0,1,3,36,39
p_227,0,12,e_3,327,375,419,15,0,0,15,3,0,0,48,44,92
p_218,0,11,e_0,343,373,424,10,1,0,10,4,0,1,30,51,81
p_190,0,1,e_2,379,421,428,24,3,3,13,3,0,0,42,7,49
p_183,0,1,e_2,396,421,428,18,2,2,8,4,0,1,25,7,32
p_182,0,2,e_2,397,421,433,18,2,2,8,4,0,1,24,12,36
p_180,0,2,e_2,399,421,433,18,2,2,7,4,0,1,22,12,34
p_215,0,15,e_0,348,373,438,9,1,0,8,4,0,1,25,65,90
p_213,0,15,e_0,350,373,438,8,1,0,7,4,0,1,23,65,88
p_178,0,3,e_2,401,421,438,17,2,2,6,4,0,1,20,17,37
p_186,0,4,e_2,390,421,443,20,3,3,10,4,0,1,31,22,53
p_176,0,4,e_2,403,421,443,16,2,2,6,4,0,1,18,22,40
p_189,0,8,e_2,382,421,457,23,3,3,13,4,0,1,39,36,75
p_179,0,8,e_2,400,421,457,17,2,2,7,4,0,1,21,36,57
p_161,0,1,e_1,421,454,461,12,0,0,10,3,0,0,33,7,40
p_158,0,1,e_1,430,454,461,12,0,0,8,4,0,1,24,7,31
p_177,0,9,e_2,402,421,462,17,2,2,6,4,0,1,19,41,60
p_185,0,10,e_2,391,421,467,20,3,3,10,4,0,1,30,46,76
p_187,0,12,e_2,389,421,475,20,3,3,10,4,0,1,32,54,86
p_184,0,12,e_2,392,421,475,19,3,3,9,4,0,1,29,54,83
p_159,0,6,e_1,429,454,478,12,0,0,8,4,0,1,25,24,49
p_150,0,6,e_1,443,454,478,12,0,0,3,4,0,1,11,24,35
p_188,0,13,e_2,384,421,480,22,3,3,12,4,0,1,37,59,96
p_154,0,7,e_1,436,454,483,12,0,0,6,4,0,1,18,29,47
p_148,0,8,e_1,449,454,488,12,0,0,1,4,0,1,5,34,39
p_181,0,15,e_2,398,421,488,18,2,2,7,4,0,1,23,67,90
p_153,0,9,e_1,437,454,493,12,0,0,5,4,0,1,17,39,56
p_147,0,9,e_1,452,454,493,12,0,0,0,4,0,1,2,39,41
p_209,0,2,e_0,357,485,495,6,1,0,5,4,0,1,128,10,138
p_205,0,2,e_0,362,485,495,4,1,0,3,4,0,1,123,10,133
p_200,0,4,e_0,367,485,503,2,1,0,2,4,0,1,118,18,136
p_201,0,5,e_0,366,485,508,3,1,0,2,4,0,1,119,23,142
p_157,0,14,e_1,431,454,510,12,0,0,7,4,0,1,23,56,79
p_155,0,14,e_1,435,454,510,12,0,0,6,4,0,1,19,56,75
p_210,0,6,e_0,354,485,513,7,1,0,6,4,0,1,131,28,159
p_208,0,6,e_0,358,485,513,5,1,0,5,4,0,1,127,28,155
p_160,0,15,e_1,426,454,515,12,0,0,9,4,0,1,28,61,89
p_156,0,15,e_1,434,454,515,12,0,0,6,4,0,1,20,61,81
p_152,0,15,e_1,441,454,515,12,0,0,4,4,0,1,13,61,74
p_151,0,15,e_1,442,454,515,12,0,0,4,4,0,1,12,61,73
p_149,0,15,e_1,444,454,515,12,0,0,3,4,0,1,10,61,71
p_198,0,9,e_0,369,485,524,2,1,0,1,4,0,1,116,39,155
p_197,0,10,e_0,370,485,529,1,1,0,1,4,0,1,115,44,159
p_113,0,1,e_3,489,524,529,11,1,0,11,4,0,1,35,5,40
p_207,0,11,e_0,359,485,534,5,1,0,4,4,0,1,126,49,175
p_114,0,3,e_3,488,524,537,12,1,0,12,4,0,1,36,13,49
p_106,0,3,e_3,500,524,537,8,1,0,8,4,0,1,24,13,37
p_206,0,12,e_0,361,485,539,4,1,0,4,4,0,1,124,54,178
p_203,0,12,e_0,364,485,539,3,1,0,3,4,0,1,121,54,175
p_167,0,1,e_2,413,535,540,13,1,1,2,4,0,1,122,5,127
p_204,0,14,e_0,363,485,547,4,1,0,3,4,0,1,122,62,184
p_108,0,6,e_3,496,524,548,9,1,0,9,4,0,1,28,24,52
p_165,0,4,e_2,417,535,551,12,1,1,1,4,0,1,118,16,134
p_92,0,4,e_2,525,535,551,30,10,10,3,4,0,1,10,16,26
p_211,0,15,e_0,353,485,552,7,1,0,6,4,0,1,132,67,199
p_202,0,15,e_0,365,485,552,3,1,0,2,4,0,1,120,67,187
p_199,0,15,e_0,368,485,552,2,1,0,1,4,0,1,117,67,184
p_111,0,8,e_3,491,524,556,11,1,0,11,4,0,1,33,32,65
p_115,0,9,e_3,487,524,561,12,1,0,12,4,0,1,37,37,74
p_117,0,10,e_3,485,524,566,12,0,0,12,3,0,0,39,42,81
p_116,0,10,e_3,486,524,566,12,1,0,12,4,0,1,38,42,80
p_169,0,9,e_2,411,535,568,14,2,2,3,4,0,1,124,33,157
p_146,0,1,e_1,453,562,569,12,0,0,0,3,0,0,109,7,116
p_112,0,11,e_3,490,524,571,11,1,0,11,4,0,1,34,47,81
p_110,0,11,e_3,492,524,571,10,1,0,10,4,0,1,32,47,79
p_107,0,11,e_3,499,524,571,8,1,0,8,4,0,1,25,47,72
p_103,0,11,e_3,508,524,571,5,1,0,5,4,0,1,16,47,63
p_163,0,10,e_2,419,535,573,12,0,0,0,4,0,1,116,38,154
p_86,0,2,e_1,544,562,574,25,9,9,6,4,0,1,18,12,30
p_105,0,12,e_3,502,524,576,7,1,0,7,4,0,1,22,52,74
p_173,0,11,e_2,407,535,578,15,2,2,4,4,0,1,128,43,171
p_164,0,11,e_2,418,535,578,12,0,0,1,4,0,1,117,43,160
p_162,0,11,e_2,420,535,578,12,0,0,0,3,0,0,115,43,158
p_77,0,3,e_1,557,562,579,22,7,7,1,4,0,1,5,17,22
p_166,0,12,e_2,416,535,583,13,1,1,1,4,0,1,119,48,167
p_104,0,14,e_3,503,524,584,7,1,0,7,4,0,1,21,60,81
p_88,0,5,e_1,538,562,587,27,9,9,8,4,0,1,24,25,49
p_171,0,13,e_2,409,535,588,14,2,2,4,4,0,1,126,53,179
p_168,0,13,e_2,412,535,588,13,2,2,3,4,0,1,123,53,176
p_109,0,15,e_3,493,524,589,10,1,0,10,4,0,1,31,65,96
p_76,0,6,e_1,558,562,592,22,7,7,1,4,0,1,4,30,34
p_175,0,14,e_2,405,535,593,16,2,2,5,4,0,1,130,58,188
p_174,0,14,e_2,406,535,593,15,2,2,5,4,0,1,129,58,187
p_170,0,14,e_2,410,535,593,14,2,2,3,4,0,1,125,58,183
p_80,0,7,e_1,552,562,597,23,8,8,3,4,0,1,10,35,45
p_172,0,15,e_2,408,535,598,15,2,2,4,4,0,1,127,63,190
p_87,0,8,e_1,539,562,602,27,9,9,7,4,0,1,23,40,63
p_83,0,8,e_1,549,562,602,24,8,8,4,4,0,1,13,40,53
p_89,0,9,e_1,535,562,607,27,10,10,9,4,0,1,27,45,72
p_143,0,3,e_0,456,599,612,12,0,0,9,4,0,1,143,13,156
p_136,0,3,e_0,465,599,612,12,0,0,6,4,0,1,134,13,147
p_196,0,4,e_0,371,599,617,1,1,0,0,4,0,1,228,18,246
p_137,0,4,e_0,464,599,617,12,0,0,7,4,0,1,135,18,153
p_84,0,12,e_1,546,562,618,24,9,9,5,4,0,1,16,56,72
p_78,0,12,e_1,556,562,618,22,7,7,2,4,0,1,6,56,62
p_141,0,6,e_0,458,599,625,12,0,0,9,4,0,1,141,26,167
p_82,0,14,e_1,550,562,626,24,8,8,4,4,0,1,12,64,76
p_81,0,14,e_1,551,562,626,23,8,8,3,4,0,1,11,64,75
p_79,0,14,e_1,553,562,626,23,8,8,3,4,0,1,9,64,73
p_85,0,15,e_1,545,562,631,25,9,9,5,4,0,1,17,69,86
p_140,0,8,e_0,459,599,633,12,0,0,8,4,0,1,140,34,174
p_144,0,9,e_0,455,599,638,12,0,0,10,4,0,1,144,39,183
p_142,0,9,e_0,457,599,638,12,0,0,9,4,0,1,142,39,181
p_96,0,1,e_3,517,636,641,2,1,0,2,4,0,1,119,5,124
p_139,0,10,e_0,461,599,643,12,0,0,8,4,0,1,138,44,182
p_135,0,10,e_0,466,599,643,12,0,0,6,4,0,1,133,44,177
p_145,0,11,e_0,454,599,648,12,0,0,10,4,0,1,145,49,194
p_138,0,11,e_0,463,599,648,12,0,0,7,4,0,1,136,49,185
p_133,0,12,e_0,469,599,653,12,0,0,5,4,0,1,130,54,184
p_99,0,6,e_3,514,636,658,3,1,0,3,4,0,1,122,22,144
p_94,0,6,e_3,519,636,658,1,1,0,1,4,0,1,117,22,139
p_102,0,7,e_3,509,636,663,5,1,0,5,4,0,1,127,27,154
p_98,0,7,e_3,515,636,663,3,1,0,3,4,0,1,121,27,148
p_97,0,7,e_3,516,636,663,2,1,0,2,4,0,1,120,27,147
p_195,0,15,e_0,372,599,664,1,1,0,0,3,0,0,227,65,292
p_134,0,15,e_0,467,599,664,12,0,0,6,4,0,1,132,65,197
p_101,0,8,e_3,511,636,668,4,1,0,4,4,0,1,125,32,157
p_100,0,9,e_3,513,636,673,3,1,0,3,4,0,1,123,37,160
p_37,0,9,e_3,615,636,673,7,1,0,7,4,0,1,21,37,58
p_41,0,11,e_3,600,636,681,12,1,0,12,4,0,1,36,45,81
p_91,0,12,e_2,526,645,683,30,10,10,3,4,0,1,119,38,157
p_39,0,12,e_3,607,636,686,9,1,0,9,4,0,1,29,50,79
p_90,0,13,e_2,527,645,688,29,11,11,2,4,0,1,118,43,161
p_30,0,3,e_1,668,678,691,20,6,6,3,4,0,1,10,13,23
p_93,0,13,e_3,520,636,691,1,1,0,1,4,0,1,116,55,171
p_40,0,13,e_3,602,636,691,11,1,0,11,4,0,1,34,55,89
p_38,0,13,e_3,608,636,691,9,1,0,9,4,0,1,28,55,83
p_95,0,14,e_3,518,636,696,2,1,0,2,4,0,1,118,60,178
p_75,0,5,e_1,559,678,699,21,7,7,1,4,0,1,119,21,140
p_29,0,5,e_1,670,678,699,20,6,6,2,4,0,1,8,21,29
p_32,0,6,e_1,650,678,704,24,9,9,9,4,0,1,28,26,54
p_31,0,6,e_1,666,678,704,20,7,7,4,4,0,1,12,26,38
p_74,0,7,e_1,560,678,709,21,6,6,0,4,0,1,118,31,149
p_130,0,1,e_0,472,711,716,12,0,0,4,4,0,1,239,5,244
p_119,0,1,e_0,483,711,716,12,0,0,0,4,0,1,228,5,233
p_27,0,10,e_1,677,678,720,18,5,5,0,3,0,0,1,42,43
p_129,0,3,e_0,473,711,724,12,0,0,4,4,0,1,238,13,251
p_73,0,11,e_1,561,678,725,21,6,6,0,3,0,0,117,47,164
p_28,0,11,e_1,676,678,725,18,5,5,0,4,0,1,2,47,49
p_34,0,12,e_1,646,678,730,26,9,9,10,4,0,1,32,52,84
p_124,0,7,e_0,478,711,738,12,0,0,2,4,0,1,233,27,260
p_118,0,7,e_0,484,711,738,12,0,0,0,3,0,0,227,27,254
p_33,0,15,e_1,649,678,741,25,9,9,9,4,0,1,29,63,92
p_127,0,10,e_0,475,711,749,12,0,0,3,4,0,1,236,38,274
p_22,0,3,e_3,719,740,751,7,1,0,7,4,0,1,21,11,32
p_132,0,11,e_0,470,711,754,12,0,0,5,4,0,1,241,43,284
p_128,0,11,e_0,474,711,754,12,0,0,3,4,0,1,237,43,280
p_123,0,11,e_0,479,711,754,12,0,0,2,4,0,1,232,43,275
p_121,0,11,e_0,481,711,754,12,0,0,1,4,0,1,230,43,273
p_120,0,11,e_0,482,711,754,12,0,0,1,4,0,1,229,43,272
p_21,0,4,e_3,731,740,756,3,1,0,3,4,0,1,9,16,25
p_126,0,12,e_0,476,711,759,12,0,0,3,4,0,1,235,48,283
p_131,0,14,e_0,471,711,767,12,0,0,4,4,0,1,240,56,296
p_125,0,14,e_0,477,711,767,12,0,0,2,4,0,1,234,56,290
p_122,0,15,e_0,480,711,772,12,0,0,1,4,0,1,231,61,292
p_35,0,9,e_3,630,740,773,2,1,0,2,4,0,1,110,33,143
p_23,0,12,e_3,711,740,784,9,1,0,9,4,0,1,29,44,73
p_36,0,13,e_3,628,740,789,2,1,0,2,4,0,1,112,49,161
p_20,0,14,e_3,734,740,794,2,1,0,2,4,0,1,6,54,60
p_16,0,2,e_2,780,796,804,17,3,3,5,4,0,1,16,8,24
p_14,0,4,e_2,794,796,812,14,0,0,0,4,0,1,2,16,18
p_65,0,1,e_0,573,819,824,19,4,4,8,4,0,1,246,5,251
p_15,0,9,e_2,793,796,829,14,0,0,1,4,0,1,3,33,36
p_72,0,3,e_0,562,819,832,21,6,6,12,4,0,1,257,13,270
p_71,0,3,e_0,564,819,832,20,6,6,11,4,0,1,255,13,268
p_70,0,3,e_0,565,819,832,20,5,5,11,4,0,1,254,13,267
p_67,0,3,e_0,568,819,832,20,5,5,10,4,0,1,251,13,264
p_66,0,3,e_0,569,819,832,19,5,5,10,4,0,1,250,13,263
p_18,0,10,e_2,766,796,834,21,4,4,10,4,0,1,30,38,68
p_17,0,10,e_2,776,796,834,18,3,3,6,4,0,1,20,38,58
p_64,0,4,e_0,574,819,837,18,4,4,8,4,0,1,245,18,263
p_19,0,11,e_2,754,796,839,24,5,5,13,3,0,0,42,43,85
p_61,0,6,e_0,579,819,845,17,3,3,6,4,0,1,240,26,266
p_60,0,10,e_0,580,819,859,17,3,3,6,4,0,1,239,40,279
p_58,0,11,e_0,582,819,864,16,3,3,5,4,0,1,237,45,282
p_68,0,13,e_0,567,819,872,20,5,5,10,4,0,1,252,53,305
p_63,0,13,e_0,577,819,872,18,3,3,7,4,0,1,242,53,295
p_62,0,13,e_0,578,819,872,18,3,3,7,4,0,1,241,53,294
p_69,0,14,e_0,566,819,877,20,5,5,11,4,0,1,253,58,311
p_59,0,14,e_0,581,819,877,17,3,3,6,4,0,1,238,58,296
p_9,0,2,e_2,846,882,890,11,1,0,11,3,0,0,36,8,44
p_6,0,3,e_2,877,882,895,1,1,0,1,4,0,1,5,13,18
p_7,0,5,e_3,875,880,897,1,1,0,1,4,0,1,5,17,22
p_10,0,8,e_3,835,880,908,14,0,0,14,3,0,0,45,28,73
p_8,0,11,e_2,874,882,921,2,1,0,2,4,0,1,8,39,47
p_45,0,2,e_0,595,921,929,13,1,0,1,4,0,1,326,8,334
p_55,0,3,e_0,585,921,934,16,2,2,4,4,0,1,336,13,349
p_54,0,3,e_0,586,921,934,16,2,2,4,4,0,1,335,13,348
p_52,0,3,e_0,588,921,934,15,1,1,3,4,0,1,333,13,346
p_48,0,4,e_0,592,921,939,14,1,0,2,4,0,1,329,18,347
p_46,0,4,e_0,594,921,939,14,1,0,1,4,0,1,327,18,345
p_56,0,6,e_0,584,921,947,16,2,2,5,4,0,1,337,26,363
p_50,0,7,e_0,590,921,952,15,1,0,3,4,0,1,331,31,362
p_43,0,7,e_0,597,921,952,13,1,0,0,4,0,1,324,31,355
p_44,0,8,e_0,596,921,957,13,1,0,1,4,0,1,325,36,361
p_53,0,9,e_0,587,921,962,15,2,2,4,4,0,1,334,41,375
p_51,0,9,e_0,589,921,962,15,1,0,3,4,0,1,332,41,373
p_47,0,9,e_0,593,921,962,14,1,0,2,4,0,1,328,41,369
p_57,0,11,e_0,583,921,970,16,2,2,5,4,0,1,338,49,387
p_49,0,14,e_0,591,921,981,15,1,0,2,4,0,1,330,60,390
p_4,0,1,e_0,886,1025,1030,14,2,2,11,4,0,1,139,5,144
p_24,0,2,e_0,695,1025,1035,14,1,1,5,4,0,1,330,10,340
p_1,0,5,e_0,894,1025,1046,12,2,2,9,4,0,1,131,21,152
p_42,0,6,e_0,598,1025,1051,12,1,0,0,3,0,0,427,26,453
p_26,0,8,e_0,684,1025,1059,16,4,4,9,4,0,1,341,34,375
p_25,0,8,e_0,686,1025,1059,16,3,3,8,4,0,1,339,34,373
p_5,0,8,e_0,883,1025,1059,15,2,2,12,4,0,1,142,34,176
p_3,0,8,e_0,888,1025,1059,14,2,2,11,4,0,1,137,34,171
p_11,0,9,e_0,807,1025,1064,14,0,0,4,4,0,1,218,39,257
p_13,0,11,e_0,796,1025,1072,14,0,0,7,4,0,1,229,47,276
p_12,0,11,e_0,798,1025,1072,14,0,0,7,4,0,1,227,47,274
p_2,0,11,e_0,892,1025,1072,12,2,2,9,4,0,1,133,47,180
p_300,0,4,e_0,8,9,25,0,0,0,0,3,0,0,1,16,17
p_299,0,5,e_1,9,10,29,0,0,0,0,3,0,0,1,19,20
p_297,0,6,e_3,15,16,38,0,0,0,0,3,0,0,1,22,23
p_298,0,9,e_2,11,12,43,0,0,0,0,3,0,0,1,31,32
p_296,0,4,e_0,28,43,57,9,1,1,4,3,0,0,15,14,29
p_286,0,3,e_1,46,47,60,4,1,0,0,3,0,0,1,13,14
p_290,0,6,e_0,40,43,65,6,1,0,1,4,0,1,3,22,25
p_289,0,4,e_1,43,47,65,5,1,0,1,4,0,1,4,18,22
p_295,0,5,e_1,29,47,70,9,1,1,5,3,0,0,18,23,41
p_287,0,5,e_1,45,47,70,4,1,0,0,4,0,1,2,23,25
p_285,0,4,e_3,53,59,73,2,1,0,2,4,0,1,6,14,20
p_284,0,4,e_3,54,59,73,1,1,0,1,4,0,1,5,14,19
p_288,0,8,e_1,44,47,81,5,1,0,1,4,0,1,3,34,37
p_292,0,6,e_3,38,59,81,6,0,0,6,3,0,0,21,22,43
p_291,0,11,e_0,39,43,82,6,1,0,1,4,0,1,4,39,43
p_294,0,12,e_0,31,43,87,8,1,1,4,4,0,1,12,44,56
p_293,0,12,e_0,33,43,87,7,1,1,3,4,0,1,10,44,54
p_283,0,9,e_3,57,59,92,0,1,0,0,4,0,1,2,33,35
p_281,0,1,e_2,73,96,101,14,2,2,7,4,0,1,23,5,28
p_278,0,2,e_2,77,96,106,13,2,2,6,4,0,1,19,10,29
p_279,0,5,e_2,76,96,117,13,2,2,6,4,0,1,20,21,41
p_282,0,7,e_2,66,96,125,16,3,3,9,3,0,0,30,29,59
p_277,0,6,e_1,82,109,129,12,1,1,8,3,0,0,27,20,47
p_274,0,8,e_2,88,96,130,10,1,1,2,4,0,1,8,34,42
p_276,0,11,e_2,84,96,141,11,1,1,4,4,0,1,12,45,57
p_271,0,1,e_3,121,140,145,6,1,0,6,4,0,1,19,5,24
p_280,0,14,e_2,75,96,152,14,2,2,7,4,0,1,21,56,77
p_275,0,14,e_2,86,96,152,11,1,1,3,4,0,1,10,56,66
p_273,0,4,e_3,110,140,156,9,0,0,9,3,0,0,30,16,46
p_267,0,1,e_0,148,152,159,16,2,2,1,4,0,1,4,7,11
p_270,0,9,e_3,122,140,173,6,1,0,6,4,0,1,18,33,51
p_269,0,9,e_3,127,140,173,4,1,0,4,4,0,1,13,33,46
p_268,0,2,e_1,144,165,175,17,2,2,6,3,0,0,21,10,31
p_266,0,6,e_0,151,152,176,15,2,2,0,3,0,0,1,24,25
p_265,0,4,e_1,152,165,183,15,2,2,4,4,0,1,13,18,31
p_262,0,5,e_1,157,165,188,14,1,1,2,4,0,1,8,23,31
p_261,0,5,e_1,164,165,188,12,1,1,0,3,0,0,1,23,24
p_272,0,10,e_0,113,152,190,9,1,0,12,3,0,0,39,38,77
p_263,0,7,e_1,154,165,196,14,2,2,3,4,0,1,11,31,42
p_264,0,11,e_1,153,165,210,15,2,2,4,4,0,1,12,45,57
p_255,0,3,e_3,184,202,213,6,1,0,6,4,0,1,18,11,29
p_254,0,4,e_3,187,202,218,5,1,0,5,4,0,1,15,16,31
p_252,0,5,e_2,205,210,229,29,4,4,1,4,0,1,5,19,24
p_250,0,2,e_0,217,223,231,4,2,2,2,4,0,1,6,8,14
p_260,0,7,e_2,165,210,237,11,1,1,14,3,0,0,45,27,72
p_258,0,7,e_2,168,210,237,10,2,2,14,4,0,1,42,27,69
p_256,0,10,e_3,182,202,238,6,1,0,6,4,0,1,20,36,56
p_253,0,5,e_0,190,223,242,4,1,0,10,3,0,0,33,19,52
p_259,0,15,e_3,167,202,255,11,1,1,7,5,1,0,35,53,88
p_257,0,14,e_2,169,210,260,10,2,2,13,4,0,1,41,50,91
p_251,0,15,e_2,209,210,265,28,4,4,0,3,0,0,1,55,56
p_248,0,5,e_0,246,264,281,18,1,1,5,3,0,0,18,17,35
p_247,0,5,e_0,250,264,281,16,1,1,4,4,0,1,14,17,31
p_249,0,6,e_1,239,275,295,20,1,1,11,3,0,0,36,20,56
p_246,0,10,e_0,262,264,298,15,0,0,0,4,0,1,2,34,36
p_245,0,7,e_1,269,275,300,15,0,0,2,4,0,1,6,25,31
p_244,0,12,e_1,271,275,317,15,0,0,1,4,0,1,4,42,46
p_243,0,15,e_1,272,275,328,15,0,0,1,4,0,1,3,53,56
p_236,0,1,e_2,305,325,330,8,1,0,6,4,0,1,20,5,25
p_233,0,1,e_2,311,325,330,6,1,0,4,4,0,1,14,5,19
p_230,0,3,e_2,319,325,338,4,1,0,2,4,0,1,6,13,19
p_241,0,1,e_3,283,331,338,15,0,0,15,3,0,0,48,7,55
p_226,0,2,e_3,329,331,343,0,1,0,0,4,0,1,2,12,14
p_232,0,5,e_2,314,325,346,5,1,0,3,4,0,1,11,21,32
p_224,0,5,e_0,331,334,351,24,6,6,1,4,0,1,3,17,20
p_228,0,4,e_3,325,331,351,2,1,0,2,4,0,1,6,20,26
p_237,0,7,e_2,304,325,354,9,1,0,7,4,0,1,21,29,50
p_231,0,7,e_2,317,325,354,4,1,0,2,4,0,1,8,29,37
p_225,0,5,e_3,330,331,356,0,0,0,0,3,0,0,1,25,26
p_242,0,8,e_2,277,325,359,15,0,0,15,3,0,0,48,34,82
p_235,0,8,e_2,308,325,359,7,1,0,5,4,0,1,17,34,51
p_234,0,8,e_2,310,325,359,7,1,0,5,4,0,1,15,34,49
p_240,0,9,e_0,301,334,365,10,1,0,10,3,0,0,33,31,64
p_239,0,11,e_2,302,325,370,9,1,0,7,4,0,1,23,45,68
p_238,0,13,e_2,303,325,378,9,1,0,7,4,0,1,22,53,75
p_229,0,13,e_2,320,325,378,3,1,0,1,4,0,1,5,53,58
p_227,0,12,e_3,327,331,379,1,1,0,1,4,0,1,4,48,52
p_216,0,1,e_1,347,384,389,21,3,3,12,4,0,1,37,5,42
p_223,0,2,e_1,336,384,394,23,5,5,15,3,0,0,48,10,58
p_209,0,2,e_1,357,384,394,19,1,1,9,4,0,1,27,10,37
p_214,0,3,e_1,349,384,399,20,3,3,11,4,0,1,35,15,50
p_222,0,5,e_1,337,384,407,23,4,4,15,4,0,1,47,23,70
p_219,0,5,e_1,342,384,407,22,3,3,14,4,0,1,42,23,65
p_186,0,4,e_0,390,394,408,12,0,0,1,4,0,1,4,14,18
p_221,0,6,e_1,339,384,412,23,4,4,15,4,0,1,45,28,73
p_220,0,6,e_1,341,384,412,22,4,4,14,4,0,1,43,28,71
p_210,0,6,e_1,354,384,412,19,2,2,10,4,0,1,30,28,58
p_217,0,7,e_1,346,384,417,21,3,3,12,4,0,1,38,33,71
p_212,0,7,e_1,351,384,417,20,2,2,11,4,0,1,33,33,66
p_185,0,10,e_0,391,394,428,12,0,0,1,4,0,1,3,34,37
p_218,0,11,e_1,343,384,431,22,3,3,13,4,0,1,41,47,88
p_203,0,12,e_0,364,394,436,17,1,1,9,2,1,0,30,42,72
p_187,0,12,e_0,389,394,436,12,0,0,1,4,0,1,5,42,47
p_184,0,12,e_0,392,394,436,12,0,0,0,4,0,1,2,42,44
p_188,0,13,e_0,384,394,441,12,0,0,3,4,0,1,10,47,57
p_183,0,1,e_3,396,435,442,12,0,0,12,3,0,0,39,7,46
p_215,0,15,e_1,348,384,445,21,3,3,12,4,0,1,36,61,97
p_213,0,15,e_1,350,384,445,4,2,2,11,4,0,1,34,61,95
p_211,0,15,e_1,353,384,445,20,2,2,10,4,0,1,31,61,92
p_182,0,2,e_2,397,439,447,12,1,0,13,3,0,0,42,8,50
p_180,0,2,e_3,399,435,447,12,1,0,12,4,0,1,36,12,48
p_178,0,3,e_3,401,435,452,11,1,0,11,4,0,1,34,17,51
p_176,0,4,e_3,403,435,457,10,1,0,10,4,0,1,32,22,54
p_154,0,7,e_2,436,439,464,30,10,10,1,4,0,1,3,25,28
p_179,0,8,e_3,400,435,471,11,1,0,11,4,0,1,35,36,71
p_153,0,9,e_2,437,439,472,30,10,10,0,4,0,1,2,33,35
p_177,0,9,e_3,402,435,476,11,1,0,11,4,0,1,33,41,74
p_169,0,9,e_3,411,435,476,8,1,0,8,4,0,1,24,41,65
p_173,0,11,e_3,407,435,484,9,1,0,9,4,0,1,28,49,77
p_155,0,14,e_2,435,439,489,30,11,11,1,4,0,1,4,50,54
p_146,0,1,e_0,453,483,490,27,8,8,10,4,0,1,30,7,37
p_171,0,13,e_3,409,435,492,8,1,0,8,4,0,1,26,57,83
p_168,0,13,e_3,412,435,492,7,1,0,7,4,0,1,23,57,80
p_175,0,14,e_3,405,435,497,10,1,0,10,4,0,1,30,62,92
p_174,0,14,e_3,406,435,497,9,1,0,9,4,0,1,29,62,91
p_170,0,14,e_3,410,435,497,8,1,0,8,4,0,1,25,62,87
p_143,0,3,e_0,456,483,498,4,7,7,9,4,0,1,27,15,42
p_205,0,2,e_1,362,492,502,17,1,1,7,4,0,1,130,10,140
p_181,0,15,e_3,398,435,502,12,1,0,12,4,0,1,37,67,104
p_172,0,15,e_3,408,435,502,9,1,0,9,4,0,1,27,67,94
p_150,0,6,e_0,443,483,509,29,10,10,13,4,0,1,40,26,66
p_141,0,6,e_0,458,483,509,26,7,7,8,4,0,1,25,26,51
p_200,0,4,e_1,367,492,510,16,1,1,5,4,0,1,125,18,143
p_196,0,4,e_1,371,492,510,14,1,1,4,4,0,1,121,18,139
p_201,0,5,e_1,366,492,515,16,1,1,6,4,0,1,126,23,149
p_148,0,8,e_0,449,483,517,28,9,9,11,4,0,1,34,34,68
p_140,0,8,e_0,459,483,517,26,7,7,8,4,0,1,24,34,58
p_208,0,6,e_1,358,492,520,19,1,1,8,4,0,1,134,28,162
p_194,0,6,e_1,373,492,520,14,1,1,3,4,0,1,119,28,147
p_147,0,9,e_0,452,483,522,27,8,8,10,4,0,1,31,39,70
p_144,0,9,e_0,455,483,522,26,8,8,9,4,0,1,28,39,67
p_142,0,9,e_0,457,483,522,26,7,7,8,4,0,1,26,39,65
p_139,0,10,e_0,461,483,527,25,7,7,7,4,0,1,22,44,66
p_198,0,9,e_1,369,492,531,15,1,1,5,4,0,1,123,39,162
p_145,0,11,e_0,454,483,532,27,8,8,9,4,0,1,29,49,78
p_138,0,11,e_0,463,483,532,24,7,7,6,4,0,1,20,49,69
p_197,0,10,e_1,370,492,536,15,1,1,4,4,0,1,122,44,166
p_207,0,11,e_1,359,492,541,18,1,1,8,4,0,1,133,49,182
p_193,0,11,e_1,374,492,541,13,1,1,3,4,0,1,118,49,167
p_96,0,1,e_2,517,537,542,10,1,0,6,4,0,1,20,5,25
p_152,0,15,e_0,441,483,546,29,10,10,13,3,0,0,42,63,105
p_151,0,15,e_0,442,483,546,29,10,10,13,4,0,1,41,63,104
p_149,0,15,e_0,444,483,546,29,10,10,13,4,0,1,39,63,102
p_206,0,12,e_1,361,492,546,18,1,1,7,4,0,1,131,54,185
p_106,0,3,e_2,500,537,550,15,2,2,12,4,0,1,37,13,50
p_204,0,14,e_1,363,492,554,17,1,1,7,4,0,1,129,62,191
p_167,0,1,e_3,413,549,554,7,1,0,7,4,0,1,136,5,141
p_161,0,1,e_3,421,549,554,4,1,0,4,4,0,1,128,5,133
p_158,0,1,e_3,430,549,554,1,1,0,1,4,0,1,119,5,124
p_202,0,15,e_1,365,492,559,16,1,1,6,4,0,1,127,67,194
p_199,0,15,e_1,368,492,559,15,1,1,5,4,0,1,124,67,191
p_195,0,15,e_1,372,492,559,14,1,1,4,4,0,1,120,67,187
p_86,0,2,e_3,544,549,559,1,1,0,1,4,0,1,5,10,15
p_108,0,6,e_2,496,537,561,16,2,2,13,4,0,1,41,24,65
p_99,0,6,e_2,514,537,561,11,1,0,7,4,0,1,23,24,47
p_102,0,7,e_2,509,537,566,13,1,0,9,4,0,1,28,29,57
p_98,0,7,e_2,515,537,566,11,1,0,7,4,0,1,22,29,51
p_97,0,7,e_2,516,537,566,11,1,0,7,4,0,1,21,29,50
p_165,0,4,e_3,417,549,567,6,1,0,6,4,0,1,132,18,150
p_101,0,8,e_2,511,537,571,12,1,0,8,4,0,1,26,34,60
p_88,0,5,e_3,538,549,572,3,1,0,3,4,0,1,11,23,34
p_100,0,9,e_2,513,537,576,12,1,0,8,4,0,1,24,39,63
p_159,0,6,e_3,429,549,577,2,1,0,2,4,0,1,120,28,148
p_110,0,11,e_2,492,537,584,17,3,3,14,3,0,0,45,47,92
p_107,0,11,e_2,499,537,584,16,2,2,12,4,0,1,38,47,85
p_103,0,11,e_2,508,537,584,13,1,0,9,4,0,1,29,47,76
p_87,0,8,e_3,539,549,585,3,1,0,3,4,0,1,10,36,46
p_105,0,12,e_2,502,537,589,15,1,0,11,4,0,1,35,52,87
p_163,0,10,e_3,419,549,593,5,1,0,5,4,0,1,130,44,174
p_104,0,14,e_2,503,537,597,15,1,0,11,4,0,1,34,60,94
p_164,0,11,e_3,418,549,598,5,1,0,5,4,0,1,131,49,180
p_162,0,11,e_3,420,549,598,5,1,0,5,4,0,1,129,49,178
p_130,0,1,e_0,472,593,600,22,6,6,3,4,0,1,121,7,128
p_109,0,15,e_2,493,537,602,17,3,3,14,4,0,1,44,65,109
p_166,0,12,e_3,416,549,603,6,1,0,6,4,0,1,133,54,187
p_136,0,3,e_0,465,593,608,24,7,7,6,4,0,1,128,15,143
p_129,0,3,e_0,473,593,608,22,6,6,3,4,0,1,120,15,135
p_190,0,1,e_1,379,606,611,12,0,0,1,4,0,1,227,5,232
p_119,0,1,e_1,483,606,611,19,4,4,3,4,0,1,123,5,128
p_113,0,1,e_1,489,606,611,18,4,4,1,4,0,1,117,5,122
p_157,0,14,e_3,431,549,611,1,1,0,1,4,0,1,118,62,180
p_137,0,4,e_0,464,593,613,24,7,7,6,4,0,1,129,20,149
p_160,0,15,e_3,426,549,616,3,1,0,3,4,0,1,123,67,190
p_156,0,15,e_3,434,549,616,0,0,0,0,3,0,0,115,67,182
p_114,0,3,e_1,488,606,619,18,4,4,1,4,0,1,118,13,131
p_124,0,7,e_0,478,593,624,21,5,5,1,4,0,1,115,31,146
p_46,0,4,e_1,594,606,624,20,5,5,4,4,0,1,12,18,30
p_135,0,10,e_0,466,593,635,23,7,7,5,4,0,1,127,42,169
p_127,0,10,e_0,475,593,635,21,5,5,2,4,0,1,118,42,160
p_118,0,7,e_1,484,606,635,19,4,4,2,4,0,1,122,29,151
p_132,0,11,e_0,470,593,640,22,6,6,4,4,0,1,123,47,170
p_128,0,11,e_0,474,593,640,21,6,6,3,4,0,1,119,47,166
p_123,0,11,e_0,479,593,640,20,5,5,1,4,0,1,114,47,161
p_192,0,8,e_1,375,606,640,13,1,1,3,4,0,1,231,34,265
p_189,0,8,e_1,382,606,640,12,0,0,0,4,0,1,224,34,258
p_111,0,8,e_1,491,606,640,17,3,3,0,3,0,0,115,34,149
p_133,0,12,e_0,469,593,645,22,7,7,4,4,0,1,124,52,176
p_126,0,12,e_0,476,593,645,21,5,5,2,4,0,1,117,52,169
p_115,0,9,e_1,487,606,645,18,4,4,1,4,0,1,119,39,158
p_47,0,9,e_1,593,606,645,20,5,5,4,4,0,1,13,39,52
p_191,0,10,e_1,376,606,650,13,1,1,2,4,0,1,230,44,274
p_117,0,10,e_1,485,606,650,19,4,4,2,4,0,1,121,44,165
p_116,0,10,e_1,486,606,650,19,4,4,2,4,0,1,120,44,164
p_131,0,14,e_0,471,593,653,22,6,6,4,4,0,1,122,60,182
p_125,0,14,e_0,477,593,653,21,5,5,2,4,0,1,116,60,176
p_112,0,11,e_1,490,606,655,17,4,4,0,4,0,1,116,49,165
p_134,0,15,e_0,467,593,658,23,7,7,5,4,0,1,126,65,191
p_92,0,4,e_2,525,649,663,8,1,0,4,4,0,1,124,14,138
p_94,0,6,e_2,519,649,671,10,1,0,6,4,0,1,130,22,152
p_89,0,9,e_2,535,649,682,4,1,0,0,4,0,1,114,33,147
p_37,0,9,e_2,615,649,682,15,1,1,11,4,0,1,34,33,67
p_35,0,9,e_2,630,649,682,11,1,0,6,4,0,1,19,33,52
p_32,0,6,e_3,650,663,683,4,1,0,4,4,0,1,13,20,33
p_91,0,12,e_2,526,649,693,7,1,0,3,4,0,1,123,44,167
p_39,0,12,e_2,607,649,693,17,3,3,14,4,0,1,42,44,86
p_34,0,12,e_2,646,649,693,5,1,0,1,4,0,1,3,44,47
p_45,0,2,e_1,595,690,698,20,5,5,3,4,0,1,95,8,103
p_93,0,13,e_2,520,649,698,9,1,0,5,4,0,1,129,49,178
p_90,0,13,e_2,527,649,698,7,1,0,3,4,0,1,122,49,171
p_38,0,13,e_2,608,649,698,17,3,3,13,4,0,1,41,49,90
p_36,0,13,e_2,628,649,698,11,1,0,7,4,0,1,21,49,70
p_30,0,3,e_1,668,690,703,29,3,3,7,4,0,1,22,13,35
p_95,0,14,e_2,518,649,703,10,1,0,6,4,0,1,131,54,185
p_84,0,12,e_3,546,663,703,1,1,0,1,4,0,1,117,40,157
p_29,0,5,e_1,670,690,711,28,3,3,6,4,0,1,20,21,41
p_85,0,15,e_3,545,663,714,1,1,0,1,4,0,1,118,51,169
p_33,0,15,e_3,649,663,714,4,1,0,4,4,0,1,14,51,65
p_77,0,3,e_0,557,705,716,28,11,11,12,4,0,1,148,11,159
p_72,0,3,e_0,562,705,716,27,10,10,10,4,0,1,143,11,154
p_42,0,6,e_1,598,690,716,19,4,4,2,4,0,1,92,26,118
p_31,0,6,e_1,666,690,716,29,3,3,8,4,0,1,24,26,50
p_43,0,7,e_1,597,690,721,19,4,4,3,4,0,1,93,31,124
p_75,0,5,e_0,559,705,724,28,10,10,11,4,0,1,146,19,165
p_44,0,8,e_1,596,690,726,19,5,5,3,4,0,1,94,36,130
p_26,0,8,e_1,684,690,726,24,2,2,2,4,0,1,6,36,42
p_25,0,8,e_1,686,690,726,23,2,2,1,4,0,1,4,36,40
p_76,0,6,e_0,558,705,729,28,10,10,11,4,0,1,147,24,171
p_80,0,7,e_0,552,705,734,29,12,12,13,4,0,1,153,29,182
p_74,0,7,e_0,560,705,734,28,10,10,11,4,0,1,145,29,174
p_27,0,10,e_1,677,690,734,26,3,3,4,4,0,1,13,44,57
p_83,0,8,e_0,549,705,739,30,11,11,14,4,0,1,156,34,190
p_41,0,11,e_1,600,690,739,19,4,4,2,4,0,1,90,49,139
p_28,0,11,e_1,676,690,739,26,3,3,4,4,0,1,14,49,63
p_40,0,13,e_1,602,690,747,18,3,3,1,4,0,1,88,57,145
p_121,0,11,e_0,481,705,750,20,5,5,0,4,0,1,224,45,269
p_120,0,11,e_0,482,705,750,19,5,5,0,3,0,0,223,45,268
p_73,0,11,e_0,561,705,750,28,10,10,10,4,0,1,144,45,189
p_78,0,12,e_0,556,705,755,29,11,11,12,4,0,1,149,50,199
p_82,0,14,e_0,550,705,763,30,11,11,14,4,0,1,155,58,213
p_81,0,14,e_0,551,705,763,30,11,11,14,4,0,1,154,58,212
p_79,0,14,e_0,553,705,763,29,11,11,13,4,0,1,152,58,210
p_122,0,15,e_0,480,705,768,20,5,5,1,4,0,1,225,63,288
p_21,0,4,e_2,731,756,770,12,1,0,8,4,0,1,25,14,39
p_22,0,3,e_3,719,767,780,15,0,0,15,3,0,0,48,13,61
p_19,0,11,e_2,754,756,793,4,1,0,0,4,0,1,2,37,39
p_23,0,12,e_2,711,756,798,16,1,1,14,3,0,0,45,42,87
p_18,0,10,e_3,766,767,803,0,0,0,0,3,0,0,1,36,37
p_20,0,14,e_2,734,756,806,11,1,0,7,4,0,1,22,50,72
p_65,0,1,e_0,573,815,820,25,8,8,6,4,0,1,242,5,247
p_71,0,3,e_0,564,815,828,27,10,10,9,4,0,1,251,13,264
p_70,0,3,e_0,565,815,828,26,10,10,9,4,0,1,250,13,263
p_67,0,3,e_0,568,815,828,26,9,9,8,4,0,1,247,13,260
p_66,0,3,e_0,569,815,828,26,9,9,8,4,0,1,246,13,259
p_64,0,4,e_0,574,815,833,25,8,8,6,4,0,1,241,18,259
p_61,0,6,e_0,579,815,841,24,7,7,4,4,0,1,236,26,262
p_17,0,10,e_1,776,818,850,18,2,2,13,3,0,0,42,32,74
p_60,0,10,e_0,580,815,855,23,7,7,4,4,0,1,235,40,275
p_58,0,11,e_0,582,815,860,23,7,7,3,4,0,1,233,45,278
p_57,0,11,e_0,583,815,860,22,7,7,3,4,0,1,232,45,277
p_68,0,13,e_0,567,815,868,26,9,9,8,4,0,1,248,53,301
p_63,0,13,e_0,577,815,868,24,7,7,5,4,0,1,238,53,291
p_62,0,13,e_0,578,815,868,24,7,7,5,4,0,1,237,53,290
p_69,0,14,e_0,566,815,873,4,9,9,9,4,0,1,249,58,307
p_59,0,14,e_0,581,815,873,23,7,7,4,4,0,1,234,58,292
p_9,0,2,e_3,846,868,876,7,1,0,7,4,0,1,22,8,30
p_10,0,8,e_3,835,868,896,10,0,0,10,3,0,0,33,28,61
p_4,0,1,e_1,886,907,912,11,1,1,7,4,0,1,21,5,26
p_6,0,3,e_1,877,907,920,14,1,1,10,4,0,1,30,13,43
p_24,0,2,e_0,695,917,925,20,2,2,3,4,0,1,222,8,230
p_16,0,2,e_0,780,917,925,17,1,1,11,4,0,1,137,8,145
p_1,0,5,e_1,894,907,928,8,1,1,4,4,0,1,13,21,34
p_55,0,3,e_0,585,917,930,22,6,6,2,4,0,1,332,13,345
p_54,0,3,e_0,586,917,930,22,6,6,2,4,0,1,331,13,344
p_52,0,3,e_0,588,917,930,21,6,6,1,4,0,1,329,13,342
p_48,0,4,e_0,592,917,935,20,5,5,0,3,0,0,325,18,343
p_14,0,4,e_0,794,917,935,13,1,1,7,4,0,1,123,18,141
p_7,0,5,e_2,875,920,937,14,1,1,14,3,0,0,45,17,62
p_5,0,8,e_1,883,907,939,12,1,1,8,4,0,1,24,32,56
p_3,0,8,e_1,888,907,939,10,1,1,6,4,0,1,19,32,51
p_56,0,6,e_0,584,917,943,22,6,6,3,4,0,1,333,26,359
p_50,0,7,e_0,590,917,948,21,6,6,1,4,0,1,327,31,358
p_8,0,11,e_1,874,907,950,14,2,2,10,3,0,0,33,43,76
p_2,0,11,e_1,892,907,950,9,1,1,5,4,0,1,15,43,58
p_53,0,9,e_0,587,917,956,22,6,6,2,4,0,1,330,39,369
p_51,0,9,e_0,589,917,956,21,6,6,1,4,0,1,328,39,367
p_15,0,9,e_0,793,917,956,13,1,1,7,4,0,1,124,39,163
p_13,0,11,e_0,796,917,964,12,1,1,6,4,0,1,121,47,168
p_12,0,11,e_0,798,917,964,11,1,1,5,4,0,1,119,47,166
p_49,0,14,e_0,591,917,975,20,6,6,0,4,0,1,326,58,384
p_11,0,9,e_0,807,1019,1048,10,0,0,2,4,0,1,212,29,241
p_300,0,4,e_0,8,9,25,0,0,0,0,3,0,0,1,16,17
p_299,0,5,e_1,9,10,29,0,0,0,0,3,0,0,1,19,20
p_297,0,6,e_3,15,16,38,0,0,0,0,3,0,0,1,22,23
p_298,0,9,e_2,11,12,43,0,0,0,0,3,0,0,1,31,32
p_296,0,4,e_0,28,43,57,9,1,1,4,3,0,0,15,14,29
p_286,0,3,e_1,46,47,60,4,1,0,0,3,0,0,1,13,14
p_290,0,6,e_0,40,43,65,6,1,0,1,4,0,1,3,22,25
p_289,0,4,e_1,43,47,65,5,1,0,1,4,0,1,4,18,22
p_295,0,5,e_1,29,47,70,9,1,1,5,3,0,0,18,23,41
p_287,0,5,e_1,45,47,70,4,1,0,0,4,0,1,2,23,25
p_284,0,4,e_3,54,59,73,1,1,0,1,4,0,1,5,14,19
p_288,0,8,e_1,44,47,81,5,1,0,1,4,0,1,3,34,37
p_292,0,6,e_3,38,59,81,6,0,0,6,3,0,0,21,22,43
p_291,0,11,e_0,39,43,82,6,1,0,1,4,0,1,4,39,43
p_294,0,12,e_0,31,43,87,8,1,1,4,4,0,1,12,44,56
p_293,0,12,e_0,33,43,87,7,1,1,3,4,0,1,10,44,54
p_281,0,1,e_2,73,83,90,14,2,2,3,4,0,1,10,7,17
p_283,0,9,e_3,57,59,92,0,1,0,0,4,0,1,2,33,35
p_278,0,2,e_2,77,83,95,13,2,2,2,4,0,1,6,12,18
p_285,0,4,e_2,53,83,103,2,1,0,9,3,0,0,30,20,50
p_279,0,5,e_2,76,83,108,13,2,2,2,4,0,1,7,25,32
p_277,0,6,e_2,82,83,113,12,1,1,0,3,0,0,1,30,31
p_282,0,7,e_2,66,83,118,16,3,3,5,4,0,1,17,35,52
p_273,0,4,e_1,110,111,127,9,0,0,0,3,0,0,1,16,17
p_271,0,1,e_0,121,125,130,7,1,0,1,4,0,1,4,5,9
p_274,0,8,e_1,88,111,141,10,1,1,7,4,0,1,23,30,53
p_280,0,14,e_2,75,83,141,14,2,2,2,4,0,1,8,58,66
p_276,0,11,e_1,84,111,152,11,1,1,8,3,0,0,27,41,68
p_270,0,9,e_0,122,125,156,7,1,0,1,4,0,1,3,31,34
p_269,0,9,e_3,127,143,172,5,1,0,5,4,0,1,16,29,45
p_275,0,14,e_0,86,125,173,11,1,1,12,2,1,0,39,48,87
p_272,0,10,e_3,113,143,177,9,0,0,9,3,0,0,30,34,64
p_267,0,1,e_2,148,189,194,19,2,2,13,4,0,1,41,5,46
p_255,0,3,e_1,184,187,198,10,0,0,1,4,0,1,3,11,14
p_268,0,2,e_2,144,189,199,20,2,2,14,3,0,0,45,10,55
p_265,0,4,e_1,152,187,203,17,2,2,11,4,0,1,35,16,51
p_254,0,4,e_2,187,189,207,10,0,0,0,4,0,1,2,18,20
p_262,0,5,e_1,157,187,208,16,2,2,10,4,0,1,30,21,51
p_261,0,5,e_1,164,187,208,13,2,2,7,4,0,1,23,21,44
p_266,0,6,e_1,151,187,213,18,2,2,11,2,1,0,36,26,62
p_263,0,7,e_1,154,187,218,17,2,2,11,4,0,1,33,31,64
p_260,0,7,e_1,165,187,218,13,2,2,7,4,0,1,22,31,53
p_258,0,7,e_1,168,187,218,12,2,2,6,4,0,1,19,31,50
p_256,0,10,e_1,182,187,229,10,0,0,1,4,0,1,5,42,47
p_250,0,2,e_2,217,224,232,2,1,0,2,4,0,1,7,8,15
p_264,0,11,e_1,153,187,234,17,2,2,11,4,0,1,34,47,81
p_253,0,5,e_3,190,223,240,10,0,0,10,3,0,0,33,17,50
p_252,0,5,e_3,205,223,240,6,1,0,6,4,0,1,18,17,35
p_257,0,14,e_1,169,187,245,12,2,2,6,4,0,1,18,58,76
p_259,0,15,e_1,167,187,250,12,2,2,6,4,0,1,20,63,83
p_251,0,15,e_2,209,224,273,4,1,0,4,3,0,0,15,49,64
p_248,0,5,e_3,246,257,274,3,1,0,3,4,0,1,11,17,28
p_247,0,5,e_3,250,257,274,2,1,0,2,4,0,1,7,17,24
p_249,0,6,e_3,239,257,279,5,0,0,5,2,1,0,18,22,40
p_241,0,1,e_3,283,299,304,5,1,0,5,4,0,1,16,5,21
p_236,0,1,e_0,305,307,312,15,1,1,0,4,0,1,2,5,7
p_233,0,1,e_1,311,317,322,13,1,1,2,4,0,1,6,5,11
p_242,0,8,e_3,277,299,327,6,1,1,6,5,1,0,22,28,50
p_237,0,7,e_0,304,307,332,15,1,1,1,4,0,1,3,25,28
p_230,0,3,e_2,319,320,333,10,1,1,0,3,0,0,1,13,14
p_232,0,5,e_1,314,317,336,12,1,1,1,4,0,1,3,19,22
p_240,0,9,e_0,301,307,340,16,2,2,2,4,0,1,6,33,39
p_245,0,7,e_1,269,317,344,8,2,2,15,3,0,0,48,27,75
p_246,0,10,e_0,262,307,345,11,2,2,14,3,0,0,45,38,83
p_231,0,7,e_2,317,320,347,11,1,1,1,4,0,1,3,27,30
p_235,0,8,e_1,308,317,349,14,1,1,3,4,0,1,9,32,41
p_234,0,8,e_1,310,317,349,13,1,1,2,4,0,1,7,32,39
p_239,0,11,e_0,302,307,350,15,2,2,1,4,0,1,5,43,48
p_244,0,12,e_0,271,307,355,8,2,2,12,4,0,1,36,48,84
p_216,0,1,e_3,347,353,358,2,1,0,2,4,0,1,6,5,11
p_238,0,13,e_0,303,307,360,15,1,1,1,4,0,1,4,53,57
p_226,0,2,e_3,329,353,363,8,1,0,8,4,0,1,24,10,34
p_223,0,2,e_3,336,353,363,5,1,0,5,4,0,1,17,10,27
p_214,0,3,e_3,349,353,368,1,1,0,1,4,0,1,4,15,19
p_243,0,15,e_2,272,320,373,7,2,2,15,2,1,0,48,53,101
p_228,0,4,e_3,325,353,373,8,2,2,8,5,1,1,28,20,48
p_225,0,5,e_3,330,353,378,7,1,0,7,4,0,1,23,25,48
p_224,0,5,e_3,331,353,378,7,1,0,7,4,0,1,22,25,47
p_222,0,5,e_3,337,353,378,5,1,0,5,4,0,1,16,25,41
p_219,0,5,e_3,342,353,378,3,1,0,3,4,0,1,11,25,36
p_221,0,6,e_3,339,353,383,4,1,0,4,4,0,1,14,30,44
p_220,0,6,e_3,341,353,383,4,1,0,4,4,0,1,12,30,42
p_209,0,2,e_1,357,375,385,25,10,10,6,4,0,1,18,10,28
p_205,0,2,e_1,362,375,385,24,9,9,4,4,0,1,13,10,23
p_217,0,7,e_3,346,353,388,2,1,0,2,4,0,1,7,35,42
p_200,0,4,e_1,367,375,393,23,8,8,2,4,0,1,8,18,26
p_201,0,5,e_1,366,375,398,23,9,9,3,4,0,1,9,23,32
p_218,0,11,e_3,343,353,402,3,1,0,3,4,0,1,10,49,59
p_210,0,6,e_1,354,375,403,26,10,10,7,4,0,1,21,28,49
p_208,0,6,e_1,358,375,403,25,10,10,5,4,0,1,17,28,45
p_227,0,12,e_3,327,353,407,8,1,0,8,4,0,1,26,54,80
p_229,0,13,e_3,320,353,412,10,1,1,6,5,1,0,33,59,92
p_198,0,9,e_1,369,375,414,23,8,8,2,4,0,1,6,39,45
p_207,0,11,e_1,359,375,422,25,10,10,5,4,0,1,16,47,63
p_190,0,1,e_0,379,417,424,21,6,6,12,4,0,1,38,7,45
p_183,0,1,e_0,396,417,424,17,4,4,7,4,0,1,21,7,28
p_206,0,12,e_1,361,375,427,24,10,10,4,4,0,1,14,52,66
p_203,0,12,e_1,364,375,427,24,9,9,3,4,0,1,11,52,63
p_182,0,2,e_0,397,417,429,16,4,4,6,4,0,1,20,12,32
p_180,0,2,e_0,399,417,429,16,4,4,6,4,0,1,18,12,30
p_161,0,1,e_2,421,424,429,10,1,0,1,4,0,1,3,5,8
p_178,0,3,e_0,401,417,434,15,3,3,5,4,0,1,16,17,33
p_204,0,14,e_1,363,375,435,24,9,9,4,4,0,1,12,60,72
p_186,0,4,e_0,390,417,439,19,4,4,9,4,0,1,27,22,49
p_215,0,15,e_1,348,375,440,1,1,0,8,2,1,0,27,65,92
p_211,0,15,e_1,353,375,440,26,10,10,7,4,0,1,22,65,87
p_202,0,15,e_1,365,375,440,24,9,9,3,4,0,1,10,65,75
p_199,0,15,e_1,368,375,440,23,8,8,2,4,0,1,7,65,72
p_165,0,4,e_2,417,424,440,12,1,0,2,4,0,1,7,16,23
p_192,0,8,e_0,375,417,453,22,7,7,13,3,0,0,42,36,78
p_189,0,8,e_0,382,417,453,20,5,5,11,4,0,1,35,36,71
p_179,0,8,e_0,400,417,453,15,4,4,5,4,0,1,17,36,53
p_177,0,9,e_0,402,417,458,15,3,3,5,4,0,1,15,41,56
p_191,0,10,e_2,376,424,460,21,7,7,15,3,0,0,48,36,84
p_163,0,10,e_2,419,424,460,11,1,0,1,4,0,1,5,36,41
p_158,0,1,e_3,430,453,460,7,1,0,7,4,0,1,23,7,30
p_185,0,10,e_0,391,417,463,18,4,4,8,4,0,1,26,46,72
p_164,0,11,e_2,418,424,465,11,1,0,2,4,0,1,6,41,47
p_162,0,11,e_2,420,424,465,11,1,0,1,4,0,1,4,41,45
p_187,0,12,e_0,389,417,471,19,4,4,9,4,0,1,28,54,82
p_184,0,12,e_0,392,417,471,18,4,4,8,4,0,1,25,54,79
p_188,0,13,e_0,384,417,476,20,5,5,11,4,0,1,33,59,92
p_159,0,6,e_3,429,453,477,8,1,0,8,4,0,1,24,24,48
p_150,0,6,e_3,443,453,477,3,1,0,3,4,0,1,10,24,34
p_212,0,7,e_3,351,453,482,0,1,0,0,4,0,1,102,29,131
p_154,0,7,e_3,436,453,482,5,1,0,5,4,0,1,17,29,46
p_181,0,15,e_0,398,417,484,16,4,4,6,4,0,1,19,67,86
p_148,0,8,e_3,449,453,487,1,1,0,1,4,0,1,4,34,38
p_153,0,9,e_3,437,453,492,5,1,0,5,4,0,1,16,39,55
p_146,0,1,e_1,453,487,494,30,8,8,11,4,0,1,34,7,41
p_143,0,3,e_1,456,487,502,30,7,7,10,4,0,1,31,15,46
p_136,0,3,e_1,465,487,502,28,7,7,7,4,0,1,22,15,37
p_196,0,4,e_1,371,487,507,22,8,8,1,4,0,1,116,20,136
p_113,0,1,e_2,489,500,507,22,4,4,3,4,0,1,11,7,18
p_157,0,14,e_3,431,453,509,7,1,0,7,4,0,1,22,56,78
p_155,0,14,e_3,435,453,509,6,1,0,6,4,0,1,18,56,74
p_213,0,15,e_3,350,453,514,1,1,0,1,4,0,1,103,61,164
p_160,0,15,e_3,426,453,514,9,1,0,9,4,0,1,27,61,88
p_156,0,15,e_3,434,453,514,6,1,0,6,4,0,1,19,61,80
p_152,0,15,e_3,441,453,514,4,1,0,4,4,0,1,12,61,73
p_151,0,15,e_3,442,453,514,3,1,0,3,4,0,1,11,61,72
p_149,0,15,e_3,444,453,514,3,1,0,3,4,0,1,9,61,70
p_194,0,6,e_1,373,487,515,22,7,7,0,4,0,1,114,28,142
p_141,0,6,e_1,458,487,515,29,8,8,9,4,0,1,29,28,57
p_114,0,3,e_2,488,500,515,22,4,4,4,4,0,1,12,15,27
p_137,0,4,e_2,464,500,520,28,7,7,11,2,1,0,36,20,56
p_140,0,8,e_1,459,487,523,29,7,7,9,4,0,1,28,36,64
p_144,0,9,e_1,455,487,528,30,7,7,10,4,0,1,32,41,73
p_142,0,9,e_1,457,487,528,30,7,7,10,4,0,1,30,41,71
p_108,0,6,e_2,496,500,528,20,3,3,1,4,0,1,4,28,32
p_197,0,10,e_1,370,487,533,23,8,8,1,4,0,1,117,46,163
p_139,0,10,e_1,461,487,533,29,7,7,8,4,0,1,26,46,72
p_167,0,1,e_0,413,531,536,13,1,0,1,4,0,1,118,5,123
p_111,0,8,e_2,491,500,536,21,3,3,3,4,0,1,9,36,45
p_193,0,11,e_1,374,487,538,22,7,7,0,3,0,0,113,51,164
p_145,0,11,e_1,454,487,538,30,7,7,11,4,0,1,33,51,84
p_138,0,11,e_1,463,487,538,28,7,7,8,4,0,1,24,51,75
p_115,0,9,e_2,487,500,541,22,4,4,4,4,0,1,13,41,54
p_106,0,3,e_0,500,531,544,19,3,3,10,4,0,1,31,13,44
p_176,0,4,e_0,403,531,549,15,3,3,4,4,0,1,128,18,146
p_112,0,11,e_2,490,500,549,21,4,4,3,4,0,1,10,49,59
p_110,0,11,e_2,492,500,549,21,3,3,2,4,0,1,8,49,57
p_107,0,11,e_2,499,500,549,19,3,3,0,3,0,0,1,49,50
p_195,0,15,e_1,372,487,552,4,7,7,1,4,0,1,115,65,180
p_109,0,15,e_2,493,500,563,21,3,3,2,4,0,1,7,63,70
p_169,0,9,e_0,411,531,566,13,1,1,2,4,0,1,120,35,155
p_86,0,2,e_3,544,561,571,5,1,0,5,4,0,1,17,10,27
p_173,0,11,e_0,407,531,574,14,2,2,3,4,0,1,124,43,167
p_103,0,11,e_0,508,531,574,16,2,2,7,4,0,1,23,43,66
p_77,0,3,e_3,557,561,576,1,1,0,1,4,0,1,4,15,19
p_166,0,12,e_0,416,531,579,12,1,0,0,3,0,0,115,48,163
p_105,0,12,e_0,502,531,579,18,3,3,9,4,0,1,29,48,77
p_171,0,13,e_0,409,531,584,14,2,2,2,4,0,1,122,53,175
p_168,0,13,e_0,412,531,584,13,1,0,1,4,0,1,119,53,172
p_88,0,5,e_3,538,561,584,7,1,0,7,4,0,1,23,23,46
p_175,0,14,e_0,405,531,589,14,3,3,4,4,0,1,126,58,184
p_174,0,14,e_0,406,531,589,14,2,2,3,4,0,1,125,58,183
p_170,0,14,e_0,410,531,589,13,2,2,2,4,0,1,121,58,179
p_104,0,14,e_0,503,531,589,18,3,3,9,4,0,1,28,58,86
p_76,0,6,e_3,558,561,589,1,1,0,1,4,0,1,3,28,31
p_172,0,15,e_0,408,531,594,14,2,2,3,4,0,1,123,63,186
p_80,0,7,e_3,552,561,594,3,1,0,3,4,0,1,9,33,42
p_87,0,8,e_3,539,561,599,7,1,0,7,4,0,1,22,38,60
p_83,0,8,e_3,549,561,599,4,1,0,4,4,0,1,12,38,50
p_147,0,9,e_3,452,561,604,0,0,0,0,3,0,0,109,43,152
p_89,0,9,e_3,535,561,604,8,1,0,8,4,0,1,26,43,69
p_130,0,1,e_1,472,599,606,25,7,7,5,4,0,1,127,7,134
p_129,0,3,e_1,473,599,614,25,7,7,4,4,0,1,126,15,141
p_84,0,12,e_3,546,561,615,5,1,0,5,4,0,1,15,54,69
p_78,0,12,e_3,556,561,615,1,1,0,1,4,0,1,5,54,59
p_72,0,3,e_2,562,610,621,30,10,10,15,2,1,0,48,11,59
p_82,0,14,e_3,550,561,623,3,1,0,3,4,0,1,11,62,73
p_81,0,14,e_3,551,561,623,3,1,0,3,4,0,1,10,62,72
p_79,0,14,e_3,553,561,623,2,1,0,2,4,0,1,8,62,70
p_124,0,7,e_1,478,599,628,24,6,6,3,4,0,1,121,29,150
p_85,0,15,e_3,545,561,628,5,1,0,5,4,0,1,16,67,83
p_135,0,10,e_1,466,599,639,27,7,7,7,4,0,1,133,40,173
p_127,0,10,e_1,475,599,639,24,7,7,4,4,0,1,124,40,164
p_132,0,11,e_1,470,599,644,26,7,7,5,4,0,1,129,45,174
p_128,0,11,e_1,474,599,644,25,7,7,4,4,0,1,125,45,170
p_123,0,11,e_1,479,599,644,24,6,6,2,4,0,1,120,45,165
p_121,0,11,e_1,481,599,644,23,5,5,2,4,0,1,118,45,163
p_96,0,1,e_0,517,641,646,14,1,0,4,4,0,1,124,5,129
p_41,0,11,e_2,600,610,647,22,5,5,3,4,0,1,10,37,47
p_133,0,12,e_1,469,599,649,26,7,7,6,4,0,1,130,50,180
p_126,0,12,e_1,476,599,649,24,6,6,3,4,0,1,123,50,173
p_39,0,12,e_2,607,610,652,20,4,4,1,4,0,1,3,42,45
p_92,0,4,e_0,525,641,657,12,1,0,2,4,0,1,116,16,132
p_131,0,14,e_1,471,599,657,26,7,7,5,4,0,1,128,58,186
p_125,0,14,e_1,477,599,657,24,6,6,3,4,0,1,122,58,180
p_40,0,13,e_2,602,610,657,21,5,5,2,4,0,1,8,47,55
p_38,0,13,e_2,608,610,657,20,4,4,0,4,0,1,2,47,49
p_134,0,15,e_1,467,599,662,27,7,7,6,4,0,1,132,63,195
p_122,0,15,e_1,480,599,662,23,6,6,2,4,0,1,119,63,182
p_99,0,6,e_0,514,641,665,15,1,0,5,4,0,1,127,24,151
p_94,0,6,e_0,519,641,665,14,1,0,4,4,0,1,122,24,146
p_102,0,7,e_0,509,641,670,16,2,2,7,4,0,1,132,29,161
p_98,0,7,e_0,515,641,670,15,1,0,5,4,0,1,126,29,155
p_97,0,7,e_0,516,641,670,15,1,0,5,4,0,1,125,29,154
p_101,0,8,e_0,511,641,675,16,2,2,6,4,0,1,130,34,164
p_100,0,9,e_0,513,641,680,15,1,1,6,4,0,1,128,39,167
p_37,0,9,e_0,615,641,680,18,3,3,8,4,0,1,26,39,65
p_30,0,3,e_3,668,675,686,2,1,0,2,4,0,1,7,11,18
p_91,0,12,e_0,526,641,691,11,1,0,1,4,0,1,115,50,165
p_75,0,5,e_3,559,675,694,0,1,0,0,4,0,1,116,19,135
p_29,0,5,e_3,670,675,694,1,1,0,1,4,0,1,5,19,24
p_93,0,13,e_0,520,641,696,13,1,0,3,4,0,1,121,55,176
p_90,0,13,e_0,527,641,696,11,1,0,1,4,0,1,114,55,169
p_36,0,13,e_0,628,641,696,15,1,0,4,4,0,1,13,55,68
p_32,0,6,e_3,650,675,699,8,1,0,8,4,0,1,25,24,49
p_31,0,6,e_3,666,675,699,3,1,0,3,4,0,1,9,24,33
p_95,0,14,e_0,518,641,701,14,1,0,4,4,0,1,123,60,183
p_74,0,7,e_3,560,675,704,0,0,0,0,3,0,0,115,29,144
p_119,0,1,e_1,483,709,714,23,5,5,1,4,0,1,226,5,231
p_65,0,1,e_1,573,709,714,28,10,10,8,4,0,1,136,5,141
p_34,0,12,e_3,646,675,721,9,1,0,9,4,0,1,29,46,75
p_71,0,3,e_1,564,709,722,30,10,10,11,4,0,1,145,13,158
p_70,0,3,e_1,565,709,722,30,10,10,11,4,0,1,144,13,157
p_67,0,3,e_1,568,709,722,29,11,11,10,4,0,1,141,13,154
p_66,0,3,e_1,569,709,722,28,11,11,10,4,0,1,140,13,153
p_64,0,4,e_1,574,709,727,27,10,10,8,4,0,1,135,18,153
p_33,0,15,e_3,649,675,732,8,1,0,8,4,0,1,26,57,83
p_118,0,7,e_1,484,709,738,23,5,5,1,4,0,1,225,29,254
p_117,0,10,e_1,485,709,749,22,5,5,0,4,0,1,224,40,264
p_116,0,10,e_1,486,709,749,22,4,4,0,3,0,0,223,40,263
p_28,0,11,e_2,676,718,753,30,6,6,13,3,0,0,42,35,77
p_120,0,11,e_1,482,709,754,23,5,5,1,4,0,1,227,45,272
p_73,0,11,e_1,561,709,754,30,11,11,12,4,0,1,148,45,193
p_22,0,3,e_0,719,745,756,18,2,2,8,4,0,1,26,11,37
p_23,0,12,e_2,711,718,758,21,2,2,2,4,0,1,7,40,47
p_21,0,4,e_0,731,745,761,15,0,0,4,4,0,1,14,16,30
p_68,0,13,e_1,567,709,762,29,11,11,10,4,0,1,142,53,195
p_63,0,13,e_1,577,709,762,27,9,9,7,4,0,1,132,53,185
p_69,0,14,e_1,566,709,767,29,11,11,11,4,0,1,143,58,201
p_35,0,9,e_0,630,745,778,15,1,0,3,4,0,1,115,33,148
p_20,0,14,e_0,734,745,795,15,0,0,3,4,0,1,11,50,61
p_16,0,2,e_3,780,802,810,7,1,0,7,4,0,1,22,8,30
p_14,0,4,e_3,794,802,818,2,1,0,2,4,0,1,8,16,24
p_55,0,3,e_1,585,811,822,25,8,8,4,4,0,1,226,11,237
p_54,0,3,e_1,586,811,822,25,8,8,4,4,0,1,225,11,236
p_52,0,3,e_1,588,811,822,24,7,7,3,4,0,1,223,11,234
p_48,0,4,e_1,592,811,827,23,7,7,2,4,0,1,219,16,235
p_61,0,6,e_1,579,811,835,26,9,9,6,4,0,1,232,24,256
p_56,0,6,e_1,584,811,835,25,8,8,5,4,0,1,227,24,251
p_15,0,9,e_3,793,802,835,3,1,0,3,4,0,1,9,33,42
p_18,0,10,e_2,766,805,837,12,1,0,12,3,0,0,39,32,71
p_50,0,7,e_1,590,811,840,24,7,7,3,4,0,1,221,29,250
p_17,0,10,e_3,776,802,840,8,1,0,8,4,0,1,26,38,64
p_19,0,11,e_3,754,802,845,15,0,0,15,3,0,0,48,43,91
p_13,0,11,e_3,796,802,845,2,1,0,2,4,0,1,6,43,49
p_12,0,11,e_3,798,802,845,1,1,0,1,4,0,1,4,43,47
p_53,0,9,e_1,587,811,848,24,8,8,4,4,0,1,224,37,261
p_51,0,9,e_1,589,811,848,24,7,7,3,4,0,1,222,37,259
p_60,0,10,e_1,580,811,853,26,9,9,6,4,0,1,231,42,273
p_58,0,11,e_1,582,811,858,25,9,9,5,4,0,1,229,47,276
p_57,0,11,e_1,583,811,858,25,8,8,5,4,0,1,228,47,275
p_62,0,13,e_1,578,811,866,27,9,9,7,4,0,1,233,55,288
p_59,0,14,e_1,581,811,871,26,9,9,6,4,0,1,230,60,290
p_49,0,14,e_1,591,811,871,24,7,7,2,4,0,1,220,60,280
p_9,0,2,e_2,846,879,887,11,0,0,10,3,0,0,33,8,41
p_6,0,3,e_2,877,879,892,11,0,0,0,4,0,1,2,13,15
p_7,0,5,e_0,875,880,897,11,0,0,1,4,0,1,5,17,22
p_10,0,8,e_0,835,880,908,13,2,2,14,3,0,0,45,28,73
p_8,0,11,e_2,874,879,918,11,0,0,1,4,0,1,5,39,44
p_4,0,1,e_1,886,915,920,11,1,0,9,4,0,1,29,5,34
p_45,0,2,e_1,595,915,925,23,6,6,1,4,0,1,320,10,330
p_24,0,2,e_1,695,915,925,25,4,4,4,4,0,1,220,10,230
p_46,0,4,e_1,594,915,933,23,6,6,1,4,0,1,321,18,339
p_1,0,5,e_1,894,915,938,8,1,0,7,4,0,1,21,23,44
p_42,0,6,e_1,598,915,943,22,5,5,0,3,0,0,317,28,345
p_5,0,8,e_3,883,919,945,11,0,0,11,3,0,0,36,26,62
p_43,0,7,e_1,597,915,948,22,6,6,0,4,0,1,318,33,351
p_44,0,8,e_1,596,915,953,23,6,6,1,4,0,1,319,38,357
p_26,0,8,e_1,684,915,953,27,6,6,8,4,0,1,231,38,269
p_25,0,8,e_1,686,915,953,27,5,5,7,4,0,1,229,38,267
p_3,0,8,e_1,888,915,953,10,1,0,9,4,0,1,27,38,65
p_47,0,9,e_1,593,915,958,23,6,6,2,4,0,1,322,43,365
p_11,0,9,e_1,807,915,958,21,5,5,1,4,0,1,108,43,151
p_27,0,10,e_1,677,915,963,30,6,6,10,4,0,1,238,48,286
p_2,0,11,e_1,892,915,968,9,1,0,7,4,0,1,23,53,76
