p_296,1,0,e_2,20,25,30,1,0,0,0,3,0,0,5,5,10
p_299,3,0,e_1,7,18,37,3,0,0,0,3,0,0,11,19,30
p_298,4,0,e_1,10,23,37,4,0,0,1,5,0,1,13,14,27
p_290,4,0,e_1,43,51,79,6,1,1,1,5,0,1,8,28,36
p_295,5,0,e_1,22,56,79,5,0,0,4,3,1,0,34,23,57
p_286,3,0,e_1,51,64,79,6,2,2,4,3,0,2,13,15,28
p_285,2,0,e_1,54,69,79,6,2,1,5,5,1,3,15,10,25
p_288,1,0,e_1,49,74,79,9,2,2,4,5,0,2,25,5,30
p_291,6,0,e_3,35,56,108,6,0,0,0,3,0,0,21,52,73
p_289,7,0,e_3,47,61,108,4,1,0,3,5,0,1,14,47,61
p_283,10,0,e_3,55,72,108,4,2,0,6,5,0,2,17,36,53
p_281,10,0,e_3,63,72,108,3,2,0,7,5,1,1,9,36,45
p_276,5,0,e_3,82,89,108,2,2,0,7,4,1,1,7,19,26
p_279,2,0,e_3,76,100,108,7,1,0,9,4,1,0,24,8,32
p_275,2,0,e_3,84,100,108,4,3,1,6,4,1,2,16,8,24
p_300,8,0,e_0,4,31,109,8,0,0,0,3,0,0,27,78,105
p_297,12,0,e_0,18,45,109,12,0,0,4,5,0,1,27,64,91
p_294,13,0,e_0,23,50,109,13,0,0,6,5,0,2,27,59,86
p_293,15,0,e_0,26,58,109,15,0,0,7,5,0,3,32,51,83
p_284,14,0,e_0,55,63,109,8,2,0,14,5,1,1,8,46,54
p_282,6,0,e_0,62,89,109,7,2,1,14,1,1,0,27,20,47
p_292,11,0,e_2,30,66,111,11,0,0,0,3,0,0,36,45,81
p_287,12,0,e_2,51,71,111,7,2,0,6,5,0,1,20,40,60
p_280,12,0,e_2,65,71,111,4,2,0,11,5,0,2,6,40,46
p_274,4,0,e_2,84,97,111,2,3,1,8,4,1,0,13,14,27
p_267,1,0,e_3,153,159,164,1,0,0,0,3,0,0,6,5,11
p_277,10,0,e_1,81,112,182,27,2,2,0,5,0,1,31,70,101
p_273,13,0,e_1,95,123,182,21,2,2,5,5,0,2,28,59,87
p_278,15,0,e_1,80,131,182,23,2,2,0,3,0,0,51,51,102
p_272,15,0,e_1,105,131,182,16,1,1,8,5,0,3,26,51,77
p_271,11,0,e_1,127,145,182,11,0,0,14,5,1,1,18,37,55
p_264,5,0,e_1,162,165,182,25,1,1,6,4,1,0,3,17,20
p_258,5,0,e_3,175,181,206,4,1,1,3,5,0,1,6,25,31
p_262,6,0,e_3,164,186,206,6,0,0,0,3,1,0,22,20,42
p_259,6,0,e_3,174,186,206,3,1,0,3,5,0,1,12,20,32
p_252,2,0,e_3,212,220,228,2,0,0,0,3,0,0,8,8,16
p_270,7,0,e_0,133,156,233,7,0,0,0,3,0,0,23,77,100
p_268,10,0,e_0,150,167,233,10,0,0,5,5,0,1,17,66,83
p_266,15,0,e_0,155,184,233,15,1,0,7,2,0,1,29,49,78
p_257,12,0,e_0,179,195,233,7,2,0,14,5,1,1,16,38,54
p_269,4,0,e_2,146,160,236,4,0,0,0,3,0,0,14,76,90
p_265,12,0,e_2,157,186,236,11,1,0,3,5,0,1,29,50,79
p_263,12,0,e_2,163,186,236,18,1,1,4,5,1,1,23,50,73
p_261,12,0,e_2,170,186,236,11,1,0,7,5,1,1,16,50,66
p_260,13,0,e_2,171,191,236,11,1,0,7,5,1,1,20,45,65
p_255,10,0,e_2,192,202,236,25,1,1,13,4,1,1,10,34,44
p_256,8,0,e_2,191,210,236,27,1,1,13,4,1,0,19,26,45
p_251,4,0,e_3,228,243,277,4,0,0,0,3,0,0,15,34,49
p_250,7,0,e_3,236,254,277,5,1,0,2,5,0,1,18,23,41
p_249,7,0,e_3,238,254,277,4,2,0,3,5,0,2,16,23,39
p_248,7,0,e_3,246,254,277,3,2,0,4,5,1,1,8,23,31
p_254,3,0,e_1,199,210,299,29,1,1,0,3,0,0,11,89,100
p_253,15,0,e_1,208,248,299,15,0,0,3,5,0,1,40,51,91
p_247,12,0,e_1,248,259,299,7,2,0,15,4,1,0,11,40,51
p_244,2,0,e_1,271,291,299,30,1,1,8,4,1,0,20,8,28
p_243,8,0,e_2,285,295,331,8,0,0,5,5,0,1,10,36,46
p_245,9,0,e_2,269,300,331,24,1,1,0,3,0,0,31,31,62
p_233,2,0,e_2,319,323,331,17,3,2,3,4,1,0,4,8,12
p_246,12,0,e_0,257,296,336,24,1,1,0,3,0,0,39,40,79
p_237,5,0,e_0,313,319,336,16,3,2,7,4,1,0,6,17,23
p_242,4,0,e_3,287,302,398,4,0,0,0,3,0,0,15,96,111
p_241,13,0,e_3,300,331,398,10,1,0,3,5,0,1,31,67,98
p_239,13,0,e_3,305,331,398,10,3,1,5,5,1,2,26,67,93
p_240,14,0,e_3,301,336,398,10,1,1,4,3,0,1,35,62,97
p_234,14,0,e_3,314,336,398,7,3,0,7,5,1,2,22,62,84
p_224,13,0,e_3,335,341,398,3,4,0,14,2,1,3,6,57,63
p_223,13,0,e_3,339,341,398,1,5,0,14,4,1,4,2,57,59
p_226,12,0,e_3,331,346,398,3,4,1,13,2,1,3,15,52,67
p_228,11,0,e_3,325,351,398,6,4,2,11,5,1,3,26,47,73
p_220,9,0,e_3,342,359,398,4,4,2,13,4,1,3,17,39,56
p_212,9,0,e_3,348,359,398,3,6,1,12,4,1,5,11,39,50
p_215,6,0,e_3,346,370,398,6,5,2,12,4,1,4,24,28,52
p_206,6,0,e_3,362,370,398,3,4,0,9,4,1,3,8,28,36
p_230,5,0,e_3,323,375,398,12,3,2,11,5,1,2,52,23,75
p_214,4,0,e_3,346,380,398,8,4,3,12,4,1,3,34,18,52
p_221,4,0,e_2,341,355,401,9,4,3,0,3,0,0,14,46,60
p_210,4,0,e_2,353,355,401,7,5,3,3,5,0,2,2,46,48
p_217,8,0,e_2,345,369,401,4,4,2,1,5,0,1,24,32,56
p_204,8,0,e_2,364,369,401,30,4,4,7,5,1,3,5,32,37
p_196,5,0,e_2,376,380,401,30,3,3,6,4,1,2,4,21,25
p_209,2,0,e_2,354,391,401,9,5,4,4,3,0,1,37,10,47
p_205,1,0,e_2,362,396,401,8,4,3,6,5,1,2,34,5,39
p_238,2,0,e_1,311,319,431,20,3,2,0,3,0,0,8,112,120
p_232,5,0,e_1,320,330,431,13,3,2,2,5,1,1,10,101,111
p_236,8,0,e_1,313,341,431,13,3,2,0,5,0,1,28,90,118
p_235,8,0,e_1,314,341,431,12,3,2,1,5,0,2,27,90,117
p_229,9,0,e_1,323,346,431,9,3,2,3,5,1,3,23,85,108
p_227,9,0,e_1,326,346,431,7,5,2,4,5,1,4,20,85,105
p_231,10,0,e_1,320,351,431,8,3,2,2,5,1,2,31,80,111
p_225,10,0,e_1,333,351,431,5,5,1,6,5,1,3,18,80,98
p_219,11,0,e_1,342,356,431,2,4,1,8,5,1,2,14,75,89
p_213,12,0,e_1,347,361,431,30,6,6,9,5,1,3,14,70,84
p_207,12,0,e_1,355,361,431,28,5,5,11,5,1,4,6,70,76
p_208,13,0,e_1,355,366,431,27,5,5,11,2,1,3,11,65,76
p_202,13,0,e_1,365,366,431,24,4,4,13,5,1,3,1,65,66
p_201,13,0,e_1,366,366,431,24,4,4,13,2,1,2,0,65,65
p_211,14,0,e_1,348,373,431,28,6,6,9,5,1,4,25,58,83
p_222,3,0,e_0,339,351,458,10,5,3,0,3,0,0,12,107,119
p_218,9,0,e_0,343,371,458,4,5,2,1,5,0,1,28,87,115
p_194,11,0,e_0,377,379,458,24,3,3,11,5,1,2,2,79,81
p_203,12,0,e_0,365,384,458,26,4,4,7,5,1,1,19,74,93
p_193,12,0,e_0,378,384,458,23,3,3,11,5,1,3,6,74,80
p_190,14,0,e_0,382,392,458,20,2,2,11,5,1,2,10,66,76
p_183,12,0,e_0,393,400,458,19,2,2,14,4,1,2,7,58,65
p_181,11,0,e_0,395,405,458,20,2,2,14,4,1,3,10,53,63
p_173,10,0,e_0,405,410,458,9,4,0,11,4,1,3,5,48,53
p_170,10,0,e_0,408,410,458,8,3,0,11,4,1,4,2,48,50
p_177,9,0,e_0,398,415,458,9,2,2,13,4,1,4,17,43,60
p_197,8,0,e_0,375,420,458,27,3,3,10,5,1,1,45,38,83
p_167,7,0,e_0,412,425,458,12,3,1,10,4,1,3,13,33,46
p_166,5,0,e_0,415,433,458,14,3,1,9,4,1,3,18,25,43
p_163,4,0,e_0,417,438,458,20,5,4,9,4,1,4,21,20,41
p_160,10,0,e_2,421,433,521,13,5,4,6,5,0,2,12,88,100
p_159,11,0,e_2,424,438,521,12,5,3,7,5,0,3,14,83,97
p_180,14,0,e_2,396,449,521,16,2,2,1,1,1,0,53,72,125
p_172,14,0,e_2,405,449,521,13,4,0,1,5,0,1,44,72,116
p_168,15,0,e_2,412,454,521,12,3,0,3,5,0,1,42,67,109
p_151,15,0,e_2,443,454,521,4,5,0,12,5,1,4,11,67,78
p_149,15,0,e_2,444,454,521,3,6,0,12,5,1,4,10,67,77
p_142,15,0,e_2,452,454,521,2,8,0,15,5,1,5,2,67,69
p_140,13,0,e_2,455,462,521,3,8,1,15,4,1,4,7,59,66
p_139,13,0,e_2,456,462,521,3,8,1,15,4,1,5,6,59,65
p_137,13,0,e_2,458,462,521,3,8,1,14,4,1,5,4,59,63
p_134,12,0,e_2,462,467,521,3,7,0,13,1,1,4,5,54,59
p_146,10,0,e_2,451,475,521,5,7,1,14,5,1,4,24,46,70
p_128,10,0,e_2,471,475,521,2,6,0,11,4,1,5,4,46,50
p_131,9,0,e_2,467,480,521,5,7,2,12,4,1,4,13,41,54
p_186,1,0,e_3,391,403,524,1,1,0,2,4,1,0,12,121,133
p_199,2,0,e_3,368,408,524,4,4,2,6,4,1,3,40,116,156
p_175,2,0,e_3,399,408,524,8,3,1,0,5,0,3,9,116,125
p_174,3,0,e_3,402,413,524,6,2,1,1,2,0,2,11,111,122
p_171,3,0,e_3,408,413,524,5,3,1,2,5,1,2,5,111,116
p_178,5,0,e_3,398,421,524,5,2,2,0,3,1,2,23,103,126
p_169,11,0,e_3,410,441,524,9,3,0,2,5,1,2,31,83,114
p_164,12,0,e_3,416,446,524,12,4,1,4,5,1,3,30,78,108
p_157,12,0,e_3,427,446,524,9,5,2,7,5,1,4,19,78,97
p_161,13,0,e_3,418,451,524,11,5,1,4,5,1,4,33,73,106
p_165,14,0,e_3,416,456,524,10,3,0,4,5,1,2,40,68,108
p_162,14,0,e_3,417,456,524,10,5,0,4,5,1,4,39,68,107
p_158,14,0,e_3,426,456,524,8,5,0,6,5,1,4,30,68,98
p_141,15,0,e_3,455,461,524,1,8,0,14,5,1,7,6,63,69
p_145,12,0,e_3,451,472,524,3,7,1,13,2,1,6,21,52,73
p_216,1,0,e_1,346,436,563,11,4,3,9,5,1,2,90,127,217
p_192,5,0,e_1,380,450,563,29,2,2,12,1,1,2,70,113,183
p_184,5,0,e_1,393,450,563,26,2,2,9,4,1,5,57,113,170
p_182,5,0,e_1,394,450,563,26,2,2,9,4,1,5,56,113,169
p_179,6,0,e_1,397,455,563,6,1,1,8,4,1,5,58,108,166
p_176,6,0,e_1,398,455,563,6,3,0,8,4,1,6,57,108,165
p_191,7,0,e_1,382,460,563,27,2,2,12,4,1,3,78,103,181
p_189,7,0,e_1,387,460,563,25,1,1,10,4,1,5,73,103,176
p_187,7,0,e_1,391,460,563,25,1,1,9,4,1,6,69,103,172
p_188,8,0,e_1,390,465,563,24,1,1,9,4,1,5,75,98,173
p_198,9,0,e_1,368,470,563,27,5,5,13,5,1,3,102,93,195
p_195,9,0,e_1,376,470,563,26,3,3,13,4,1,3,94,93,187
p_200,12,0,e_1,367,481,563,25,4,4,13,2,1,2,114,82,196
p_124,14,0,e_1,474,489,563,28,6,6,10,5,1,2,15,74,89
p_127,15,0,e_1,473,494,563,27,6,6,9,5,1,1,21,69,90
p_156,1,0,e_0,428,463,590,20,5,4,7,4,1,3,35,127,162
p_185,2,0,e_0,392,468,590,29,3,3,14,2,1,1,76,122,198
p_136,2,0,e_0,460,468,590,13,7,0,0,5,0,3,8,122,130
p_155,3,0,e_0,434,473,590,16,5,4,5,4,1,3,39,117,156
p_133,4,0,e_0,463,478,590,11,7,3,1,5,1,3,15,112,127
p_129,5,0,e_0,470,483,590,8,7,3,2,5,1,3,13,107,120
p_126,6,0,e_0,473,488,590,6,6,2,3,5,1,3,15,102,117
p_135,7,0,e_0,461,493,590,8,7,2,0,5,0,3,32,97,129
p_132,7,0,e_0,463,493,590,8,7,2,1,2,0,3,30,97,127
p_123,12,0,e_0,474,510,590,30,6,6,3,5,1,4,36,80,116
p_109,14,0,e_0,506,518,590,20,6,6,11,5,1,2,12,72,84
p_112,15,0,e_0,497,523,590,21,7,7,8,5,1,1,26,67,93
p_111,15,0,e_0,501,523,590,20,7,7,9,5,1,2,22,67,89
p_103,13,0,e_0,517,531,590,18,7,7,14,2,1,1,14,59,73
p_101,12,0,e_0,521,536,590,19,7,7,14,5,1,2,15,54,69
p_107,1,0,e_3,512,529,646,1,7,0,2,4,1,6,17,117,134
p_143,2,0,e_3,451,534,646,13,6,1,13,2,1,5,83,112,195
p_150,3,0,e_3,444,539,646,13,5,2,12,5,1,4,95,107,202
p_144,4,0,e_3,451,544,646,11,5,1,13,2,1,4,93,102,195
p_147,7,0,e_3,450,555,646,8,4,1,13,2,1,3,105,91,196
p_116,7,0,e_3,490,555,646,1,7,0,8,4,1,6,65,91,156
p_121,9,0,e_3,480,563,646,1,5,0,10,1,1,4,83,83,166
p_152,10,0,e_3,439,568,646,7,5,3,11,5,1,4,129,78,207
p_74,11,0,e_3,567,573,646,7,5,2,10,5,1,4,6,73,79
p_92,13,0,e_3,533,581,646,11,6,0,2,2,1,5,48,65,113
p_88,14,0,e_3,538,586,646,11,6,0,3,2,1,5,48,60,108
p_79,14,0,e_3,549,586,646,9,6,0,5,5,1,5,37,60,97
p_75,14,0,e_3,563,586,646,5,5,0,9,2,1,4,23,60,83
p_68,14,0,e_3,574,586,646,3,6,0,11,5,1,5,12,60,72
p_52,11,0,e_3,591,597,646,2,7,0,13,4,1,6,6,49,55
p_110,1,0,e_2,501,526,649,4,7,3,5,4,1,5,25,123,148
p_102,2,0,e_2,521,531,649,29,7,7,0,3,1,7,10,118,128
p_148,3,0,e_2,447,536,649,13,5,2,14,5,1,4,89,113,202
p_125,4,0,e_2,474,541,649,8,6,2,10,1,1,4,67,108,175
p_118,4,0,e_2,488,541,649,4,6,1,7,4,1,5,53,108,161
p_122,5,0,e_2,477,546,649,6,6,2,10,4,1,5,69,103,172
p_119,5,0,e_2,483,546,649,4,7,1,8,4,1,5,63,103,166
p_154,7,0,e_2,438,554,649,11,5,4,11,5,1,3,116,95,211
p_138,7,0,e_2,456,554,649,9,8,1,15,4,1,5,98,95,193
p_153,8,0,e_2,438,559,649,10,5,4,11,2,1,2,121,90,211
p_130,9,0,e_2,469,564,649,4,7,2,12,4,1,5,95,85,180
p_91,13,0,e_2,535,578,649,11,7,0,3,5,1,6,43,71,114
p_87,15,0,e_2,539,586,649,12,7,0,4,5,1,6,47,63,110
p_72,15,0,e_2,569,586,649,5,5,0,10,5,1,3,17,63,80
p_66,12,0,e_2,577,597,649,4,6,2,13,5,1,3,20,52,72
p_64,1,0,e_0,579,595,684,15,6,2,2,4,1,7,16,89,105
p_71,2,0,e_0,569,600,684,16,5,3,4,4,1,5,31,84,115
p_82,3,0,e_0,547,605,684,21,6,5,10,4,1,3,58,79,137
p_70,3,0,e_0,572,605,684,14,4,2,4,4,1,6,33,79,112
p_78,4,0,e_0,555,610,684,17,5,4,7,4,1,4,55,74,129
p_83,5,0,e_0,546,615,684,19,6,5,10,4,1,2,69,69,138
p_86,6,0,e_0,541,620,684,19,7,5,11,4,1,2,79,64,143
p_80,6,0,e_0,548,620,684,17,6,5,9,4,1,5,72,64,136
p_77,6,0,e_0,557,620,684,15,5,4,7,4,1,5,63,64,127
p_93,7,0,e_0,529,625,684,12,6,2,14,4,1,3,96,59,155
p_89,7,0,e_0,537,625,684,17,7,3,12,4,1,2,88,59,147
p_100,10,0,e_0,522,636,684,21,7,7,15,5,1,3,114,48,162
p_97,10,0,e_0,526,636,684,10,7,0,15,4,1,3,110,48,158
p_36,11,0,e_0,635,641,684,23,7,7,10,5,1,2,6,43,49
p_33,8,0,e_0,647,652,684,22,8,3,9,4,1,2,5,32,37
p_99,1,0,e_1,522,568,689,30,7,7,9,4,1,6,46,121,167
p_90,2,0,e_1,536,573,689,22,7,6,5,4,1,9,37,116,153
p_81,2,0,e_1,547,573,689,22,6,5,3,4,1,10,26,116,142
p_85,3,0,e_1,542,578,689,21,7,5,4,4,1,10,36,111,147
p_84,3,0,e_1,546,578,689,21,6,5,4,4,1,10,32,111,143
p_106,4,0,e_1,512,583,689,28,7,7,11,4,1,4,71,106,177
p_105,4,0,e_1,515,583,689,28,7,7,10,1,1,5,68,106,174
p_108,5,0,e_1,509,588,689,28,6,6,11,4,1,4,79,101,180
p_96,5,0,e_1,527,588,689,15,7,3,7,1,1,8,61,101,162
p_62,5,0,e_1,582,588,689,10,5,1,4,3,1,7,6,101,107
p_98,6,0,e_1,524,593,689,14,7,3,8,4,1,8,69,96,165
p_95,6,0,e_1,527,593,689,14,7,3,7,4,1,9,66,96,162
p_94,6,0,e_1,528,593,689,13,6,3,7,4,1,8,65,96,161
p_104,7,0,e_1,516,598,689,25,7,7,10,4,1,5,82,91,173
p_114,9,0,e_1,494,606,689,28,6,6,15,2,1,2,112,83,195
p_35,4,0,e_0,640,698,740,28,8,8,11,5,1,2,58,42,100
p_32,5,0,e_0,657,703,740,22,8,6,7,4,1,1,46,37,83
p_31,5,0,e_0,662,703,740,21,8,6,6,4,1,3,41,37,78
p_37,7,0,e_0,633,711,740,27,7,7,9,5,1,1,78,29,107
p_25,7,0,e_0,703,711,740,9,2,1,5,5,1,3,8,29,37
p_24,5,0,e_0,707,719,740,20,1,0,6,5,1,3,12,21,33
p_26,3,0,e_0,698,727,740,15,2,1,4,3,0,3,29,13,42
p_27,2,0,e_0,693,732,740,18,2,1,2,5,0,3,39,8,47
p_51,1,0,e_2,591,654,743,12,8,7,14,4,1,5,63,89,152
p_56,2,0,e_2,588,659,743,12,5,4,15,4,1,3,71,84,155
p_48,2,0,e_2,593,659,743,10,8,7,13,4,1,7,66,84,150
p_43,3,0,e_2,599,664,743,8,7,6,12,4,1,6,65,79,144
p_55,4,0,e_2,590,669,743,9,7,6,14,4,1,4,79,74,153
p_42,4,0,e_2,600,669,743,6,7,5,11,4,1,7,69,74,143
p_40,4,0,e_2,601,669,743,6,7,5,11,4,1,7,68,74,142
p_49,5,0,e_2,592,674,743,7,8,6,14,4,1,6,82,69,151
p_45,5,0,e_2,597,674,743,6,7,5,12,4,1,6,77,69,146
p_73,6,0,e_2,568,679,743,12,5,3,10,5,1,2,111,64,175
p_59,6,0,e_2,584,679,743,9,6,1,14,5,1,3,95,64,159
p_57,6,0,e_2,587,679,743,8,5,3,15,4,1,3,92,64,156
p_47,6,0,e_2,594,679,743,6,8,5,13,4,1,7,85,64,149
p_28,6,0,e_2,679,681,743,16,4,3,6,5,1,3,2,62,64
p_60,9,0,e_2,584,692,743,5,6,0,15,5,1,3,108,51,159
p_38,4,0,e_3,627,660,756,1,6,0,5,4,1,5,33,96,129
p_61,5,0,e_3,583,665,756,10,5,1,13,5,1,4,82,91,173
p_54,6,0,e_3,590,670,756,7,5,3,13,4,1,4,80,86,166
p_76,7,0,e_3,559,675,756,13,5,4,8,5,1,4,116,81,197
p_67,8,0,e_3,574,680,756,9,5,2,11,5,1,4,106,76,182
p_63,8,0,e_3,581,680,756,7,5,1,13,5,1,4,99,76,175
p_53,9,0,e_3,590,685,756,4,6,1,13,4,1,5,95,71,166
p_69,10,0,e_3,573,690,756,7,4,2,11,2,1,3,117,66,183
p_58,10,0,e_3,586,690,756,4,5,0,14,4,1,4,104,66,170
p_50,10,0,e_3,592,690,756,2,8,1,12,4,1,7,98,66,164
p_41,10,0,e_3,600,690,756,1,7,0,11,4,1,6,90,66,156
p_34,15,0,e_3,643,707,756,16,8,8,1,4,1,7,64,49,113
p_29,15,0,e_3,678,707,756,7,5,0,8,5,1,4,29,49,78
p_22,10,0,e_3,712,724,756,4,1,0,14,4,1,0,12,32,44
p_18,2,0,e_0,768,777,785,2,0,0,0,3,0,0,9,8,17
p_120,10,0,e_1,481,721,797,30,6,6,12,2,1,2,240,76,316
p_115,10,0,e_1,494,721,797,27,6,6,15,2,1,2,227,76,303
p_113,11,0,e_1,496,726,797,26,6,6,15,4,1,3,230,71,301
p_117,12,0,e_1,490,731,797,26,7,7,14,5,1,2,241,66,307
p_46,13,0,e_1,596,736,797,28,7,7,7,5,1,5,140,61,201
p_44,15,0,e_1,598,744,797,26,7,7,7,5,1,5,146,53,199
p_39,15,0,e_1,609,744,797,24,6,6,9,5,1,5,135,53,188
p_19,12,0,e_1,740,755,797,23,1,1,14,5,1,3,15,42,57
p_21,10,0,e_1,732,763,797,28,1,1,12,5,1,2,31,34,65
p_20,9,0,e_1,737,768,797,27,1,1,13,5,1,2,31,29,60
p_30,5,0,e_2,676,760,847,18,5,4,5,5,1,3,84,87,171
p_23,5,0,e_2,709,760,847,10,1,0,10,4,1,2,51,87,138
p_65,12,0,e_2,578,783,847,4,6,2,13,5,1,3,205,64,269
p_16,13,0,e_2,774,788,847,13,0,0,9,5,1,2,14,59,73
p_17,15,0,e_2,772,796,847,15,0,0,8,5,1,1,24,51,75
p_15,15,0,e_2,782,796,847,15,0,0,12,2,1,2,14,51,65
p_14,15,0,e_2,790,796,847,15,0,0,13,5,1,1,6,51,57
p_12,13,0,e_2,796,804,847,13,0,0,15,4,1,1,8,43,51
p_13,11,0,e_2,794,812,847,11,0,0,15,5,1,1,18,35,53
p_11,11,0,e_2,810,812,847,11,0,0,12,4,1,1,2,35,37
p_8,1,0,e_2,847,853,858,1,0,0,0,3,0,0,6,5,11
p_9,2,0,e_1,845,853,861,2,0,0,0,3,0,0,8,8,16
p_4,1,0,e_1,864,869,874,8,1,1,0,3,0,0,5,5,10
p_3,1,0,e_1,876,881,886,4,1,0,0,3,0,0,5,5,10
p_5,5,0,e_3,860,877,896,5,0,0,0,3,0,0,17,19,36
p_2,3,0,e_3,878,885,896,2,1,0,5,4,1,0,7,11,18
p_10,14,0,e_0,810,855,901,14,0,0,0,3,0,0,45,46,91
p_7,12,0,e_0,851,863,901,12,0,0,13,5,0,1,12,38,50
p_1,2,0,e_1,889,897,905,30,1,1,0,3,0,0,8,8,16
p_6,14,0,e_2,858,902,946,14,0,0,0,3,1,0,44,44,88
p_296,1,0,e_2,20,26,31,1,0,0,0,3,0,0,6,5,11
p_299,3,0,e_1,7,18,37,3,0,0,0,3,0,0,11,19,30
p_298,4,0,e_1,10,23,37,4,0,0,1,5,0,1,13,14,27
p_290,4,0,e_1,43,51,79,6,1,1,1,5,0,1,8,28,36
p_295,5,0,e_1,22,56,79,5,0,0,4,5,1,1,34,23,57
p_286,3,0,e_1,51,64,79,7,2,2,4,3,0,2,13,15,28
p_285,2,0,e_1,54,69,79,7,2,2,5,5,1,3,15,10,25
p_288,1,0,e_1,49,74,79,9,2,2,4,5,0,2,25,5,30
p_300,8,0,e_0,4,30,108,8,0,0,0,3,0,0,26,78,104
p_297,12,0,e_0,18,44,108,12,0,0,4,5,0,1,26,64,90
p_294,13,0,e_0,23,49,108,13,0,0,6,5,0,2,26,59,85
p_293,15,0,e_0,26,57,108,15,0,0,7,5,0,3,31,51,82
p_284,14,0,e_0,55,62,108,8,2,0,14,5,1,2,7,46,53
p_287,12,0,e_0,51,70,108,8,2,0,13,5,1,1,19,38,57
p_291,6,0,e_3,35,56,110,6,0,0,0,3,0,0,21,54,75
p_289,7,0,e_3,47,61,110,4,1,0,3,5,0,1,14,49,63
p_283,10,0,e_3,55,72,110,4,2,0,6,5,0,2,17,38,55
p_276,5,0,e_3,82,89,110,2,2,0,7,4,1,1,7,21,28
p_274,4,0,e_3,84,94,110,2,3,1,6,4,1,2,10,16,26
p_279,2,0,e_3,76,102,110,7,1,0,9,4,1,0,26,8,34
p_275,2,0,e_3,84,102,110,5,3,1,7,4,1,2,18,8,26
p_292,11,0,e_2,30,66,113,11,0,0,0,3,1,0,36,47,83
p_280,12,0,e_2,65,71,113,4,2,0,11,5,0,3,6,42,48
p_281,10,0,e_2,63,79,113,3,2,0,10,5,0,2,16,34,50
p_282,6,0,e_2,62,93,113,7,2,1,10,5,0,1,31,20,51
p_267,1,0,e_3,153,158,163,1,0,0,0,3,0,0,5,5,10
p_277,10,0,e_1,81,112,182,27,2,2,0,5,0,1,31,70,101
p_273,13,0,e_1,95,123,182,21,2,2,5,5,0,2,28,59,87
p_278,15,0,e_1,80,131,182,23,2,2,0,3,0,0,51,51,102
p_272,15,0,e_1,105,131,182,16,1,1,8,5,0,3,26,51,77
p_271,11,0,e_1,127,145,182,11,0,0,14,5,1,1,18,37,55
p_264,5,0,e_1,162,165,182,25,1,1,6,4,1,0,3,17,20
p_258,5,0,e_3,175,181,206,4,1,1,3,5,0,1,6,25,31
p_262,6,0,e_3,164,186,206,6,0,0,0,3,0,0,22,20,42
p_259,6,0,e_3,174,186,206,3,1,0,3,5,0,1,12,20,32
p_252,2,0,e_3,212,220,228,2,0,0,0,3,0,0,8,8,16
p_269,4,0,e_2,146,160,234,4,0,0,0,3,0,0,14,74,88
p_265,12,0,e_2,157,186,234,11,1,0,3,5,0,1,29,48,77
p_263,12,0,e_2,163,186,234,12,0,0,5,5,1,1,23,48,71
p_261,12,0,e_2,170,186,234,11,1,0,7,5,1,1,16,48,64
p_260,13,0,e_2,171,191,234,11,1,0,7,5,1,1,20,43,63
p_255,10,0,e_2,192,202,234,25,1,1,13,4,1,0,10,32,42
p_270,7,0,e_0,133,156,235,7,0,0,0,3,0,0,23,79,102
p_268,10,0,e_0,150,167,235,10,0,0,5,5,0,1,17,68,85
p_266,15,0,e_0,155,184,235,15,1,0,7,2,0,1,29,51,80
p_257,12,0,e_0,179,195,235,7,2,0,14,5,1,1,16,40,56
p_256,8,0,e_0,191,209,235,27,1,1,13,4,1,1,18,26,44
p_251,4,0,e_3,228,243,277,4,0,0,0,3,0,0,15,34,49
p_250,7,0,e_3,236,254,277,5,1,0,2,5,0,1,18,23,41
p_249,7,0,e_3,238,254,277,4,2,0,3,5,0,2,16,23,39
p_248,7,0,e_3,246,254,277,3,2,0,4,5,1,1,8,23,31
p_244,2,0,e_2,271,280,288,30,1,1,0,3,0,0,9,8,17
p_254,3,0,e_1,199,211,298,29,1,1,0,3,0,0,12,87,99
p_253,15,0,e_1,208,249,298,15,0,0,2,5,0,1,41,49,90
p_247,12,0,e_1,248,260,298,7,2,0,15,5,1,1,12,38,50
p_246,12,0,e_1,257,260,298,24,1,1,13,4,1,1,3,38,41
p_243,8,0,e_0,285,295,331,8,0,0,5,5,0,1,10,36,46
p_245,9,0,e_0,269,300,331,23,1,1,0,3,0,0,31,31,62
p_233,2,0,e_0,319,323,331,17,3,2,3,4,1,0,4,8,12
p_222,3,0,e_0,339,350,387,11,3,2,0,3,0,0,11,37,48
p_221,4,0,e_0,341,355,387,9,2,1,0,5,0,1,14,32,46
p_214,4,0,e_0,346,355,387,8,2,1,2,5,0,3,9,32,41
p_210,4,0,e_0,353,355,387,7,2,1,3,5,1,2,2,32,34
p_215,6,0,e_0,346,363,387,6,2,1,2,5,0,2,17,24,41
p_206,6,0,e_0,362,363,387,3,1,0,6,5,1,3,1,24,25
p_209,2,0,e_0,354,377,387,9,2,1,4,5,1,2,23,10,33
p_199,2,0,e_0,368,377,387,5,1,0,5,4,1,2,9,10,19
p_205,1,0,e_0,362,382,387,8,1,0,6,5,1,2,20,5,25
p_242,4,0,e_3,287,302,388,4,0,0,0,3,0,0,15,86,101
p_241,13,0,e_3,300,331,388,10,1,0,3,5,0,1,31,57,88
p_239,13,0,e_3,305,331,388,11,3,1,4,5,1,2,26,57,83
p_240,14,0,e_3,301,336,388,10,1,1,4,3,0,1,35,52,87
p_234,14,0,e_3,314,336,388,6,3,0,8,5,1,2,22,52,74
p_224,13,0,e_3,335,341,388,3,2,0,14,2,1,1,6,47,53
p_226,12,0,e_3,331,346,388,3,2,1,13,2,1,1,15,42,57
p_219,11,0,e_3,342,351,388,2,2,1,13,4,1,1,9,37,46
p_212,9,0,e_3,348,359,388,3,2,1,12,4,1,1,11,29,40
p_238,2,0,e_1,311,320,420,19,3,2,0,3,0,0,9,100,109
p_237,5,0,e_1,313,331,420,16,3,2,0,5,0,1,18,89,107
p_232,5,0,e_1,320,331,420,13,3,2,2,5,1,1,11,89,100
p_230,5,0,e_1,323,331,420,13,3,2,2,5,1,1,8,89,97
p_229,9,0,e_1,323,345,420,9,3,2,3,5,1,1,22,75,97
p_227,9,0,e_1,326,345,420,8,3,2,3,5,1,2,19,75,94
p_220,9,0,e_1,342,345,420,4,2,1,8,5,1,2,3,75,78
p_218,9,0,e_1,343,345,420,4,3,2,9,5,1,2,2,75,77
p_225,10,0,e_1,333,350,420,5,3,1,5,5,1,1,17,70,87
p_213,12,0,e_1,347,358,420,30,2,2,9,5,1,3,11,62,73
p_207,12,0,e_1,355,358,420,28,2,2,11,5,1,3,3,62,65
p_208,13,0,e_1,355,363,420,27,2,2,11,5,1,3,8,57,65
p_203,12,0,e_1,365,368,420,26,1,1,13,4,1,2,3,52,55
p_198,9,0,e_1,368,379,420,27,1,1,12,1,1,2,11,41,52
p_195,9,0,e_1,376,379,420,25,1,1,10,4,1,3,3,41,44
p_236,8,0,e_2,313,339,421,13,3,2,0,3,0,0,26,82,108
p_235,8,0,e_2,314,339,421,12,3,2,0,5,0,1,25,82,107
p_231,10,0,e_2,320,347,421,8,3,2,2,5,0,1,27,74,101
p_228,11,0,e_2,325,352,421,6,3,2,4,5,0,2,27,69,96
p_223,13,0,e_2,339,360,421,30,3,3,8,5,1,2,21,61,82
p_211,14,0,e_2,348,365,421,28,2,2,10,5,1,2,17,56,73
p_202,13,0,e_2,365,370,421,24,1,1,14,4,1,0,5,51,56
p_201,13,0,e_2,366,370,421,24,1,1,14,4,1,1,4,51,55
p_200,12,0,e_2,367,375,421,25,1,1,14,4,1,1,8,46,54
p_194,11,0,e_2,377,380,421,22,1,1,12,4,1,0,3,41,44
p_189,7,0,e_2,387,394,421,7,0,0,9,4,1,0,7,27,34
p_187,7,0,e_2,391,394,421,9,1,1,8,4,1,1,3,27,30
p_178,5,0,e_2,398,402,421,17,4,4,6,4,1,0,4,19,23
p_171,3,0,e_2,408,410,421,16,6,6,4,4,1,0,2,11,13
p_216,1,0,e_1,346,425,490,11,2,1,9,5,1,2,79,65,144
p_186,1,0,e_1,391,425,490,15,1,1,7,4,1,3,34,65,99
p_185,2,0,e_1,392,430,490,14,1,1,7,4,1,3,38,60,98
p_175,2,0,e_1,399,430,490,20,5,5,5,4,1,4,31,60,91
p_174,3,0,e_1,402,435,490,18,5,5,4,4,1,5,33,55,88
p_155,3,0,e_1,434,435,490,15,5,3,3,5,1,4,1,55,56
p_196,5,0,e_1,376,443,490,29,1,1,10,4,1,3,67,47,114
p_192,5,0,e_1,380,443,490,28,1,1,9,4,1,3,63,47,110
p_184,5,0,e_1,393,443,490,11,1,1,6,4,1,5,50,47,97
p_182,5,0,e_1,394,443,490,19,2,2,6,4,1,5,49,47,96
p_191,7,0,e_1,382,451,490,25,1,1,8,4,1,3,69,39,108
p_154,7,0,e_1,438,451,490,10,4,2,4,5,1,3,13,39,52
p_147,7,0,e_1,450,451,490,9,3,1,7,5,1,3,1,39,40
p_217,8,0,e_1,345,456,490,4,3,1,9,2,1,1,111,34,145
p_204,8,0,e_1,364,456,490,30,1,1,13,4,1,2,92,34,126
p_193,12,0,e_0,378,425,495,21,1,1,2,4,1,1,47,70,117
p_161,13,0,e_0,418,430,495,8,8,1,10,5,0,4,12,65,77
p_190,14,0,e_0,382,435,495,18,1,1,1,4,1,1,53,60,113
p_180,14,0,e_0,396,435,495,13,3,0,2,5,0,2,39,60,99
p_172,14,0,e_0,405,435,495,10,5,0,6,5,0,2,30,60,90
p_162,14,0,e_0,417,435,495,7,8,0,10,5,0,3,18,60,78
p_158,14,0,e_0,426,435,495,5,6,0,12,5,1,5,9,60,69
p_168,15,0,e_0,412,440,495,9,6,0,8,5,0,2,28,55,83
p_159,11,0,e_0,424,454,495,9,7,2,12,5,0,5,30,41,71
p_135,7,0,e_0,461,468,495,6,4,0,9,4,1,1,7,27,34
p_132,7,0,e_0,463,468,495,6,4,1,8,4,1,2,5,27,32
p_129,5,0,e_0,470,476,495,6,5,1,7,4,1,1,6,19,25
p_163,4,0,e_0,417,481,495,17,8,6,10,5,0,3,64,14,78
p_125,4,0,e_0,474,481,495,6,7,3,5,4,1,2,7,14,21
p_179,6,0,e_3,397,411,517,17,3,3,1,5,0,3,14,106,120
p_176,6,0,e_3,398,411,517,16,5,4,2,5,0,5,13,106,119
p_167,7,0,e_3,412,416,517,11,6,5,6,5,1,5,4,101,105
p_188,8,0,e_3,390,421,517,8,0,0,0,3,0,0,31,96,127
p_177,9,0,e_3,398,426,517,13,4,2,2,5,0,4,28,91,119
p_173,10,0,e_3,405,431,517,10,5,2,4,5,0,5,26,86,112
p_170,10,0,e_3,408,431,517,9,6,2,5,5,0,6,23,86,109
p_181,11,0,e_3,395,436,517,12,2,1,1,5,0,2,41,81,122
p_169,11,0,e_3,410,436,517,7,5,1,6,2,0,5,26,81,107
p_183,12,0,e_3,393,441,517,12,1,0,0,5,0,1,48,76,124
p_164,12,0,e_3,416,441,517,5,7,0,7,5,1,6,25,76,101
p_157,12,0,e_3,427,441,517,7,6,1,9,5,1,5,14,76,90
p_165,14,0,e_3,416,449,517,7,7,0,7,5,1,6,33,68,101
p_151,15,0,e_3,443,454,517,3,3,0,12,5,1,2,11,63,74
p_149,15,0,e_3,444,454,517,3,4,0,12,5,1,3,10,63,73
p_160,10,0,e_2,421,453,537,10,7,3,0,3,1,0,32,84,116
p_152,10,0,e_2,439,453,537,7,4,2,5,5,0,2,14,84,98
p_146,10,0,e_2,451,453,537,6,3,1,9,5,0,2,2,84,86
p_145,12,0,e_2,451,461,537,4,3,1,10,5,0,2,10,76,86
p_141,15,0,e_2,455,472,537,30,2,2,10,5,1,2,17,65,82
p_124,14,0,e_2,474,477,537,26,7,7,15,4,1,2,3,60,63
p_123,12,0,e_2,474,485,537,28,8,8,15,4,1,1,11,52,63
p_120,10,0,e_2,481,493,537,29,7,7,13,4,1,3,12,44,56
p_121,9,0,e_2,480,498,537,30,7,7,13,4,1,2,18,39,57
p_114,9,0,e_2,494,498,537,26,8,8,10,4,1,3,4,39,43
p_116,7,0,e_2,490,506,537,29,9,9,11,4,1,3,16,31,47
p_108,5,0,e_2,509,514,537,27,10,10,7,4,1,1,5,23,28
p_106,4,0,e_2,512,519,537,27,9,9,6,4,1,2,7,18,25
p_105,4,0,e_2,515,519,537,27,9,9,5,4,1,2,4,18,22
p_102,2,0,e_2,521,527,537,27,10,9,4,4,1,1,6,10,16
p_100,10,0,e_0,522,528,604,19,10,3,8,5,0,4,6,76,82
p_97,10,0,e_0,526,528,604,18,10,3,9,5,0,6,2,76,78
p_113,11,0,e_0,496,533,604,24,8,8,0,3,0,0,37,71,108
p_101,12,0,e_0,521,538,604,17,9,2,8,5,0,3,17,66,83
p_103,13,0,e_0,517,543,604,17,10,1,7,5,0,2,26,61,87
p_92,13,0,e_0,533,543,604,9,9,9,11,2,1,6,10,61,71
p_91,13,0,e_0,535,543,604,13,9,1,11,5,1,6,8,61,69
p_109,14,0,e_0,506,548,604,19,10,10,3,5,0,1,42,56,98
p_88,14,0,e_0,538,548,604,11,8,1,12,2,1,5,10,56,66
p_93,7,0,e_0,529,571,604,20,10,5,10,5,1,6,42,33,75
p_98,6,0,e_0,524,576,604,23,10,6,9,5,0,5,52,28,80
p_95,6,0,e_0,527,576,604,22,10,6,10,5,0,7,49,28,77
p_94,6,0,e_0,528,576,604,22,10,6,10,2,0,6,48,28,76
p_73,6,0,e_0,568,576,604,12,5,3,8,4,1,5,8,28,36
p_96,5,0,e_0,527,581,604,23,10,7,10,5,0,6,54,23,77
p_143,2,0,e_1,451,498,606,14,3,1,7,5,1,3,47,108,155
p_136,2,0,e_1,460,498,606,11,4,1,7,1,1,4,38,108,146
p_150,3,0,e_1,444,503,606,15,4,2,5,5,1,2,59,103,162
p_148,3,0,e_1,447,503,606,13,4,1,6,5,1,3,56,103,159
p_144,4,0,e_1,451,508,606,12,3,1,7,5,1,2,57,98,155
p_133,4,0,e_1,463,508,606,9,4,2,7,4,1,4,45,98,143
p_138,7,0,e_1,456,519,606,8,3,1,8,4,1,3,63,87,150
p_197,8,0,e_1,375,524,606,26,1,1,10,4,1,3,149,82,231
p_153,8,0,e_1,438,524,606,9,4,2,4,5,1,3,86,82,168
p_115,10,0,e_1,494,532,606,25,8,8,1,5,0,7,38,74,112
p_117,12,0,e_1,490,540,606,24,9,9,0,5,0,6,50,66,116
p_127,15,0,e_1,473,551,606,25,7,7,4,4,1,4,78,55,133
p_112,15,0,e_1,497,551,606,20,8,8,2,5,0,8,54,55,109
p_111,15,0,e_1,501,551,606,19,8,8,2,5,1,7,50,55,105
p_87,15,0,e_1,539,551,606,10,8,0,12,2,1,1,12,55,67
p_51,1,0,e_0,591,609,630,13,6,4,3,4,1,1,18,21,39
p_81,2,0,e_0,547,614,630,21,7,5,14,5,1,4,67,16,83
p_56,2,0,e_0,588,614,630,12,7,4,3,1,1,1,26,16,42
p_82,3,0,e_0,547,619,630,20,7,5,14,5,1,5,72,11,83
p_70,3,0,e_0,572,619,630,15,4,3,7,4,1,4,47,11,58
p_110,1,0,e_3,501,522,647,3,8,0,4,1,1,7,21,125,146
p_118,4,0,e_3,488,533,647,3,8,2,7,4,1,7,45,114,159
p_166,5,0,e_3,415,538,647,12,6,5,7,2,1,5,123,109,232
p_122,5,0,e_3,477,538,647,5,7,2,10,4,1,6,61,109,170
p_119,5,0,e_3,483,538,647,4,7,1,9,4,1,6,55,109,164
p_126,6,0,e_3,473,543,647,4,7,1,10,4,1,6,70,104,174
p_104,7,0,e_3,516,548,647,7,9,9,0,3,1,9,32,99,131
p_131,9,0,e_3,467,556,647,3,4,0,12,1,1,3,89,91,180
p_130,9,0,e_3,469,556,647,3,5,0,12,4,1,4,87,91,178
p_128,10,0,e_3,471,561,647,1,5,0,11,4,1,4,90,86,176
p_134,12,0,e_3,462,569,647,1,3,0,13,1,1,2,107,78,185
p_140,13,0,e_3,455,574,647,2,2,0,15,4,1,1,119,73,192
p_139,13,0,e_3,456,574,647,2,3,0,15,4,1,2,118,73,191
p_137,13,0,e_3,458,574,647,1,4,0,14,4,1,3,116,73,189
p_75,14,0,e_3,563,579,647,6,4,1,10,5,1,3,16,68,84
p_156,1,0,e_2,428,542,675,18,6,4,2,5,0,1,114,133,247
p_107,1,0,e_2,512,542,675,30,9,9,6,4,1,3,30,133,163
p_99,1,0,e_2,522,542,675,28,10,9,3,4,1,2,20,133,153
p_90,2,0,e_2,536,547,675,23,9,7,0,3,1,1,11,128,139
p_85,3,0,e_2,542,552,675,21,8,6,1,5,1,3,10,123,133
p_84,3,0,e_2,546,552,675,21,7,6,2,2,1,3,6,123,129
p_78,4,0,e_2,555,557,675,17,5,4,4,5,1,3,2,118,120
p_83,5,0,e_2,546,562,675,19,7,6,2,2,1,3,16,113,129
p_86,6,0,e_2,541,567,675,19,8,6,1,5,0,3,26,108,134
p_80,6,0,e_2,548,567,675,17,6,5,2,5,1,4,19,108,127
p_77,6,0,e_2,557,567,675,15,5,4,4,3,1,3,10,108,118
p_89,7,0,e_2,537,572,675,18,8,5,0,5,0,2,35,103,138
p_76,7,0,e_2,559,572,675,14,5,4,4,5,1,3,13,103,116
p_67,8,0,e_2,574,577,675,9,3,2,7,5,1,2,3,98,101
p_69,10,0,e_2,573,585,675,7,4,2,7,5,1,1,12,90,102
p_35,4,0,e_0,640,654,698,28,10,10,0,3,0,0,14,44,58
p_32,5,0,e_0,657,659,698,22,9,6,4,5,1,1,2,39,41
p_33,8,0,e_0,647,670,698,8,9,9,2,5,0,1,23,28,51
p_31,5,0,e_0,662,681,698,21,9,6,5,5,1,1,19,17,36
p_30,5,0,e_0,676,681,698,18,6,5,6,4,1,1,5,17,22
p_64,1,0,e_1,579,611,716,15,2,1,7,4,1,2,32,105,137
p_71,2,0,e_1,569,616,716,16,4,3,10,4,1,1,47,100,147
p_48,2,0,e_1,593,616,716,11,6,4,3,4,1,4,23,100,123
p_62,5,0,e_1,582,627,716,10,4,0,6,4,1,3,45,89,134
p_36,11,0,e_1,635,647,716,22,10,10,7,5,1,1,12,69,81
p_79,14,0,e_1,549,658,716,9,6,1,14,5,1,1,109,58,167
p_34,15,0,e_1,643,663,716,16,10,10,10,5,1,2,20,53,73
p_28,6,0,e_1,679,692,716,16,6,4,10,4,1,0,13,24,37
p_26,3,0,e_1,698,703,716,15,3,2,5,4,1,1,5,13,18
p_27,2,0,e_1,693,708,716,18,3,2,6,4,1,0,15,8,23
p_24,5,0,e_0,707,720,751,11,2,1,1,5,0,1,13,31,44
p_23,5,0,e_0,709,720,751,10,2,0,1,5,0,2,11,31,42
p_25,7,0,e_0,703,728,751,10,3,2,0,3,0,0,25,23,48
p_43,3,0,e_3,599,658,759,8,7,4,11,4,1,6,59,101,160
p_42,4,0,e_3,600,663,759,7,8,4,11,4,1,7,63,96,159
p_40,4,0,e_3,601,663,759,6,10,4,10,4,1,9,62,96,158
p_38,4,0,e_3,627,663,759,1,9,0,5,4,1,8,36,96,132
p_61,5,0,e_3,583,668,759,10,3,0,15,2,1,2,85,91,176
p_45,5,0,e_3,597,668,759,7,7,3,12,4,1,6,71,91,162
p_59,6,0,e_3,584,673,759,9,5,0,15,2,1,4,89,86,175
p_63,8,0,e_3,581,681,759,8,2,1,14,5,1,1,100,78,178
p_60,9,0,e_3,584,686,759,6,4,0,15,2,1,3,102,73,175
p_41,10,0,e_3,600,691,759,1,9,0,11,4,1,8,91,68,159
p_68,14,0,e_3,574,705,759,3,3,1,13,5,1,2,131,54,185
p_142,15,0,e_3,452,710,759,1,3,0,14,5,1,2,258,49,307
p_72,15,0,e_3,569,710,759,3,4,0,12,5,1,3,141,49,190
p_29,15,0,e_3,678,710,759,8,6,0,7,5,1,5,32,49,81
p_22,10,0,e_3,712,727,759,5,1,0,15,4,1,0,15,32,47
p_55,4,0,e_2,590,689,793,10,6,4,11,5,1,4,99,104,203
p_49,5,0,e_2,592,694,793,9,6,3,11,2,1,5,102,99,201
p_57,6,0,e_2,587,699,793,8,6,2,10,5,1,3,112,94,206
p_54,6,0,e_2,590,699,793,8,6,2,11,2,1,4,109,94,203
p_47,6,0,e_2,594,699,793,7,7,2,11,5,1,6,105,94,199
p_37,7,0,e_2,633,704,793,27,9,9,10,1,1,8,71,89,160
p_53,9,0,e_2,590,712,793,5,6,0,11,2,1,3,122,81,203
p_58,10,0,e_2,586,717,793,5,6,1,10,5,1,2,131,76,207
p_50,10,0,e_2,592,717,793,4,6,0,11,2,1,6,125,76,201
p_74,11,0,e_2,567,722,793,7,5,3,6,5,1,1,155,71,226
p_52,11,0,e_2,591,722,793,3,6,0,11,5,1,5,131,71,202
p_66,12,0,e_2,577,727,793,4,3,1,8,5,1,2,150,66,216
p_65,12,0,e_2,578,727,793,4,2,1,8,5,1,3,149,66,215
p_46,13,0,e_2,596,732,793,29,7,7,12,2,1,6,136,61,197
p_44,15,0,e_2,598,740,793,26,7,7,12,5,1,7,142,53,195
p_13,11,0,e_3,794,830,867,11,0,0,0,3,0,0,36,37,73
p_11,11,0,e_3,810,830,867,6,1,0,5,5,0,1,20,37,57
p_8,1,0,e_3,847,862,867,5,1,0,6,4,1,0,15,5,20
p_17,15,0,e_1,772,820,869,15,0,0,0,3,0,0,48,49,97
p_9,2,0,e_1,845,861,869,5,1,0,7,4,1,0,16,8,24
p_18,2,0,e_0,768,777,871,2,0,0,0,3,0,0,9,94,103
p_16,13,0,e_0,774,812,871,13,0,0,1,5,0,1,38,59,97
p_12,13,0,e_0,796,812,871,13,1,0,8,5,1,2,16,59,75
p_10,14,0,e_0,810,817,871,9,1,0,13,5,1,2,7,54,61
p_15,15,0,e_0,782,822,871,15,0,0,3,5,1,1,40,49,89
p_14,15,0,e_0,790,822,871,15,0,0,6,5,1,2,32,49,81
p_4,1,0,e_0,864,866,871,30,2,2,2,4,1,0,2,5,7
p_3,1,0,e_0,876,882,887,25,1,1,0,3,0,0,6,5,11
p_20,9,0,e_2,737,822,901,28,1,1,14,5,1,2,85,79,164
p_21,10,0,e_2,732,827,901,29,1,1,13,5,1,1,95,74,169
p_19,12,0,e_2,740,835,901,24,1,1,15,4,1,2,95,66,161
p_39,15,0,e_2,609,846,901,24,9,9,15,5,1,9,237,55,292
p_7,12,0,e_2,851,857,901,23,2,2,14,4,1,0,6,44,50
p_5,5,0,e_2,860,880,901,26,3,3,11,4,1,0,20,21,41
p_2,3,0,e_2,878,888,901,22,1,1,5,4,1,1,10,13,23
p_1,2,0,e_2,889,893,901,19,1,1,3,4,1,0,4,8,12
p_6,14,0,e_3,858,911,955,18,2,2,2,4,1,1,53,44,97
p_299,3,0,e_1,7,18,29,3,0,0,0,3,0,0,11,11,22
p_296,1,0,e_3,20,26,31,1,0,0,0,3,0,0,6,5,11
p_290,4,0,e_3,43,50,88,6,1,1,2,5,0,1,7,38,45
p_291,6,0,e_3,35,58,88,6,0,0,0,3,0,0,23,30,53
p_289,7,0,e_3,47,63,88,4,2,0,3,5,0,2,16,25,41
p_279,2,0,e_3,76,80,88,1,1,0,3,4,1,0,4,8,12
p_300,8,0,e_0,4,31,99,8,0,0,0,3,0,0,27,68,95
p_297,12,0,e_0,18,45,99,12,0,0,4,5,0,1,27,54,81
p_294,13,0,e_0,23,50,99,13,1,0,5,5,0,2,27,49,76
p_287,12,0,e_0,51,55,99,8,3,0,13,4,1,1,4,44,48
p_283,10,0,e_0,55,63,99,5,3,0,12,4,1,2,8,36,44
p_285,2,0,e_0,54,89,99,7,3,2,12,4,1,2,35,10,45
p_275,2,0,e_0,84,89,99,29,2,2,4,4,1,2,5,10,15
p_288,1,0,e_0,49,94,99,9,3,2,13,2,1,0,45,5,50
p_292,11,0,e_1,30,65,106,19,1,1,0,3,0,0,35,41,76
p_282,6,0,e_1,62,82,106,13,1,0,10,5,0,2,20,24,44
p_276,5,0,e_1,82,87,106,27,2,2,6,1,1,1,5,19,24
p_286,3,0,e_1,51,95,106,7,3,2,6,5,0,1,44,11,55
p_298,4,0,e_2,10,25,117,4,0,0,0,3,0,0,15,92,107
p_295,5,0,e_2,22,30,117,5,1,0,3,5,0,1,8,87,95
p_284,14,0,e_2,55,59,117,9,3,0,13,5,1,1,4,58,62
p_293,15,0,e_2,26,64,117,16,0,0,4,5,1,1,38,53,91
p_280,12,0,e_2,65,75,117,25,1,1,15,4,1,1,10,42,52
p_281,10,0,e_2,63,83,117,17,1,0,15,5,1,1,20,34,54
p_277,10,0,e_2,81,83,117,22,2,2,11,4,1,1,2,34,36
p_274,4,0,e_2,84,103,117,27,2,2,10,4,1,0,19,14,33
p_269,4,0,e_2,146,161,177,8,1,0,0,3,0,0,15,16,31
p_267,1,0,e_2,153,172,177,9,2,0,1,5,0,1,19,5,24
p_270,7,0,e_1,133,157,182,9,2,1,0,3,0,0,24,25,49
p_264,5,0,e_1,162,165,182,3,1,0,6,4,1,0,3,17,20
p_273,13,0,e_3,95,129,188,15,1,1,2,5,0,1,34,59,93
p_278,15,0,e_3,80,137,188,17,1,1,2,1,1,0,57,51,108
p_272,15,0,e_3,105,137,188,10,2,0,5,5,0,2,32,51,83
p_268,10,0,e_3,150,154,188,1,1,0,11,4,1,0,4,34,38
p_262,6,0,e_3,164,168,188,1,1,0,7,4,1,0,4,20,24
p_254,3,0,e_3,199,210,223,3,0,0,0,3,0,0,11,13,24
p_252,2,0,e_3,212,215,223,1,1,0,3,4,1,0,3,8,11
p_271,11,0,e_0,127,163,236,7,2,2,0,3,0,0,36,73,109
p_263,12,0,e_0,163,168,236,26,1,1,11,2,0,1,5,68,73
p_260,13,0,e_0,171,173,236,22,1,1,13,5,1,2,2,63,65
p_266,15,0,e_0,155,181,236,25,1,1,8,5,0,1,26,55,81
p_261,12,0,e_0,170,192,236,24,1,1,12,5,1,1,22,44,66
p_255,10,0,e_0,192,200,236,10,0,0,12,4,1,2,8,36,44
p_259,6,0,e_0,174,214,236,29,1,1,13,5,1,2,40,22,62
p_258,5,0,e_0,175,219,236,29,1,1,13,5,1,3,44,17,61
p_256,8,0,e_1,191,217,245,8,0,0,0,3,0,0,26,28,54
p_251,4,0,e_1,228,231,245,4,0,0,5,4,1,0,3,14,17
p_265,12,0,e_2,157,215,275,27,1,1,3,5,0,2,58,60,118
p_257,12,0,e_2,179,215,275,21,1,1,0,5,0,1,36,60,96
p_253,15,0,e_2,208,226,275,12,1,0,10,5,0,1,18,49,67
p_249,7,0,e_2,238,252,275,7,0,0,11,4,1,0,14,23,37
p_248,7,0,e_2,246,252,275,7,0,0,9,4,1,1,6,23,29
p_244,2,0,e_3,271,279,287,2,0,0,0,3,0,0,8,8,16
p_250,7,0,e_0,236,260,317,7,0,0,0,3,0,0,24,57,81
p_247,12,0,e_0,248,277,317,12,0,0,3,5,0,1,29,40,69
p_246,12,0,e_0,257,277,317,12,0,0,6,5,0,2,20,40,60
p_243,8,0,e_0,285,291,317,22,1,1,10,4,1,0,6,26,32
p_245,9,0,e_1,269,298,329,9,0,0,0,3,0,0,29,31,60
p_238,2,0,e_1,311,321,329,23,1,1,5,4,1,0,10,8,18
p_242,4,0,e_2,287,302,390,4,0,0,0,3,0,0,15,88,103
p_236,8,0,e_2,313,316,390,16,1,1,7,5,1,2,3,74,77
p_228,11,0,e_2,325,327,390,9,2,1,11,5,1,3,2,63,65
p_241,13,0,e_2,300,335,390,13,0,0,3,5,0,1,35,55,90
p_239,13,0,e_2,305,335,390,14,1,1,5,5,1,1,30,55,85
p_229,9,0,e_2,323,349,390,12,2,1,10,5,1,2,26,41,67
p_220,9,0,e_2,342,349,390,7,3,2,11,4,1,3,7,41,48
p_218,9,0,e_2,343,349,390,7,3,2,11,4,1,3,6,41,47
p_217,8,0,e_2,345,354,390,7,3,1,10,4,1,3,9,36,45
p_215,6,0,e_2,346,362,390,9,4,1,10,4,1,4,16,28,44
p_237,5,0,e_2,313,367,390,20,1,1,7,5,1,1,54,23,77
p_232,5,0,e_2,320,367,390,17,2,2,9,5,1,2,47,23,70
p_221,4,0,e_2,341,372,390,12,3,2,11,4,1,2,31,18,49
p_210,4,0,e_2,353,372,390,10,4,1,8,1,1,3,19,18,37
p_209,2,0,e_2,354,380,390,11,4,2,8,1,1,3,26,10,36
p_235,8,0,e_3,314,327,407,16,1,1,4,5,0,1,13,80,93
p_227,9,0,e_3,326,332,407,11,1,1,8,2,0,1,6,75,81
p_224,13,0,e_3,335,346,407,5,2,1,10,5,1,1,11,61,72
p_240,14,0,e_3,301,351,407,14,0,0,0,3,0,0,50,56,106
p_234,14,0,e_3,314,351,407,10,1,0,4,5,0,1,37,56,93
p_211,14,0,e_3,348,351,407,1,5,0,13,5,1,4,3,56,59
p_207,12,0,e_3,355,359,407,1,4,0,13,4,1,3,4,48,52
p_212,9,0,e_3,348,370,407,6,4,1,13,5,1,3,22,37,59
p_196,5,0,e_3,376,384,407,3,3,0,8,4,1,2,8,23,31
p_192,5,0,e_3,380,384,407,1,4,0,6,4,1,3,4,23,27
p_214,4,0,e_3,346,389,407,11,3,1,13,5,1,2,43,18,61
p_185,2,0,e_3,392,397,407,1,2,0,3,4,1,1,5,10,15
p_216,1,0,e_3,346,402,407,14,2,1,13,2,1,1,56,5,61
p_186,1,0,e_3,391,402,407,3,2,0,4,4,1,1,11,5,16
p_233,2,0,e_0,319,328,414,20,2,2,0,3,0,0,9,86,95
p_230,5,0,e_0,323,339,414,16,2,2,0,5,0,2,16,75,91
p_231,10,0,e_0,320,356,414,12,2,1,0,3,0,1,36,58,94
p_225,10,0,e_0,333,356,414,9,2,1,3,5,1,2,23,58,81
p_219,11,0,e_0,342,361,414,5,3,2,6,5,1,2,19,53,72
p_213,12,0,e_0,347,366,414,3,4,1,7,5,1,3,19,48,67
p_204,8,0,e_0,364,380,414,3,4,1,12,5,1,3,16,34,50
p_197,8,0,e_0,375,380,414,30,3,3,10,4,1,3,5,34,39
p_191,7,0,e_0,382,385,414,29,4,4,8,4,1,2,3,29,32
p_206,6,0,e_0,362,390,414,6,4,1,11,5,1,2,28,24,52
p_222,3,0,e_0,339,401,414,14,3,2,5,2,1,1,62,13,75
p_175,2,0,e_0,399,406,414,30,3,3,4,4,1,1,7,8,15
p_226,12,0,e_1,331,369,429,7,3,1,0,3,0,0,38,60,98
p_203,12,0,e_1,365,369,429,29,4,4,11,5,0,2,4,60,64
p_200,12,0,e_1,367,369,429,28,4,4,11,5,0,2,2,60,62
p_223,13,0,e_1,339,374,429,4,3,1,2,5,0,1,35,55,90
p_208,13,0,e_1,355,374,429,30,4,4,8,5,0,2,19,55,74
p_202,13,0,e_1,365,374,429,27,4,4,11,5,0,2,9,55,64
p_201,13,0,e_1,366,374,429,27,4,4,11,5,0,2,8,55,63
p_194,11,0,e_1,377,382,429,26,4,4,13,4,1,1,5,47,52
p_198,9,0,e_1,368,390,429,30,4,4,12,2,0,1,22,39,61
p_195,9,0,e_1,376,390,429,29,4,4,13,4,1,1,14,39,53
p_188,8,0,e_1,390,395,429,26,2,2,9,1,1,1,5,34,39
p_189,7,0,e_1,387,400,429,27,3,3,10,4,1,1,13,29,42
p_187,7,0,e_1,391,400,429,27,2,2,9,4,1,2,9,29,38
p_179,6,0,e_1,397,405,429,26,2,2,8,4,1,2,8,24,32
p_176,6,0,e_1,398,405,429,26,3,3,7,4,1,3,7,24,31
p_205,1,0,e_2,362,395,510,11,4,2,6,1,1,3,33,115,148
p_199,2,0,e_2,368,400,510,8,4,2,5,4,1,3,32,110,142
p_181,11,0,e_2,395,429,510,21,3,3,1,5,1,3,34,81,115
p_193,12,0,e_2,378,434,510,25,4,4,3,4,1,2,56,76,132
p_183,12,0,e_2,393,434,510,21,3,3,1,5,0,4,41,76,117
p_157,12,0,e_2,427,434,510,8,6,1,10,5,1,4,7,76,83
p_190,14,0,e_2,382,442,510,22,4,4,2,4,1,2,60,68,128
p_180,14,0,e_2,396,442,510,18,2,2,1,5,1,4,46,68,114
p_172,14,0,e_2,405,442,510,16,2,2,3,5,1,3,37,68,105
p_158,14,0,e_2,426,442,510,8,6,0,10,5,1,4,16,68,84
p_168,15,0,e_2,412,447,510,14,4,0,5,5,1,3,35,63,98
p_151,15,0,e_2,443,447,510,5,4,0,14,5,1,2,4,63,67
p_149,15,0,e_2,444,447,510,5,4,0,14,5,1,3,3,63,66
p_145,12,0,e_2,451,458,510,2,3,1,14,4,1,2,7,52,59
p_152,10,0,e_2,439,466,510,7,5,3,13,5,1,2,27,44,71
p_167,7,0,e_3,412,430,525,14,3,3,1,5,0,3,18,95,113
p_177,9,0,e_3,398,438,525,23,2,2,2,4,1,1,40,87,127
p_170,10,0,e_3,408,443,525,10,1,0,0,5,0,1,35,82,117
p_169,11,0,e_3,410,448,525,10,2,0,1,5,0,2,38,77,115
p_164,12,0,e_3,416,453,525,9,4,0,3,5,0,4,37,72,109
p_161,13,0,e_3,418,458,525,10,5,0,3,5,0,5,40,67,107
p_140,13,0,e_3,455,458,525,1,3,0,12,5,1,2,3,67,70
p_137,13,0,e_3,458,460,525,4,3,1,13,5,1,2,2,65,67
p_141,15,0,e_3,455,468,525,3,3,0,12,5,1,2,13,57,70
p_123,12,0,e_3,474,479,525,1,4,0,13,4,1,3,5,46,51
p_128,10,0,e_3,471,487,525,5,3,0,15,4,1,2,16,38,54
p_120,10,0,e_3,481,487,525,2,4,0,12,4,1,3,6,38,44
p_116,7,0,e_3,490,498,525,2,3,0,9,4,1,2,8,27,35
p_144,4,0,e_3,451,509,525,10,3,1,12,5,1,2,58,16,74
p_125,4,0,e_3,474,509,525,10,4,1,14,4,1,3,35,16,51
p_163,4,0,e_0,417,428,530,17,5,5,1,5,0,3,11,102,113
p_166,5,0,e_0,415,433,530,15,4,4,0,5,0,1,18,97,115
p_173,10,0,e_0,405,450,530,21,2,2,2,1,1,0,45,80,125
p_160,10,0,e_0,421,450,530,12,6,3,2,5,0,4,29,80,109
p_159,11,0,e_0,424,455,530,10,6,2,3,5,0,4,31,75,106
p_165,14,0,e_0,416,466,530,12,4,0,0,5,0,2,50,64,114
p_162,14,0,e_0,417,466,530,11,5,0,1,5,0,3,49,64,113
p_142,15,0,e_0,452,471,530,3,4,0,10,5,1,2,19,59,78
p_124,14,0,e_0,474,476,530,30,4,4,15,4,1,2,2,54,56
p_134,12,0,e_0,462,484,530,5,4,1,13,5,1,2,22,46,68
p_121,9,0,e_0,480,495,530,3,4,1,13,4,1,2,15,35,50
p_129,5,0,e_0,470,509,530,10,3,0,15,5,1,2,39,21,60
p_122,5,0,e_0,477,509,530,8,5,2,14,4,1,2,32,21,53
p_106,4,0,e_0,512,514,530,29,5,5,5,4,1,2,2,16,18
p_110,1,0,e_0,501,525,530,6,4,2,8,4,1,2,24,5,29
p_156,1,0,e_1,428,434,553,18,6,5,0,3,1,2,6,119,125
p_174,3,0,e_1,402,442,553,28,2,2,7,4,1,2,40,111,151
p_171,3,0,e_1,408,442,553,17,2,2,6,4,1,2,34,111,145
p_155,3,0,e_1,434,442,553,15,6,5,1,5,1,2,8,111,119
p_184,5,0,e_1,393,450,553,28,3,3,9,4,1,2,57,103,160
p_182,5,0,e_1,394,450,553,28,3,3,8,1,1,2,56,103,159
p_178,5,0,e_1,398,450,553,27,3,3,7,4,1,3,52,103,155
p_154,7,0,e_1,438,458,553,10,5,4,2,5,1,3,20,95,115
p_147,7,0,e_1,450,458,553,8,3,2,5,5,1,2,8,95,103
p_153,8,0,e_1,438,463,553,9,5,4,2,5,1,2,25,90,115
p_139,13,0,e_1,456,480,553,5,4,1,6,5,1,3,24,73,97
p_127,15,0,e_1,473,488,553,29,4,4,11,5,1,2,15,65,80
p_117,12,0,e_1,490,499,553,27,3,3,15,4,1,1,9,54,63
p_113,11,0,e_1,496,504,553,27,4,4,13,4,1,4,8,49,57
p_115,10,0,e_1,494,509,553,28,4,4,13,4,1,2,15,44,59
p_150,3,0,e_2,444,521,630,13,4,3,14,5,1,2,77,109,186
p_148,3,0,e_2,447,521,630,12,4,2,15,4,1,2,74,109,183
p_133,4,0,e_2,463,526,630,12,4,1,11,4,1,3,63,104,167
p_119,5,0,e_2,483,531,630,6,4,1,6,1,1,5,48,99,147
p_126,6,0,e_2,473,536,630,8,4,1,9,4,1,4,63,94,157
p_138,7,0,e_2,456,541,630,10,4,1,13,4,1,3,85,89,174
p_135,7,0,e_2,461,541,630,10,4,1,12,4,1,3,80,89,169
p_132,7,0,e_2,463,541,630,9,4,1,11,4,1,3,78,89,167
p_89,7,0,e_2,537,541,630,20,5,3,6,5,1,5,4,89,93
p_131,9,0,e_2,467,549,630,16,3,0,10,4,1,3,82,81,163
p_130,9,0,e_2,469,549,630,6,3,0,10,4,1,4,80,81,161
p_146,10,0,e_2,451,554,630,5,3,2,14,4,1,2,103,76,179
p_101,12,0,e_2,521,562,630,19,5,5,3,2,0,7,41,68,109
p_103,13,0,e_2,517,567,630,19,4,4,2,5,0,7,50,63,113
p_92,13,0,e_2,533,567,630,15,4,2,5,5,1,6,34,63,97
p_136,2,0,e_3,460,533,645,15,3,1,13,5,1,2,73,112,185
p_118,4,0,e_3,488,541,645,6,3,0,10,4,1,2,53,104,157
p_86,6,0,e_3,541,549,645,20,4,3,4,5,1,3,8,96,104
p_80,6,0,e_3,548,549,645,18,5,3,6,2,1,4,1,96,97
p_97,10,0,e_3,526,565,645,20,4,2,0,5,0,4,39,80,119
p_109,14,0,e_3,506,579,645,21,4,4,5,4,1,3,73,66,139
p_68,14,0,e_3,574,579,645,4,4,1,12,5,1,3,5,66,71
p_111,15,0,e_3,501,584,645,22,3,3,7,4,1,2,83,61,144
p_87,15,0,e_3,539,584,645,12,5,0,3,5,1,4,45,61,106
p_65,12,0,e_3,578,595,645,4,3,1,14,2,1,2,17,50,67
p_63,8,0,e_3,581,609,645,8,5,1,14,5,1,4,28,36,64
p_47,6,0,e_3,594,617,645,6,5,1,12,1,1,4,23,28,51
p_61,5,0,e_3,583,622,645,10,5,0,15,2,1,4,39,23,62
p_45,5,0,e_3,597,622,645,7,6,2,12,4,1,5,25,23,48
p_40,4,0,e_3,601,627,645,6,6,3,10,4,1,5,26,18,44
p_107,1,0,e_0,512,535,648,2,5,1,4,4,1,3,23,113,136
p_99,1,0,e_0,522,535,648,30,5,5,2,4,1,3,13,113,126
p_83,5,0,e_0,546,549,648,20,6,4,4,5,1,4,3,99,102
p_95,6,0,e_0,527,554,648,24,5,3,1,4,1,2,27,94,121
p_94,6,0,e_0,528,554,648,24,5,3,0,4,1,3,26,94,120
p_93,7,0,e_0,529,559,648,22,5,3,0,3,1,4,30,89,119
p_100,10,0,e_0,522,570,648,21,5,5,2,4,1,2,48,78,126
p_112,15,0,e_0,497,587,648,22,3,3,9,4,1,1,90,61,151
p_72,15,0,e_0,569,587,648,4,4,0,10,2,1,2,18,61,79
p_52,11,0,e_0,591,601,648,2,6,1,14,4,1,4,10,47,57
p_41,10,0,e_0,600,606,648,1,6,0,11,4,1,5,6,42,48
p_53,9,0,e_0,590,611,648,5,6,1,15,4,1,3,21,37,58
p_67,8,0,e_0,574,616,648,9,4,2,11,5,1,3,42,32,74
p_73,6,0,e_0,568,624,648,13,4,2,10,5,1,2,56,24,80
p_57,6,0,e_0,587,624,648,8,6,2,15,2,1,3,37,24,61
p_71,2,0,e_0,569,656,678,17,4,2,10,2,1,2,87,22,109
p_56,2,0,e_0,588,656,678,12,6,4,15,4,1,3,68,22,90
p_38,4,0,e_0,627,664,678,30,3,3,5,4,1,1,37,14,51
p_143,2,0,e_1,451,561,679,13,3,2,5,5,1,2,110,118,228
p_102,2,0,e_1,521,561,679,29,5,5,7,4,1,5,40,118,158
p_90,2,0,e_1,536,561,679,26,5,4,4,1,1,5,25,118,143
p_105,4,0,e_1,515,569,679,29,5,5,9,4,1,2,54,110,164
p_108,5,0,e_1,509,574,679,29,4,4,10,4,1,2,65,105,170
p_96,5,0,e_1,527,574,679,25,5,3,6,1,1,5,47,105,152
p_98,6,0,e_1,524,579,679,6,4,4,7,4,1,4,55,100,155
p_77,6,0,e_1,557,579,679,16,5,3,1,5,0,6,22,100,122
p_104,7,0,e_1,516,584,679,25,4,4,9,4,1,3,68,95,163
p_76,7,0,e_1,559,584,679,15,5,3,1,5,0,6,25,95,120
p_114,9,0,e_1,494,592,679,29,4,4,13,4,1,3,98,87,185
p_60,9,0,e_1,584,592,679,6,6,1,7,2,1,5,8,87,95
p_69,10,0,e_1,573,597,679,8,4,2,5,2,1,4,24,82,106
p_58,10,0,e_1,586,597,679,5,6,1,7,5,1,5,11,82,93
p_50,10,0,e_1,592,597,679,3,6,1,9,5,1,6,5,82,87
p_32,5,0,e_0,657,695,722,14,3,2,2,5,1,1,38,27,65
p_31,5,0,e_0,662,695,722,13,3,2,3,5,1,2,33,27,60
p_28,6,0,e_0,679,700,722,7,3,1,0,5,0,1,21,22,43
p_26,3,0,e_0,698,711,722,4,3,1,6,5,1,1,13,11,24
p_64,1,0,e_3,579,650,725,15,4,1,14,5,1,3,71,75,146
p_84,3,0,e_3,546,658,725,22,5,4,5,5,1,4,112,67,179
p_43,3,0,e_3,599,658,725,8,6,3,11,4,1,5,59,67,126
p_33,8,0,e_3,647,675,725,14,3,1,0,5,0,3,28,50,78
p_36,11,0,e_3,635,686,725,21,2,2,2,4,1,1,51,39,90
p_30,5,0,e_3,676,706,725,9,2,1,8,5,1,1,30,19,49
p_27,2,0,e_3,693,717,725,7,2,1,9,4,1,1,24,8,32
p_81,2,0,e_2,547,638,744,22,6,3,9,5,1,6,91,106,197
p_85,3,0,e_2,542,643,744,23,5,4,7,5,1,5,101,101,202
p_82,3,0,e_2,547,643,744,22,6,4,9,5,1,6,96,101,197
p_78,4,0,e_2,555,648,744,19,5,3,10,5,1,5,93,96,189
p_42,4,0,e_2,600,648,744,7,6,3,7,4,1,8,48,96,144
p_54,6,0,e_2,590,656,744,7,6,2,11,4,1,6,66,88,154
p_74,11,0,e_2,567,673,744,9,4,2,13,5,1,4,106,71,177
p_66,12,0,e_2,577,678,744,5,4,2,13,1,1,5,101,66,167
p_91,13,0,e_2,535,683,744,15,5,2,6,5,1,6,148,61,209
p_88,14,0,e_2,538,688,744,13,5,1,6,5,1,5,150,56,206
p_79,14,0,e_2,549,688,744,10,6,1,9,5,1,6,139,56,195
p_75,14,0,e_2,563,688,744,7,5,1,12,5,1,5,125,56,181
p_34,15,0,e_2,643,693,744,16,3,3,3,5,1,6,50,51,101
p_29,15,0,e_2,678,693,744,6,3,0,12,5,1,3,15,51,66
p_25,7,0,e_2,703,719,744,29,3,3,12,4,1,0,16,25,41
p_24,5,0,e_2,707,761,780,30,2,2,11,4,1,1,54,19,73
p_23,5,0,e_2,709,761,780,29,2,2,10,4,1,2,52,19,71
p_18,2,0,e_2,768,772,780,7,1,0,3,4,1,0,4,8,12
p_51,1,0,e_1,591,684,789,12,6,4,9,5,1,6,93,105,198
p_48,2,0,e_1,593,689,789,10,6,3,9,5,1,6,96,100,196
p_70,3,0,e_1,572,694,789,15,4,2,5,5,1,4,122,95,217
p_55,4,0,e_1,590,699,789,9,6,3,9,5,1,5,109,90,199
p_35,4,0,e_1,640,699,789,27,3,3,8,4,1,9,59,90,149
p_62,5,0,e_1,582,704,789,11,6,1,7,5,1,4,122,85,207
p_49,5,0,e_1,592,704,789,8,6,2,9,5,1,6,112,85,197
p_59,6,0,e_1,584,709,789,9,6,0,7,2,1,4,125,80,205
p_37,7,0,e_1,633,714,789,26,2,2,11,4,1,8,81,75,156
p_46,13,0,e_1,596,734,789,29,6,6,10,2,1,6,138,55,193
p_44,15,0,e_1,598,742,789,27,6,6,10,5,1,7,144,47,191
p_39,15,0,e_1,609,742,789,23,6,6,13,5,1,7,133,47,180
p_20,9,0,e_3,737,766,795,9,0,0,0,3,0,0,29,29,58
p_22,10,0,e_0,712,754,800,23,2,2,3,4,1,0,42,46,88
p_21,10,0,e_0,732,754,800,10,0,0,3,5,0,1,22,46,68
p_19,12,0,e_0,740,762,800,12,1,0,5,5,0,1,22,38,60
p_13,11,0,e_1,794,824,875,19,1,1,1,5,0,1,30,51,81
p_16,13,0,e_1,774,832,875,24,1,1,5,4,1,0,58,43,101
p_9,2,0,e_1,845,867,875,9,1,0,9,4,1,0,22,8,30
p_10,14,0,e_2,810,824,878,10,1,0,10,5,0,1,14,54,68
p_17,15,0,e_2,772,829,878,22,1,1,2,1,1,0,57,49,106
p_15,15,0,e_2,782,829,878,19,1,1,0,5,0,1,47,49,96
p_14,15,0,e_2,790,829,878,17,1,1,3,5,0,1,39,49,88
p_8,1,0,e_2,847,873,878,9,1,0,10,4,1,0,26,5,31
p_4,1,0,e_2,864,873,878,4,2,0,4,4,1,1,9,5,14
p_12,13,0,e_3,796,837,880,13,0,0,0,3,0,0,41,43,84
p_5,5,0,e_3,860,863,880,1,2,0,6,4,1,1,3,17,20
p_11,11,0,e_0,810,846,881,11,1,1,0,3,0,0,36,35,71
p_3,1,0,e_1,876,882,887,30,2,2,0,3,0,0,6,5,11
p_2,3,0,e_2,878,889,900,28,2,2,0,3,1,0,11,11,22
p_1,2,0,e_1,889,897,905,19,1,1,0,3,0,0,8,8,16
p_7,12,0,e_3,851,918,956,27,1,1,9,4,1,0,67,38,105
p_6,14,0,e_0,858,925,969,22,2,2,7,4,1,0,67,44,111
p_296,1,0,e_3,20,25,30,1,0,0,0,3,0,0,5,5,10
p_299,3,0,e_1,7,19,30,3,0,0,0,3,0,0,12,11,23
p_298,4,0,e_2,10,25,47,4,0,0,0,3,0,0,15,22,37
p_295,5,0,e_2,22,30,47,5,1,0,3,5,0,1,8,17,25
p_288,1,0,e_2,49,54,75,9,3,2,0,3,0,0,5,21,26
p_285,2,0,e_2,54,59,75,7,3,2,1,2,0,1,5,16,21
p_286,3,0,e_2,51,64,75,7,3,2,0,5,0,1,13,11,24
p_290,4,0,e_3,43,50,88,6,1,1,2,5,0,1,7,38,45
p_291,6,0,e_3,35,58,88,6,0,0,0,3,0,0,23,30,53
p_289,7,0,e_3,47,63,88,4,2,0,3,5,0,2,16,25,41
p_282,6,0,e_3,62,68,88,1,2,0,7,5,1,1,6,20,26
p_283,10,0,e_1,55,62,112,5,3,0,8,5,0,2,7,50,57
p_292,11,0,e_1,30,67,112,11,0,0,0,3,1,0,37,45,82
p_287,12,0,e_1,51,72,112,8,3,0,6,5,0,1,21,40,61
p_274,4,0,e_1,84,98,112,27,1,1,9,4,1,0,14,14,28
p_300,8,0,e_0,4,30,114,8,0,0,0,3,0,0,26,84,110
p_297,12,0,e_0,18,44,114,12,0,0,4,5,0,1,26,70,96
p_294,13,0,e_0,23,49,114,12,1,0,6,5,0,2,26,65,91
p_293,15,0,e_0,26,57,114,16,1,1,7,5,0,3,31,57,88
p_284,14,0,e_0,55,62,114,9,3,0,14,5,1,1,7,52,59
p_280,12,0,e_0,65,70,114,25,2,2,13,4,1,1,5,44,49
p_281,10,0,e_0,63,78,114,27,2,2,14,4,1,0,15,36,51
p_276,5,0,e_0,82,95,114,27,1,1,9,4,1,0,13,19,32
p_275,2,0,e_0,84,106,114,29,1,1,8,4,1,1,22,8,30
p_279,2,0,e_2,76,84,176,2,1,0,0,3,0,0,8,92,100
p_277,10,0,e_2,81,110,176,22,1,1,1,5,0,2,29,66,95
p_278,15,0,e_2,80,127,176,17,1,1,1,5,0,1,47,49,96
p_272,15,0,e_2,105,127,176,12,1,0,9,5,1,2,22,49,71
p_271,11,0,e_2,127,141,176,5,1,1,15,4,1,0,14,35,49
p_269,4,0,e_1,146,160,176,6,1,0,0,3,0,0,14,16,30
p_267,1,0,e_1,153,171,176,7,1,0,2,5,0,1,18,5,23
p_273,13,0,e_3,95,136,177,13,0,0,0,3,0,0,41,41,82
p_254,3,0,e_3,199,211,224,3,0,0,0,3,0,0,12,13,25
p_252,2,0,e_3,212,216,224,1,1,0,3,4,1,0,4,8,12
p_256,8,0,e_2,191,217,243,8,0,0,0,3,0,0,26,26,52
p_270,7,0,e_0,133,156,245,7,1,1,0,3,0,0,23,89,112
p_268,10,0,e_0,150,167,245,29,1,1,5,5,0,1,17,78,95
p_263,12,0,e_0,163,175,245,23,1,1,9,5,1,3,12,70,82
p_261,12,0,e_0,170,175,245,20,1,1,11,5,1,4,5,70,75
p_260,13,0,e_0,171,180,245,19,1,1,11,5,1,4,9,65,74
p_266,15,0,e_0,155,188,245,22,1,1,7,5,0,2,33,57,90
p_257,12,0,e_0,179,199,245,12,0,0,13,5,1,4,20,46,66
p_255,10,0,e_0,192,207,245,10,0,0,14,4,1,3,15,38,53
p_262,6,0,e_0,164,221,245,28,1,1,9,5,1,4,57,24,81
p_259,6,0,e_0,174,221,245,25,1,1,12,2,1,4,47,24,71
p_264,5,0,e_0,162,226,245,30,1,1,8,5,1,2,64,19,83
p_258,5,0,e_0,175,226,245,26,1,1,12,5,1,4,51,19,70
p_251,4,0,e_0,228,231,245,4,0,0,5,4,1,0,3,14,17
p_265,12,0,e_1,157,214,274,25,1,1,3,5,0,2,57,60,117
p_253,15,0,e_1,208,225,274,13,1,0,10,5,0,1,17,49,66
p_250,7,0,e_1,236,251,274,7,0,0,12,4,1,0,15,23,38
p_249,7,0,e_1,238,251,274,7,0,0,11,4,1,1,13,23,36
p_248,7,0,e_1,246,251,274,7,0,0,9,4,1,1,5,23,28
p_244,2,0,e_3,271,280,288,2,0,0,0,3,0,0,9,8,17
p_247,12,0,e_0,248,286,328,12,0,0,0,3,0,0,38,42,80
p_246,12,0,e_0,257,286,328,12,0,0,2,5,0,1,29,42,71
p_243,8,0,e_0,285,300,328,23,1,1,12,5,0,1,15,28,43
p_238,2,0,e_0,311,320,328,22,1,1,5,4,1,0,9,8,17
p_245,9,0,e_2,269,299,330,9,0,0,0,3,0,0,30,31,61
p_233,2,0,e_2,319,322,330,20,2,2,3,4,1,0,3,8,11
p_242,4,0,e_1,287,301,397,26,1,1,0,3,0,0,14,96,110
p_235,8,0,e_1,314,315,397,16,2,1,8,5,1,3,1,82,83
p_231,10,0,e_1,320,323,397,12,2,1,9,5,1,3,3,74,77
p_228,11,0,e_1,325,328,397,10,3,1,10,5,1,4,3,69,72
p_226,12,0,e_1,331,333,397,7,4,1,11,5,1,4,2,64,66
p_241,13,0,e_1,300,338,397,13,0,0,4,5,0,1,38,59,97
p_240,14,0,e_1,301,343,397,14,0,0,4,5,1,1,42,54,96
p_234,14,0,e_1,314,343,397,11,2,0,8,2,1,3,29,54,83
p_213,12,0,e_1,347,351,397,3,3,1,13,4,1,3,4,46,50
p_229,9,0,e_1,323,362,397,12,3,1,10,2,1,3,39,35,74
p_220,9,0,e_1,342,362,397,7,3,2,14,5,1,3,20,35,55
p_218,9,0,e_1,343,362,397,7,3,2,14,4,1,2,19,35,54
p_237,5,0,e_1,313,376,397,19,1,1,7,5,1,2,63,21,84
p_230,5,0,e_1,323,376,397,16,3,2,10,5,1,4,53,21,74
p_209,2,0,e_1,354,387,397,13,3,1,11,4,1,3,33,10,43
p_222,3,0,e_2,339,351,414,14,2,1,0,3,0,0,12,63,75
p_221,4,0,e_2,341,356,414,12,2,1,0,5,0,1,15,58,73
p_210,4,0,e_2,353,356,414,11,3,1,3,5,1,2,3,58,61
p_206,6,0,e_2,362,364,414,8,3,1,6,5,1,1,2,50,52
p_217,8,0,e_2,345,372,414,7,2,1,1,5,0,2,27,42,69
p_198,9,0,e_2,368,377,414,3,3,0,7,5,1,2,9,37,46
p_191,7,0,e_2,382,385,414,2,4,1,8,4,1,2,3,29,32
p_192,5,0,e_2,380,393,414,4,4,2,8,4,1,1,13,21,34
p_185,2,0,e_2,392,404,414,5,3,2,5,1,1,1,12,10,22
p_175,2,0,e_2,399,404,414,3,3,0,4,4,1,2,5,10,15
p_205,1,0,e_2,362,409,414,13,3,2,6,5,1,2,47,5,52
p_186,1,0,e_2,391,409,414,6,3,2,6,4,1,2,18,5,23
p_232,5,0,e_3,320,322,419,17,2,2,4,5,0,2,2,97,99
p_236,8,0,e_3,313,333,419,16,1,1,2,5,0,1,20,86,106
p_227,9,0,e_3,326,338,419,11,3,1,6,5,1,2,12,81,93
p_219,11,0,e_3,342,346,419,5,2,1,10,5,1,1,4,73,77
p_239,13,0,e_3,305,354,419,13,0,0,0,3,0,0,49,65,114
p_224,13,0,e_3,335,354,419,5,3,0,8,5,1,2,19,65,84
p_223,13,0,e_3,339,354,419,4,2,0,9,5,1,1,15,65,80
p_208,13,0,e_3,355,356,419,2,3,1,13,5,1,2,1,63,64
p_211,14,0,e_3,348,361,419,3,3,0,11,5,1,2,13,58,71
p_207,12,0,e_3,355,369,419,3,3,1,13,2,1,2,14,50,64
p_203,12,0,e_3,365,369,419,1,3,0,13,4,1,2,4,50,54
p_200,12,0,e_3,367,369,419,1,3,0,13,4,1,2,2,50,52
p_195,9,0,e_3,376,380,419,1,3,0,10,4,1,2,4,39,43
p_197,8,0,e_3,375,385,419,3,2,0,11,4,1,1,10,34,44
p_189,7,0,e_3,387,390,419,1,3,0,8,4,1,2,3,29,32
p_214,4,0,e_0,346,348,440,11,3,1,4,5,0,1,2,92,94
p_212,9,0,e_0,348,365,440,8,4,2,4,5,1,1,17,75,92
p_225,10,0,e_0,333,370,440,8,3,1,0,3,0,0,37,70,107
p_202,13,0,e_0,365,381,440,30,3,3,9,2,1,2,16,59,75
p_201,13,0,e_0,366,381,440,30,3,3,9,5,1,3,15,59,74
p_193,12,0,e_0,378,386,440,27,5,5,12,5,1,3,8,54,62
p_194,11,0,e_0,377,391,440,29,5,5,12,5,1,2,14,49,63
p_204,8,0,e_0,364,402,440,5,3,1,9,2,1,1,38,38,76
p_188,8,0,e_0,390,402,440,29,3,3,11,1,1,1,12,38,50
p_187,7,0,e_0,391,407,440,30,3,3,11,1,1,1,16,33,49
p_179,6,0,e_0,397,412,440,30,2,2,10,4,1,2,15,28,43
p_176,6,0,e_0,398,412,440,30,2,2,9,4,1,3,14,28,42
p_178,5,0,e_0,398,417,440,30,2,2,9,4,1,3,19,23,42
p_163,4,0,e_0,417,422,440,26,4,4,5,1,1,1,5,18,23
p_171,3,0,e_0,408,427,440,30,3,3,7,4,1,2,19,13,32
p_156,1,0,e_0,428,445,474,21,6,6,3,4,1,0,17,29,46
p_150,3,0,e_0,444,453,474,15,5,4,1,5,0,1,9,21,30
p_148,3,0,e_0,447,453,474,14,5,4,1,5,1,1,6,21,27
p_144,4,0,e_0,451,458,474,12,4,3,2,5,1,3,7,16,23
p_143,2,0,e_0,451,466,474,14,4,3,2,5,1,2,15,8,23
p_136,2,0,e_0,460,466,474,14,4,3,4,4,1,2,6,8,14
p_216,1,0,e_1,346,402,523,14,3,1,13,4,1,2,56,121,177
p_199,2,0,e_1,368,407,523,10,2,1,7,4,1,3,39,116,155
p_166,5,0,e_1,415,418,523,26,4,4,4,5,1,6,3,105,108
p_167,7,0,e_1,412,426,523,25,4,4,3,5,1,5,14,97,111
p_177,9,0,e_1,398,434,523,26,2,2,0,5,0,5,36,89,125
p_173,10,0,e_1,405,439,523,24,4,4,1,5,1,5,34,84,118
p_170,10,0,e_1,408,439,523,23,3,3,2,5,1,5,31,84,115
p_152,10,0,e_1,439,441,523,9,6,2,10,5,1,5,2,82,84
p_181,11,0,e_1,395,446,523,25,2,2,1,4,1,3,51,77,128
p_169,11,0,e_1,410,446,523,22,3,3,2,5,1,5,36,77,113
p_183,12,0,e_1,393,451,523,24,3,3,1,4,1,2,58,72,130
p_164,12,0,e_1,416,451,523,19,4,4,5,5,1,7,35,72,107
p_161,13,0,e_1,418,456,523,17,4,4,5,2,1,6,38,67,105
p_190,14,0,e_1,382,461,523,25,4,4,4,4,1,2,79,62,141
p_180,14,0,e_1,396,461,523,22,2,2,0,4,1,5,65,62,127
p_172,14,0,e_2,405,458,524,20,4,4,2,4,1,1,53,66,119
p_165,14,0,e_2,416,458,524,17,4,4,0,5,0,2,42,66,108
p_168,15,0,e_2,412,463,524,17,4,4,0,4,1,1,51,61,112
p_151,15,0,e_2,443,463,524,9,5,0,9,5,0,3,20,61,81
p_149,15,0,e_2,444,463,524,9,5,0,9,5,0,3,19,61,80
p_142,15,0,e_2,452,463,524,7,4,0,12,5,0,3,11,61,72
p_140,13,0,e_2,455,471,524,4,4,0,13,5,0,3,16,53,69
p_134,12,0,e_2,462,476,524,4,4,1,15,5,1,3,14,48,62
p_128,10,0,e_2,471,484,524,4,5,1,13,4,1,4,13,40,53
p_120,10,0,e_2,481,484,524,6,5,1,11,4,1,4,3,40,43
p_131,9,0,e_2,467,489,524,6,5,2,14,4,1,3,22,35,57
p_121,9,0,e_2,480,489,524,7,5,1,11,4,1,4,9,35,44
p_154,7,0,e_2,438,497,524,12,6,4,8,5,0,2,59,27,86
p_116,7,0,e_2,490,497,524,7,5,2,9,4,1,2,7,27,34
p_129,5,0,e_2,470,505,524,9,5,1,13,4,1,4,35,19,54
p_174,3,0,e_3,402,430,549,2,2,0,5,4,1,1,28,119,147
p_196,5,0,e_3,376,438,549,5,4,3,10,4,1,3,62,111,173
p_184,5,0,e_3,393,438,549,1,3,0,6,4,1,2,45,111,156
p_182,5,0,e_3,394,438,549,1,2,0,6,1,1,1,44,111,155
p_215,6,0,e_3,346,443,549,9,2,1,11,2,1,1,97,106,203
p_153,8,0,e_3,438,451,549,11,5,3,5,5,1,4,13,98,111
p_160,10,0,e_3,421,459,549,10,3,0,0,5,0,3,38,90,128
p_159,11,0,e_3,424,464,549,10,4,0,1,5,0,4,40,85,125
p_157,12,0,e_3,427,469,549,10,5,0,2,5,0,5,42,80,122
p_145,12,0,e_3,451,469,549,4,4,0,8,5,1,3,18,80,98
p_139,13,0,e_3,456,474,549,4,4,0,9,5,1,3,18,75,93
p_137,13,0,e_3,458,474,549,3,4,0,10,2,1,3,16,75,91
p_124,14,0,e_3,474,479,549,3,5,1,13,5,1,4,5,70,75
p_127,15,0,e_3,473,484,549,2,5,0,13,5,1,4,11,65,76
p_117,12,0,e_3,490,495,549,2,4,0,14,4,1,3,5,54,59
p_125,4,0,e_0,474,488,604,13,5,1,0,3,1,2,14,116,130
p_118,4,0,e_0,488,488,604,10,4,2,4,3,0,3,0,116,116
p_122,5,0,e_0,477,495,604,12,6,2,0,5,0,3,18,109,127
p_126,6,0,e_0,473,500,604,11,6,1,0,3,1,1,27,104,131
p_147,7,0,e_0,450,505,604,9,4,3,2,5,1,1,55,99,154
p_138,7,0,e_0,456,505,604,10,5,4,4,5,1,3,49,99,148
p_101,12,0,e_0,521,522,604,24,6,6,12,5,1,3,1,82,83
p_103,13,0,e_0,517,527,604,24,7,7,10,5,1,2,10,77,87
p_109,14,0,e_0,506,532,604,26,5,5,7,5,1,1,26,72,98
p_112,15,0,e_0,497,537,604,27,6,6,5,5,1,2,40,67,107
p_111,15,0,e_0,501,537,604,26,5,5,6,5,1,2,36,67,103
p_88,14,0,e_0,538,542,604,18,9,9,15,4,1,2,4,62,66
p_92,13,0,e_0,533,547,604,21,8,8,14,5,1,2,14,57,71
p_91,13,0,e_0,535,547,604,20,9,9,14,5,1,3,12,57,69
p_100,10,0,e_0,522,558,604,26,9,9,12,2,1,3,36,46,82
p_110,1,0,e_2,501,529,642,10,5,4,6,4,1,1,28,113,141
p_107,1,0,e_2,512,529,642,8,6,3,3,4,1,2,17,113,130
p_119,5,0,e_2,483,543,642,10,4,0,10,4,1,4,60,99,159
p_96,5,0,e_2,527,543,642,30,8,8,0,5,0,3,16,99,115
p_98,6,0,e_2,524,548,642,29,9,9,0,3,1,2,24,94,118
p_95,6,0,e_2,527,548,642,29,8,8,0,5,0,3,21,94,115
p_94,6,0,e_2,528,548,642,29,8,8,1,2,0,2,20,94,114
p_93,7,0,e_2,529,553,642,28,8,8,1,2,0,2,24,89,113
p_89,7,0,e_2,537,553,642,26,9,9,3,5,1,3,16,89,105
p_79,14,0,e_2,549,576,642,14,8,0,6,5,1,2,27,66,93
p_75,14,0,e_2,563,576,642,11,7,0,10,5,1,2,13,66,79
p_87,15,0,e_2,539,581,642,17,8,8,4,5,1,3,42,61,103
p_72,15,0,e_2,569,581,642,11,6,0,12,5,1,2,12,61,73
p_66,12,0,e_2,577,592,642,6,5,0,14,5,1,2,15,50,65
p_52,11,0,e_2,591,597,642,1,6,0,12,1,1,3,6,45,51
p_155,3,0,e_1,434,534,645,17,6,5,9,2,1,5,100,111,211
p_135,7,0,e_1,461,548,645,9,4,3,14,2,1,3,87,97,184
p_146,10,0,e_1,451,559,645,6,4,2,12,5,1,3,108,86,194
p_123,12,0,e_1,474,567,645,5,5,1,14,4,1,4,93,78,171
p_162,14,0,e_1,417,575,645,16,4,4,5,5,1,7,158,70,228
p_158,14,0,e_1,426,575,645,12,5,0,7,2,1,6,149,70,219
p_68,14,0,e_1,574,575,645,9,5,0,14,2,1,3,1,70,71
p_141,15,0,e_1,455,582,645,6,4,0,13,2,1,3,127,63,190
p_65,12,0,e_1,578,593,645,6,5,0,14,5,1,3,15,52,67
p_74,11,0,e_1,567,598,645,7,6,0,12,2,1,2,31,47,78
p_50,10,0,e_1,592,603,645,2,5,1,12,1,1,4,11,42,53
p_41,10,0,e_1,600,603,645,9,7,2,11,4,1,5,3,42,45
p_67,8,0,e_1,574,611,645,9,5,3,14,5,1,3,37,34,71
p_57,6,0,e_1,587,619,645,7,6,2,14,4,1,4,32,26,58
p_62,5,0,e_1,582,624,645,10,4,3,15,4,1,3,42,21,63
p_99,1,0,e_3,522,554,671,5,8,3,6,4,1,7,32,117,149
p_102,2,0,e_3,521,559,671,4,7,2,6,4,1,6,38,112,150
p_90,2,0,e_3,536,559,671,1,9,0,3,4,1,8,23,112,135
p_133,4,0,e_3,463,567,671,11,4,2,11,2,1,3,104,104,208
p_106,4,0,e_3,512,567,671,5,6,2,9,4,1,5,55,104,159
p_105,4,0,e_3,515,567,671,4,7,2,8,4,1,6,52,104,156
p_108,5,0,e_3,509,572,671,4,5,1,9,1,1,4,63,99,162
p_132,7,0,e_3,463,580,671,8,3,2,11,2,1,2,117,91,208
p_104,7,0,e_3,516,580,671,1,7,0,8,4,1,6,64,91,155
p_130,9,0,e_3,469,588,671,5,4,1,12,2,1,3,119,83,202
p_114,9,0,e_3,494,588,671,3,4,0,12,1,1,3,94,83,177
p_115,10,0,e_3,494,593,671,2,4,0,12,1,1,3,99,78,177
p_113,11,0,e_3,496,598,671,1,5,0,12,4,1,4,102,73,175
p_46,13,0,e_3,596,606,671,3,6,0,10,5,1,5,10,65,75
p_44,15,0,e_3,598,614,671,4,6,0,11,2,1,5,16,57,73
p_43,3,0,e_1,599,656,709,16,7,2,11,4,1,4,57,53,110
p_38,4,0,e_1,627,661,709,7,6,2,5,4,1,1,34,48,82
p_45,5,0,e_1,597,666,709,10,6,1,11,1,1,4,69,43,112
p_32,5,0,e_1,657,666,709,29,6,6,3,5,1,3,9,43,52
p_31,5,0,e_1,662,666,709,27,6,6,4,5,1,2,4,43,47
p_33,8,0,e_1,647,677,709,28,6,6,0,5,0,3,30,32,62
p_28,6,0,e_1,679,685,709,22,6,2,8,4,1,1,6,24,30
p_30,5,0,e_1,676,690,709,24,6,3,8,5,1,1,14,19,33
p_27,2,0,e_1,693,701,709,23,4,3,5,4,1,0,8,8,16
p_64,1,0,e_0,579,609,724,14,5,3,5,1,1,6,30,115,145
p_51,1,0,e_0,591,609,724,11,6,1,3,4,1,7,18,115,133
p_81,2,0,e_0,547,614,724,28,8,8,13,4,1,4,67,110,177
p_71,2,0,e_0,569,614,724,16,6,5,7,4,1,6,45,110,155
p_56,2,0,e_0,588,614,724,11,5,2,3,4,1,7,26,110,136
p_85,3,0,e_0,542,619,724,29,8,8,14,1,1,3,77,105,182
p_84,3,0,e_0,546,619,724,28,8,8,13,1,1,3,73,105,178
p_82,3,0,e_0,547,619,724,27,8,8,13,4,1,5,72,105,177
p_70,3,0,e_0,572,619,724,14,5,4,7,4,1,6,47,105,152
p_78,4,0,e_0,555,624,724,17,8,5,11,4,1,5,69,100,169
p_83,5,0,e_0,546,629,724,26,8,8,13,1,1,3,83,95,178
p_86,6,0,e_0,541,634,724,26,8,8,14,4,1,3,93,90,183
p_80,6,0,e_0,548,634,724,24,9,9,13,4,1,5,86,90,176
p_77,6,0,e_0,557,634,724,14,8,4,10,4,1,6,77,90,167
p_73,6,0,e_0,568,634,724,12,6,4,7,1,1,6,66,90,156
p_23,5,0,e_1,709,727,744,16,2,1,0,3,0,0,18,17,35
p_42,4,0,e_2,600,656,752,15,7,2,10,4,1,4,56,96,152
p_40,4,0,e_2,601,656,752,15,7,2,10,1,1,4,55,96,151
p_49,5,0,e_2,592,661,752,7,6,1,12,4,1,4,69,91,160
p_63,8,0,e_2,581,672,752,7,4,3,15,2,1,2,91,80,171
p_60,9,0,e_2,584,677,752,5,5,2,15,4,1,3,93,75,168
p_53,9,0,e_2,590,677,752,4,6,2,13,4,1,4,87,75,162
p_69,10,0,e_2,573,682,752,7,5,1,13,5,1,2,109,70,179
p_58,10,0,e_2,586,682,752,4,6,1,14,4,1,4,96,70,166
p_29,15,0,e_2,678,699,752,13,6,0,9,5,1,1,21,53,74
p_22,10,0,e_2,712,716,752,10,2,1,11,4,1,2,4,36,40
p_25,7,0,e_2,703,727,752,16,2,1,14,4,1,0,24,25,49
p_24,5,0,e_2,707,735,752,17,2,1,13,4,1,1,28,17,45
p_48,2,0,e_3,593,679,779,10,5,1,10,5,1,4,86,100,186
p_55,4,0,e_3,590,687,779,9,5,2,9,5,1,4,97,92,189
p_35,4,0,e_3,640,687,779,3,6,2,7,1,1,5,47,92,139
p_61,5,0,e_3,583,692,779,9,4,3,8,5,1,3,109,87,196
p_59,6,0,e_3,584,697,779,8,5,3,8,5,1,4,113,82,195
p_54,6,0,e_3,590,697,779,7,5,2,9,5,1,4,107,82,189
p_47,6,0,e_3,594,697,779,6,6,1,10,5,1,5,103,82,185
p_37,7,0,e_3,633,702,779,2,6,0,9,4,1,5,69,77,146
p_39,15,0,e_3,609,728,779,2,6,0,13,5,1,5,119,51,170
p_21,10,0,e_3,732,745,779,4,1,0,14,4,1,0,13,34,47
p_20,9,0,e_3,737,750,779,4,2,1,13,4,1,1,13,29,42
p_18,2,0,e_1,768,776,784,1,1,0,0,3,0,0,8,8,16
p_26,3,0,e_0,698,735,832,21,3,2,7,4,1,4,37,97,134
p_76,7,0,e_0,559,749,832,13,7,3,10,4,1,5,190,83,273
p_97,10,0,e_0,526,760,832,25,8,8,13,2,1,3,234,72,306
p_36,11,0,e_0,635,765,832,28,7,7,6,5,1,2,130,67,197
p_19,12,0,e_0,740,770,832,30,3,3,4,5,1,4,30,62,92
p_16,13,0,e_0,774,775,832,19,1,1,13,5,1,1,1,57,58
p_34,15,0,e_0,643,783,832,21,6,6,8,5,1,3,140,49,189
p_17,15,0,e_0,772,783,832,17,1,1,12,5,1,1,11,49,60
p_13,11,0,e_0,794,797,832,11,0,0,12,4,1,0,3,35,38
p_10,14,0,e_2,810,827,879,14,1,0,9,5,0,1,17,52,69
p_15,15,0,e_2,782,832,879,15,0,0,0,3,0,0,50,47,97
p_14,15,0,e_2,790,832,879,15,0,0,2,5,0,1,42,47,89
p_11,11,0,e_3,810,845,880,11,0,0,0,3,0,0,35,35,70
p_12,13,0,e_1,796,837,882,13,0,0,0,3,0,0,41,45,86
p_5,5,0,e_1,860,863,882,2,1,0,6,4,1,0,3,19,22
p_4,1,0,e_1,864,877,882,4,1,0,5,4,1,0,13,5,18
p_2,3,0,e_2,878,890,901,28,1,1,0,3,1,0,12,11,23
p_1,2,0,e_1,889,898,906,2,0,0,0,3,0,0,9,8,17
p_8,1,0,e_0,847,850,941,10,1,0,0,5,0,1,3,91,94
p_9,2,0,e_0,845,855,941,13,0,0,0,3,0,0,10,86,96
p_7,12,0,e_0,851,887,941,27,1,1,1,5,1,1,36,54,90
p_6,14,0,e_0,858,895,941,23,1,1,3,5,1,1,37,46,83
p_3,1,0,e_0,876,936,941,30,1,1,8,5,1,2,60,5,65
p_299,3,0,e_1,7,19,32,3,0,0,0,3,0,0,12,13,25
p_296,1,0,e_1,20,27,32,23,1,1,3,4,1,0,7,5,12
p_298,4,0,e_2,10,24,46,4,0,0,0,3,0,0,14,22,36
p_295,5,0,e_2,22,29,46,19,1,1,3,5,0,1,7,17,24
p_290,4,0,e_1,43,50,80,19,2,2,2,5,0,1,7,30,37
p_291,6,0,e_1,35,58,80,19,2,2,0,3,0,0,23,22,45
p_288,1,0,e_1,49,75,80,19,2,2,4,3,0,1,26,5,31
p_300,8,0,e_0,4,31,101,8,0,0,0,3,0,0,27,70,97
p_292,11,0,e_0,30,42,101,16,2,2,8,5,0,2,12,59,71
p_294,13,0,e_0,23,50,101,12,1,0,6,5,0,1,27,51,78
p_287,12,0,e_0,51,55,101,8,2,1,13,4,1,1,4,46,50
p_283,10,0,e_0,55,63,101,8,2,1,12,4,1,1,8,38,46
p_282,6,0,e_0,62,77,101,11,2,1,10,4,1,2,15,24,39
p_286,3,0,e_0,51,88,101,17,2,2,13,4,1,0,37,13,50
p_279,2,0,e_0,76,93,101,11,3,2,6,1,1,1,17,8,25
p_275,2,0,e_0,84,93,101,9,3,2,4,4,1,2,9,8,17
p_297,12,0,e_3,18,57,121,12,0,0,0,3,0,0,39,64,103
p_293,15,0,e_3,26,68,121,13,1,0,2,5,0,1,42,53,95
p_280,12,0,e_3,65,79,121,4,3,1,14,5,1,2,14,42,56
p_281,10,0,e_3,63,87,121,6,2,1,14,5,1,1,24,34,58
p_277,10,0,e_3,81,87,121,2,2,0,12,4,1,1,6,34,40
p_276,5,0,e_3,82,104,121,7,2,1,12,4,1,1,22,17,39
p_285,2,0,e_2,54,56,142,17,2,2,2,5,0,1,2,86,88
p_289,7,0,e_2,47,73,142,14,2,2,0,3,0,0,26,69,95
p_284,14,0,e_2,55,96,142,4,2,1,2,5,0,2,41,46,87
p_274,4,0,e_2,84,128,142,7,3,2,10,5,1,1,44,14,58
p_273,13,0,e_1,95,122,181,25,2,2,4,5,0,1,27,59,86
p_278,15,0,e_1,80,130,181,27,2,2,0,3,0,0,50,51,101
p_270,7,0,e_1,133,156,181,13,1,1,14,4,1,0,23,25,48
p_264,5,0,e_1,162,164,181,14,2,1,6,4,1,0,2,17,19
p_272,15,0,e_0,105,153,206,20,1,1,0,3,0,0,48,53,101
p_265,12,0,e_0,157,164,206,8,2,1,14,4,1,1,7,42,49
p_262,6,0,e_0,164,184,206,13,2,1,12,1,1,1,20,22,42
p_259,6,0,e_0,174,184,206,10,3,1,9,4,1,2,10,22,32
p_267,1,0,e_0,153,201,206,13,1,1,15,4,1,0,48,5,53
p_271,11,0,e_3,127,162,229,11,0,0,0,3,0,0,35,67,102
p_266,15,0,e_3,155,176,229,6,1,0,9,5,0,1,21,53,74
p_261,12,0,e_3,170,187,229,5,2,1,13,5,1,1,17,42,59
p_257,12,0,e_3,179,187,229,2,3,0,14,4,1,2,8,42,50
p_258,5,0,e_3,175,210,229,10,2,0,15,2,1,1,35,19,54
p_252,2,0,e_3,212,221,229,3,1,0,5,4,1,0,9,8,17
p_269,4,0,e_2,146,161,237,12,1,1,0,3,0,0,15,76,91
p_268,10,0,e_2,150,181,237,5,1,1,1,5,0,1,31,56,87
p_263,12,0,e_2,163,189,237,7,2,1,4,5,1,1,26,48,74
p_260,13,0,e_2,171,194,237,4,3,1,7,5,1,2,23,43,66
p_254,3,0,e_2,199,226,237,6,2,1,12,4,1,0,27,11,38
p_256,8,0,e_1,191,218,260,3,2,0,0,3,0,0,27,42,69
p_255,10,0,e_1,192,226,260,1,2,0,0,5,0,1,34,34,68
p_251,4,0,e_1,228,246,260,26,1,1,10,4,1,0,18,14,32
p_249,7,0,e_3,238,262,287,7,0,0,0,3,0,0,24,25,49
p_244,2,0,e_3,271,279,287,3,1,0,5,4,1,0,8,8,16
p_253,15,0,e_0,208,256,305,21,2,2,0,3,0,0,48,49,97
p_246,12,0,e_0,257,267,305,6,1,0,15,4,1,0,10,38,48
p_250,7,0,e_2,236,260,317,7,0,0,0,3,1,0,24,57,81
p_248,7,0,e_2,246,260,317,5,1,0,2,5,0,1,14,57,71
p_247,12,0,e_2,248,277,317,10,1,0,3,5,0,1,29,40,69
p_243,8,0,e_2,285,291,317,23,1,1,10,4,1,0,6,26,32
p_245,9,0,e_1,269,299,330,26,1,1,0,3,0,0,30,31,61
p_238,2,0,e_1,311,322,330,19,3,2,6,4,1,0,11,8,19
p_233,2,0,e_1,319,322,330,16,4,2,3,4,1,1,3,8,11
p_242,4,0,e_3,287,301,393,4,0,0,0,3,1,0,14,92,106
p_241,13,0,e_3,300,330,393,9,0,0,4,3,0,0,30,63,93
p_240,14,0,e_3,301,335,393,10,1,1,4,3,0,1,34,58,92
p_219,11,0,e_3,342,346,393,1,4,0,12,4,1,3,4,47,51
p_225,10,0,e_3,333,351,393,4,3,0,14,5,1,2,18,42,60
p_235,8,0,e_3,314,359,393,12,3,2,8,5,1,2,45,34,79
p_217,8,0,e_3,345,359,393,3,5,1,11,4,1,4,14,34,48
p_206,6,0,e_3,362,367,393,2,3,0,8,4,1,2,5,26,31
p_214,4,0,e_3,346,375,393,7,4,2,11,4,1,3,29,18,47
p_210,4,0,e_3,353,375,393,6,4,1,10,4,1,3,22,18,40
p_222,3,0,e_3,339,380,393,10,3,2,13,4,1,2,41,13,54
p_199,2,0,e_3,368,385,393,4,3,2,6,4,1,2,17,8,25
p_236,8,0,e_0,313,332,410,12,3,2,2,5,0,1,19,78,97
p_239,13,0,e_0,305,349,410,10,3,1,0,3,0,0,44,61,105
p_234,14,0,e_0,314,354,410,6,3,0,2,5,0,2,40,56,96
p_207,12,0,e_0,355,362,410,27,4,4,14,4,1,4,7,48,55
p_212,9,0,e_0,348,373,410,2,5,1,13,2,1,3,25,37,62
p_198,9,0,e_0,368,373,410,27,3,3,11,4,1,4,5,37,42
p_196,5,0,e_0,376,387,410,29,3,3,8,4,1,3,11,23,34
p_192,5,0,e_0,380,387,410,28,2,2,7,4,1,4,7,23,30
p_221,4,0,e_0,341,392,410,8,4,2,11,5,1,2,51,18,69
p_209,2,0,e_0,354,400,410,8,4,3,14,2,1,3,46,10,56
p_185,2,0,e_0,392,400,410,28,2,2,4,1,1,2,8,10,18
p_216,1,0,e_0,346,405,410,10,5,4,12,5,1,3,59,5,64
p_186,1,0,e_0,391,405,410,30,2,2,4,1,1,2,14,5,19
p_237,5,0,e_2,313,334,427,15,3,2,1,4,1,0,21,93,114
p_232,5,0,e_2,320,334,427,13,4,2,1,5,0,1,14,93,107
p_230,5,0,e_2,323,334,427,12,4,2,1,5,0,2,11,93,104
p_229,9,0,e_2,323,348,427,8,4,2,1,5,0,2,25,79,104
p_231,10,0,e_2,320,353,427,8,4,2,1,5,0,1,33,74,107
p_228,11,0,e_2,325,358,427,5,4,2,2,5,0,3,33,69,102
p_213,12,0,e_2,347,363,427,29,5,5,9,2,1,3,16,64,80
p_208,13,0,e_2,355,368,427,26,4,4,10,5,1,3,13,59,72
p_203,12,0,e_2,365,373,427,24,4,4,12,5,1,4,8,54,62
p_200,12,0,e_2,367,373,427,24,3,3,13,5,1,5,6,54,60
p_195,9,0,e_2,376,384,427,25,3,3,11,4,1,3,8,43,51
p_204,8,0,e_2,364,389,427,29,4,4,12,5,1,3,25,38,63
p_191,7,0,e_2,382,394,427,26,3,3,10,4,1,4,12,33,45
p_189,7,0,e_2,387,394,427,25,2,2,8,4,1,4,7,33,40
p_187,7,0,e_2,391,394,427,23,2,2,8,4,1,3,3,33,36
p_227,9,0,e_1,326,359,440,7,4,2,1,4,1,0,33,81,114
p_220,9,0,e_1,342,359,440,3,5,2,4,5,0,3,17,81,98
p_218,9,0,e_1,343,359,440,3,5,2,4,5,0,3,16,81,97
p_226,12,0,e_1,331,370,440,3,3,1,0,5,0,1,39,70,109
p_224,13,0,e_1,335,375,440,7,3,0,1,5,0,2,40,65,105
p_223,13,0,e_1,339,375,440,30,4,4,3,5,0,3,36,65,101
p_202,13,0,e_1,365,375,440,23,4,4,11,5,1,3,10,65,75
p_201,13,0,e_1,366,375,440,23,4,4,11,5,1,3,9,65,74
p_211,14,0,e_1,348,380,440,27,5,5,6,5,0,3,32,60,92
p_193,12,0,e_1,378,388,440,21,3,3,13,5,1,3,10,52,62
p_194,11,0,e_1,377,393,440,23,3,3,13,5,1,2,16,47,63
p_177,9,0,e_1,398,401,440,18,4,3,10,4,1,2,3,39,42
p_197,8,0,e_1,375,406,440,26,3,3,13,2,1,1,31,34,65
p_188,8,0,e_1,390,406,440,23,2,2,12,4,1,2,16,34,50
p_176,6,0,e_1,398,414,440,21,4,3,10,4,1,3,16,26,42
p_184,5,0,e_3,393,410,505,5,1,1,0,3,1,1,17,95,112
p_181,11,0,e_3,395,430,505,17,3,2,0,5,0,3,35,75,110
p_183,12,0,e_3,393,435,505,12,2,2,0,3,1,2,42,70,112
p_164,12,0,e_3,416,435,505,10,4,1,6,5,1,3,19,70,89
p_161,13,0,e_3,418,440,505,8,4,1,7,5,1,3,22,65,87
p_190,14,0,e_3,382,445,505,19,2,2,3,4,1,1,63,60,123
p_180,14,0,e_3,396,445,505,13,4,0,1,5,0,4,49,60,109
p_172,14,0,e_3,405,445,505,11,4,0,3,5,0,4,40,60,100
p_165,14,0,e_3,416,445,505,7,4,0,7,5,1,3,29,60,89
p_162,14,0,e_3,417,445,505,7,4,0,7,5,1,3,28,60,88
p_158,14,0,e_3,426,445,505,4,5,0,10,5,1,4,19,60,79
p_145,12,0,e_3,451,453,505,1,4,0,13,4,1,3,2,52,54
p_152,10,0,e_3,439,461,505,5,4,1,13,2,1,3,22,44,66
p_154,7,0,e_3,438,472,505,9,4,2,12,5,1,3,34,33,67
p_138,7,0,e_3,456,472,505,5,4,1,12,4,1,3,16,33,49
p_167,7,0,e_0,412,433,524,16,4,3,0,5,0,3,21,91,112
p_173,10,0,e_0,405,444,524,15,4,3,1,4,1,0,39,80,119
p_170,10,0,e_0,408,444,524,14,4,3,1,4,1,1,36,80,116
p_169,11,0,e_0,410,449,524,12,3,2,0,3,1,1,39,75,114
p_159,11,0,e_0,424,449,524,8,5,3,4,5,0,4,25,75,100
p_168,15,0,e_0,412,463,524,10,4,0,0,5,0,2,51,61,112
p_151,15,0,e_0,443,463,524,1,5,0,10,5,1,3,20,61,81
p_149,15,0,e_0,444,463,524,9,4,0,10,5,1,2,19,61,80
p_128,10,0,e_0,471,480,524,27,4,4,13,4,1,5,9,44,53
p_131,9,0,e_0,467,485,524,30,4,4,14,4,1,4,18,39,57
p_130,9,0,e_0,469,485,524,29,4,4,14,4,1,5,16,39,55
p_147,7,0,e_0,450,493,524,6,4,1,11,5,1,2,43,31,74
p_133,4,0,e_0,463,504,524,6,4,1,15,2,1,3,41,20,61
p_148,3,0,e_0,447,509,524,11,4,2,11,5,1,2,62,15,77
p_143,2,0,e_0,451,514,524,11,5,4,11,5,1,3,63,10,73
p_205,1,0,e_2,362,432,549,6,4,3,12,2,1,2,70,117,187
p_175,2,0,e_2,399,437,549,24,4,4,6,4,1,2,38,112,150
p_174,3,0,e_2,402,442,549,23,4,4,6,4,1,3,40,107,147
p_171,3,0,e_2,408,442,549,20,4,3,4,4,1,4,34,107,141
p_178,5,0,e_2,398,450,549,22,4,3,6,1,1,1,52,99,151
p_215,6,0,e_2,346,455,549,5,5,2,9,5,1,3,109,94,203
p_179,6,0,e_2,397,455,549,21,4,3,7,4,1,2,58,94,152
p_153,8,0,e_2,438,463,549,8,5,2,2,5,1,4,25,86,111
p_157,12,0,e_2,427,477,549,6,5,2,0,5,0,5,50,72,122
p_139,13,0,e_2,456,482,549,29,4,4,6,5,1,3,26,67,93
p_142,15,0,e_2,452,490,549,27,5,5,5,5,1,3,38,59,97
p_141,15,0,e_2,455,490,549,27,4,4,6,5,1,3,35,59,94
p_127,15,0,e_2,473,490,549,22,5,5,11,5,1,3,17,59,76
p_117,12,0,e_2,490,501,549,22,6,6,15,4,1,3,11,48,59
p_120,10,0,e_2,481,509,549,25,7,7,13,2,1,2,28,40,68
p_156,1,0,e_1,428,445,556,17,5,4,3,4,1,3,17,111,128
p_163,4,0,e_1,417,456,556,17,4,3,6,4,1,1,39,100,139
p_144,4,0,e_1,451,456,556,8,5,2,3,5,1,3,5,100,105
p_182,5,0,e_1,394,461,556,23,3,2,11,4,1,1,67,95,162
p_166,5,0,e_1,415,461,556,17,4,3,6,4,1,1,46,95,141
p_160,10,0,e_1,421,478,556,10,5,4,5,4,1,1,57,78,135
p_146,10,0,e_1,451,478,556,2,5,0,3,5,1,3,27,78,105
p_134,12,0,e_1,462,486,556,28,4,4,5,5,1,2,24,70,94
p_123,12,0,e_1,474,486,556,25,5,5,9,5,1,3,12,70,82
p_140,13,0,e_1,455,491,556,29,4,4,4,5,1,3,36,65,101
p_137,13,0,e_1,458,491,556,28,4,4,4,5,1,3,33,65,98
p_124,14,0,e_1,474,496,556,23,5,5,9,5,1,3,22,60,82
p_113,11,0,e_1,496,507,556,21,6,6,14,2,1,3,11,49,60
p_114,9,0,e_1,494,515,556,24,6,6,13,5,1,3,21,41,62
p_116,7,0,e_1,490,523,556,26,6,6,13,2,1,2,33,33,66
p_136,2,0,e_3,460,513,635,8,4,2,10,4,1,3,53,122,175
p_155,3,0,e_3,434,518,635,13,4,2,12,5,1,3,84,117,201
p_150,3,0,e_3,444,518,635,11,4,0,14,2,1,3,74,117,191
p_125,4,0,e_3,474,523,635,3,5,2,7,4,1,4,49,112,161
p_129,5,0,e_3,470,528,635,2,4,0,7,4,1,3,58,107,165
p_122,5,0,e_3,477,528,635,1,6,0,6,1,1,5,51,107,158
p_126,6,0,e_3,473,533,635,1,4,0,7,4,1,3,60,102,162
p_95,6,0,e_3,527,533,635,17,5,3,5,2,1,4,6,102,108
p_94,6,0,e_3,528,533,635,17,5,3,5,5,1,4,5,102,107
p_135,7,0,e_3,461,538,635,3,4,0,10,4,1,3,77,97,174
p_132,7,0,e_3,463,538,635,3,4,0,10,4,1,3,75,97,172
p_93,7,0,e_3,529,538,635,16,5,2,5,5,1,4,9,97,106
p_89,7,0,e_3,537,538,635,14,4,3,7,2,1,3,1,97,98
p_97,10,0,e_3,526,551,635,14,5,1,4,5,1,4,25,84,109
p_92,13,0,e_3,533,562,635,9,4,1,6,2,1,3,29,73,102
p_110,1,0,e_0,501,529,646,30,7,7,5,4,1,4,28,117,145
p_107,1,0,e_0,512,529,646,25,6,6,2,4,1,3,17,117,134
p_100,10,0,e_0,522,558,646,6,5,5,0,4,1,3,36,88,124
p_101,12,0,e_0,521,566,646,13,6,1,1,4,1,2,45,80,125
p_103,13,0,e_0,517,571,646,12,6,1,1,4,1,2,54,75,129
p_112,15,0,e_0,497,579,646,17,6,6,6,4,1,3,82,67,149
p_65,12,0,e_0,578,590,646,2,7,1,15,5,1,6,12,56,68
p_52,11,0,e_0,591,595,646,30,8,8,12,4,1,6,4,51,55
p_69,10,0,e_0,573,600,646,5,7,3,13,5,1,4,27,46,73
p_67,8,0,e_0,574,608,646,7,7,3,14,5,1,5,34,38,72
p_73,6,0,e_0,568,616,646,10,7,1,12,5,1,4,48,30,78
p_45,5,0,e_0,597,621,646,5,9,2,11,4,1,6,24,25,49
p_42,4,0,e_0,600,626,646,5,9,2,10,4,1,6,26,20,46
p_85,3,0,e_0,542,631,646,20,6,4,5,5,1,4,89,15,104
p_84,3,0,e_0,546,631,646,18,7,4,6,5,1,5,85,15,100
p_90,2,0,e_2,536,557,667,20,5,4,3,4,1,5,21,110,131
p_106,4,0,e_2,512,565,667,22,6,4,9,4,1,4,53,102,155
p_119,5,0,e_2,483,570,667,30,6,6,13,5,1,3,87,97,184
p_108,5,0,e_2,509,570,667,22,7,3,10,1,1,3,61,97,158
p_121,9,0,e_2,480,584,667,26,7,7,13,5,1,2,104,83,187
p_115,10,0,e_2,494,589,667,23,6,6,14,4,1,4,95,78,173
p_58,10,0,e_2,586,589,667,2,8,1,9,5,1,4,3,78,81
p_79,14,0,e_2,549,603,667,6,7,1,0,5,0,6,54,64,118
p_68,14,0,e_2,574,603,667,1,7,0,6,5,1,4,29,64,93
p_111,15,0,e_2,501,608,667,16,6,6,12,1,1,3,107,59,166
p_72,15,0,e_2,569,608,667,1,7,0,5,2,1,4,39,59,98
p_44,15,0,e_2,598,608,667,25,9,9,12,5,1,7,10,59,69
p_41,10,0,e_2,600,625,667,29,9,9,13,5,1,7,25,42,67
p_57,6,0,e_2,587,639,667,6,8,1,10,5,1,4,52,28,80
p_61,5,0,e_2,583,644,667,8,7,2,9,2,1,3,61,23,84
p_99,1,0,e_1,522,561,684,23,6,4,7,4,1,3,39,123,162
p_102,2,0,e_1,521,566,684,23,6,5,7,4,1,2,45,118,163
p_118,4,0,e_1,488,574,684,30,6,6,12,5,1,2,86,110,196
p_105,4,0,e_1,515,574,684,22,7,4,9,4,1,2,59,110,169
p_96,5,0,e_1,527,579,684,18,5,4,6,1,1,4,52,105,157
p_98,6,0,e_1,524,584,684,18,5,2,7,4,1,3,60,100,160
p_77,6,0,e_1,557,584,684,12,7,3,0,5,0,6,27,100,127
p_104,7,0,e_1,516,589,684,19,7,1,9,4,1,2,73,95,168
p_76,7,0,e_1,559,589,684,11,7,3,0,5,0,6,30,95,125
p_63,8,0,e_1,581,594,684,5,7,1,5,5,1,4,13,90,103
p_60,9,0,e_1,584,599,684,4,7,1,6,5,1,4,15,85,100
p_66,12,0,e_1,577,610,684,2,7,1,4,5,1,4,33,74,107
p_46,13,0,e_1,596,615,684,27,9,9,8,5,1,6,19,69,88
p_75,14,0,e_1,563,620,684,3,6,1,1,5,1,5,57,64,121
p_39,15,0,e_1,609,625,684,22,10,10,12,5,1,6,16,59,75
p_51,1,0,e_2,591,672,699,10,8,4,10,5,1,6,81,27,108
p_56,2,0,e_2,588,677,699,10,8,4,10,2,1,4,89,22,111
p_55,4,0,e_2,590,685,699,7,7,2,10,5,1,5,95,14,109
p_40,4,0,e_2,601,685,699,5,9,2,14,5,1,8,84,14,98
p_35,4,0,e_2,640,685,699,25,9,8,6,4,1,4,45,14,59
p_30,5,0,e_2,676,716,741,15,5,4,2,2,1,1,40,25,65
p_24,5,0,e_2,707,716,741,7,3,0,2,5,0,2,9,25,34
p_23,5,0,e_2,709,716,741,7,3,0,3,5,0,2,7,25,32
p_28,6,0,e_2,679,721,741,13,4,3,2,5,1,2,42,20,62
p_78,4,0,e_3,555,649,749,15,6,3,11,5,1,5,94,100,194
p_83,5,0,e_3,546,654,749,16,6,4,9,5,1,5,108,95,203
p_62,5,0,e_3,582,654,749,8,7,2,13,1,1,6,72,95,167
p_86,6,0,e_3,541,659,749,17,5,4,7,5,1,4,118,90,208
p_80,6,0,e_3,548,659,749,15,7,4,9,5,1,6,111,90,201
p_59,6,0,e_3,584,659,749,7,7,1,13,4,1,6,75,90,165
p_54,6,0,e_3,590,659,749,5,7,0,11,1,1,6,69,90,159
p_53,9,0,e_3,590,670,749,2,7,0,11,4,1,6,80,79,159
p_50,10,0,e_3,592,675,749,1,8,0,11,4,1,7,83,74,157
p_74,11,0,e_3,567,680,749,5,6,1,14,2,1,5,113,69,182
p_91,13,0,e_3,535,688,749,9,5,1,6,5,1,4,153,61,214
p_109,14,0,e_3,506,693,749,14,6,0,0,5,0,6,187,56,243
p_88,14,0,e_3,538,693,749,7,5,0,7,5,1,4,155,56,211
p_87,15,0,e_3,539,698,749,8,4,0,7,2,1,3,159,51,210
p_26,3,0,e_3,698,736,749,14,2,0,15,2,1,1,38,13,51
p_64,1,0,e_0,579,651,754,13,7,5,15,2,1,6,72,103,175
p_81,2,0,e_0,547,656,754,19,7,4,7,5,1,5,109,98,207
p_71,2,0,e_0,569,656,754,14,7,1,13,5,1,5,87,98,185
p_82,3,0,e_0,547,661,754,18,7,4,7,5,1,5,114,93,207
p_70,3,0,e_0,572,661,754,12,7,0,13,5,1,4,89,93,182
p_43,3,0,e_0,599,661,754,6,10,3,10,1,1,6,62,93,155
p_31,5,0,e_0,662,669,754,19,7,6,3,5,1,2,7,85,92
p_33,8,0,e_0,647,680,754,18,9,6,0,5,0,4,33,74,107
p_34,15,0,e_0,643,703,754,13,9,0,1,4,1,2,60,51,111
p_29,15,0,e_0,678,703,754,5,5,0,8,5,1,2,25,51,76
p_22,10,0,e_0,712,720,754,1,3,0,13,4,1,1,8,34,42
p_25,7,0,e_0,703,731,754,7,3,0,15,4,1,0,28,23,51
p_27,2,0,e_3,693,757,765,14,2,1,14,2,1,1,64,8,72
p_48,2,0,e_1,593,692,768,9,9,5,8,5,1,5,99,76,175
p_38,4,0,e_1,627,700,768,29,10,10,15,4,1,3,73,68,141
p_49,5,0,e_1,592,705,768,6,8,2,8,5,1,4,113,63,176
p_32,5,0,e_1,657,705,768,19,8,6,6,4,1,6,48,63,111
p_47,6,0,e_1,594,710,768,4,9,1,8,2,1,5,116,58,174
p_37,7,0,e_1,633,715,768,23,10,10,13,4,1,4,82,53,135
p_36,11,0,e_1,635,729,768,19,9,3,12,4,1,5,94,39,133
p_21,10,0,e_1,732,734,768,24,3,3,11,4,1,0,2,34,36
p_20,9,0,e_1,737,739,768,24,2,2,10,4,1,0,2,29,31
p_18,2,0,e_0,768,776,784,2,0,0,0,3,0,0,8,8,16
p_19,12,0,e_2,740,779,825,20,2,2,0,4,1,0,39,46,85
p_16,13,0,e_2,774,784,825,13,0,0,11,5,0,1,10,41,51
p_13,11,0,e_1,794,807,872,16,1,1,7,5,0,1,13,65,78
p_10,14,0,e_1,810,818,872,7,2,1,12,5,1,1,8,54,62
p_17,15,0,e_1,772,823,872,15,0,0,0,3,0,0,51,49,100
p_8,1,0,e_1,847,867,872,9,1,0,7,4,1,0,20,5,25
p_12,13,0,e_3,796,823,882,13,1,1,4,5,0,1,27,59,86
p_15,15,0,e_3,782,831,882,15,0,0,0,3,0,0,49,51,100
p_5,5,0,e_3,860,863,882,1,1,0,6,4,1,0,3,19,22
p_4,1,0,e_3,864,877,882,4,1,0,5,4,1,0,13,5,18
p_11,11,0,e_0,810,826,887,10,2,2,6,5,0,1,16,61,77
p_14,15,0,e_0,790,840,887,13,1,0,0,3,0,0,50,47,97
p_3,1,0,e_1,876,881,900,30,2,2,0,3,0,0,5,19,24
p_2,3,0,e_1,878,889,900,28,1,1,0,5,0,1,11,11,22
p_1,2,0,e_0,889,897,905,2,0,0,0,3,0,0,8,8,16
p_9,2,0,e_2,845,854,938,9,1,0,0,3,0,0,9,84,93
p_7,12,0,e_2,851,886,938,27,1,1,1,5,0,1,35,52,87
p_6,14,0,e_2,858,894,938,22,1,1,3,5,1,1,36,44,80
p_296,1,0,e_3,20,25,30,1,0,0,0,3,0,0,5,5,10
p_299,3,0,e_1,7,19,30,3,0,0,0,3,0,0,12,11,23
p_298,4,0,e_2,10,25,47,4,0,0,0,3,0,0,15,22,37
p_295,5,0,e_2,22,30,47,5,1,0,3,5,0,1,8,17,25
p_288,1,0,e_2,49,54,97,9,3,2,0,3,0,0,5,43,48
p_285,2,0,e_2,54,59,97,7,3,2,1,2,0,1,5,38,43
p_286,3,0,e_2,51,64,97,7,3,2,0,5,0,1,13,33,46
p_282,6,0,e_2,62,75,97,7,3,1,2,5,1,1,13,22,35
p_279,2,0,e_2,76,89,97,8,1,0,6,4,1,0,13,8,21
p_275,2,0,e_2,84,89,97,5,2,1,3,4,1,3,5,8,13
p_290,4,0,e_3,43,50,108,6,1,1,2,5,0,1,7,58,65
p_291,6,0,e_3,35,58,108,6,0,0,0,3,0,0,23,50,73
p_289,7,0,e_3,47,63,108,4,2,0,3,5,0,2,16,45,61
p_283,10,0,e_3,55,74,108,5,3,0,5,5,1,2,19,34,53
p_281,10,0,e_3,63,74,108,3,2,0,7,2,1,1,11,34,45
p_274,4,0,e_3,84,94,108,3,1,0,7,4,1,0,10,14,24
p_292,11,0,e_1,30,66,109,11,0,0,0,3,0,0,36,43,79
p_287,12,0,e_1,51,71,109,8,3,0,6,5,0,1,20,38,58
p_280,12,0,e_1,65,71,109,5,2,0,11,5,0,2,6,38,44
p_300,8,0,e_0,4,31,109,8,0,0,0,3,0,0,27,78,105
p_297,12,0,e_0,18,45,109,12,0,0,4,5,0,1,27,64,91
p_294,13,0,e_0,23,50,109,12,1,0,5,5,0,2,27,59,86
p_293,15,0,e_0,26,58,109,16,1,1,7,5,0,3,32,51,83
p_284,14,0,e_0,55,63,109,9,4,0,14,5,1,1,8,46,54
p_276,5,0,e_0,82,92,109,3,1,0,8,4,1,0,10,17,27
p_269,4,0,e_3,146,161,177,4,0,0,0,3,0,0,15,16,31
p_267,1,0,e_3,153,172,177,5,1,1,2,5,0,1,19,5,24
p_277,10,0,e_2,81,129,201,28,1,1,5,4,1,2,48,72,120
p_273,13,0,e_2,95,140,201,21,1,1,1,4,1,2,45,61,106
p_278,15,0,e_2,80,148,201,23,1,1,5,4,1,1,68,53,121
p_272,15,0,e_2,105,148,201,16,1,1,2,5,0,3,43,53,96
p_265,12,0,e_2,157,159,201,9,2,0,13,4,1,0,2,42,44
p_262,6,0,e_2,164,179,201,28,2,2,11,4,1,1,15,22,37
p_259,6,0,e_2,174,179,201,25,1,1,7,4,1,2,5,22,27
p_264,5,0,e_2,162,184,201,29,2,2,11,4,1,0,22,17,39
p_258,5,0,e_2,175,184,201,25,1,1,7,4,1,2,9,17,26
p_270,7,0,e_1,133,156,223,7,0,0,0,3,0,0,23,67,90
p_268,10,0,e_1,150,167,223,9,1,0,5,5,0,1,17,56,73
p_263,12,0,e_1,163,175,223,22,2,2,9,5,1,1,12,48,60
p_261,12,0,e_1,170,175,223,19,2,2,11,5,1,1,5,48,53
p_260,13,0,e_1,171,180,223,18,1,1,11,5,1,1,9,43,52
p_256,8,0,e_1,191,197,223,8,0,0,10,4,1,0,6,26,32
p_271,11,0,e_0,127,162,227,11,0,0,0,3,0,0,35,65,100
p_266,15,0,e_0,155,176,227,13,2,0,9,5,0,1,21,51,72
p_257,12,0,e_0,179,187,227,12,0,0,14,4,1,0,8,40,48
p_255,10,0,e_0,192,195,227,10,0,0,11,4,1,0,3,32,35
p_252,2,0,e_2,212,221,229,25,2,1,0,3,0,0,9,8,17
p_244,2,0,e_2,271,279,287,7,1,0,0,3,0,0,8,8,16
p_254,3,0,e_3,199,211,298,3,0,0,0,3,0,0,12,87,99
p_253,15,0,e_3,208,249,298,13,1,0,2,5,0,1,41,49,90
p_246,12,0,e_3,257,260,298,1,1,0,13,4,1,0,3,38,41
p_251,4,0,e_0,228,242,310,18,2,1,0,3,0,0,14,68,82
p_250,7,0,e_0,236,253,310,12,2,1,2,5,0,1,17,57,74
p_249,7,0,e_0,238,253,310,11,2,1,3,5,0,2,15,57,72
p_248,7,0,e_0,246,253,310,9,2,1,5,5,1,1,7,57,64
p_247,12,0,e_0,248,270,310,27,1,0,5,5,1,1,22,40,62
p_242,4,0,e_0,287,296,310,30,1,1,7,4,1,0,9,14,23
p_243,8,0,e_1,285,296,334,26,1,1,5,5,0,1,11,38,49
p_245,9,0,e_1,269,301,334,30,1,1,0,3,0,0,32,33,65
p_237,5,0,e_1,313,315,334,20,1,1,6,4,1,0,2,19,21
p_233,2,0,e_1,319,326,334,21,1,1,4,4,1,0,7,8,15
p_225,10,0,e_3,333,334,402,8,1,1,10,5,0,1,1,68,69
p_240,14,0,e_3,301,348,402,14,0,0,0,3,0,0,47,54,101
p_204,8,0,e_3,364,368,402,1,4,0,9,4,1,3,4,34,38
p_206,6,0,e_3,362,376,402,4,3,0,10,4,1,2,14,26,40
p_210,4,0,e_3,353,384,402,9,2,0,13,4,1,1,31,18,49
p_199,2,0,e_3,368,392,402,6,4,2,8,4,1,3,24,10,34
p_216,1,0,e_3,346,397,402,13,2,0,14,5,1,1,51,5,56
p_186,1,0,e_3,391,397,402,1,2,0,2,1,1,1,6,5,11
p_241,13,0,e_2,300,342,403,13,0,0,0,3,0,0,42,61,103
p_239,13,0,e_2,305,342,403,15,1,1,1,5,0,1,37,61,98
p_224,13,0,e_2,335,342,403,5,2,1,11,5,0,2,7,61,68
p_223,13,0,e_2,339,342,403,4,2,1,12,5,0,2,3,61,64
p_234,14,0,e_2,314,347,403,10,1,0,4,5,0,1,33,56,89
p_219,11,0,e_2,342,358,403,5,2,1,13,5,1,1,16,45,61
p_220,9,0,e_2,342,366,403,7,2,1,13,5,1,2,24,37,61
p_218,9,0,e_2,343,366,403,7,2,1,13,5,1,3,23,37,60
p_212,9,0,e_2,348,366,403,21,2,0,14,4,1,4,18,37,55
p_215,6,0,e_2,346,377,403,9,2,1,14,5,1,3,31,26,57
p_196,5,0,e_2,376,382,403,1,4,0,6,1,1,1,6,21,27
p_214,4,0,e_2,346,387,403,11,2,1,14,5,1,4,41,16,57
p_185,2,0,e_2,392,395,403,30,2,2,3,4,1,0,3,8,11
p_238,2,0,e_0,311,320,432,23,1,1,0,3,0,0,9,112,121
p_232,5,0,e_0,320,331,432,17,1,1,2,2,0,2,11,101,112
p_230,5,0,e_0,323,331,432,17,1,1,3,5,1,3,8,101,109
p_236,8,0,e_0,313,342,432,17,1,1,0,5,0,1,29,90,119
p_235,8,0,e_0,314,342,432,16,1,1,0,5,0,2,28,90,118
p_229,9,0,e_0,323,347,432,13,1,1,3,5,1,3,24,85,109
p_227,9,0,e_0,326,347,432,12,1,1,4,5,1,5,21,85,106
p_231,10,0,e_0,320,352,432,12,1,1,2,2,0,1,32,80,112
p_228,11,0,e_0,325,357,432,10,1,1,3,5,1,4,32,75,107
p_226,12,0,e_0,331,362,432,7,1,1,5,5,1,4,31,70,101
p_213,12,0,e_0,347,362,432,24,2,0,9,2,1,3,15,70,85
p_207,12,0,e_0,355,362,432,30,3,3,11,5,1,3,7,70,77
p_208,13,0,e_0,355,367,432,29,3,3,11,5,1,3,12,65,77
p_202,13,0,e_0,365,367,432,26,5,5,12,5,1,2,2,65,67
p_201,13,0,e_0,366,367,432,26,5,5,13,5,1,2,1,65,66
p_222,3,0,e_1,339,350,457,14,2,1,0,3,0,0,11,107,118
p_221,4,0,e_1,341,355,457,12,2,1,0,5,0,1,14,102,116
p_217,8,0,e_1,345,369,457,7,2,1,2,5,0,2,24,88,112
p_203,12,0,e_1,365,383,457,27,5,5,7,5,1,3,18,74,92
p_193,12,0,e_1,378,383,457,24,4,4,11,5,1,4,5,74,79
p_190,14,0,e_1,382,391,457,21,4,4,12,5,1,4,9,66,75
p_183,12,0,e_1,393,399,457,20,2,2,14,4,1,3,6,58,64
p_181,11,0,e_1,395,404,457,20,2,2,13,4,1,4,9,53,62
p_173,10,0,e_1,405,409,457,10,1,0,11,4,1,4,4,48,52
p_177,9,0,e_1,398,414,457,22,1,1,12,1,1,4,16,43,59
p_197,8,0,e_1,375,419,457,28,5,5,10,5,1,3,44,38,82
p_167,7,0,e_1,412,424,457,12,3,2,10,4,1,4,12,33,45
p_166,5,0,e_1,415,432,457,14,3,2,9,4,1,4,17,25,42
p_163,4,0,e_1,417,437,457,21,5,4,9,4,1,5,20,20,40
p_155,3,0,e_1,434,442,457,16,6,5,5,4,1,3,8,15,23
p_160,10,0,e_2,421,435,519,13,6,4,5,5,0,2,14,84,98
p_180,14,0,e_2,396,449,519,17,2,2,2,4,1,0,53,70,123
p_172,14,0,e_2,405,449,519,14,1,0,0,5,0,1,44,70,114
p_168,15,0,e_2,412,454,519,13,3,0,2,5,0,1,42,65,107
p_151,15,0,e_2,443,454,519,4,4,0,12,5,1,5,11,65,76
p_149,15,0,e_2,444,454,519,4,4,0,12,5,1,5,10,65,75
p_142,15,0,e_2,452,454,519,2,8,0,14,5,1,4,2,65,67
p_140,13,0,e_2,455,462,519,3,9,1,15,4,1,3,7,57,64
p_139,13,0,e_2,456,462,519,3,8,1,15,4,1,4,6,57,63
p_137,13,0,e_2,458,462,519,3,8,1,14,4,1,4,4,57,61
p_134,12,0,e_2,462,467,519,3,7,0,13,1,1,3,5,52,57
p_152,10,0,e_2,439,475,519,8,5,4,11,5,1,4,36,44,80
p_128,10,0,e_2,471,475,519,3,7,1,11,4,1,4,4,44,48
p_131,9,0,e_2,467,480,519,5,7,2,12,4,1,3,13,39,52
p_130,9,0,e_2,469,480,519,4,7,2,12,4,1,4,11,39,50
p_174,3,0,e_3,402,414,525,3,0,0,0,3,0,0,12,111,123
p_171,3,0,e_3,408,414,525,2,1,0,1,5,0,1,6,111,117
p_170,10,0,e_3,408,437,525,9,1,0,1,5,0,1,29,88,117
p_169,11,0,e_3,410,442,525,9,2,0,2,5,0,2,32,83,115
p_159,11,0,e_3,424,442,525,11,6,3,6,5,1,5,18,83,101
p_164,12,0,e_3,416,447,525,13,4,1,3,5,1,3,31,78,109
p_157,12,0,e_3,427,447,525,9,6,2,7,5,1,5,20,78,98
p_161,13,0,e_3,418,452,525,11,5,1,4,5,1,4,34,73,107
p_165,14,0,e_3,416,457,525,11,3,0,3,5,1,2,41,68,109
p_162,14,0,e_3,417,457,525,11,5,0,3,5,1,4,40,68,108
p_158,14,0,e_3,426,457,525,8,6,0,6,5,1,5,31,68,99
p_141,15,0,e_3,455,462,525,1,8,0,14,5,1,7,7,63,70
p_145,12,0,e_3,451,473,525,3,6,1,13,5,1,5,22,52,74
p_146,10,0,e_3,451,481,525,5,7,1,13,5,1,6,30,44,74
p_121,9,0,e_3,480,486,525,1,6,0,10,4,1,5,6,39,45
p_175,2,0,e_0,399,440,568,29,1,1,8,4,1,7,41,128,169
p_192,5,0,e_0,380,451,568,30,4,4,12,4,1,3,71,117,188
p_184,5,0,e_0,393,451,568,27,2,2,9,1,1,6,58,117,175
p_182,5,0,e_0,394,451,568,27,2,2,9,4,1,6,57,117,174
p_178,5,0,e_0,398,451,568,26,1,1,8,4,1,7,53,117,170
p_179,6,0,e_0,397,456,568,25,1,1,8,4,1,7,59,112,171
p_176,6,0,e_0,398,456,568,25,1,1,8,4,1,7,58,112,170
p_191,7,0,e_0,382,461,568,27,4,4,12,4,1,4,79,107,186
p_189,7,0,e_0,387,461,568,26,3,3,11,4,1,5,74,107,181
p_187,7,0,e_0,391,461,568,25,3,3,10,4,1,7,70,107,177
p_188,8,0,e_0,390,466,568,24,3,3,10,4,1,6,76,102,178
p_198,9,0,e_0,368,471,568,29,4,4,13,5,1,2,103,97,200
p_195,9,0,e_0,376,471,568,27,4,4,13,4,1,3,95,97,192
p_194,11,0,e_0,377,479,568,25,4,4,13,4,1,3,102,89,191
p_200,12,0,e_0,367,484,568,26,5,5,13,2,1,1,117,84,201
p_205,1,0,e_1,362,462,591,9,4,2,6,5,1,2,100,129,229
p_156,1,0,e_1,428,462,591,20,6,5,6,4,1,4,34,129,163
p_209,2,0,e_1,354,467,591,10,3,1,4,3,1,1,113,124,237
p_136,2,0,e_1,460,467,591,14,8,1,0,5,0,3,7,124,131
p_133,4,0,e_1,463,475,591,11,7,3,1,5,1,2,12,116,128
p_125,4,0,e_1,474,475,591,8,6,2,4,3,1,3,1,116,117
p_129,5,0,e_1,470,482,591,8,7,3,2,5,1,2,12,109,121
p_122,5,0,e_1,477,482,591,6,6,2,4,3,1,3,5,109,114
p_126,6,0,e_1,473,487,591,6,6,2,4,5,1,3,14,104,118
p_138,7,0,e_1,456,492,591,9,8,1,0,3,1,2,36,99,135
p_135,7,0,e_1,461,492,591,8,8,0,1,5,0,3,31,99,130
p_132,7,0,e_1,463,492,591,8,7,2,1,5,1,3,29,99,128
p_120,10,0,e_1,481,503,591,30,6,6,5,2,1,2,22,88,110
p_117,12,0,e_1,490,511,591,26,5,5,7,5,1,2,21,80,101
p_109,14,0,e_1,506,519,591,20,4,4,11,5,1,2,13,72,85
p_110,1,0,e_2,501,524,641,4,5,3,5,4,1,3,23,117,140
p_118,4,0,e_2,488,535,641,5,5,1,7,4,1,2,47,106,153
p_119,5,0,e_2,483,540,641,5,6,2,9,4,1,2,57,101,158
p_154,7,0,e_2,438,548,641,11,5,4,11,5,1,3,110,93,203
p_153,8,0,e_2,438,553,641,10,5,4,10,5,1,2,115,88,203
p_92,13,0,e_2,533,570,641,12,5,0,4,5,1,4,37,71,108
p_88,14,0,e_2,538,575,641,12,5,0,4,5,1,4,37,66,103
p_87,15,0,e_2,539,580,641,12,5,0,5,2,1,4,41,61,102
p_72,15,0,e_2,569,580,641,4,4,0,13,2,1,3,11,61,72
p_69,10,0,e_2,573,597,641,6,4,2,14,5,1,3,24,44,68
p_58,10,0,e_2,586,597,641,4,4,1,14,4,1,4,11,44,55
p_50,10,0,e_2,592,597,641,2,7,1,12,4,1,6,5,44,49
p_60,9,0,e_2,584,602,641,5,4,1,14,4,1,3,18,39,57
p_67,8,0,e_2,574,607,641,8,4,2,14,2,1,3,33,34,67
p_63,8,0,e_2,581,607,641,7,4,1,15,4,1,3,26,34,60
p_107,1,0,e_3,512,530,645,2,4,1,3,4,1,3,18,115,133
p_143,2,0,e_3,451,535,645,13,5,1,13,5,1,4,84,110,194
p_150,3,0,e_3,444,540,645,14,4,3,11,5,1,3,96,105,201
p_148,3,0,e_3,447,540,645,13,4,2,12,2,1,3,93,105,198
p_144,4,0,e_3,451,545,645,11,8,1,13,5,1,7,94,100,194
p_147,7,0,e_3,450,556,645,8,4,1,13,5,1,3,106,89,195
p_116,7,0,e_3,490,556,645,1,5,0,8,4,1,4,66,89,155
p_74,11,0,e_3,567,570,645,7,4,2,10,5,1,3,3,75,78
p_91,13,0,e_3,535,578,645,11,4,0,2,2,1,3,43,67,110
p_79,14,0,e_3,549,583,645,9,3,0,5,5,1,2,34,62,96
p_75,14,0,e_3,563,583,645,5,4,0,9,5,1,3,20,62,82
p_68,14,0,e_3,574,583,645,2,4,0,12,5,1,3,9,62,71
p_66,12,0,e_3,577,591,645,3,3,1,13,2,1,2,14,54,68
p_65,12,0,e_3,578,591,645,3,4,1,13,2,1,3,13,54,67
p_52,11,0,e_3,591,596,645,1,5,0,12,4,1,4,5,49,54
p_102,2,0,e_0,521,576,704,29,5,5,10,4,1,9,55,128,183
p_90,2,0,e_0,536,576,704,22,5,4,7,4,1,10,40,128,168
p_81,2,0,e_0,547,576,704,20,3,2,5,4,1,11,29,128,157
p_85,3,0,e_0,542,581,704,20,4,3,6,4,1,10,39,123,162
p_84,3,0,e_0,546,581,704,19,3,2,5,4,1,11,35,123,158
p_82,3,0,e_0,547,581,704,19,3,2,5,4,1,11,34,123,157
p_106,4,0,e_0,512,586,704,29,4,4,12,4,1,6,74,118,192
p_105,4,0,e_0,515,586,704,28,5,5,11,4,1,7,71,118,189
p_108,5,0,e_0,509,591,704,28,5,5,13,4,1,6,82,113,195
p_96,5,0,e_0,527,591,704,9,5,1,9,4,1,10,64,113,177
p_98,6,0,e_0,524,596,704,24,5,5,10,4,1,9,72,108,180
p_95,6,0,e_0,527,596,704,8,5,1,9,4,1,10,69,108,177
p_94,6,0,e_0,528,596,704,7,5,1,9,4,1,10,68,108,176
p_104,7,0,e_0,516,601,704,25,5,5,11,4,1,7,85,103,188
p_93,7,0,e_0,529,601,704,6,5,0,9,4,1,10,72,103,175
p_56,2,0,e_2,588,649,707,11,5,4,13,4,1,4,61,58,119
p_55,4,0,e_2,590,657,707,8,6,4,12,4,1,5,67,50,117
p_42,4,0,e_2,600,657,707,6,8,4,9,4,1,6,57,50,107
p_40,4,0,e_2,601,657,707,6,8,4,9,1,1,5,56,50,106
p_49,5,0,e_2,592,662,707,7,7,4,11,4,1,6,70,45,115
p_45,5,0,e_2,597,662,707,6,7,3,10,4,1,6,65,45,110
p_32,5,0,e_2,657,662,707,11,6,3,4,3,1,3,5,45,50
p_31,5,0,e_2,662,664,707,10,5,3,5,5,1,2,2,43,45
p_73,6,0,e_2,568,669,707,11,5,2,13,5,1,3,101,38,139
p_59,6,0,e_2,584,669,707,8,4,2,14,4,1,3,85,38,123
p_33,8,0,e_2,647,677,707,10,7,1,2,5,0,4,30,30,60
p_28,6,0,e_2,679,685,707,17,3,2,8,4,1,0,6,22,28
p_27,2,0,e_2,693,699,707,17,2,1,4,4,1,0,6,8,14
p_99,1,0,e_1,522,596,707,30,5,5,14,5,1,3,74,111,185
p_64,1,0,e_1,579,596,707,14,4,1,2,4,1,11,17,111,128
p_71,2,0,e_1,569,601,707,15,4,2,4,4,1,8,32,106,138
p_70,3,0,e_1,572,606,707,14,4,2,4,4,1,9,34,101,135
p_78,4,0,e_1,555,611,707,17,4,2,7,1,1,7,56,96,152
p_83,5,0,e_1,546,616,707,17,3,2,10,4,1,6,70,91,161
p_86,6,0,e_1,541,621,707,17,4,2,11,4,1,6,80,86,166
p_80,6,0,e_1,548,621,707,15,3,2,10,4,1,7,73,86,159
p_77,6,0,e_1,557,621,707,15,3,2,7,4,1,8,64,86,150
p_89,7,0,e_1,537,626,707,17,5,1,12,1,1,4,89,81,170
p_100,10,0,e_1,522,637,707,21,5,5,14,5,1,4,115,70,185
p_97,10,0,e_1,526,637,707,10,5,0,15,4,1,4,111,70,181
p_101,12,0,e_1,521,645,707,19,5,5,14,5,1,2,124,62,186
p_103,13,0,e_1,517,650,707,19,5,5,14,5,1,2,133,57,190
p_111,15,0,e_1,501,658,707,20,5,5,10,5,1,2,157,49,206
p_24,5,0,e_2,707,724,741,10,3,1,0,3,1,0,17,17,34
p_23,5,0,e_2,709,724,741,9,3,1,0,5,0,1,15,17,32
p_51,1,0,e_3,591,650,759,11,6,5,12,4,1,5,59,109,168
p_48,2,0,e_3,593,655,759,10,7,5,12,4,1,6,62,104,166
p_43,3,0,e_3,599,660,759,8,7,4,11,4,1,6,61,99,160
p_62,5,0,e_3,582,668,759,9,3,0,14,2,1,2,86,91,177
p_61,5,0,e_3,583,668,759,9,4,2,14,4,1,3,85,91,176
p_57,6,0,e_3,587,673,759,7,4,2,13,4,1,3,86,86,172
p_54,6,0,e_3,590,673,759,6,6,2,12,4,1,5,83,86,169
p_47,6,0,e_3,594,673,759,5,8,2,11,4,1,7,79,86,165
p_76,7,0,e_3,559,678,759,13,3,2,8,5,1,2,119,81,200
p_53,9,0,e_3,590,686,759,3,5,0,12,4,1,4,96,73,169
p_29,15,0,e_3,678,706,759,8,2,0,7,2,1,1,28,53,81
p_22,10,0,e_3,712,723,759,3,3,0,13,4,1,2,11,36,47
p_25,7,0,e_3,703,734,759,9,3,1,14,5,1,2,31,25,56
p_26,3,0,e_3,698,748,759,15,2,1,12,5,1,1,50,11,61
p_35,4,0,e_1,640,721,809,27,7,7,10,5,1,3,81,88,169
p_20,9,0,e_1,737,738,809,28,2,2,9,5,1,2,1,71,72
p_21,10,0,e_1,732,743,809,28,3,3,7,5,1,1,11,66,77
p_19,12,0,e_1,740,751,809,24,2,2,9,5,1,2,11,58,69
p_34,15,0,e_1,643,762,809,15,8,8,12,5,1,4,119,47,166
p_38,4,0,e_0,627,718,818,30,8,8,13,5,1,6,91,100,191
p_30,5,0,e_0,676,723,818,7,3,2,7,1,1,8,47,95,142
p_37,7,0,e_0,633,731,818,26,7,7,14,5,1,8,98,87,185
p_114,9,0,e_0,494,739,818,28,4,4,14,5,1,2,245,79,324
p_115,10,0,e_0,494,744,818,27,4,4,14,5,1,3,250,74,324
p_41,10,0,e_0,600,744,818,30,8,8,7,2,1,7,144,74,218
p_113,11,0,e_0,496,749,818,26,4,4,15,2,1,4,253,69,322
p_36,11,0,e_0,635,749,818,21,7,7,14,5,1,8,114,69,183
p_123,12,0,e_0,474,754,818,30,6,6,9,5,1,4,280,64,344
p_46,13,0,e_0,596,759,818,28,7,7,6,5,1,7,163,59,222
p_211,14,0,e_0,348,764,818,30,2,2,9,5,1,3,416,54,470
p_124,14,0,e_0,474,764,818,28,6,6,9,5,1,4,290,54,344
p_127,15,0,e_0,473,769,818,27,6,6,9,5,1,3,296,49,345
p_112,15,0,e_0,497,769,818,21,5,5,15,2,1,5,272,49,321
p_44,15,0,e_0,598,769,818,26,7,7,6,5,1,8,171,49,220
p_9,2,0,e_1,845,854,862,4,1,0,0,3,0,0,9,8,17
p_13,11,0,e_3,794,829,866,11,0,0,0,3,0,0,35,37,72
p_11,11,0,e_3,810,829,866,6,1,0,5,5,0,1,19,37,56
p_8,1,0,e_3,847,861,866,4,1,0,5,4,1,0,14,5,19
p_18,2,0,e_2,768,776,868,2,0,0,0,3,0,0,8,92,100
p_12,13,0,e_2,796,811,868,13,1,0,8,5,1,1,15,57,72
p_10,14,0,e_2,810,816,868,9,1,0,13,5,1,2,6,52,58
p_17,15,0,e_2,772,821,868,15,0,0,1,5,0,1,49,47,96
p_15,15,0,e_2,782,821,868,15,0,0,3,5,1,1,39,47,86
p_14,15,0,e_2,790,821,868,15,0,0,6,5,1,1,31,47,78
p_4,1,0,e_1,864,870,875,30,1,1,0,3,0,0,6,5,11
p_3,1,0,e_1,876,881,886,1,0,0,0,3,0,0,5,5,10
p_2,3,0,e_2,878,889,900,3,0,0,0,3,0,0,11,11,22
p_1,2,0,e_1,889,898,906,2,0,0,0,3,0,0,9,8,17
p_7,12,0,e_0,851,856,920,22,2,2,10,5,0,2,5,64,69
p_16,13,0,e_0,774,861,920,13,0,0,14,4,1,1,87,59,146
p_6,14,0,e_0,858,866,920,18,2,2,12,5,1,2,8,54,62
p_39,15,0,e_0,609,871,920,23,8,8,9,5,1,6,262,49,311
p_5,5,0,e_0,860,903,920,26,2,2,13,5,1,3,43,17,60
p_299,3,0,e_1,7,19,30,3,0,0,0,3,0,0,12,11,23
p_296,1,0,e_3,20,26,31,1,0,0,0,3,0,0,6,5,11
p_298,4,0,e_2,10,25,47,4,0,0,0,3,0,0,15,22,37
p_295,5,0,e_2,22,30,47,5,1,0,3,5,0,1,8,17,25
p_288,1,0,e_2,49,54,97,9,3,2,0,3,0,0,5,43,48
p_285,2,0,e_2,54,59,97,7,3,2,1,5,1,1,5,38,43
p_286,3,0,e_2,51,64,97,7,3,2,0,5,0,1,13,33,46
p_282,6,0,e_2,62,75,97,7,2,1,2,5,1,1,13,22,35
p_279,2,0,e_2,76,89,97,7,1,0,6,4,1,0,13,8,21
p_275,2,0,e_2,84,89,97,5,1,0,4,4,1,3,5,8,13
p_290,4,0,e_3,43,49,107,6,1,1,2,5,0,1,6,58,64
p_291,6,0,e_3,35,57,107,6,0,0,0,3,0,0,22,50,72
p_289,7,0,e_3,47,62,107,4,2,0,3,5,0,2,15,45,60
p_283,10,0,e_3,55,73,107,5,3,0,5,5,1,2,18,34,52
p_281,10,0,e_3,63,73,107,3,2,0,7,5,1,1,10,34,44
p_274,4,0,e_3,84,93,107,3,1,0,7,4,1,0,9,14,23
p_292,11,0,e_1,30,65,108,11,0,0,0,3,1,0,35,43,78
p_287,12,0,e_1,51,70,108,8,3,0,6,5,0,1,19,38,57
p_280,12,0,e_1,65,70,108,4,2,0,11,2,0,1,5,38,43
p_300,8,0,e_0,4,30,108,8,0,0,0,3,0,0,26,78,104
p_297,12,0,e_0,18,44,108,12,0,0,4,5,0,1,26,64,90
p_294,13,0,e_0,23,49,108,13,1,0,6,5,0,2,26,59,85
p_293,15,0,e_0,26,57,108,16,1,1,7,5,0,3,31,51,82
p_284,14,0,e_0,55,62,108,9,4,0,14,5,1,1,7,46,53
p_276,5,0,e_0,82,91,108,3,1,0,8,4,1,0,9,17,26
p_269,4,0,e_3,146,161,177,4,0,0,0,3,0,0,15,16,31
p_267,1,0,e_3,153,172,177,6,1,1,1,5,0,1,19,5,24
p_277,10,0,e_2,81,129,201,28,1,1,4,4,1,2,48,72,120
p_273,13,0,e_2,95,140,201,21,1,1,1,4,1,2,45,61,106
p_278,15,0,e_2,80,148,201,23,1,1,5,4,1,1,68,53,121
p_272,15,0,e_2,105,148,201,15,1,1,2,5,0,3,43,53,96
p_265,12,0,e_2,157,159,201,9,2,0,13,4,1,0,2,42,44
p_262,6,0,e_2,164,179,201,28,2,2,11,4,1,1,15,22,37
p_259,6,0,e_2,174,179,201,25,1,1,7,4,1,2,5,22,27
p_264,5,0,e_2,162,184,201,29,2,2,11,4,1,0,22,17,39
p_258,5,0,e_2,175,184,201,26,1,1,7,4,1,2,9,17,26
p_270,7,0,e_1,133,157,224,7,0,0,0,3,0,0,24,67,91
p_268,10,0,e_1,150,168,224,10,1,0,5,5,0,1,18,56,74
p_263,12,0,e_1,163,176,224,22,2,2,8,5,1,1,13,48,61
p_261,12,0,e_1,170,176,224,20,2,2,10,5,1,1,6,48,54
p_260,13,0,e_1,171,181,224,18,2,2,11,5,1,1,10,43,53
p_256,8,0,e_1,191,198,224,8,0,0,10,4,1,0,7,26,33
p_271,11,0,e_0,127,162,227,11,0,0,0,3,0,0,35,65,100
p_266,15,0,e_0,155,176,227,13,2,0,9,5,0,1,21,51,72
p_257,12,0,e_0,179,187,227,12,0,0,14,4,1,0,8,40,48
p_255,10,0,e_0,192,195,227,10,0,0,11,4,1,0,3,32,35
p_252,2,0,e_2,212,221,229,25,2,1,0,3,0,0,9,8,17
p_251,4,0,e_0,228,243,277,18,2,1,0,3,0,0,15,34,49
p_250,7,0,e_0,236,254,277,12,2,1,2,5,0,1,18,23,41
p_249,7,0,e_0,238,254,277,11,2,1,3,5,0,2,16,23,39
p_248,7,0,e_0,246,254,277,9,2,1,4,5,1,1,8,23,31
p_244,2,0,e_1,271,280,288,7,1,0,0,3,0,0,9,8,17
p_254,3,0,e_3,199,211,300,3,0,0,0,3,0,0,12,89,101
p_253,15,0,e_3,208,249,300,13,1,0,2,5,0,1,41,51,92
p_247,12,0,e_3,248,260,300,3,2,0,15,5,1,1,12,40,52
p_246,12,0,e_3,257,260,300,1,2,0,13,4,1,1,3,40,43
p_245,9,0,e_3,269,271,300,1,1,0,10,4,1,0,2,29,31
p_233,2,0,e_3,319,322,354,7,1,1,1,5,0,1,3,32,35
p_237,5,0,e_3,313,333,354,5,0,0,0,3,0,0,20,21,41
p_232,5,0,e_3,320,333,354,3,2,0,2,5,0,2,13,21,34
p_230,5,0,e_3,323,333,354,3,2,0,2,5,1,1,10,21,31
p_222,3,0,e_3,339,341,354,1,1,0,4,4,1,0,2,13,15
p_216,1,0,e_3,346,349,354,1,1,0,2,4,1,0,3,5,8
p_209,2,0,e_3,354,362,384,6,1,1,0,5,0,1,8,22,30
p_210,4,0,e_3,353,370,384,4,0,0,0,3,1,0,17,14,31
p_243,8,0,e_0,285,311,385,27,1,1,0,3,0,0,26,74,100
p_240,14,0,e_0,301,331,385,14,0,0,5,5,0,1,30,54,84
p_234,14,0,e_0,314,331,385,14,1,0,9,5,1,1,17,54,71
p_225,10,0,e_0,333,345,385,25,1,1,14,4,1,0,12,40,52
p_218,9,0,e_0,343,350,385,24,1,1,10,4,1,1,7,35,42
p_212,9,0,e_0,348,350,385,22,2,2,10,4,1,3,2,35,37
p_217,8,0,e_0,345,355,385,24,1,1,10,4,1,1,10,30,40
p_214,4,0,e_0,346,369,385,28,2,2,10,4,1,2,23,16,39
p_205,1,0,e_0,362,380,385,5,2,1,6,4,1,1,18,5,23
p_242,4,0,e_2,287,301,385,30,1,1,0,3,0,0,14,84,98
p_231,10,0,e_2,320,321,385,8,2,0,10,5,1,1,1,64,65
p_241,13,0,e_2,300,332,385,13,0,0,4,3,0,0,32,53,85
p_239,13,0,e_2,305,332,385,13,0,0,5,5,1,1,27,53,80
p_226,12,0,e_2,331,337,385,8,2,0,13,5,1,2,6,48,54
p_228,11,0,e_2,325,342,385,8,2,0,11,5,1,1,17,43,60
p_220,9,0,e_2,342,350,385,24,1,1,11,4,1,1,8,35,43
p_215,6,0,e_2,346,361,385,26,2,2,10,4,1,2,15,24,39
p_221,4,0,e_2,341,369,385,29,1,1,11,1,1,0,28,16,44
p_199,2,0,e_2,368,377,385,12,5,3,4,1,1,0,9,8,17
p_238,2,0,e_1,311,320,434,2,0,0,0,3,0,0,9,114,123
p_236,8,0,e_1,313,340,434,8,1,1,0,5,0,1,27,94,121
p_235,8,0,e_1,314,340,434,8,1,1,0,5,0,2,26,94,120
p_229,9,0,e_1,323,345,434,7,2,0,2,5,1,1,22,89,111
p_227,9,0,e_1,326,345,434,6,2,0,4,5,1,2,19,89,108
p_219,11,0,e_1,342,353,434,22,1,1,8,5,1,2,11,81,92
p_213,12,0,e_1,347,358,434,20,2,2,9,5,1,2,11,76,87
p_207,12,0,e_1,355,358,434,12,2,0,11,5,1,3,3,76,79
p_224,13,0,e_1,335,363,434,22,1,1,7,5,1,2,28,71,99
p_223,13,0,e_1,339,363,434,21,2,2,8,2,1,2,24,71,95
p_208,13,0,e_1,355,363,434,13,2,0,11,5,1,3,8,71,79
p_211,14,0,e_1,348,368,434,17,2,2,10,5,1,3,20,66,86
p_202,13,0,e_1,365,373,434,11,4,0,13,5,1,1,8,61,69
p_201,13,0,e_1,366,373,434,10,4,0,13,5,1,3,7,61,68
p_203,12,0,e_1,365,378,434,9,4,0,13,5,1,2,13,56,69
p_161,13,0,e_0,418,426,483,4,6,0,10,5,0,2,8,57,65
p_190,14,0,e_0,382,431,483,17,4,4,1,4,1,0,49,52,101
p_180,14,0,e_0,396,431,483,11,4,0,3,5,0,1,35,52,87
p_172,14,0,e_0,405,431,483,8,5,0,6,5,0,1,26,52,78
p_165,14,0,e_0,416,431,483,5,7,0,10,5,0,1,15,52,67
p_162,14,0,e_0,417,431,483,5,6,0,10,5,0,1,14,52,66
p_158,14,0,e_0,426,431,483,3,4,0,13,5,1,2,5,52,57
p_152,10,0,e_0,439,445,483,30,5,5,12,4,1,2,6,38,44
p_147,7,0,e_0,450,456,483,30,4,4,9,4,1,2,6,27,33
p_163,4,0,e_0,417,467,483,11,6,3,10,5,0,1,50,16,66
p_133,4,0,e_0,463,467,483,30,4,4,5,4,1,2,4,16,20
p_155,3,0,e_0,434,472,483,9,4,2,13,4,1,1,38,11,49
p_150,3,0,e_0,444,472,483,6,5,3,10,4,1,3,28,11,39
p_206,6,0,e_3,362,404,484,4,2,0,2,5,1,1,42,80,122
p_204,8,0,e_3,364,412,484,6,3,0,2,5,1,2,48,72,120
p_198,9,0,e_3,368,417,484,5,4,0,4,5,1,3,49,67,116
p_177,9,0,e_3,398,417,484,9,4,1,4,5,0,4,19,67,86
p_173,10,0,e_3,405,422,484,6,4,1,6,5,1,3,17,62,79
p_170,10,0,e_3,408,422,484,5,5,1,7,5,1,4,14,62,76
p_160,10,0,e_3,421,422,484,4,6,2,10,5,1,5,1,62,63
p_181,11,0,e_3,395,427,484,8,3,0,3,5,0,3,32,57,89
p_159,11,0,e_3,424,427,484,3,5,1,10,5,1,4,3,57,60
p_164,12,0,e_3,416,432,484,3,6,0,9,5,1,5,16,52,68
p_157,12,0,e_3,427,432,484,1,4,0,11,2,1,3,5,52,57
p_153,8,0,e_3,438,446,484,3,4,0,11,4,1,3,8,38,46
p_167,7,0,e_3,412,451,484,7,4,3,8,2,1,3,39,33,72
p_154,7,0,e_3,438,451,484,3,5,1,10,4,1,4,13,33,46
p_166,5,0,e_3,415,459,484,8,5,2,9,5,1,4,44,25,69
p_169,11,0,e_2,410,420,489,4,5,0,8,5,0,1,10,69,79
p_193,12,0,e_2,378,425,489,20,4,4,2,4,1,0,47,64,111
p_183,12,0,e_2,393,425,489,10,3,0,2,5,0,1,32,64,96
p_168,15,0,e_2,412,436,489,7,4,0,9,5,0,2,24,53,77
p_146,10,0,e_2,451,453,489,27,5,5,11,4,1,0,2,36,38
p_138,7,0,e_2,456,464,489,29,5,5,9,4,1,1,8,25,33
p_135,7,0,e_2,461,464,489,28,5,5,8,4,1,2,3,25,28
p_143,2,0,e_2,451,481,489,5,5,3,10,4,1,1,30,8,38
p_156,1,0,e_3,428,489,520,12,4,1,11,5,1,3,61,31,92
p_136,2,0,e_3,460,494,520,3,4,2,5,4,1,3,34,26,60
p_148,3,0,e_3,447,499,520,5,4,2,8,4,1,3,52,21,73
p_144,4,0,e_3,451,504,520,3,4,1,7,1,1,3,53,16,69
p_118,4,0,e_3,488,504,520,3,4,0,1,5,0,4,16,16,32
p_107,1,0,e_3,512,515,520,1,3,0,2,4,1,2,3,5,8
p_186,1,0,e_1,391,439,578,15,3,3,9,1,1,5,48,139,187
p_185,2,0,e_1,392,444,578,14,3,3,9,4,1,6,52,134,186
p_175,2,0,e_1,399,444,578,15,4,4,7,4,1,9,45,134,179
p_174,3,0,e_1,402,449,578,13,4,3,7,4,1,8,47,129,176
p_171,3,0,e_1,408,449,578,12,5,4,6,4,1,9,41,129,170
p_196,5,0,e_1,376,457,578,27,4,4,12,4,1,2,81,121,202
p_192,5,0,e_1,380,457,578,26,4,4,12,4,1,4,77,121,198
p_184,5,0,e_1,393,457,578,11,3,3,9,4,1,7,64,121,185
p_182,5,0,e_1,394,457,578,10,3,3,9,4,1,7,63,121,184
p_178,5,0,e_1,398,457,578,13,4,4,8,4,1,8,59,121,180
p_179,6,0,e_1,397,462,578,12,4,3,8,4,1,7,65,116,181
p_176,6,0,e_1,398,462,578,12,4,3,8,4,1,8,64,116,180
p_191,7,0,e_1,382,467,578,24,4,4,11,4,1,4,85,111,196
p_189,7,0,e_1,387,467,578,11,3,2,10,4,1,5,80,111,191
p_187,7,0,e_1,391,467,578,9,3,2,9,1,1,6,76,111,187
p_116,7,0,e_2,490,514,583,6,4,0,0,3,0,0,24,69,93
p_113,11,0,e_2,496,528,583,9,5,0,1,5,0,1,32,55,87
p_101,12,0,e_2,521,533,583,12,2,0,9,5,1,3,12,50,62
p_97,10,0,e_2,526,541,583,8,2,0,11,5,1,5,15,42,57
p_93,7,0,e_2,529,552,583,11,2,2,11,5,1,5,23,31,54
p_89,7,0,e_2,537,552,583,14,3,3,11,4,1,5,15,31,46
p_98,6,0,e_2,524,557,583,13,2,2,10,5,1,4,33,26,59
p_94,6,0,e_2,528,557,583,12,2,2,11,5,1,5,29,26,55
p_86,6,0,e_2,541,557,583,18,5,5,10,4,1,4,16,26,42
p_108,5,0,e_2,509,562,583,28,3,3,6,5,0,2,53,21,74
p_83,5,0,e_2,546,562,583,17,5,5,9,4,1,4,16,21,37
p_105,4,0,e_2,515,567,583,27,3,3,7,5,1,2,52,16,68
p_84,3,0,e_2,546,572,583,19,5,5,9,4,1,4,26,11,37
p_119,5,0,e_0,483,500,585,5,4,4,0,3,1,0,17,85,102
p_117,12,0,e_0,490,523,585,11,4,0,2,5,0,1,33,62,95
p_103,13,0,e_0,517,528,585,18,3,3,10,5,1,4,11,57,68
p_100,10,0,e_0,522,539,585,10,2,0,12,5,1,6,17,46,63
p_104,7,0,e_0,516,550,585,24,3,3,10,5,1,3,34,35,69
p_95,6,0,e_0,527,555,585,12,2,2,13,2,1,6,28,30,58
p_80,6,0,e_0,548,555,585,15,4,4,7,4,1,7,7,30,37
p_96,5,0,e_0,527,560,585,13,2,2,13,5,1,6,33,25,58
p_106,4,0,e_0,512,565,585,28,4,4,9,5,1,2,53,20,73
p_78,4,0,e_0,555,565,585,16,4,3,6,4,1,5,10,20,30
p_85,3,0,e_0,542,570,585,20,5,5,9,4,1,6,28,15,43
p_82,3,0,e_0,547,570,585,18,5,4,8,4,1,7,23,15,38
p_102,2,0,e_0,521,575,585,18,2,2,12,5,1,5,54,10,64
p_81,2,0,e_0,547,575,585,20,5,5,8,4,1,7,28,10,38
p_71,2,0,e_0,569,575,585,14,5,1,3,1,1,2,6,10,16
p_114,9,0,e_3,494,549,646,7,3,0,2,2,1,2,55,97,152
p_115,10,0,e_3,494,554,646,8,4,0,2,2,1,3,60,92,152
p_92,13,0,e_3,533,565,646,9,2,0,4,5,0,2,32,81,113
p_91,13,0,e_3,535,565,646,9,3,0,4,5,0,3,30,81,111
p_88,14,0,e_3,538,570,646,8,3,0,6,5,0,3,32,76,108
p_79,14,0,e_3,549,570,646,7,5,1,9,5,1,4,21,76,97
p_75,14,0,e_3,563,570,646,4,6,1,12,5,1,5,7,76,83
p_87,15,0,e_3,539,575,646,9,4,0,6,5,0,4,36,71,107
p_72,15,0,e_3,569,575,646,1,5,0,14,2,1,4,6,71,77
p_68,14,0,e_3,574,580,646,1,7,0,15,5,1,6,6,66,72
p_66,12,0,e_3,577,588,646,3,8,1,15,4,1,7,11,58,69
p_65,12,0,e_3,578,588,646,2,9,0,14,4,1,8,10,58,68
p_74,11,0,e_3,567,593,646,6,5,2,13,5,1,4,26,53,79
p_69,10,0,e_3,573,598,646,5,6,0,15,5,1,5,25,48,73
p_58,10,0,e_3,586,598,646,3,11,2,13,4,1,10,12,48,60
p_55,4,0,e_2,590,598,694,8,10,7,2,5,0,2,8,96,104
p_61,5,0,e_2,583,603,694,9,10,6,0,3,0,0,20,91,111
p_59,6,0,e_2,584,608,694,7,10,5,0,3,0,1,24,86,110
p_57,6,0,e_2,587,608,694,6,11,5,1,5,0,2,21,86,107
p_54,6,0,e_2,590,608,694,6,10,5,2,5,0,3,18,86,104
p_52,11,0,e_2,591,625,694,30,10,10,2,5,0,4,34,69,103
p_44,15,0,e_2,598,639,694,25,8,8,4,5,1,4,41,55,96
p_36,11,0,e_2,635,653,694,22,9,9,14,5,1,3,18,41,59
p_32,5,0,e_2,657,673,694,12,9,5,10,4,1,2,16,21,37
p_31,5,0,e_2,662,673,694,12,8,5,9,4,1,3,11,21,32
p_38,4,0,e_2,627,678,694,30,9,9,11,5,1,2,51,16,67
p_35,4,0,e_2,640,678,694,27,9,9,15,4,1,3,38,16,54
p_51,1,0,e_2,591,689,694,10,10,7,2,5,0,3,98,5,103
p_110,1,0,e_0,501,590,695,16,4,3,5,5,1,1,89,105,194
p_99,1,0,e_0,522,590,695,19,2,2,12,2,1,6,68,105,173
p_56,2,0,e_0,588,595,695,10,10,8,0,5,0,1,7,100,107
p_48,2,0,e_0,593,595,695,9,9,7,2,5,1,2,2,100,102
p_53,9,0,e_0,590,618,695,3,10,2,1,2,0,1,28,77,105
p_41,10,0,e_0,600,623,695,30,9,9,3,5,1,2,23,72,95
p_46,13,0,e_0,596,634,695,28,9,9,2,5,1,1,38,61,99
p_39,15,0,e_0,609,642,695,23,9,9,6,5,1,3,33,53,86
p_33,8,0,e_0,647,665,695,12,9,2,14,4,1,1,18,30,48
p_37,7,0,e_0,633,670,695,26,9,9,13,2,1,1,37,25,62
p_30,5,0,e_0,676,678,695,9,5,4,6,4,1,0,2,17,19
p_90,2,0,e_1,536,586,706,19,3,3,9,1,1,11,50,120,170
p_125,4,0,e_1,474,594,706,28,4,4,8,5,1,10,120,112,232
p_129,5,0,e_1,470,599,706,28,4,4,8,5,1,6,129,107,236
p_122,5,0,e_1,477,599,706,26,4,4,9,2,1,11,122,107,229
p_126,6,0,e_1,473,604,706,26,4,4,8,5,1,8,131,102,233
p_132,7,0,e_1,463,609,706,27,4,4,6,5,1,7,146,97,243
p_197,8,0,e_1,375,614,706,25,4,4,13,4,1,1,239,92,331
p_188,8,0,e_1,390,614,706,8,3,1,9,1,1,5,224,92,316
p_195,9,0,e_1,376,619,706,23,4,4,12,4,1,3,243,87,330
p_131,9,0,e_1,467,619,706,24,5,5,7,5,1,6,152,87,239
p_130,9,0,e_1,469,619,706,24,4,4,7,5,1,6,150,87,237
p_121,9,0,e_1,480,619,706,22,4,4,10,5,1,12,139,87,226
p_128,10,0,e_1,471,624,706,23,4,4,8,2,1,7,153,82,235
p_120,10,0,e_1,481,624,706,21,4,4,10,5,1,12,143,82,225
p_194,11,0,e_1,377,629,706,21,4,4,12,1,1,3,252,77,329
p_24,5,0,e_2,707,725,742,11,3,1,0,3,0,0,18,17,35
p_23,5,0,e_2,709,725,742,11,3,1,0,5,0,1,16,17,33
p_26,3,0,e_0,698,710,747,16,2,1,0,3,0,0,12,37,49
p_25,7,0,e_0,703,724,747,10,3,1,1,5,0,1,21,23,44
p_64,1,0,e_3,579,651,760,13,8,7,14,1,1,7,72,109,181
p_70,3,0,e_3,572,659,760,13,5,1,14,5,1,4,87,101,188
p_43,3,0,e_3,599,659,760,7,8,5,10,4,1,7,60,101,161
p_42,4,0,e_3,600,664,760,6,8,5,10,4,1,7,64,96,160
p_40,4,0,e_3,601,664,760,6,9,5,10,4,1,8,63,96,159
p_62,5,0,e_3,582,669,760,9,9,6,14,4,1,8,87,91,178
p_49,5,0,e_3,592,669,760,6,9,5,11,1,1,8,77,91,168
p_45,5,0,e_3,597,669,760,5,9,4,10,4,1,8,72,91,163
p_77,6,0,e_3,557,674,760,14,4,3,10,5,1,3,117,86,203
p_73,6,0,e_3,568,674,760,11,6,2,13,5,1,5,106,86,192
p_47,6,0,e_3,594,674,760,5,9,4,11,4,1,8,80,86,166
p_76,7,0,e_3,559,679,760,12,5,3,11,5,1,4,120,81,201
p_67,8,0,e_3,574,684,760,7,8,0,15,5,1,7,110,76,186
p_63,8,0,e_3,581,684,760,6,9,3,14,4,1,8,103,76,179
p_60,9,0,e_3,584,689,760,4,10,3,13,4,1,9,105,71,176
p_27,2,0,e_1,693,714,814,18,3,1,4,4,1,5,21,100,121
p_28,6,0,e_1,679,728,814,17,5,4,8,4,1,4,49,86,135
p_20,9,0,e_1,737,739,814,28,3,3,9,5,1,5,2,75,77
p_21,10,0,e_1,732,744,814,29,3,3,7,5,1,4,12,70,82
p_200,12,0,e_1,367,752,814,9,4,0,14,2,1,2,385,62,447
p_145,12,0,e_1,451,752,814,25,5,5,3,5,1,8,301,62,363
p_134,12,0,e_1,462,752,814,23,5,5,6,5,1,7,290,62,352
p_123,12,0,e_1,474,752,814,20,4,4,8,5,1,11,278,62,340
p_19,12,0,e_1,740,752,814,24,3,3,9,5,1,5,12,62,74
p_140,13,0,e_1,455,757,814,23,5,5,4,5,1,8,302,57,359
p_139,13,0,e_1,456,757,814,23,5,5,5,5,1,9,301,57,358
p_137,13,0,e_1,458,757,814,22,5,5,5,5,1,8,299,57,356
p_124,14,0,e_1,474,762,814,18,4,4,8,5,1,9,288,52,340
p_109,14,0,e_1,506,762,814,20,3,3,15,2,1,11,256,52,308
p_151,15,0,e_1,443,767,814,24,5,5,2,2,1,8,324,47,371
p_18,2,0,e_0,768,776,856,26,2,2,0,3,0,0,8,80,88
p_13,11,0,e_0,794,805,856,9,2,1,7,5,1,1,11,51,62
p_16,13,0,e_0,774,813,856,13,2,1,2,5,0,1,39,43,82
p_12,13,0,e_0,796,813,856,6,2,1,8,5,1,2,17,43,60
p_9,2,0,e_0,845,848,856,3,1,0,3,4,1,0,3,8,11
p_8,1,0,e_2,847,853,858,3,1,0,0,3,0,0,6,5,11
p_50,10,0,e_3,592,792,860,1,9,0,11,1,1,8,200,68,268
p_22,10,0,e_3,712,792,860,5,2,0,15,4,1,1,80,68,148
p_29,15,0,e_3,678,809,860,8,4,0,7,2,1,3,131,51,182
p_17,15,0,e_3,772,809,860,12,2,0,3,5,0,2,37,51,88
p_15,15,0,e_3,782,809,860,8,2,0,7,5,0,2,27,51,78
p_14,15,0,e_3,790,809,860,6,2,0,9,5,0,2,19,51,70
p_10,14,0,e_3,810,814,860,1,2,0,15,4,1,1,4,46,50
p_11,11,0,e_3,810,825,860,4,1,0,15,4,1,0,15,35,50
p_4,1,0,e_2,864,870,875,1,0,0,0,3,0,0,6,5,11
p_3,1,0,e_2,876,882,887,1,0,0,0,3,0,0,6,5,11
p_5,5,0,e_0,860,877,896,5,0,0,0,3,0,0,17,19,36
p_2,3,0,e_0,878,885,896,3,0,0,5,4,1,0,7,11,18
p_1,2,0,e_2,889,898,906,2,0,0,0,3,0,0,9,8,17
p_7,12,0,e_1,851,852,912,21,1,1,12,5,0,1,1,60,61
p_6,14,0,e_1,858,860,912,17,1,1,13,5,1,1,2,52,54
p_149,15,0,e_1,444,865,912,23,5,5,2,2,1,9,421,47,468
p_142,15,0,e_1,452,865,912,22,5,5,4,5,1,8,413,47,460
p_141,15,0,e_1,455,865,912,21,5,5,4,5,1,9,410,47,457
p_127,15,0,e_1,473,865,912,17,4,4,8,5,1,8,392,47,439
p_112,15,0,e_1,497,865,912,13,5,0,13,2,1,11,368,47,415
p_111,15,0,e_1,501,865,912,12,4,0,14,2,1,11,364,47,411
p_34,15,0,e_1,643,865,912,16,9,9,14,5,1,4,222,47,269
p_296,1,0,e_3,20,25,30,1,0,0,0,3,0,0,5,5,10
p_299,3,0,e_1,7,19,30,3,0,0,0,3,0,0,12,11,23
p_298,4,0,e_2,10,24,46,4,0,0,0,3,0,0,14,22,36
p_295,5,0,e_2,22,29,46,5,1,0,4,5,0,1,7,17,24
p_288,1,0,e_2,49,54,97,9,3,2,0,3,0,0,5,43,48
p_285,2,0,e_2,54,59,97,7,3,2,1,5,1,1,5,38,43
p_286,3,0,e_2,51,64,97,7,3,2,0,5,0,1,13,33,46
p_282,6,0,e_2,62,75,97,7,2,1,2,5,1,1,13,22,35
p_279,2,0,e_2,76,89,97,7,1,0,6,4,1,0,13,8,21
p_275,2,0,e_2,84,89,97,5,3,1,4,4,1,2,5,8,13
p_290,4,0,e_3,43,49,107,6,1,1,2,5,0,1,6,58,64
p_291,6,0,e_3,35,57,107,6,0,0,0,3,0,0,22,50,72
p_289,7,0,e_3,47,62,107,3,2,0,4,5,0,2,15,45,60
p_283,10,0,e_3,55,73,107,5,3,0,5,5,1,2,18,34,52
p_281,10,0,e_3,63,73,107,3,2,0,7,5,1,1,10,34,44
p_274,4,0,e_3,84,93,107,3,2,0,7,4,1,1,9,14,23
p_292,11,0,e_1,30,65,108,11,0,0,0,3,1,0,35,43,78
p_287,12,0,e_1,51,70,108,8,3,0,6,5,0,1,19,38,57
p_280,12,0,e_1,65,70,108,5,2,0,11,2,0,1,5,38,43
p_300,8,0,e_0,4,31,109,8,0,0,0,3,0,0,27,78,105
p_297,12,0,e_0,18,45,109,12,0,0,4,5,0,1,27,64,91
p_294,13,0,e_0,23,50,109,13,1,0,5,5,0,2,27,59,86
p_293,15,0,e_0,26,58,109,16,1,1,7,5,0,3,32,51,83
p_284,14,0,e_0,55,63,109,9,3,0,14,5,1,1,8,46,54
p_276,5,0,e_0,82,92,109,3,2,0,8,4,1,0,10,17,27
p_269,4,0,e_1,146,161,177,7,1,0,0,3,0,0,15,16,31
p_267,1,0,e_1,153,172,177,7,1,0,1,5,0,1,19,5,24
p_277,10,0,e_3,81,139,179,28,1,1,8,4,1,0,58,40,98
p_271,11,0,e_3,127,144,179,5,1,0,6,5,0,1,17,35,52
p_270,7,0,e_0,133,156,181,7,2,2,0,3,0,0,23,25,48
p_264,5,0,e_0,162,164,181,30,1,1,6,4,1,0,2,17,19
p_273,13,0,e_2,95,138,199,21,2,2,0,4,1,1,43,61,104
p_278,15,0,e_2,80,146,199,23,1,1,5,4,1,1,66,53,119
p_272,15,0,e_2,105,146,199,16,2,2,2,5,0,2,41,53,94
p_268,10,0,e_2,150,163,199,29,1,1,14,4,1,0,13,36,49
p_262,6,0,e_2,164,177,199,29,1,1,10,4,1,0,13,22,35
p_259,6,0,e_2,174,177,199,26,2,2,7,4,1,1,3,22,25
p_258,5,0,e_2,175,182,199,26,2,2,7,4,1,1,7,17,24
p_254,3,0,e_2,199,211,224,15,3,3,0,3,0,0,12,13,25
p_252,2,0,e_2,212,216,224,12,2,1,3,4,1,0,4,8,12
p_251,4,0,e_2,228,242,256,6,1,0,0,3,0,0,14,14,28
p_256,8,0,e_3,191,205,259,12,1,1,4,5,0,1,14,54,68
p_255,10,0,e_3,192,213,259,10,2,1,4,5,0,2,21,46,67
p_261,12,0,e_3,170,221,259,21,1,1,3,4,1,0,51,38,89
p_257,12,0,e_3,179,221,259,12,1,1,0,3,1,1,42,38,80
p_263,12,0,e_0,163,219,267,23,1,1,5,1,1,0,56,48,104
p_260,13,0,e_0,171,224,267,20,2,2,3,4,1,1,53,43,96
p_250,7,0,e_0,236,244,267,30,1,1,10,4,1,0,8,23,31
p_249,7,0,e_0,238,244,267,30,1,1,9,4,1,1,6,23,29
p_265,12,0,e_1,157,215,275,25,1,1,3,5,0,3,58,60,118
p_266,15,0,e_1,155,226,275,23,1,1,2,5,0,2,71,49,120
p_253,15,0,e_1,208,226,275,7,3,0,10,5,0,2,18,49,67
p_248,7,0,e_1,246,252,275,27,1,1,9,4,1,0,6,23,29
p_244,2,0,e_3,271,280,288,2,0,0,0,3,0,0,9,8,17
p_243,8,0,e_0,285,295,331,23,1,1,5,5,0,1,10,36,46
p_245,9,0,e_0,269,300,331,9,0,0,0,3,0,0,31,31,62
p_238,2,0,e_0,311,323,331,23,1,1,6,4,1,0,12,8,20
p_233,2,0,e_0,319,323,331,20,1,1,3,4,1,1,4,8,12
p_247,12,0,e_2,248,294,334,21,1,1,3,4,1,0,46,40,86
p_246,12,0,e_2,257,294,334,18,1,1,0,5,0,1,37,40,77
p_237,5,0,e_2,313,317,334,19,1,1,6,4,1,0,4,17,21
p_242,4,0,e_1,287,301,397,4,0,0,0,3,0,0,14,96,110
p_236,8,0,e_1,313,315,397,16,1,1,8,5,1,2,2,82,84
p_235,8,0,e_1,314,315,397,16,1,1,8,2,1,2,1,82,83
p_241,13,0,e_1,300,334,397,13,0,0,4,3,0,0,34,63,97
p_240,14,0,e_1,301,339,397,14,0,0,4,5,1,1,38,58,96
p_234,14,0,e_1,314,339,397,12,1,0,8,2,1,2,25,58,83
p_224,13,0,e_1,335,344,397,4,4,0,13,5,1,3,9,53,62
p_223,13,0,e_1,339,344,397,3,4,0,14,2,1,3,5,53,58
p_219,11,0,e_1,342,352,397,4,3,2,14,4,1,3,10,45,55
p_229,9,0,e_1,323,360,397,12,2,2,10,5,1,3,37,37,74
p_227,9,0,e_1,326,360,397,11,3,3,10,5,1,4,34,37,71
p_220,9,0,e_1,342,360,397,6,3,2,13,4,1,4,18,37,55
p_218,9,0,e_1,343,360,397,6,3,2,13,4,1,4,17,37,54
p_212,9,0,e_1,348,360,397,5,4,1,12,4,1,3,12,37,49
p_206,6,0,e_1,362,371,397,8,3,1,9,4,1,3,9,26,35
p_222,3,0,e_2,339,350,415,13,4,3,0,3,0,0,11,65,76
p_221,4,0,e_2,341,355,415,12,4,3,0,5,0,1,14,60,74
p_215,6,0,e_2,346,363,415,9,3,2,2,5,0,3,17,52,69
p_217,8,0,e_2,345,371,415,7,3,2,1,5,0,2,26,44,70
p_204,8,0,e_2,364,371,415,6,3,1,6,5,1,1,7,44,51
p_198,9,0,e_2,368,376,415,4,3,1,7,5,1,2,8,39,47
p_197,8,0,e_2,375,381,415,3,2,0,9,5,1,2,6,34,40
p_191,7,0,e_2,382,386,415,2,3,0,8,4,1,2,4,29,33
p_196,5,0,e_2,376,394,415,5,3,1,9,4,1,2,18,21,39
p_199,2,0,e_2,368,405,415,11,3,2,7,5,1,1,37,10,47
p_185,2,0,e_2,392,405,415,5,3,2,6,4,1,3,13,10,23
p_175,2,0,e_2,399,405,415,3,3,1,4,4,1,2,6,10,16
p_186,1,0,e_2,391,410,415,6,3,2,6,4,1,2,19,5,24
p_231,10,0,e_3,320,338,418,12,1,1,4,5,0,1,18,80,98
p_228,11,0,e_3,325,343,418,9,2,1,6,5,0,2,18,75,93
p_226,12,0,e_3,331,348,418,6,3,1,8,5,0,3,17,70,87
p_213,12,0,e_3,347,348,418,2,3,1,12,2,1,2,1,70,71
p_239,13,0,e_3,305,355,418,13,0,0,0,3,0,0,50,63,113
p_208,13,0,e_3,355,355,418,2,3,1,13,2,1,2,0,63,63
p_211,14,0,e_3,348,362,418,2,4,0,12,2,1,3,14,56,70
p_207,12,0,e_3,355,370,418,3,4,1,13,2,1,3,15,48,63
p_203,12,0,e_3,365,370,418,1,3,0,13,4,1,2,5,48,53
p_200,12,0,e_3,367,370,418,1,3,0,13,4,1,2,3,48,51
p_195,9,0,e_3,376,381,418,2,2,0,11,4,1,1,5,37,42
p_189,7,0,e_3,387,389,418,1,3,0,8,4,1,2,2,29,31
p_192,5,0,e_3,380,397,418,4,2,0,9,1,1,1,17,21,38
p_184,5,0,e_3,393,397,418,1,3,0,6,4,1,2,4,21,25
p_182,5,0,e_3,394,397,418,1,3,0,6,4,1,2,3,21,24
p_225,10,0,e_0,333,366,436,8,4,3,0,3,0,0,33,70,103
p_202,13,0,e_0,365,377,436,30,3,3,10,5,0,3,12,59,71
p_201,13,0,e_0,366,377,436,30,3,3,10,5,1,3,11,59,70
p_193,12,0,e_0,378,382,436,28,3,3,13,4,1,3,4,54,58
p_194,11,0,e_0,377,387,436,29,3,3,13,4,1,2,10,49,59
p_188,8,0,e_0,390,398,436,29,3,3,10,4,1,2,8,38,46
p_187,7,0,e_0,391,403,436,30,3,3,10,4,1,3,12,33,45
p_179,6,0,e_0,397,408,436,29,3,3,8,1,1,3,11,28,39
p_176,6,0,e_0,398,408,436,29,3,3,8,4,1,4,10,28,38
p_178,5,0,e_0,398,413,436,30,3,3,8,4,1,4,15,23,38
p_171,3,0,e_0,408,421,436,30,3,3,6,4,1,3,13,15,28
p_209,2,0,e_0,354,426,436,13,4,1,6,5,0,2,72,10,82
p_216,1,0,e_0,346,431,436,13,4,1,4,5,0,1,85,5,90
p_156,1,0,e_0,428,431,436,24,5,4,2,4,1,1,3,5,8
p_205,1,0,e_1,362,402,519,13,3,0,9,4,1,2,40,117,157
p_210,4,0,e_1,353,413,519,11,4,1,11,4,1,2,60,106,166
p_232,5,0,e_1,320,418,519,17,2,2,8,5,1,2,98,101,199
p_230,5,0,e_1,323,418,519,16,2,2,10,5,1,4,95,101,196
p_167,7,0,e_1,412,426,519,25,4,4,4,3,1,7,14,93,107
p_177,9,0,e_1,398,434,519,26,3,3,0,5,0,6,36,85,121
p_173,10,0,e_1,405,439,519,24,3,3,2,5,1,6,34,80,114
p_170,10,0,e_1,408,439,519,23,3,3,3,5,1,7,31,80,111
p_181,11,0,e_1,395,444,519,25,3,3,1,4,1,4,49,75,124
p_183,12,0,e_1,393,449,519,24,3,3,1,4,1,3,56,70,126
p_190,14,0,e_1,382,457,519,25,3,3,4,4,1,2,75,62,137
p_172,14,0,e_1,405,457,519,19,3,3,2,5,1,7,52,62,114
p_168,15,0,e_1,412,462,519,17,4,4,4,5,1,7,50,57,107
p_151,15,0,e_1,443,462,519,9,5,0,11,2,1,3,19,57,76
p_149,15,0,e_1,444,462,519,8,5,0,11,5,1,3,18,57,75
p_163,4,0,e_2,417,429,523,26,4,4,0,5,0,4,12,94,106
p_166,5,0,e_2,415,434,523,26,4,4,0,5,0,1,19,89,108
p_169,11,0,e_2,410,454,523,21,3,3,1,1,1,0,44,69,113
p_159,11,0,e_2,424,454,523,16,5,2,3,5,0,5,30,69,99
p_164,12,0,e_2,416,459,523,18,4,4,0,5,0,3,43,64,107
p_157,12,0,e_2,427,459,523,14,5,2,4,5,0,5,32,64,96
p_145,12,0,e_2,451,459,523,7,5,2,10,5,1,3,8,64,72
p_140,13,0,e_2,455,464,523,5,4,1,11,5,1,2,9,59,68
p_137,13,0,e_2,458,464,523,4,4,1,12,5,1,3,6,59,65
p_165,14,0,e_2,416,469,523,16,4,4,0,5,0,2,53,54,107
p_162,14,0,e_2,417,469,523,14,3,3,0,5,0,5,52,54,106
p_158,14,0,e_2,426,469,523,12,5,0,3,5,0,5,43,54,97
p_130,9,0,e_2,469,486,523,17,2,0,14,4,1,2,17,37,54
p_121,9,0,e_2,480,486,523,3,3,0,11,4,1,3,6,37,43
p_132,7,0,e_2,463,494,523,8,4,1,13,2,1,2,31,29,60
p_174,3,0,e_3,402,429,526,1,2,0,4,1,1,1,27,97,124
p_214,4,0,e_3,346,434,526,10,3,1,12,5,1,2,88,92,180
p_160,10,0,e_3,421,454,526,18,4,2,0,5,0,4,33,72,105
p_161,13,0,e_3,418,465,526,13,3,3,0,3,1,3,47,61,108
p_180,14,0,e_3,396,470,526,21,2,2,5,1,1,1,74,56,130
p_123,12,0,e_3,474,478,526,1,3,0,13,4,1,2,4,48,52
p_120,10,0,e_3,481,486,526,2,3,0,12,4,1,2,5,40,45
p_129,5,0,e_3,470,503,526,9,2,0,14,4,1,1,33,23,56
p_122,5,0,e_3,477,503,526,7,3,0,12,1,1,2,26,23,49
p_118,4,0,e_3,488,508,526,6,3,1,10,4,1,2,20,18,38
p_155,3,0,e_3,434,513,526,1,4,4,4,3,1,3,79,13,92
p_107,1,0,e_3,512,521,526,2,3,0,3,4,1,2,9,5,14
p_150,3,0,e_0,444,450,565,18,5,3,1,5,0,3,6,115,121
p_154,7,0,e_0,438,464,565,16,5,3,0,3,0,0,26,101,127
p_147,7,0,e_0,450,464,565,12,5,3,3,2,0,3,14,101,115
p_153,8,0,e_0,438,469,565,15,5,3,0,3,0,1,31,96,127
p_131,9,0,e_0,467,474,565,6,3,1,8,5,1,4,7,91,98
p_152,10,0,e_0,439,479,565,13,5,2,0,5,0,2,40,86,126
p_146,10,0,e_0,451,479,565,9,5,2,3,5,1,4,28,86,114
p_128,10,0,e_0,471,479,565,4,3,0,8,5,1,4,8,86,94
p_124,14,0,e_0,474,493,565,29,4,4,9,5,1,5,19,72,91
p_127,15,0,e_0,473,498,565,29,3,3,9,2,1,4,25,67,92
p_112,15,0,e_0,497,498,565,22,4,4,15,5,1,8,1,67,68
p_117,12,0,e_0,490,509,565,27,4,4,13,5,1,5,19,56,75
p_113,11,0,e_0,496,514,565,26,4,4,14,5,1,7,18,51,69
p_115,10,0,e_0,494,519,565,28,4,4,14,5,1,6,25,46,71
p_114,9,0,e_0,494,524,565,29,4,4,14,5,1,5,30,41,71
p_86,6,0,e_3,541,546,636,18,4,4,4,5,0,4,5,90,95
p_97,10,0,e_3,526,560,636,18,3,3,0,5,0,3,34,76,110
p_101,12,0,e_3,521,568,636,19,3,3,1,1,1,2,47,68,115
p_103,13,0,e_3,517,573,636,19,3,3,2,4,1,2,56,63,119
p_92,13,0,e_3,533,573,636,13,4,1,2,5,0,4,40,63,103
p_91,13,0,e_3,535,573,636,12,4,1,3,5,0,4,38,63,101
p_109,14,0,e_3,506,578,636,21,3,3,5,4,1,2,72,58,130
p_88,14,0,e_3,538,578,636,10,4,0,4,5,0,4,40,58,98
p_79,14,0,e_3,549,578,636,8,5,0,6,5,1,4,29,58,87
p_75,14,0,e_3,563,578,636,3,5,0,11,5,1,4,15,58,73
p_68,14,0,e_3,574,578,636,1,6,0,13,5,1,5,4,58,62
p_74,11,0,e_3,567,589,636,5,5,2,12,5,1,4,22,47,69
p_69,10,0,e_3,573,594,636,5,5,1,13,5,1,4,21,42,63
p_58,10,0,e_3,586,594,636,2,6,1,12,4,1,5,8,42,50
p_50,10,0,e_3,592,594,636,1,5,0,11,4,1,4,2,42,44
p_148,3,0,e_1,447,530,637,17,5,3,12,5,1,3,83,107,190
p_144,4,0,e_1,451,535,637,15,5,3,12,5,1,3,84,102,186
p_125,4,0,e_1,474,535,637,9,4,2,12,1,1,5,61,102,163
p_138,7,0,e_1,456,546,637,11,4,2,14,5,1,4,90,91,181
p_135,7,0,e_1,461,546,637,9,4,2,15,2,1,4,85,91,176
p_100,10,0,e_1,522,557,637,21,4,4,1,5,0,6,35,80,115
p_134,12,0,e_1,462,565,637,4,4,2,15,4,1,4,103,72,175
p_139,13,0,e_1,456,570,637,5,4,1,14,2,1,4,114,67,181
p_142,15,0,e_1,452,578,637,6,5,0,13,5,1,4,126,59,185
p_141,15,0,e_1,455,578,637,5,4,0,13,5,1,4,123,59,182
p_72,15,0,e_1,569,578,637,3,5,0,13,2,1,2,9,59,68
p_65,12,0,e_1,578,589,637,2,5,0,15,4,1,2,11,48,59
p_53,9,0,e_1,590,600,637,2,5,1,12,4,1,3,10,37,47
p_77,6,0,e_1,557,611,637,13,5,4,10,2,1,3,54,26,80
p_57,6,0,e_1,587,611,637,6,6,4,12,4,1,4,24,26,50
p_110,1,0,e_2,501,528,639,5,4,3,5,4,1,4,27,111,138
p_99,1,0,e_2,522,528,639,30,4,4,0,3,1,5,6,111,117
p_136,2,0,e_2,460,533,639,15,4,2,12,5,1,2,73,106,179
p_119,5,0,e_2,483,544,639,6,4,1,10,4,1,3,61,95,156
p_80,6,0,e_2,548,549,639,16,5,4,6,5,1,3,1,90,91
p_116,7,0,e_2,490,554,639,2,4,0,8,4,1,3,64,85,149
p_89,7,0,e_2,537,554,639,18,4,4,3,5,1,3,17,85,102
p_111,15,0,e_2,501,580,639,21,4,4,5,4,1,3,79,59,138
p_87,15,0,e_2,539,580,639,11,4,0,4,5,1,3,41,59,100
p_66,12,0,e_2,577,591,639,4,5,0,14,5,1,3,14,48,62
p_52,11,0,e_2,591,596,639,30,5,5,12,4,1,3,5,43,48
p_47,6,0,e_2,594,613,639,4,5,2,11,4,1,4,19,26,45
p_83,5,0,e_2,546,618,639,17,5,4,5,5,1,2,72,21,93
p_78,4,0,e_2,555,623,639,16,5,4,7,5,1,2,68,16,84
p_55,4,0,e_2,590,623,639,7,5,3,12,1,1,3,33,16,49
p_143,2,0,e_0,451,573,697,17,5,3,3,5,1,3,122,124,246
p_102,2,0,e_0,521,573,697,29,3,3,10,4,1,6,52,124,176
p_90,2,0,e_0,536,573,697,23,4,4,6,1,1,4,37,124,161
p_81,2,0,e_0,547,573,697,20,5,4,4,1,1,5,26,124,150
p_85,3,0,e_0,542,578,697,20,5,5,5,4,1,4,36,119,155
p_84,3,0,e_0,546,578,697,19,5,4,4,1,1,5,32,119,151
p_82,3,0,e_0,547,578,697,19,5,4,4,1,1,5,31,119,150
p_133,4,0,e_0,463,583,697,12,4,2,7,5,1,4,120,114,234
p_106,4,0,e_0,512,583,697,29,3,3,11,4,1,7,71,114,185
p_105,4,0,e_0,515,583,697,29,3,3,11,4,1,6,68,114,182
p_108,5,0,e_0,509,588,697,29,3,3,12,1,1,6,79,109,188
p_96,5,0,e_0,527,588,697,23,4,4,9,4,1,5,61,109,170
p_61,5,0,e_0,583,588,697,8,5,3,4,3,1,4,5,109,114
p_126,6,0,e_0,473,593,697,8,3,0,9,5,1,4,120,104,224
p_98,6,0,e_0,524,593,697,24,4,4,9,1,1,5,69,104,173
p_71,2,0,e_1,569,645,699,14,5,2,13,2,1,2,76,54,130
p_40,4,0,e_1,601,653,699,5,5,1,9,4,1,3,52,46,98
p_62,5,0,e_1,582,658,699,8,5,3,14,4,1,3,76,41,117
p_45,5,0,e_1,597,658,699,5,5,2,10,4,1,4,61,41,102
p_32,5,0,e_1,657,658,699,8,3,2,5,5,1,3,1,41,42
p_54,6,0,e_1,590,663,699,5,5,3,12,4,1,3,73,36,109
p_33,8,0,e_1,647,671,699,7,5,1,2,5,1,3,24,28,52
p_31,5,0,e_1,662,682,699,7,3,2,6,5,1,2,20,17,37
p_30,5,0,e_1,676,682,699,4,1,0,7,4,1,1,6,17,23
p_48,2,0,e_3,593,644,706,8,5,3,10,4,1,4,51,62,113
p_70,3,0,e_3,572,649,706,12,4,1,13,2,1,3,77,57,134
p_43,3,0,e_3,599,649,706,6,4,1,9,1,1,3,50,57,107
p_42,4,0,e_3,600,654,706,5,4,1,9,4,1,3,54,52,106
p_76,7,0,e_3,559,665,706,11,4,3,10,2,1,3,106,41,147
p_60,9,0,e_3,584,673,706,3,5,2,12,4,1,4,89,33,122
p_28,6,0,e_3,679,684,706,1,1,0,7,4,1,0,5,22,27
p_27,2,0,e_3,693,698,706,2,1,0,4,4,1,0,5,8,13
p_64,1,0,e_2,579,644,741,13,5,4,15,2,1,3,65,97,162
p_35,4,0,e_2,640,655,741,13,5,2,0,5,0,1,15,86,101
p_34,15,0,e_2,643,690,741,13,5,0,1,5,0,2,47,51,98
p_29,15,0,e_2,678,690,741,23,1,1,11,5,1,1,12,51,63
p_25,7,0,e_2,703,716,741,24,1,1,11,4,1,1,13,25,38
p_26,3,0,e_2,698,730,741,29,1,1,13,4,1,0,32,11,43
p_23,5,0,e_3,709,726,743,5,0,0,0,3,0,0,17,17,34
p_24,5,0,e_1,707,724,789,5,0,0,0,3,0,0,17,65,82
p_22,10,0,e_1,712,741,789,10,1,0,1,5,0,1,29,48,77
p_21,10,0,e_1,732,741,789,23,1,1,7,5,1,1,9,48,57
p_19,12,0,e_1,740,749,789,19,1,1,10,5,1,2,9,40,49
p_20,9,0,e_1,737,760,789,23,1,1,9,5,1,1,23,29,52
p_51,1,0,e_0,591,702,813,10,5,4,6,5,1,4,111,111,222
p_56,2,0,e_0,588,707,813,9,5,4,5,5,1,3,119,106,225
p_38,4,0,e_0,627,715,813,28,6,6,14,5,1,9,88,98,186
p_49,5,0,e_0,592,720,813,6,5,3,6,2,1,4,128,93,221
p_95,6,0,e_0,527,725,813,22,4,4,9,4,1,5,198,88,286
p_94,6,0,e_0,528,725,813,22,4,4,8,4,1,5,197,88,285
p_73,6,0,e_0,568,725,813,10,5,2,1,5,0,6,157,88,245
p_59,6,0,e_0,584,725,813,6,5,3,4,5,1,4,141,88,229
p_104,7,0,e_0,516,730,813,25,3,3,11,4,1,6,214,83,297
p_93,7,0,e_0,529,730,813,21,4,4,8,4,1,5,201,83,284
p_37,7,0,e_0,633,730,813,24,6,6,14,4,1,10,97,83,180
p_67,8,0,e_0,574,735,813,7,6,1,2,5,1,5,161,78,239
p_63,8,0,e_0,581,735,813,6,5,2,3,5,1,5,154,78,232
p_41,10,0,e_0,600,743,813,29,4,4,7,5,1,7,143,70,213
p_36,11,0,e_0,635,748,813,11,5,5,14,4,1,10,113,65,178
p_13,11,0,e_1,794,830,867,12,1,1,0,3,0,0,36,37,73
p_11,11,0,e_1,810,830,867,7,3,3,5,5,0,1,20,37,57
p_9,2,0,e_1,845,859,867,6,1,0,7,4,1,0,14,8,22
p_18,2,0,e_2,768,777,869,2,0,0,0,3,0,0,9,92,101
p_16,13,0,e_2,774,812,869,17,1,1,1,5,0,1,38,57,95
p_14,15,0,e_2,790,820,869,10,1,0,6,5,1,1,30,49,79
p_8,1,0,e_2,847,864,869,7,1,0,7,4,1,0,17,5,22
p_12,13,0,e_3,796,813,872,10,1,1,7,5,0,1,17,59,76
p_10,14,0,e_3,810,818,872,4,2,1,12,5,0,2,8,54,62
p_17,15,0,e_3,772,823,872,15,0,0,0,3,0,0,51,49,100
p_15,15,0,e_3,782,823,872,12,1,0,3,5,0,1,41,49,90
p_4,1,0,e_3,864,867,872,1,1,0,2,4,1,0,3,5,8
p_3,1,0,e_1,876,881,886,1,0,0,0,3,0,0,5,5,10
p_2,3,0,e_2,878,890,901,3,0,0,0,3,0,0,12,11,23
p_1,2,0,e_1,889,898,906,2,0,0,0,3,0,0,9,8,17
p_46,13,0,e_0,596,854,915,27,5,5,7,5,1,6,258,61,319
p_6,14,0,e_0,858,859,915,20,1,1,14,5,1,2,1,56,57
p_44,15,0,e_0,598,864,915,24,4,4,7,5,1,6,266,51,317
p_39,15,0,e_0,609,864,915,22,5,5,10,5,1,9,255,51,306
p_7,12,0,e_0,851,875,915,24,1,1,12,5,0,2,24,40,64
p_5,5,0,e_0,860,898,915,28,1,1,14,5,1,2,38,17,55
p_296,1,0,e_2,20,26,31,1,0,0,0,3,0,0,6,5,11
p_299,3,0,e_1,7,18,37,3,0,0,0,3,0,0,11,19,30
p_298,4,0,e_1,10,23,37,4,0,0,1,5,0,1,13,14,27
p_290,4,0,e_1,43,51,79,14,1,1,2,5,0,1,8,28,36
p_295,5,0,e_1,22,56,79,5,0,0,4,3,1,0,34,23,57
p_286,3,0,e_1,51,64,79,14,2,2,4,5,1,2,13,15,28
p_285,2,0,e_1,54,69,79,14,2,2,5,5,1,3,15,10,25
p_288,1,0,e_1,49,74,79,15,1,1,4,5,0,2,25,5,30
p_292,11,0,e_3,30,65,108,11,0,0,0,3,0,0,35,43,78
p_287,12,0,e_3,51,70,108,6,1,0,6,5,0,1,19,38,57
p_280,12,0,e_3,65,70,108,1,2,0,11,5,1,1,5,38,43
p_291,6,0,e_2,35,55,109,15,1,1,0,3,0,0,20,54,74
p_289,7,0,e_2,47,60,109,10,1,1,4,5,0,1,13,49,62
p_283,10,0,e_2,55,71,109,6,2,2,6,5,1,1,16,38,54
p_282,6,0,e_2,62,85,109,8,2,2,7,5,1,1,23,24,47
p_274,4,0,e_2,84,93,109,4,1,0,6,4,1,2,9,16,25
p_279,2,0,e_2,76,101,109,9,1,0,9,4,1,1,25,8,33
p_275,2,0,e_2,84,101,109,6,1,0,6,4,1,2,17,8,25
p_300,8,0,e_0,4,31,111,8,0,0,0,3,0,0,27,80,107
p_297,12,0,e_0,18,45,111,12,0,0,4,5,0,1,27,66,93
p_294,13,0,e_0,23,50,111,13,0,0,6,5,0,2,27,61,88
p_293,15,0,e_0,26,58,111,15,0,0,7,5,0,3,32,53,85
p_284,14,0,e_0,55,63,111,6,2,0,14,5,1,1,8,48,56
p_281,10,0,e_0,63,77,111,4,2,2,14,4,1,0,14,34,48
p_276,5,0,e_0,82,94,111,4,1,0,9,4,1,0,12,17,29
p_267,1,0,e_3,153,159,164,1,0,0,0,3,0,0,6,5,11
p_277,10,0,e_1,81,113,183,29,1,1,0,3,0,1,32,70,102
p_273,13,0,e_1,95,124,183,21,1,1,4,5,0,2,29,59,88
p_278,15,0,e_1,80,132,183,24,1,1,0,3,0,0,52,51,103
p_272,15,0,e_1,105,132,183,16,1,1,7,5,0,3,27,51,78
p_271,11,0,e_1,127,146,183,11,0,0,14,5,1,1,19,37,56
p_264,5,0,e_1,162,166,183,25,1,1,6,4,1,0,4,17,21
p_258,5,0,e_3,175,181,206,4,1,1,3,5,0,1,6,25,31
p_262,6,0,e_3,164,186,206,6,0,0,0,3,1,0,22,20,42
p_259,6,0,e_3,174,186,206,3,1,0,3,5,0,1,12,20,32
p_252,2,0,e_3,212,221,229,2,0,0,0,3,0,0,9,8,17
p_270,7,0,e_0,133,157,234,7,0,0,0,3,0,0,24,77,101
p_268,10,0,e_0,150,168,234,10,0,0,5,5,0,1,18,66,84
p_266,15,0,e_0,155,185,234,15,1,0,7,5,0,2,30,49,79
p_256,8,0,e_0,191,208,234,27,1,1,13,4,1,0,17,26,43
p_269,4,0,e_2,146,161,235,4,0,0,0,3,0,0,15,74,89
p_265,12,0,e_2,157,187,235,11,1,0,3,5,0,1,30,48,78
p_263,12,0,e_2,163,187,235,12,0,0,4,5,1,1,24,48,72
p_261,12,0,e_2,170,187,235,11,1,0,6,5,1,1,17,48,65
p_257,12,0,e_2,179,187,235,8,2,0,10,5,1,2,8,48,56
p_260,13,0,e_2,171,192,235,11,1,0,7,5,1,1,21,43,64
p_255,10,0,e_2,192,203,235,24,1,1,13,4,1,0,11,32,43
p_244,2,0,e_0,271,280,288,10,2,0,0,3,0,0,9,8,17
p_254,3,0,e_1,199,211,298,29,1,1,0,3,0,0,12,87,99
p_253,15,0,e_1,208,249,298,15,0,0,2,5,0,1,41,49,90
p_246,12,0,e_1,257,260,298,4,2,0,13,4,1,0,3,38,41
p_251,4,0,e_3,228,243,313,4,0,0,0,3,1,0,15,70,85
p_250,7,0,e_3,236,254,313,5,1,0,2,5,0,1,18,59,77
p_249,7,0,e_3,238,254,313,4,2,0,3,5,0,2,16,59,75
p_248,7,0,e_3,246,254,313,2,2,0,5,5,1,1,8,59,67
p_247,12,0,e_3,248,271,313,7,2,0,5,5,1,1,23,42,65
p_245,9,0,e_3,269,282,313,3,2,0,12,5,1,1,13,31,44
p_242,4,0,e_3,287,299,313,4,1,0,8,4,1,0,12,14,26
p_233,2,0,e_3,319,322,354,7,1,1,1,5,0,1,3,32,35
p_237,5,0,e_3,313,333,354,5,0,0,0,3,0,0,20,21,41
p_232,5,0,e_3,320,333,354,4,2,0,1,5,0,2,13,21,34
p_230,5,0,e_3,323,333,354,3,2,0,2,5,1,1,10,21,31
p_222,3,0,e_3,339,341,354,1,1,0,4,4,1,0,2,13,15
p_216,1,0,e_3,346,349,354,1,1,0,2,4,1,0,3,5,8
p_209,2,0,e_3,354,362,372,2,0,0,0,3,1,0,8,10,18
p_205,1,0,e_3,362,367,372,1,1,0,2,4,1,0,5,5,10
p_243,8,0,e_2,285,312,388,30,1,1,0,3,0,0,27,76,103
p_241,13,0,e_2,300,329,388,21,1,1,4,5,0,1,29,59,88
p_239,13,0,e_2,305,329,388,20,1,1,6,5,0,3,24,59,83
p_240,14,0,e_2,301,334,388,20,1,1,4,5,0,2,33,54,87
p_234,14,0,e_2,314,334,388,14,1,1,8,5,1,2,20,54,74
p_224,13,0,e_2,335,339,388,22,1,1,14,4,1,2,4,49,53
p_226,12,0,e_2,331,344,388,7,2,0,13,5,1,2,13,44,57
p_228,11,0,e_2,325,349,388,8,2,0,12,5,1,2,24,39,63
p_219,11,0,e_2,342,349,388,22,1,1,13,4,1,2,7,39,46
p_220,9,0,e_2,342,357,388,24,1,1,12,4,1,2,15,31,46
p_212,9,0,e_2,348,357,388,22,2,2,11,4,1,2,9,31,40
p_210,4,0,e_2,353,374,388,26,1,1,10,4,1,1,21,14,35
p_236,8,0,e_1,313,340,390,8,0,0,0,3,0,0,27,50,77
p_229,9,0,e_1,323,345,390,7,2,0,2,5,0,1,22,45,67
p_227,9,0,e_1,326,345,390,6,2,0,3,5,0,2,19,45,64
p_218,9,0,e_1,343,345,390,24,1,1,9,5,1,3,2,45,47
p_225,10,0,e_1,333,350,390,25,1,1,6,5,0,2,17,40,57
p_217,8,0,e_1,345,358,390,24,1,1,9,5,1,2,13,32,45
p_215,6,0,e_1,346,366,390,26,2,2,9,5,1,3,20,24,44
p_206,6,0,e_1,362,366,390,26,1,1,7,4,1,2,4,24,28
p_221,4,0,e_1,341,374,390,29,1,1,8,5,1,2,33,16,49
p_214,4,0,e_1,346,374,390,28,2,2,9,5,1,3,28,16,44
p_199,2,0,e_1,368,382,390,29,1,1,6,4,1,1,14,8,22
p_238,2,0,e_0,311,320,430,28,1,1,0,3,0,0,9,110,119
p_235,8,0,e_0,314,340,430,8,1,0,0,5,0,1,26,90,116
p_231,10,0,e_0,320,348,430,8,2,0,2,5,1,1,28,82,110
p_213,12,0,e_0,347,356,430,19,2,2,10,2,1,1,9,74,83
p_207,12,0,e_0,355,356,430,12,1,0,12,5,1,3,1,74,75
p_223,13,0,e_0,339,361,430,21,2,2,8,5,1,2,22,69,91
p_208,13,0,e_0,355,361,430,13,1,0,12,5,1,3,6,69,75
p_211,14,0,e_0,348,366,430,17,1,1,10,2,1,2,18,64,82
p_202,13,0,e_0,365,371,430,18,2,2,14,2,1,2,6,59,65
p_201,13,0,e_0,366,371,430,18,1,1,14,4,1,3,5,59,64
p_203,12,0,e_0,365,376,430,20,2,2,14,5,1,2,11,54,65
p_200,12,0,e_0,367,376,430,19,1,1,14,4,1,3,9,54,63
p_194,11,0,e_0,377,381,430,11,1,0,12,4,1,2,4,49,53
p_198,9,0,e_0,368,389,430,22,1,1,14,4,1,3,21,41,62
p_195,9,0,e_0,376,389,430,9,1,0,12,1,1,2,13,41,54
p_186,1,0,e_1,391,397,482,22,3,2,0,3,0,0,6,85,91
p_184,5,0,e_1,393,411,482,18,2,2,0,5,0,1,18,71,89
p_177,9,0,e_1,398,425,482,13,3,2,1,5,1,2,27,57,84
p_170,10,0,e_1,408,430,482,9,4,2,4,5,1,3,22,52,74
p_160,10,0,e_1,421,430,482,8,4,3,8,5,1,4,9,52,61
p_181,11,0,e_1,395,435,482,12,3,2,0,5,0,2,40,47,87
p_169,11,0,e_1,410,435,482,7,3,2,5,2,1,3,25,47,72
p_159,11,0,e_1,424,435,482,6,3,2,9,2,1,3,11,47,58
p_153,8,0,e_1,438,446,482,6,1,0,10,4,1,2,8,36,44
p_154,7,0,e_1,438,451,482,7,1,0,10,4,1,3,13,31,44
p_166,5,0,e_1,415,459,482,14,4,3,6,5,1,3,44,23,67
p_144,4,0,e_1,451,464,482,6,2,0,7,1,1,2,13,18,31
p_155,3,0,e_1,434,469,482,12,1,0,11,2,1,1,35,13,48
p_136,2,0,e_1,460,474,482,5,3,1,5,4,1,2,14,8,22
p_185,2,0,e_2,392,401,483,21,2,2,0,3,0,0,9,82,91
p_167,7,0,e_2,412,418,483,11,3,2,5,5,1,1,6,65,71
p_183,12,0,e_2,393,435,483,11,2,1,0,5,0,1,42,48,90
p_164,12,0,e_2,416,435,483,6,4,2,7,5,1,2,19,48,67
p_157,12,0,e_2,427,435,483,4,3,1,9,5,1,2,8,48,56
p_152,10,0,e_2,439,443,483,3,1,0,11,4,1,2,4,40,44
p_147,7,0,e_2,450,454,483,3,2,0,8,4,1,3,4,29,33
p_163,4,0,e_2,417,465,483,14,3,2,7,2,1,1,48,18,66
p_133,4,0,e_2,463,465,483,2,3,0,5,4,1,3,2,18,20
p_148,3,0,e_2,447,470,483,8,2,0,9,4,1,2,23,13,36
p_156,1,0,e_2,428,478,483,15,2,1,10,5,1,2,50,5,55
p_196,5,0,e_3,376,393,486,5,0,0,0,3,0,0,17,93,110
p_173,10,0,e_3,405,410,486,9,3,2,9,5,1,2,5,76,81
p_193,12,0,e_3,378,418,486,12,1,0,0,5,0,1,40,68,108
p_161,13,0,e_3,418,423,486,5,3,2,12,2,1,2,5,63,68
p_190,14,0,e_3,382,428,486,12,2,0,2,5,0,2,46,58,104
p_180,14,0,e_3,396,428,486,8,3,0,6,5,1,2,32,58,90
p_172,14,0,e_3,405,428,486,5,4,0,9,5,1,3,23,58,81
p_165,14,0,e_3,416,428,486,4,4,1,12,5,1,3,12,58,70
p_162,14,0,e_3,417,428,486,4,3,1,12,2,1,2,11,58,69
p_158,14,0,e_3,426,428,486,3,3,1,13,5,1,2,2,58,60
p_168,15,0,e_3,412,433,486,5,3,0,10,5,1,2,21,53,74
p_138,7,0,e_3,456,459,486,1,3,0,8,4,1,2,3,27,30
p_150,3,0,e_3,444,473,486,9,1,0,12,4,1,0,29,13,42
p_143,2,0,e_3,451,478,486,7,2,1,9,4,1,1,27,8,35
p_175,2,0,e_0,399,438,570,19,3,2,7,4,1,3,39,132,171
p_174,3,0,e_0,402,443,570,18,3,2,7,4,1,4,41,127,168
p_171,3,0,e_0,408,443,570,15,4,2,5,1,1,5,35,127,162
p_192,5,0,e_0,380,451,570,18,2,1,11,4,1,3,71,119,190
p_182,5,0,e_0,394,451,570,18,3,2,8,1,1,2,57,119,176
p_178,5,0,e_0,398,451,570,17,3,2,7,4,1,4,53,119,172
p_179,6,0,e_0,397,456,570,16,3,2,7,4,1,3,59,114,173
p_176,6,0,e_0,398,456,570,16,3,2,7,1,1,3,58,114,172
p_191,7,0,e_0,382,461,570,15,2,1,11,4,1,3,79,109,188
p_189,7,0,e_0,387,461,570,18,3,2,9,4,1,4,74,109,183
p_187,7,0,e_0,391,461,570,16,3,2,9,4,1,3,70,109,179
p_135,7,0,e_0,461,461,570,30,3,3,7,2,1,5,0,109,109
p_132,7,0,e_0,463,463,570,29,3,3,7,2,1,5,0,107,107
p_204,8,0,e_0,364,470,570,24,2,2,14,5,1,1,106,100,206
p_197,8,0,e_0,375,470,570,8,0,0,12,4,1,3,95,100,195
p_118,4,0,e_2,488,502,570,4,0,0,0,3,0,0,14,68,82
p_114,9,0,e_2,494,519,570,9,0,0,2,5,0,1,25,51,76
p_115,10,0,e_2,494,524,570,10,0,0,2,5,0,2,30,46,76
p_100,10,0,e_2,522,524,570,6,3,2,10,5,1,5,2,46,48
p_93,7,0,e_2,529,535,570,7,3,2,9,4,1,5,6,35,41
p_98,6,0,e_2,524,540,570,10,3,2,10,2,1,4,16,30,46
p_95,6,0,e_2,527,540,570,8,3,2,10,4,1,5,13,30,43
p_94,6,0,e_2,528,540,570,8,3,2,9,4,1,5,12,30,42
p_108,5,0,e_2,509,545,570,13,1,1,6,5,1,3,36,25,61
p_96,5,0,e_2,527,545,570,9,3,2,10,4,1,5,18,25,43
p_106,4,0,e_2,512,550,570,13,1,1,7,5,1,4,38,20,58
p_85,3,0,e_2,542,555,570,14,4,2,6,4,1,4,13,15,28
p_84,3,0,e_2,546,555,570,13,4,1,5,4,1,4,9,15,24
p_82,3,0,e_2,547,555,570,13,3,1,5,4,1,4,8,15,23
p_102,2,0,e_2,521,560,570,13,2,1,9,5,1,4,39,10,49
p_119,5,0,e_1,483,500,585,26,1,1,0,3,0,0,17,85,102
p_116,7,0,e_1,490,508,585,7,0,0,2,5,0,1,18,77,95
p_117,12,0,e_1,490,525,585,12,0,0,2,5,0,2,35,60,95
p_103,13,0,e_1,517,530,585,7,2,0,9,5,1,3,13,55,68
p_97,10,0,e_1,526,541,585,5,3,2,12,5,1,3,15,44,59
p_104,7,0,e_1,516,552,585,9,2,1,9,5,1,2,36,33,69
p_89,7,0,e_1,537,552,585,7,3,1,11,4,1,3,15,33,48
p_86,6,0,e_1,541,557,585,11,4,2,10,4,1,2,16,28,44
p_80,6,0,e_1,548,557,585,10,3,1,8,4,1,4,9,28,37
p_83,5,0,e_1,546,562,585,11,4,1,9,4,1,3,16,23,39
p_78,4,0,e_1,555,567,585,10,3,0,7,4,1,3,12,18,30
p_71,2,0,e_1,569,575,585,8,4,3,4,4,1,1,6,10,16
p_107,1,0,e_1,512,580,585,16,1,1,8,5,1,1,68,5,73
p_113,11,0,e_3,496,532,617,11,0,0,0,3,0,0,36,85,121
p_101,12,0,e_3,521,537,617,4,2,0,8,5,0,2,16,80,96
p_92,13,0,e_3,533,542,617,2,3,0,11,5,1,2,9,75,84
p_91,13,0,e_3,535,542,617,2,4,0,11,5,1,3,7,75,82
p_88,14,0,e_3,538,547,617,2,3,0,12,5,1,2,9,70,79
p_87,15,0,e_3,539,552,617,3,4,0,12,5,1,3,13,65,78
p_79,14,0,e_3,549,557,617,2,3,1,14,5,1,2,8,60,68
p_67,8,0,e_3,574,577,617,1,5,0,9,4,1,4,3,40,43
p_76,7,0,e_3,559,582,617,7,3,0,14,4,1,2,23,35,58
p_77,6,0,e_3,557,587,617,8,2,0,14,1,1,1,30,30,60
p_73,6,0,e_3,568,587,617,5,4,1,11,4,1,3,19,30,49
p_59,6,0,e_3,584,587,617,1,6,0,7,4,1,5,3,30,33
p_62,5,0,e_3,582,592,617,2,5,1,7,1,1,4,10,25,35
p_61,5,0,e_3,583,592,617,2,6,1,7,4,1,5,9,25,34
p_105,4,0,e_3,515,597,617,12,1,1,6,5,0,1,82,20,102
p_64,1,0,e_3,579,622,651,7,5,4,8,4,1,4,43,29,72
p_51,1,0,e_3,591,622,651,4,6,3,5,4,1,5,31,29,60
p_56,2,0,e_3,588,627,651,4,5,3,6,4,1,4,39,24,63
p_48,2,0,e_3,593,627,651,3,5,2,5,4,1,4,34,24,58
p_70,3,0,e_3,572,632,651,6,4,3,9,4,1,3,60,19,79
p_43,3,0,e_3,599,632,651,1,4,0,4,4,1,3,33,19,52
p_55,4,0,e_3,590,637,651,1,6,0,5,4,1,5,47,14,61
p_38,4,0,e_3,627,637,651,2,3,0,2,5,1,2,10,14,24
p_110,1,0,e_2,501,575,678,20,1,1,4,5,0,3,74,103,177
p_99,1,0,e_2,522,575,678,15,3,2,9,5,1,5,53,103,156
p_90,2,0,e_2,536,580,678,12,4,1,7,4,1,5,44,98,142
p_81,2,0,e_2,547,580,678,14,3,1,5,4,1,4,33,98,131
p_69,10,0,e_2,573,606,678,29,5,5,0,5,0,5,33,72,105
p_74,11,0,e_2,567,611,678,30,4,4,1,4,1,2,44,67,111
p_65,12,0,e_2,578,616,678,26,5,5,1,5,1,5,38,62,100
p_46,13,0,e_2,596,621,678,21,5,5,7,5,1,5,25,57,82
p_75,14,0,e_2,563,626,678,29,4,4,2,4,1,1,63,52,115
p_68,14,0,e_2,574,626,678,25,5,5,1,2,0,5,52,52,104
p_72,15,0,e_2,569,631,678,25,4,4,0,3,1,4,62,47,109
p_44,15,0,e_2,598,631,678,19,4,4,8,5,1,6,33,47,80
p_39,15,0,e_2,609,631,678,17,4,4,11,5,1,5,22,47,69
p_49,5,0,e_1,592,602,681,30,5,5,2,5,0,6,10,79,89
p_45,5,0,e_1,597,602,681,29,4,4,3,5,0,7,5,79,84
p_57,6,0,e_1,587,607,681,30,5,5,0,5,0,4,20,74,94
p_54,6,0,e_1,590,607,681,30,6,6,1,5,0,5,17,74,91
p_47,6,0,e_1,594,607,681,29,5,5,2,5,0,7,13,74,87
p_63,8,0,e_1,581,615,681,29,5,5,1,4,1,1,34,66,100
p_60,9,0,e_1,584,620,681,28,6,6,0,3,1,2,36,61,97
p_53,9,0,e_1,590,620,681,27,6,6,1,5,0,5,30,61,91
p_58,10,0,e_1,586,625,681,26,5,5,0,5,0,3,39,56,95
p_50,10,0,e_1,592,625,681,25,5,5,2,5,0,6,33,56,89
p_41,10,0,e_1,600,625,681,24,4,4,4,5,0,7,25,56,81
p_52,11,0,e_1,591,630,681,24,6,6,1,5,0,5,39,51,90
p_66,12,0,e_1,577,635,681,26,5,5,2,4,1,1,58,46,104
p_36,11,0,e_1,635,640,681,7,3,0,12,4,1,1,5,41,46
p_33,8,0,e_1,647,651,681,23,3,3,9,4,1,1,4,30,34
p_125,4,0,e_0,474,584,688,29,2,2,9,2,1,7,110,104,214
p_129,5,0,e_0,470,589,688,29,3,3,8,2,1,5,119,99,218
p_122,5,0,e_0,477,589,688,27,1,1,9,5,1,9,112,99,211
p_126,6,0,e_0,473,594,688,27,2,2,8,5,1,6,121,94,215
p_188,8,0,e_0,390,602,688,16,3,2,9,4,1,3,212,86,298
p_131,9,0,e_0,467,607,688,26,3,3,7,5,1,5,140,81,221
p_130,9,0,e_0,469,607,688,25,3,3,8,5,1,6,138,81,219
p_121,9,0,e_0,480,607,688,23,1,1,10,2,1,9,127,81,208
p_146,10,0,e_0,451,612,688,30,2,2,5,2,1,4,161,76,237
p_128,10,0,e_0,471,612,688,24,3,3,8,5,1,6,141,76,217
p_120,10,0,e_0,481,612,688,21,1,1,10,5,1,9,131,76,207
p_145,12,0,e_0,451,620,688,28,2,2,5,5,1,5,169,68,237
p_134,12,0,e_0,462,620,688,25,3,3,7,5,1,6,158,68,226
p_123,12,0,e_0,474,620,688,21,2,2,9,2,1,8,146,68,214
p_140,13,0,e_0,455,625,688,25,3,3,6,5,1,6,170,63,233
p_42,4,0,e_1,600,695,719,30,4,4,4,5,0,7,95,24,119
p_40,4,0,e_1,601,695,719,29,4,4,5,5,0,8,94,24,118
p_35,4,0,e_1,640,695,719,30,2,2,11,1,1,1,55,24,79
p_32,5,0,e_1,657,700,719,24,2,2,6,4,1,1,43,19,62
p_27,2,0,e_1,693,711,719,15,3,1,4,5,0,2,18,8,26
p_28,6,0,e_2,679,699,721,16,3,1,0,3,0,0,20,22,42
p_26,3,0,e_2,698,710,721,12,3,0,6,5,0,1,12,11,23
p_37,7,0,e_3,633,674,753,4,2,0,3,5,1,1,41,79,120
p_34,15,0,e_3,643,700,753,18,2,2,3,4,1,1,57,53,110
p_29,15,0,e_3,678,700,753,7,3,0,8,5,1,2,22,53,75
p_22,10,0,e_3,712,717,753,1,3,0,11,4,1,2,5,36,41
p_25,7,0,e_3,703,728,753,8,2,0,15,4,1,1,25,25,50
p_30,5,0,e_3,676,736,753,18,2,1,7,5,1,1,60,17,77
p_24,5,0,e_3,707,736,753,8,3,1,13,4,1,2,29,17,46
p_23,5,0,e_3,709,736,753,8,3,1,13,4,1,2,27,17,44
p_31,5,0,e_0,662,705,790,22,2,2,8,4,1,3,43,85,128
p_139,13,0,e_0,456,731,790,25,3,3,6,5,1,6,275,59,334
p_137,13,0,e_0,458,731,790,24,3,3,6,5,1,6,273,59,332
p_124,14,0,e_0,474,736,790,19,2,2,9,2,1,8,262,54,316
p_109,14,0,e_0,506,736,790,12,1,0,15,4,1,9,230,54,284
p_151,15,0,e_0,443,741,790,27,1,1,3,5,1,4,298,49,347
p_149,15,0,e_0,444,741,790,27,2,2,3,5,1,5,297,49,346
p_142,15,0,e_0,452,741,790,24,3,3,5,5,1,6,289,49,338
p_141,15,0,e_0,455,741,790,23,3,3,6,2,1,6,286,49,335
p_127,15,0,e_0,473,741,790,18,2,2,8,5,1,6,268,49,317
p_112,15,0,e_0,497,741,790,15,1,0,13,5,1,9,244,49,293
p_111,15,0,e_0,501,741,790,14,1,0,14,5,1,9,240,49,289
p_19,12,0,e_0,740,752,790,22,1,1,15,5,1,1,12,38,50
p_21,10,0,e_1,732,764,796,26,2,2,0,3,0,0,32,32,64
p_20,9,0,e_2,737,767,796,26,1,1,0,3,0,0,30,29,59
p_8,1,0,e_2,847,853,858,6,1,0,0,3,0,0,6,5,11
p_13,11,0,e_0,794,829,864,12,3,2,0,3,0,0,35,35,70
p_11,11,0,e_0,810,829,864,6,4,2,5,5,0,1,19,35,54
p_18,2,0,e_3,768,776,868,2,0,0,0,3,0,0,8,92,100
p_16,13,0,e_3,774,811,868,16,2,1,1,5,0,2,37,57,94
p_12,13,0,e_3,796,811,868,9,3,1,8,5,1,2,15,57,72
p_10,14,0,e_3,810,816,868,3,3,1,13,5,1,2,6,52,58
p_17,15,0,e_3,772,821,868,14,1,0,1,5,0,1,49,47,96
p_15,15,0,e_3,782,821,868,12,3,0,3,5,1,2,39,47,86
p_14,15,0,e_3,790,821,868,9,3,0,6,5,1,2,31,47,78
p_4,1,0,e_0,864,870,875,30,1,1,0,3,0,0,6,5,11
p_3,1,0,e_0,876,882,887,1,0,0,0,3,0,0,6,5,11
p_5,5,0,e_2,860,877,896,27,1,1,0,3,0,0,17,19,36
p_2,3,0,e_2,878,885,896,3,0,0,5,4,1,0,7,11,18
p_1,2,0,e_0,889,898,906,2,0,0,0,3,0,0,9,8,17
p_9,2,0,e_1,845,854,938,6,1,0,0,3,0,0,9,84,93
p_7,12,0,e_1,851,886,938,23,1,1,1,5,0,1,35,52,87
p_6,14,0,e_1,858,894,938,19,1,1,3,5,1,1,36,44,80
p_296,1,0,e_2,20,26,31,1,0,0,0,3,0,0,6,5,11
p_299,3,0,e_1,7,18,37,3,0,0,0,3,0,0,11,19,30
p_298,4,0,e_1,10,23,37,4,0,0,1,5,0,1,13,14,27
p_290,4,0,e_1,43,51,79,6,1,1,1,5,0,1,8,28,36
p_295,5,0,e_1,22,56,79,5,0,0,4,3,1,0,34,23,57
p_286,3,0,e_1,51,64,79,6,2,2,4,5,1,2,13,15,28
p_285,2,0,e_1,54,69,79,6,1,1,5,5,1,3,15,10,25
p_288,1,0,e_1,49,74,79,9,2,2,4,5,0,2,25,5,30
p_300,8,0,e_0,4,31,109,8,0,0,0,3,0,0,27,78,105
p_297,12,0,e_0,18,45,109,12,0,0,4,5,0,1,27,64,91
p_294,13,0,e_0,23,50,109,13,0,0,5,5,0,2,27,59,86
p_293,15,0,e_0,26,58,109,15,0,0,6,5,0,3,32,51,83
p_284,14,0,e_0,55,63,109,8,3,0,14,5,1,2,8,46,54
p_287,12,0,e_0,51,71,109,7,2,0,13,5,1,1,20,38,58
p_291,6,0,e_3,35,55,109,6,0,0,0,3,0,0,20,54,74
p_289,7,0,e_3,47,60,109,4,1,0,3,5,0,1,13,49,62
p_283,10,0,e_3,55,71,109,4,2,0,6,5,1,1,16,38,54
p_281,10,0,e_3,63,71,109,2,2,0,8,5,1,1,8,38,46
p_276,5,0,e_3,82,88,109,2,2,0,7,4,1,1,6,21,27
p_274,4,0,e_3,84,93,109,2,3,1,6,4,1,2,9,16,25
p_279,2,0,e_3,76,101,109,7,1,0,9,4,1,0,25,8,33
p_275,2,0,e_3,84,101,109,4,4,2,6,4,1,3,17,8,25
p_292,11,0,e_2,30,66,111,11,0,0,0,3,1,0,36,45,81
p_280,12,0,e_2,65,71,111,4,2,0,11,5,0,2,6,40,46
p_282,6,0,e_2,62,91,111,7,2,1,10,5,0,1,29,20,49
p_267,1,0,e_3,153,159,164,1,0,0,0,3,0,0,6,5,11
p_277,10,0,e_1,81,113,183,27,2,2,0,5,0,1,32,70,102
p_273,13,0,e_1,95,124,183,21,2,2,4,5,0,2,29,59,88
p_278,15,0,e_1,80,132,183,23,2,2,0,3,0,0,52,51,103
p_272,15,0,e_1,105,132,183,16,1,1,7,5,0,3,27,51,78
p_271,11,0,e_1,127,146,183,11,0,0,14,5,1,1,19,37,56
p_264,5,0,e_1,162,166,183,26,1,1,6,4,1,0,4,17,21
p_258,5,0,e_3,175,182,207,4,1,1,3,5,0,1,7,25,32
p_262,6,0,e_3,164,187,207,6,0,0,0,3,0,0,23,20,43
p_259,6,0,e_3,174,187,207,4,1,0,2,5,0,1,13,20,33
p_252,2,0,e_3,212,221,229,2,0,0,0,3,0,0,9,8,17
p_270,7,0,e_0,133,156,233,7,0,0,0,3,0,0,23,77,100
p_268,10,0,e_0,150,167,233,10,0,0,5,5,0,1,17,66,83
p_266,15,0,e_0,155,184,233,15,1,0,7,2,0,1,29,49,78
p_256,8,0,e_0,191,207,233,27,1,1,13,4,1,0,16,26,42
p_269,4,0,e_2,146,160,234,4,0,0,0,3,0,0,14,74,88
p_265,12,0,e_2,157,186,234,12,1,0,3,5,0,1,29,48,77
p_263,12,0,e_2,163,186,234,12,0,0,5,5,1,1,23,48,71
p_261,12,0,e_2,170,186,234,11,1,0,7,5,1,1,16,48,64
p_257,12,0,e_2,179,186,234,8,2,0,10,5,1,2,7,48,55
p_260,13,0,e_2,171,191,234,12,1,0,7,5,1,1,20,43,63
p_255,10,0,e_2,192,202,234,25,1,1,13,4,1,0,10,32,42
p_244,2,0,e_0,271,279,287,10,2,0,0,3,0,0,8,8,16
p_254,3,0,e_1,199,210,295,30,1,1,0,3,0,0,11,85,96
p_253,15,0,e_1,208,248,295,15,0,0,3,5,0,1,40,47,87
p_251,4,0,e_3,228,243,311,4,0,0,0,3,1,0,15,68,83
p_250,7,0,e_3,236,254,311,5,1,0,2,5,0,1,18,57,75
p_249,7,0,e_3,238,254,311,4,2,0,3,5,0,2,16,57,73
p_248,7,0,e_3,246,254,311,3,2,0,4,5,1,1,8,57,65
p_247,12,0,e_3,248,271,311,7,2,0,5,5,1,1,23,40,63
p_246,12,0,e_3,257,271,311,4,2,0,8,5,1,1,14,40,54
p_245,9,0,e_3,269,282,311,3,2,0,12,5,1,1,13,29,42
p_238,2,0,e_1,311,320,350,2,0,0,0,3,0,0,9,30,39
p_233,2,0,e_1,319,320,350,13,1,1,2,2,0,1,1,30,31
p_237,5,0,e_1,313,333,350,11,1,1,0,5,0,1,20,17,37
p_232,5,0,e_1,320,333,350,9,1,1,2,2,0,2,13,17,30
p_230,5,0,e_1,323,333,350,10,2,2,2,5,1,1,10,17,27
p_209,2,0,e_1,354,361,385,14,4,2,0,5,0,1,7,24,31
p_210,4,0,e_1,353,369,385,13,4,3,0,3,0,0,16,16,32
p_205,1,0,e_1,362,380,385,14,2,1,2,5,1,1,18,5,23
p_242,4,0,e_0,287,302,386,4,1,0,0,3,0,0,15,84,99
p_231,10,0,e_0,320,322,386,8,1,0,10,5,1,1,2,64,66
p_228,11,0,e_0,325,327,386,8,2,0,11,5,1,1,2,59,61
p_241,13,0,e_0,300,335,386,20,1,1,4,5,0,1,35,51,86
p_239,13,0,e_0,305,335,386,19,1,1,5,5,1,1,30,51,81
p_226,12,0,e_0,331,340,386,6,2,0,12,5,1,1,9,46,55
p_220,9,0,e_0,342,351,386,9,3,1,12,4,1,2,9,35,44
p_218,9,0,e_0,343,351,386,8,2,1,11,4,1,3,8,35,43
p_215,6,0,e_0,346,362,386,11,2,1,11,4,1,3,16,24,40
p_221,4,0,e_0,341,370,386,14,3,2,12,4,1,1,29,16,45
p_214,4,0,e_0,346,370,386,13,2,1,10,4,1,4,24,16,40
p_222,3,0,e_0,339,375,386,15,3,2,12,4,1,1,36,11,47
p_243,8,0,e_2,285,312,392,30,1,1,0,3,0,0,27,80,107
p_240,14,0,e_2,301,332,392,19,1,1,5,5,0,1,31,60,91
p_234,14,0,e_2,314,332,392,14,1,0,8,5,1,1,18,60,78
p_224,13,0,e_2,335,337,392,6,2,0,14,4,1,1,2,55,57
p_219,11,0,e_2,342,345,392,6,3,1,12,4,1,1,3,47,50
p_225,10,0,e_2,333,350,392,4,2,0,14,4,1,0,17,42,59
p_212,9,0,e_2,348,355,392,9,4,3,10,4,1,3,7,37,44
p_217,8,0,e_2,345,360,392,9,2,1,11,4,1,1,15,32,47
p_206,6,0,e_2,362,368,392,9,2,1,8,4,1,1,6,24,30
p_199,2,0,e_2,368,382,392,12,3,2,6,1,1,1,14,10,24
p_216,1,0,e_2,346,387,392,16,2,1,11,4,1,2,41,5,46
p_236,8,0,e_3,313,339,431,8,0,0,0,3,0,0,26,92,118
p_235,8,0,e_3,314,339,431,8,1,0,0,5,0,1,25,92,117
p_229,9,0,e_3,323,344,431,6,1,0,3,5,0,1,21,87,108
p_227,9,0,e_3,326,344,431,5,2,0,4,5,0,2,18,87,105
p_213,12,0,e_3,347,355,431,4,2,1,10,5,1,1,8,76,84
p_207,12,0,e_3,355,355,431,4,3,2,12,2,1,2,0,76,76
p_223,13,0,e_3,339,362,431,5,2,0,8,5,1,1,23,69,92
p_208,13,0,e_3,355,362,431,3,4,1,12,5,1,3,7,69,76
p_211,14,0,e_3,348,367,431,4,3,0,10,5,1,2,19,64,83
p_202,13,0,e_3,365,372,431,2,2,1,13,5,1,1,7,59,66
p_201,13,0,e_3,366,372,431,1,3,0,14,2,1,2,6,59,65
p_203,12,0,e_3,365,377,431,3,3,1,13,5,1,2,12,54,66
p_200,12,0,e_3,367,377,431,2,3,0,14,2,1,2,10,54,64
p_194,11,0,e_3,377,382,431,1,4,0,12,1,1,3,5,49,54
p_195,9,0,e_3,376,390,431,3,3,0,12,1,1,2,14,41,55
p_186,1,0,e_2,391,397,494,8,4,3,0,3,1,0,6,97,103
p_185,2,0,e_2,392,402,494,7,4,3,0,3,1,1,10,92,102
p_167,7,0,e_2,412,419,494,28,6,6,5,5,1,1,7,75,82
p_181,11,0,e_2,395,433,494,27,3,3,1,5,0,2,38,61,99
p_164,12,0,e_2,416,438,494,22,7,7,6,5,1,2,22,56,78
p_161,13,0,e_2,418,443,494,20,6,6,7,2,1,3,25,51,76
p_152,10,0,e_2,439,454,494,8,5,0,12,5,1,4,15,40,55
p_154,7,0,e_2,438,465,494,7,5,1,12,2,1,3,27,29,56
p_129,5,0,e_2,470,473,494,17,5,4,6,4,1,2,3,21,24
p_163,4,0,e_2,417,478,494,29,6,6,7,5,1,3,61,16,77
p_156,1,0,e_2,428,489,494,30,7,7,10,5,1,4,61,5,66
p_193,12,0,e_0,378,424,494,30,5,5,2,4,1,0,46,70,116
p_190,14,0,e_0,382,432,494,27,4,4,1,4,1,1,50,62,112
p_180,14,0,e_0,396,432,494,24,3,3,3,5,0,2,36,62,98
p_172,14,0,e_0,405,432,494,22,6,6,6,5,0,2,27,62,89
p_168,15,0,e_0,412,437,494,20,6,6,8,5,0,2,25,57,82
p_159,11,0,e_0,424,451,494,21,6,6,12,2,0,2,27,43,70
p_147,7,0,e_0,450,465,494,19,6,2,11,1,1,1,15,29,44
p_144,4,0,e_0,451,476,494,21,6,4,11,4,1,3,25,18,43
p_133,4,0,e_0,463,476,494,19,5,4,7,4,1,4,13,18,31
p_155,3,0,e_0,434,481,494,12,6,4,14,5,1,2,47,13,60
p_150,3,0,e_0,444,481,494,24,6,5,13,4,1,2,37,13,50
p_148,3,0,e_0,447,481,494,24,6,5,12,4,1,2,34,13,47
p_143,2,0,e_0,451,486,494,23,6,4,11,1,1,2,35,8,43
p_204,8,0,e_1,364,411,495,7,2,1,2,5,1,2,47,84,131
p_198,9,0,e_1,368,416,495,5,3,2,4,5,1,3,48,79,127
p_177,9,0,e_1,398,416,495,29,4,4,4,5,0,3,18,79,97
p_173,10,0,e_1,405,421,495,26,6,6,6,5,0,3,16,74,90
p_170,10,0,e_1,408,421,495,26,6,6,7,5,0,4,13,74,87
p_160,10,0,e_1,421,423,495,22,7,7,10,5,1,4,2,72,74
p_169,11,0,e_1,410,428,495,24,6,6,8,5,0,4,18,67,85
p_183,12,0,e_1,393,433,495,27,4,4,2,5,0,2,40,62,102
p_157,12,0,e_1,427,433,495,19,6,6,11,2,1,3,6,62,68
p_165,14,0,e_1,416,441,495,20,7,7,9,2,1,4,25,54,79
p_162,14,0,e_1,417,441,495,19,7,7,9,5,1,5,24,54,78
p_158,14,0,e_1,426,441,495,18,6,6,10,5,1,4,15,54,69
p_146,10,0,e_1,451,455,495,15,6,1,11,4,1,1,4,40,44
p_138,7,0,e_1,456,466,495,17,7,4,10,4,1,1,10,29,39
p_135,7,0,e_1,461,466,495,16,5,4,8,4,1,3,5,29,34
p_110,1,0,e_2,501,507,512,14,12,11,0,3,0,0,6,5,11
p_107,1,0,e_2,512,517,546,12,12,9,0,3,1,1,5,29,34
p_106,4,0,e_2,512,528,546,9,12,8,0,3,1,0,16,18,34
p_105,4,0,e_2,515,528,546,8,12,7,0,5,0,2,13,18,31
p_102,2,0,e_2,521,536,546,9,12,7,2,5,1,1,15,10,25
p_99,1,0,e_2,522,541,546,10,12,7,2,5,1,2,19,5,24
p_175,2,0,e_3,399,439,573,5,4,2,7,4,1,3,40,134,174
p_174,3,0,e_3,402,444,573,4,5,2,7,4,1,4,42,129,171
p_171,3,0,e_3,408,444,573,2,6,0,5,4,1,5,36,129,165
p_196,5,0,e_3,376,452,573,7,2,1,12,1,1,1,76,121,197
p_192,5,0,e_3,380,452,573,7,5,3,12,4,1,4,72,121,193
p_184,5,0,e_3,393,452,573,3,4,1,8,4,1,3,59,121,180
p_182,5,0,e_3,394,452,573,3,4,1,8,4,1,3,58,121,179
p_178,5,0,e_3,398,452,573,2,4,1,7,4,1,3,54,121,175
p_179,6,0,e_3,397,457,573,2,3,1,8,4,1,2,60,116,176
p_176,6,0,e_3,398,457,573,2,4,1,8,4,1,3,59,116,175
p_191,7,0,e_3,382,462,573,4,4,2,11,1,1,3,80,111,191
p_189,7,0,e_3,387,462,573,3,5,2,10,4,1,4,75,111,186
p_187,7,0,e_3,391,462,573,2,4,1,9,4,1,3,71,111,182
p_197,8,0,e_3,375,467,573,4,2,0,12,4,1,1,92,106,198
p_188,8,0,e_3,390,467,573,1,4,0,9,4,1,3,77,106,183
p_136,2,0,e_1,460,503,601,22,6,5,9,4,1,2,43,98,141
p_125,4,0,e_1,474,511,601,17,7,4,5,1,1,2,37,90,127
p_166,5,0,e_1,415,516,601,29,7,7,9,2,1,3,101,85,186
p_108,5,0,e_1,509,516,601,8,12,7,3,5,1,3,7,85,92
p_132,7,0,e_1,463,524,601,16,5,4,8,4,1,3,61,77,138
p_104,7,0,e_1,516,524,601,5,12,4,5,2,1,1,8,77,85
p_101,12,0,e_1,521,541,601,29,12,12,6,5,1,2,20,60,80
p_103,13,0,e_1,517,546,601,29,12,12,5,5,1,1,29,55,84
p_92,13,0,e_1,533,546,601,26,12,12,10,5,1,2,13,55,68
p_91,13,0,e_1,535,546,601,25,12,12,10,5,1,2,11,55,66
p_88,14,0,e_1,538,551,601,24,13,13,11,5,1,2,13,50,63
p_79,14,0,e_1,549,551,601,21,13,13,13,5,1,1,2,50,52
p_73,6,0,e_1,568,577,601,25,15,15,9,4,1,0,9,24,33
p_71,2,0,e_1,569,591,601,29,15,15,8,4,1,1,22,10,32
p_51,1,0,e_1,591,596,601,3,12,12,2,1,1,0,5,5,10
p_114,9,0,e_0,494,523,604,7,11,1,0,3,1,0,29,81,110
p_109,14,0,e_0,506,540,604,30,12,12,4,5,0,2,34,64,98
p_111,15,0,e_0,501,545,604,30,12,12,2,5,0,1,44,59,103
p_87,15,0,e_0,539,545,604,22,13,13,14,5,1,2,6,59,65
p_76,7,0,e_0,559,571,604,26,15,15,11,4,1,2,12,33,45
p_80,6,0,e_0,548,576,604,30,14,14,15,4,1,0,28,28,56
p_77,6,0,e_0,557,576,604,28,14,14,12,4,1,2,19,28,47
p_78,4,0,e_0,555,584,604,30,14,14,12,4,1,1,29,20,49
p_70,3,0,e_0,572,589,604,3,14,14,7,4,1,2,17,15,32
p_56,2,0,e_0,588,594,604,25,13,12,3,1,1,1,6,10,16
p_64,1,0,e_0,579,599,604,27,14,13,5,4,1,2,20,5,25
p_42,4,0,e_1,600,615,629,20,10,9,0,3,1,0,15,14,29
p_40,4,0,e_1,601,615,629,20,10,9,0,3,1,1,14,14,28
p_98,6,0,e_2,524,566,672,4,13,3,3,5,1,3,42,106,148
p_97,10,0,e_2,526,580,672,30,12,12,4,5,1,4,54,92,146
p_69,10,0,e_2,573,580,672,10,14,14,8,5,1,4,7,92,99
p_74,11,0,e_2,567,585,672,21,14,14,6,5,1,2,18,87,105
p_66,12,0,e_2,577,590,672,17,14,3,9,5,1,5,13,82,95
p_65,12,0,e_2,578,590,672,17,14,3,9,5,1,6,12,82,94
p_75,14,0,e_2,563,598,672,19,14,14,5,5,0,2,35,74,109
p_68,14,0,e_2,574,598,672,16,14,1,8,5,1,4,24,74,98
p_72,15,0,e_2,569,603,672,16,15,15,6,5,1,3,34,69,103
p_44,15,0,e_2,598,603,672,10,11,0,14,5,1,10,5,69,74
p_46,13,0,e_2,596,611,672,12,11,2,14,5,1,10,15,61,76
p_52,11,0,e_2,591,619,672,7,12,12,12,5,1,8,28,53,81
p_58,10,0,e_2,586,624,672,17,13,5,11,5,1,7,38,48,86
p_50,10,0,e_2,592,624,672,16,12,5,12,5,1,9,32,48,80
p_41,10,0,e_2,600,624,672,14,11,5,14,5,1,11,24,48,72
p_35,4,0,e_1,640,654,698,12,9,1,0,3,0,0,14,44,58
p_32,5,0,e_1,657,659,698,8,9,6,5,5,1,1,2,39,41
p_33,8,0,e_1,647,670,698,7,9,6,2,5,0,1,23,28,51
p_31,5,0,e_1,662,681,698,7,9,5,5,5,1,1,19,17,36
p_30,5,0,e_1,676,681,698,4,9,2,7,4,1,1,5,17,22
p_38,4,0,e_0,627,641,699,15,9,4,0,3,0,0,14,58,72
p_36,11,0,e_0,635,664,699,6,9,2,2,5,0,1,29,35,64
p_90,2,0,e_3,536,581,713,6,12,4,8,4,1,11,45,132,177
p_81,2,0,e_3,547,581,713,4,14,3,6,4,1,13,34,132,166
p_85,3,0,e_3,542,586,713,4,13,3,7,4,1,12,44,127,171
p_84,3,0,e_3,546,586,713,3,14,2,6,4,1,13,40,127,167
p_82,3,0,e_3,547,586,713,3,14,2,6,4,1,13,39,127,166
p_118,4,0,e_3,488,591,713,14,9,3,12,5,1,8,103,122,225
p_122,5,0,e_3,477,596,713,15,8,4,10,2,1,7,119,117,236
p_119,5,0,e_3,483,596,713,13,10,3,12,5,1,9,113,117,230
p_96,5,0,e_3,527,596,713,5,12,4,10,4,1,11,69,117,186
p_83,5,0,e_3,546,596,713,1,14,0,6,4,1,13,50,117,167
p_126,6,0,e_3,473,601,713,15,6,4,9,5,1,5,128,112,240
p_95,6,0,e_3,527,601,713,4,12,3,10,4,1,11,74,112,186
p_94,6,0,e_3,528,601,713,3,12,2,9,4,1,11,73,112,185
p_86,6,0,e_3,541,601,713,1,13,0,7,4,1,12,60,112,172
p_116,7,0,e_3,490,606,713,10,10,2,13,5,1,9,116,107,223
p_24,5,0,e_0,707,724,741,27,11,11,0,3,0,0,17,17,34
p_23,5,0,e_0,709,724,741,26,11,11,0,5,0,1,15,17,32
p_26,3,0,e_1,698,709,766,1,12,0,0,3,1,0,11,57,68
p_25,7,0,e_1,703,723,766,26,12,12,1,5,0,1,20,43,63
p_22,10,0,e_1,712,734,766,20,12,12,4,5,1,1,22,32,54
p_21,10,0,e_1,732,734,766,15,11,5,10,5,1,1,2,32,34
p_18,2,0,e_0,768,776,784,16,4,3,0,3,0,0,8,8,16
p_48,2,0,e_2,593,680,786,24,12,11,13,5,1,9,87,106,193
p_43,3,0,e_2,599,685,786,21,11,9,14,5,1,10,86,101,187
p_55,4,0,e_2,590,690,786,22,13,11,12,2,1,7,100,96,196
p_62,5,0,e_2,582,695,786,23,14,10,10,5,1,5,113,91,204
p_61,5,0,e_2,583,695,786,23,14,10,10,5,1,6,112,91,203
p_49,5,0,e_2,592,695,786,21,12,10,12,5,1,9,103,91,194
p_45,5,0,e_2,597,695,786,20,11,10,14,5,1,11,98,91,189
p_59,6,0,e_2,584,700,786,22,14,9,11,5,1,6,116,86,202
p_57,6,0,e_2,587,700,786,21,13,9,11,5,1,8,113,86,199
p_54,6,0,e_2,590,700,786,20,13,9,12,5,1,8,110,86,196
p_47,6,0,e_2,594,700,786,20,12,9,13,5,1,10,106,86,192
p_37,7,0,e_2,633,705,786,11,9,3,8,1,1,6,72,81,153
p_67,8,0,e_2,574,710,786,22,14,7,8,5,1,4,136,76,212
p_63,8,0,e_2,581,710,786,20,14,7,10,5,1,5,129,76,205
p_60,9,0,e_2,584,715,786,18,14,6,11,5,1,7,131,71,202
p_27,2,0,e_3,693,721,835,4,10,0,6,4,1,9,28,114,142
p_28,6,0,e_3,679,735,835,2,10,1,8,4,1,9,56,100,156
p_93,7,0,e_3,529,740,835,2,13,1,9,4,1,12,211,95,306
p_89,7,0,e_3,537,740,835,1,13,0,8,4,1,12,203,95,298
p_153,8,0,e_3,438,745,835,6,5,0,2,2,0,5,307,90,397
p_131,9,0,e_3,467,750,835,13,4,3,8,2,1,3,283,85,368
p_130,9,0,e_3,469,750,835,13,5,3,8,5,1,4,281,85,366
p_121,9,0,e_3,480,750,835,11,9,4,10,5,1,8,270,85,355
p_128,10,0,e_3,471,755,835,11,5,3,9,2,1,4,284,80,364
p_120,10,0,e_3,481,755,835,9,10,4,11,5,1,9,274,80,354
p_115,10,0,e_3,494,755,835,6,11,1,14,2,1,10,261,80,341
p_100,10,0,e_3,522,755,835,1,12,0,11,4,1,11,233,80,313
p_113,11,0,e_3,496,760,835,5,11,1,14,5,1,10,264,75,339
p_145,12,0,e_3,451,765,835,13,5,1,5,2,1,4,314,70,384
p_134,12,0,e_3,462,765,835,11,5,2,7,2,1,4,303,70,373
p_11,11,0,e_0,810,832,883,27,6,6,4,5,0,1,22,51,73
p_12,13,0,e_0,796,840,883,29,5,5,0,3,0,0,44,43,87
p_4,1,0,e_0,864,878,883,20,5,5,6,4,1,0,14,5,19
p_3,1,0,e_0,876,878,883,17,4,3,2,4,1,1,2,5,7
p_53,9,0,e_2,590,815,884,17,13,6,12,2,1,7,225,69,294
p_20,9,0,e_2,737,815,884,15,10,6,15,4,1,1,78,69,147
p_19,12,0,e_2,740,826,884,11,9,3,14,4,1,2,86,58,144
p_29,15,0,e_2,678,837,884,24,9,9,2,5,0,8,159,47,206
p_10,14,0,e_1,810,827,885,24,6,6,8,5,0,1,17,58,75
p_15,15,0,e_1,782,832,885,30,4,4,0,3,0,0,50,53,103
p_14,15,0,e_1,790,832,885,28,4,4,2,5,0,1,42,53,95
p_5,5,0,e_1,860,864,885,17,5,5,6,4,1,2,4,21,25
p_9,2,0,e_1,845,875,885,25,5,5,11,4,1,0,30,10,40
p_8,1,0,e_1,847,880,885,25,5,5,10,4,1,1,33,5,38
p_1,2,0,e_0,889,898,906,13,2,0,0,3,0,0,9,8,17
p_13,11,0,e_3,794,870,939,1,4,0,12,1,1,3,76,69,145
p_123,12,0,e_3,474,875,939,9,7,2,9,5,1,6,401,64,465
p_117,12,0,e_3,490,875,939,5,11,2,13,5,1,10,385,64,449
p_7,12,0,e_3,851,875,939,13,5,3,5,5,0,5,24,64,88
p_140,13,0,e_3,455,880,939,11,6,1,6,5,1,5,425,59,484
p_139,13,0,e_3,456,880,939,11,7,1,6,5,1,6,424,59,483
p_137,13,0,e_3,458,880,939,11,6,1,6,5,1,5,422,59,481
p_16,13,0,e_3,774,880,939,3,5,1,14,5,1,4,106,59,165
p_124,14,0,e_3,474,885,939,7,7,1,9,5,1,6,411,54,465
p_6,14,0,e_3,858,885,939,9,5,1,7,5,0,5,27,54,81
p_151,15,0,e_3,443,890,939,12,5,0,3,2,1,4,447,49,496
p_149,15,0,e_3,444,890,939,12,6,0,3,2,1,5,446,49,495
p_142,15,0,e_3,452,890,939,10,6,0,5,5,1,5,438,49,487
p_141,15,0,e_3,455,890,939,10,6,0,5,5,1,5,435,49,484
p_127,15,0,e_3,473,890,939,6,6,0,9,5,1,5,417,49,466
p_2,3,0,e_3,878,950,1035,14,4,2,13,5,1,3,72,85,157
p_112,15,0,e_3,497,988,1035,1,12,0,14,5,1,11,491,47,538
p_39,15,0,e_3,609,988,1035,8,9,0,7,5,1,8,379,47,426
p_34,15,0,e_3,643,988,1035,1,9,0,14,5,1,8,345,47,392
p_17,15,0,e_3,772,988,1035,2,4,0,13,5,1,3,216,47,263
p_299,3,0,e_1,7,18,29,3,0,0,0,3,0,0,11,11,22
p_296,1,0,e_3,20,26,31,1,0,0,0,3,0,0,6,5,11
p_298,4,0,e_2,10,24,46,4,0,0,0,3,0,0,14,22,36
p_295,5,0,e_2,22,29,46,5,1,0,3,5,0,1,7,17,24
p_290,4,0,e_3,43,50,82,6,1,1,2,5,0,1,7,32,39
p_291,6,0,e_3,35,58,82,6,0,0,0,3,0,0,23,24,47
p_285,2,0,e_3,54,72,82,5,3,1,5,5,1,2,18,10,28
p_288,1,0,e_3,49,77,82,3,1,1,4,3,0,1,28,5,33
p_286,3,0,e_2,51,58,99,5,3,1,1,5,0,1,7,41,48
p_282,6,0,e_2,62,69,99,29,3,3,4,5,1,1,7,30,37
p_289,7,0,e_2,47,74,99,4,2,0,0,3,0,0,27,25,52
p_279,2,0,e_2,76,91,99,29,2,2,7,4,1,0,15,8,23
p_275,2,0,e_2,84,91,99,28,2,2,4,4,1,1,7,8,15
p_292,11,0,e_1,30,65,110,19,1,1,0,3,0,0,35,45,80
p_287,12,0,e_1,51,70,110,8,3,0,7,5,0,1,19,40,59
p_276,5,0,e_1,82,93,110,5,2,2,8,4,1,0,11,17,28
p_300,8,0,e_0,4,30,112,8,0,0,0,3,0,0,26,82,108
p_297,12,0,e_0,18,44,112,12,0,0,4,5,0,1,26,68,94
p_294,13,0,e_0,23,49,112,13,1,0,6,5,0,2,26,63,89
p_293,15,0,e_0,26,57,112,16,1,1,7,5,0,3,31,55,86
p_284,14,0,e_0,55,62,112,9,4,0,15,5,1,2,7,50,57
p_280,12,0,e_0,65,70,112,22,3,3,13,4,1,1,5,42,47
p_283,10,0,e_0,55,78,112,5,4,0,15,5,1,1,23,34,57
p_281,10,0,e_0,63,78,112,25,3,3,14,4,1,1,15,34,49
p_274,4,0,e_0,84,98,112,26,2,2,8,4,1,0,14,14,28
p_277,10,0,e_3,81,114,184,10,1,1,0,3,1,1,33,70,103
p_273,13,0,e_3,95,125,184,13,2,1,4,5,0,2,30,59,89
p_278,15,0,e_3,80,133,184,15,1,1,0,4,1,0,53,51,104
p_264,5,0,e_3,162,165,184,1,2,0,6,4,1,1,3,19,22
p_269,4,0,e_3,146,170,184,7,1,0,11,4,1,0,24,14,38
p_272,15,0,e_2,105,152,207,8,3,0,0,3,0,0,47,55,102
p_265,12,0,e_2,157,163,207,25,2,2,14,4,1,1,6,44,50
p_262,6,0,e_2,164,183,207,29,2,2,12,4,1,1,19,24,43
p_259,6,0,e_2,174,183,207,27,1,1,9,4,1,2,9,24,33
p_258,5,0,e_2,175,188,207,28,1,1,9,4,1,2,13,19,32
p_267,1,0,e_2,153,202,207,8,2,1,15,4,1,0,49,5,54
p_270,7,0,e_1,133,156,223,22,1,0,0,3,0,0,23,67,90
p_268,10,0,e_1,150,167,223,30,2,2,5,5,0,1,17,56,73
p_263,12,0,e_1,163,175,223,24,3,3,9,5,1,1,12,48,60
p_261,12,0,e_1,170,175,223,22,1,1,10,5,1,1,5,48,53
p_260,13,0,e_1,171,180,223,21,1,1,11,5,1,1,9,43,52
p_256,8,0,e_1,191,197,223,8,0,0,10,4,1,0,6,26,32
p_254,3,0,e_3,199,211,224,3,0,0,0,3,0,0,12,13,25
p_252,2,0,e_3,212,216,224,1,1,0,3,4,1,0,4,8,12
p_271,11,0,e_0,127,162,227,6,2,1,0,3,0,0,35,65,100
p_266,15,0,e_0,155,176,227,23,2,2,9,5,0,1,21,51,72
p_257,12,0,e_0,179,187,227,20,1,1,15,4,1,0,8,40,48
p_255,10,0,e_0,192,195,227,10,0,0,11,4,1,0,3,32,35
p_251,4,0,e_0,228,243,257,4,0,0,0,3,0,0,15,14,29
p_249,7,0,e_3,238,261,284,7,0,0,0,3,0,0,23,23,46
p_244,2,0,e_0,271,280,288,2,1,0,0,3,0,0,9,8,17
p_253,15,0,e_2,208,256,307,13,1,0,0,3,0,0,48,51,99
p_246,12,0,e_2,257,267,307,6,1,0,15,4,1,0,10,40,50
p_245,9,0,e_2,269,278,307,26,1,1,12,4,1,0,9,29,38
p_250,7,0,e_1,236,259,316,7,0,0,0,3,0,0,23,57,80
p_248,7,0,e_1,246,259,316,5,1,0,3,5,0,1,13,57,70
p_247,12,0,e_1,248,276,316,9,1,0,4,5,0,1,28,40,68
p_243,8,0,e_1,285,290,316,8,0,0,9,4,1,0,5,26,31
p_242,4,0,e_0,287,302,394,4,0,0,0,3,1,0,15,92,107
p_241,13,0,e_0,300,331,394,13,0,0,3,5,0,1,31,63,94
p_239,13,0,e_0,305,331,394,14,1,1,5,5,1,1,26,63,89
p_234,14,0,e_0,314,336,394,10,1,0,7,5,1,1,22,58,80
p_224,13,0,e_0,335,341,394,5,3,1,14,5,1,2,6,53,59
p_226,12,0,e_0,331,346,394,7,3,1,13,2,1,1,15,48,63
p_220,9,0,e_0,342,357,394,6,3,1,13,4,1,2,15,37,52
p_212,9,0,e_0,348,357,394,5,6,0,12,4,1,3,9,37,46
p_217,8,0,e_0,345,362,394,7,4,1,12,4,1,3,17,32,49
p_206,6,0,e_0,362,370,394,4,6,1,8,4,1,2,8,24,32
p_221,4,0,e_0,341,378,394,12,3,1,13,4,1,1,37,16,53
p_210,4,0,e_0,353,378,394,8,6,3,10,4,1,3,25,16,41
p_205,1,0,e_0,362,389,394,9,6,4,8,4,1,1,27,5,32
p_227,9,0,e_3,326,330,405,11,2,1,8,5,0,2,4,75,79
p_240,14,0,e_3,301,347,405,14,0,0,0,3,0,0,46,58,104
p_218,9,0,e_3,343,364,405,6,3,1,13,5,1,2,21,41,62
p_204,8,0,e_3,364,369,405,1,5,0,9,4,1,4,5,36,41
p_215,6,0,e_3,346,377,405,8,4,0,14,2,1,3,31,28,59
p_230,5,0,e_3,323,382,405,16,1,1,7,5,0,1,59,23,82
p_196,5,0,e_3,376,382,405,1,4,0,6,1,1,3,6,23,29
p_214,4,0,e_3,346,387,405,10,5,0,14,2,1,4,41,18,59
p_185,2,0,e_3,392,395,405,1,2,0,3,4,1,1,3,10,13
p_216,1,0,e_3,346,400,405,13,3,0,14,2,1,2,54,5,59
p_186,1,0,e_3,391,400,405,2,2,0,3,4,1,1,9,5,14
p_233,2,0,e_1,319,328,422,21,1,1,0,3,0,0,9,94,103
p_232,5,0,e_1,320,339,422,17,1,1,0,5,0,1,19,83,102
p_231,10,0,e_1,320,356,422,12,1,1,0,5,0,2,36,66,102
p_225,10,0,e_1,333,356,422,9,3,1,3,5,1,2,23,66,89
p_219,11,0,e_1,342,361,422,5,3,1,5,5,1,2,19,61,80
p_213,12,0,e_1,347,366,422,2,6,0,7,5,1,3,19,56,75
p_207,12,0,e_1,355,366,422,30,6,6,10,5,1,4,11,56,67
p_208,13,0,e_1,355,371,422,29,6,6,10,2,1,3,16,51,67
p_202,13,0,e_1,365,371,422,26,6,6,12,5,1,3,6,51,57
p_201,13,0,e_1,366,371,422,26,6,6,12,5,1,2,5,51,56
p_197,8,0,e_1,375,388,422,29,5,5,12,4,1,2,13,34,47
p_191,7,0,e_1,382,393,422,28,3,3,10,4,1,3,11,29,40
p_184,5,0,e_1,393,401,422,27,3,3,7,1,1,2,8,21,29
p_182,5,0,e_1,394,401,422,27,2,2,7,4,1,3,7,21,28
p_178,5,0,e_1,398,401,422,27,3,3,6,4,1,3,3,21,24
p_238,2,0,e_2,311,319,429,23,1,1,0,3,0,0,8,110,118
p_237,5,0,e_2,313,330,429,19,1,1,0,5,0,2,17,99,116
p_236,8,0,e_2,313,341,429,17,1,1,0,5,0,1,28,88,116
p_235,8,0,e_2,314,341,429,16,1,1,1,5,0,3,27,88,115
p_229,9,0,e_2,323,346,429,12,1,1,3,5,1,2,23,83,106
p_228,11,0,e_2,325,354,429,10,2,1,4,5,1,3,29,75,104
p_223,13,0,e_2,339,362,429,3,3,1,8,5,1,3,23,67,90
p_211,14,0,e_2,348,367,429,30,6,6,9,5,1,2,19,62,81
p_203,12,0,e_2,365,375,429,27,6,6,14,5,1,2,10,54,64
p_200,12,0,e_2,367,375,429,26,6,6,14,4,1,2,8,54,62
p_194,11,0,e_2,377,380,429,25,4,4,12,4,1,2,3,49,52
p_198,9,0,e_2,368,388,429,29,6,6,14,4,1,2,20,41,61
p_195,9,0,e_2,376,388,429,27,4,4,12,4,1,2,12,41,53
p_188,8,0,e_2,390,393,429,26,2,2,9,4,1,3,3,36,39
p_189,7,0,e_2,387,398,429,27,2,2,9,4,1,3,11,31,42
p_167,7,0,e_0,412,417,514,19,4,4,6,5,0,3,5,97,102
p_160,10,0,e_0,421,428,514,13,6,4,8,5,1,4,7,86,93
p_181,11,0,e_0,395,433,514,21,2,2,0,5,0,2,38,81,119
p_193,12,0,e_0,378,438,514,24,4,4,4,4,1,1,60,76,136
p_183,12,0,e_0,393,438,514,21,3,3,0,4,1,2,45,76,121
p_190,14,0,e_0,382,446,514,21,3,3,3,4,1,2,64,68,132
p_180,14,0,e_0,396,446,514,18,2,2,0,5,0,3,50,68,118
p_168,15,0,e_0,412,451,514,13,4,0,6,5,0,4,39,63,102
p_151,15,0,e_0,443,451,514,4,4,0,13,5,1,3,8,63,71
p_139,13,0,e_0,456,459,514,4,3,2,14,4,1,4,3,55,58
p_131,9,0,e_0,467,473,514,5,4,1,11,4,1,4,6,41,47
p_154,7,0,e_0,438,481,514,11,6,4,12,2,1,2,43,33,76
p_147,7,0,e_0,450,481,514,11,4,3,15,2,1,2,31,33,64
p_138,7,0,e_0,456,481,514,10,3,2,14,4,1,5,25,33,58
p_135,7,0,e_0,461,481,514,9,4,1,13,4,1,4,20,33,53
p_177,9,0,e_3,398,434,525,23,2,2,2,4,1,1,36,91,127
p_173,10,0,e_3,405,439,525,18,2,1,0,5,0,2,34,86,120
p_170,10,0,e_3,408,439,525,17,3,1,1,5,0,3,31,86,117
p_169,11,0,e_3,410,444,525,16,3,1,1,5,0,3,34,81,115
p_164,12,0,e_3,416,449,525,13,4,1,3,5,0,4,33,76,109
p_161,13,0,e_3,418,454,525,11,5,1,4,5,0,5,36,71,107
p_172,14,0,e_3,405,459,525,14,1,0,0,5,0,1,54,66,120
p_165,14,0,e_3,416,459,525,11,4,0,3,5,0,4,43,66,109
p_162,14,0,e_3,417,459,525,11,5,0,3,5,0,5,42,66,108
p_158,14,0,e_3,426,459,525,8,6,0,6,5,0,6,33,66,99
p_149,15,0,e_3,444,464,525,4,4,0,11,2,1,3,20,61,81
p_142,15,0,e_3,452,464,525,3,4,0,12,5,1,3,12,61,73
p_141,15,0,e_3,455,464,525,2,3,0,13,5,1,2,9,61,70
p_137,13,0,e_3,458,472,525,3,2,1,14,2,1,1,14,53,67
p_128,10,0,e_3,471,483,525,3,4,0,13,1,1,3,12,42,54
p_199,2,0,e_1,368,430,542,6,6,3,12,5,1,2,62,112,174
p_175,2,0,e_1,399,430,542,29,2,2,5,4,1,3,31,112,143
p_222,3,0,e_1,339,435,542,14,3,1,5,5,1,1,96,107,203
p_174,3,0,e_1,402,435,542,28,2,2,5,4,1,2,33,107,140
p_163,4,0,e_1,417,440,542,21,5,5,1,4,1,2,23,102,125
p_166,5,0,e_1,415,445,542,20,4,4,2,4,1,1,30,97,127
p_159,11,0,e_1,424,465,542,11,6,3,0,5,0,4,41,77,118
p_157,12,0,e_1,427,470,542,9,6,2,1,5,0,5,43,72,115
p_145,12,0,e_1,451,470,542,6,4,3,7,5,1,2,19,72,91
p_140,13,0,e_1,455,475,542,4,3,2,8,5,1,2,20,67,87
p_127,15,0,e_1,473,483,542,28,5,5,12,5,1,2,10,59,69
p_117,12,0,e_1,490,494,542,26,4,4,13,4,1,2,4,48,52
p_113,11,0,e_1,496,499,542,26,4,4,12,4,1,2,3,43,46
p_120,10,0,e_1,481,504,542,30,5,5,14,5,1,2,23,38,61
p_115,10,0,e_1,494,504,542,27,4,4,12,4,1,2,10,38,48
p_156,1,0,e_2,428,434,545,20,6,6,0,3,1,5,6,111,117
p_209,2,0,e_2,354,439,545,10,6,4,11,5,1,2,85,106,191
p_171,3,0,e_2,408,444,545,24,3,3,5,4,1,3,36,101,137
p_155,3,0,e_2,434,444,545,16,6,5,1,2,0,5,10,101,111
p_192,5,0,e_2,380,452,545,30,4,4,11,4,1,2,72,93,165
p_179,6,0,e_2,397,457,545,26,2,2,7,4,1,3,60,88,148
p_176,6,0,e_2,398,457,545,26,2,2,7,4,1,3,59,88,147
p_187,7,0,e_2,391,462,545,26,2,2,8,4,1,4,71,83,154
p_153,8,0,e_2,438,467,545,10,6,4,2,5,1,5,29,78,107
p_152,10,0,e_2,439,475,545,8,5,4,2,2,1,5,36,70,106
p_146,10,0,e_2,451,475,545,8,4,3,5,5,1,5,24,70,94
p_134,12,0,e_2,462,483,545,4,4,1,7,5,1,2,21,62,83
p_123,12,0,e_2,474,483,545,1,5,0,10,5,1,3,9,62,71
p_124,14,0,e_2,474,491,545,29,5,5,10,2,1,3,17,54,71
p_114,9,0,e_2,494,508,545,28,4,4,13,4,1,2,14,37,51
p_110,1,0,e_0,501,519,644,4,6,2,3,4,1,4,18,125,143
p_143,2,0,e_0,451,524,644,16,4,3,15,2,1,2,73,120,193
p_150,3,0,e_0,444,529,644,14,4,3,13,5,1,3,85,115,200
p_148,3,0,e_0,447,529,644,16,5,4,14,5,1,3,82,115,197
p_144,4,0,e_0,451,534,644,14,4,3,15,2,1,3,83,110,193
p_118,4,0,e_0,488,534,644,5,4,1,5,4,1,5,46,110,156
p_122,5,0,e_0,477,539,644,7,5,1,8,4,1,4,62,105,167
p_119,5,0,e_0,483,539,644,5,4,0,7,4,1,4,56,105,161
p_94,6,0,e_0,528,544,644,23,8,3,3,2,1,6,16,100,116
p_132,7,0,e_0,463,549,644,8,4,0,12,4,1,4,86,95,181
p_104,7,0,e_0,516,549,644,25,6,6,0,5,0,6,33,95,128
p_89,7,0,e_0,537,549,644,21,7,2,5,5,1,6,12,95,107
p_100,10,0,e_0,522,560,644,21,6,6,2,5,1,7,38,84,122
p_101,12,0,e_0,521,568,644,19,6,6,1,5,1,6,47,76,123
p_103,13,0,e_0,517,573,644,19,6,6,0,5,0,6,56,71,127
p_107,1,0,e_3,512,530,649,2,6,1,3,4,1,5,18,119,137
p_136,2,0,e_3,460,535,649,14,3,1,14,5,1,2,75,114,189
p_133,4,0,e_3,463,543,649,11,4,0,15,5,1,3,80,106,186
p_129,5,0,e_3,470,548,649,8,4,0,13,4,1,3,78,101,179
p_98,6,0,e_3,524,553,649,6,6,6,0,3,1,6,29,96,125
p_86,6,0,e_3,541,553,649,21,7,3,3,5,1,6,12,96,108
p_116,7,0,e_3,490,558,649,1,4,0,8,4,1,3,68,91,159
p_93,7,0,e_3,529,558,649,22,8,2,1,5,0,8,29,91,120
p_97,10,0,e_3,526,569,649,20,7,1,0,5,0,7,43,80,123
p_74,11,0,e_3,567,574,649,10,4,1,9,5,1,3,7,75,82
p_112,15,0,e_3,497,588,649,22,4,4,7,4,1,3,91,61,152
p_52,11,0,e_3,591,602,649,4,7,0,15,4,1,6,11,47,58
p_58,10,0,e_3,586,607,649,6,7,1,14,5,1,6,21,42,63
p_41,10,0,e_3,600,607,649,1,8,0,11,4,1,7,7,42,49
p_60,9,0,e_3,584,612,649,7,6,1,14,5,1,5,28,37,65
p_99,1,0,e_1,522,547,658,30,6,6,5,4,1,4,25,111,136
p_85,3,0,e_1,542,555,658,23,7,5,0,3,1,5,13,103,116
p_108,5,0,e_1,509,563,658,29,5,5,9,4,1,2,54,95,149
p_130,9,0,e_1,469,577,658,5,4,1,12,2,1,1,108,81,189
p_121,9,0,e_1,480,577,658,2,5,1,14,5,1,2,97,81,178
p_109,14,0,e_1,506,594,658,20,5,5,10,4,1,2,88,64,152
p_111,15,0,e_1,501,599,658,20,5,5,11,4,1,2,98,59,157
p_44,15,0,e_1,598,599,658,27,8,8,15,5,1,6,1,59,60
p_50,10,0,e_1,592,616,658,4,8,1,14,5,1,5,24,42,66
p_59,6,0,e_1,584,630,658,10,7,1,11,5,1,2,46,28,74
p_47,6,0,e_1,594,630,658,8,8,4,14,2,1,6,36,28,64
p_55,4,0,e_1,590,638,658,11,7,4,13,5,1,3,48,20,68
p_43,3,0,e_1,599,643,658,9,8,6,15,2,1,5,44,15,59
p_48,2,0,e_1,593,648,658,12,8,6,14,5,1,6,55,10,65
p_51,1,0,e_1,591,653,658,13,8,7,13,5,1,4,62,5,67
p_102,2,0,e_2,521,553,667,29,6,6,6,4,1,1,32,114,146
p_90,2,0,e_2,536,553,667,26,7,6,2,4,1,3,17,114,131
p_81,2,0,e_2,547,553,667,23,6,4,0,5,0,5,6,114,120
p_84,3,0,e_2,546,558,667,22,6,4,0,5,0,4,12,109,121
p_82,3,0,e_2,547,558,667,22,5,4,0,5,0,5,11,109,120
p_125,4,0,e_2,474,563,667,9,5,2,10,2,1,2,89,104,193
p_106,4,0,e_2,512,563,667,29,7,7,8,4,1,2,51,104,155
p_105,4,0,e_2,515,563,667,28,6,6,7,4,1,2,48,104,152
p_96,5,0,e_2,527,568,667,25,8,4,4,1,1,2,41,99,140
p_83,5,0,e_2,546,568,667,20,6,4,0,5,0,5,22,99,121
p_126,6,0,e_2,473,573,667,7,5,1,10,5,1,2,100,94,194
p_95,6,0,e_2,527,573,667,24,8,3,4,4,1,3,46,94,140
p_80,6,0,e_2,548,573,667,19,5,3,1,5,0,5,25,94,119
p_77,6,0,e_2,557,573,667,17,4,2,3,2,1,4,16,94,110
p_76,7,0,e_2,559,578,667,16,4,2,3,5,1,4,19,89,108
p_71,2,0,e_3,569,657,757,18,5,2,10,2,1,4,88,100,188
p_56,2,0,e_3,588,657,757,13,7,0,15,2,1,6,69,100,169
p_78,4,0,e_3,555,665,757,20,4,3,6,5,1,3,110,92,202
p_38,4,0,e_3,627,665,757,2,5,0,6,4,1,4,38,92,130
p_73,6,0,e_3,568,673,757,14,5,2,10,5,1,4,105,84,189
p_57,6,0,e_3,587,673,757,9,7,0,15,2,1,6,86,84,170
p_67,8,0,e_3,574,681,757,11,5,1,11,2,1,4,107,76,183
p_36,11,0,e_3,635,692,757,23,5,5,4,4,1,4,57,65,122
p_39,15,0,e_3,609,706,757,25,6,6,10,4,1,5,97,51,148
p_24,5,0,e_3,707,738,757,10,2,0,15,4,1,1,31,19,50
p_23,5,0,e_3,709,738,757,10,3,0,15,4,1,2,29,19,48
p_27,2,0,e_3,693,749,757,17,2,1,11,5,1,1,56,8,64
p_64,1,0,e_0,579,649,758,17,6,1,14,5,1,4,70,109,179
p_70,3,0,e_0,572,657,758,16,6,1,13,2,1,2,85,101,186
p_62,5,0,e_0,582,665,758,12,6,1,15,5,1,7,83,93,176
p_61,5,0,e_0,583,665,758,11,6,1,15,2,1,7,82,93,175
p_45,5,0,e_0,597,665,758,8,8,5,12,1,1,7,68,93,161
p_63,8,0,e_0,581,676,758,9,6,1,14,5,1,5,95,82,177
p_66,12,0,e_0,577,690,758,7,6,1,14,5,1,4,113,68,181
p_92,13,0,e_0,533,695,758,16,8,1,4,5,1,7,162,63,225
p_91,13,0,e_0,535,695,758,15,7,1,4,5,1,6,160,63,223
p_88,14,0,e_0,538,700,758,14,7,1,5,2,1,5,162,58,220
p_87,15,0,e_0,539,705,758,12,7,0,5,2,1,6,166,53,219
p_72,15,0,e_0,569,705,758,5,6,0,12,5,1,3,136,53,189
p_22,10,0,e_0,712,722,758,4,3,0,13,4,1,2,10,36,46
p_25,7,0,e_0,703,733,758,9,3,1,15,5,1,2,30,25,55
p_26,3,0,e_0,698,747,758,15,3,1,14,5,1,2,49,11,60
p_32,5,0,e_1,657,675,760,23,5,4,0,3,1,2,18,85,103
p_31,5,0,e_1,662,675,760,22,6,4,1,5,0,3,13,85,98
p_30,5,0,e_1,676,677,760,18,4,3,5,5,1,2,1,83,84
p_28,6,0,e_1,679,682,760,17,4,3,5,5,1,2,3,78,81
p_33,8,0,e_1,647,690,760,23,7,7,2,4,1,3,43,70,113
p_34,15,0,e_1,643,713,760,17,6,6,3,1,1,2,70,47,117
p_29,15,0,e_1,678,713,760,8,4,0,5,5,1,2,35,47,82
p_42,4,0,e_2,600,681,775,7,8,4,13,5,1,7,81,94,175
p_40,4,0,e_2,601,681,775,7,8,4,13,5,1,8,80,94,174
p_35,4,0,e_2,640,681,775,28,7,7,7,4,1,8,41,94,135
p_49,5,0,e_2,592,686,775,9,8,5,10,5,1,4,94,89,183
p_54,6,0,e_2,590,691,775,9,7,3,10,5,1,3,101,84,185
p_37,7,0,e_2,633,696,775,27,5,5,9,4,1,7,63,79,142
p_53,9,0,e_2,590,704,775,6,7,1,10,5,1,2,114,71,185
p_69,10,0,e_2,573,709,775,9,5,1,6,5,1,2,136,66,202
p_65,12,0,e_2,578,717,775,6,6,1,7,2,1,2,139,58,197
p_46,13,0,e_2,596,722,775,30,8,8,12,2,1,5,126,53,179
p_79,14,0,e_2,549,727,775,11,5,1,1,5,0,5,178,48,226
p_75,14,0,e_2,563,727,775,8,4,1,4,5,1,4,164,48,212
p_68,14,0,e_2,574,727,775,5,6,1,6,5,1,3,153,48,201
p_21,10,0,e_2,732,741,775,27,3,3,13,4,1,0,9,34,43
p_20,9,0,e_2,737,746,775,26,2,2,11,4,1,1,9,29,38
p_18,2,0,e_0,768,776,784,2,0,0,0,3,0,0,8,8,16
p_19,12,0,e_1,740,798,858,23,2,2,6,4,1,0,58,60,118
p_17,15,0,e_1,772,809,858,15,0,0,4,5,0,1,37,49,86
p_15,15,0,e_1,782,809,858,15,0,0,7,5,0,2,27,49,76
p_14,15,0,e_1,790,809,858,15,0,0,10,5,0,2,19,49,68
p_10,14,0,e_1,810,814,858,14,0,0,15,4,1,0,4,44,48
p_16,13,0,e_2,774,816,859,13,0,0,0,3,1,0,42,43,85
p_12,13,0,e_2,796,816,859,13,0,0,6,5,0,1,20,43,63
p_8,1,0,e_2,847,854,859,3,1,1,3,4,1,0,7,5,12
p_13,11,0,e_0,794,829,864,11,0,0,0,3,0,0,35,35,70
p_11,11,0,e_0,810,829,864,11,0,0,5,5,0,1,19,35,54
p_4,1,0,e_0,864,869,874,18,2,1,0,3,1,0,5,5,10
p_5,5,0,e_2,860,878,895,15,2,1,0,3,0,0,18,17,35
p_3,1,0,e_0,876,881,902,14,2,1,0,3,0,0,5,21,26
p_2,3,0,e_0,878,889,902,11,2,1,0,5,0,1,11,13,24
p_1,2,0,e_0,889,894,902,9,1,0,3,4,1,0,5,8,13
p_9,2,0,e_3,845,853,923,2,0,0,0,3,0,0,8,70,78
p_7,12,0,e_3,851,885,923,11,1,0,1,5,0,1,34,38,72
p_6,14,0,e_1,858,903,947,11,2,0,0,3,0,0,45,44,89
p_299,3,0,e_1,7,19,30,3,0,0,0,3,0,0,12,11,23
p_296,1,0,e_3,20,26,31,1,0,0,0,3,0,0,6,5,11
p_298,4,0,e_2,10,25,47,4,0,0,0,3,0,0,15,22,37
p_295,5,0,e_2,22,30,47,5,1,0,3,5,0,1,8,17,25
p_290,4,0,e_3,43,50,82,6,1,1,2,5,0,1,7,32,39
p_291,6,0,e_3,35,58,82,6,0,0,0,3,0,0,23,24,47
p_286,3,0,e_3,51,69,82,5,3,1,4,5,1,2,18,13,31
p_288,1,0,e_3,49,77,82,7,2,1,4,5,0,2,28,5,33
p_282,6,0,e_2,62,67,97,29,3,3,4,5,0,2,5,30,35
p_289,7,0,e_2,47,72,97,4,2,0,0,3,1,0,25,25,50
p_285,2,0,e_2,54,89,97,5,4,1,2,5,0,1,35,8,43
p_279,2,0,e_2,76,89,97,29,1,1,6,4,1,1,13,8,21
p_275,2,0,e_2,84,89,97,28,2,2,4,4,1,1,5,8,13
p_300,8,0,e_0,4,30,110,8,0,0,0,3,0,0,26,80,106
p_297,12,0,e_0,18,44,110,12,0,0,4,5,0,1,26,66,92
p_294,13,0,e_0,23,49,110,13,1,0,6,5,0,2,26,61,87
p_293,15,0,e_0,26,57,110,16,1,1,7,5,0,3,31,53,84
p_284,14,0,e_0,55,62,110,9,4,0,15,5,1,1,7,48,55
p_283,10,0,e_0,55,76,110,5,4,0,15,5,1,2,21,34,55
p_281,10,0,e_0,63,76,110,25,3,3,14,4,1,1,13,34,47
p_276,5,0,e_0,82,93,110,5,2,2,9,4,1,0,11,17,28
p_292,11,0,e_1,30,66,111,11,0,0,0,3,0,0,36,45,81
p_287,12,0,e_1,51,71,111,8,3,0,6,5,0,1,20,40,60
p_280,12,0,e_1,65,71,111,22,3,3,11,2,0,1,6,40,46
p_274,4,0,e_1,84,97,111,26,2,2,8,4,1,0,13,14,27
p_267,1,0,e_2,153,158,163,9,1,0,0,3,0,0,5,5,10
p_277,10,0,e_3,81,114,188,20,2,2,0,4,1,1,33,74,107
p_273,13,0,e_3,95,125,188,13,2,1,4,5,0,2,30,63,93
p_278,15,0,e_3,80,133,188,16,1,1,1,4,1,0,53,55,108
p_272,15,0,e_3,105,133,188,8,3,0,7,5,0,3,28,55,83
p_271,11,0,e_3,127,147,188,6,2,1,13,5,1,1,20,41,61
p_268,10,0,e_3,150,152,188,1,1,0,11,4,1,0,2,36,38
p_262,6,0,e_3,164,166,188,1,2,0,7,4,1,1,2,22,24
p_264,5,0,e_3,162,171,188,2,1,0,7,4,1,0,9,17,26
p_258,5,0,e_2,175,191,232,29,1,1,0,5,0,1,16,41,57
p_259,6,0,e_2,174,196,232,28,1,1,0,3,0,0,22,36,58
p_256,8,0,e_2,191,204,232,8,0,0,5,2,0,1,13,28,41
p_252,2,0,e_2,212,224,232,25,2,1,6,4,1,0,12,8,20
p_270,7,0,e_0,133,156,233,8,2,1,0,3,0,0,23,77,100
p_266,15,0,e_0,155,182,233,24,1,1,7,5,0,1,27,51,78
p_257,12,0,e_0,179,193,233,21,1,1,14,5,1,1,14,40,54
p_255,10,0,e_0,192,201,233,10,0,0,12,1,1,0,9,32,41
p_269,4,0,e_1,146,161,233,7,1,0,0,3,0,0,15,72,87
p_265,12,0,e_1,157,187,233,27,1,1,3,5,0,1,30,46,76
p_263,12,0,e_1,163,187,233,25,2,2,4,5,1,1,24,46,70
p_261,12,0,e_1,170,187,233,23,2,2,7,5,1,1,17,46,63
p_260,13,0,e_1,171,192,233,22,1,1,7,5,1,1,21,41,62
p_249,7,0,e_1,238,262,287,11,3,1,0,3,0,0,24,25,49
p_244,2,0,e_1,271,279,287,7,2,1,5,4,1,0,8,8,16
p_254,3,0,e_3,199,211,300,3,0,0,0,3,0,0,12,89,101
p_253,15,0,e_3,208,249,300,13,1,0,2,5,0,1,41,51,92
p_246,12,0,e_3,257,260,300,1,2,0,13,4,1,1,3,40,43
p_251,4,0,e_3,228,286,300,18,2,1,8,5,1,1,58,14,72
p_250,7,0,e_0,236,260,317,12,3,1,0,3,0,0,24,57,81
p_248,7,0,e_0,246,260,317,9,3,1,3,5,0,1,14,57,71
p_247,12,0,e_0,248,277,317,19,2,0,3,5,0,1,29,40,69
p_243,8,0,e_0,285,291,317,26,2,2,10,4,1,0,6,26,32
p_245,9,0,e_2,269,299,330,30,2,2,0,3,0,0,30,31,61
p_238,2,0,e_2,311,322,330,23,1,1,5,4,1,0,11,8,19
p_242,4,0,e_1,287,302,398,30,1,1,0,3,0,0,15,96,111
p_236,8,0,e_1,313,316,398,16,2,1,7,5,1,2,3,82,85
p_241,13,0,e_1,300,333,398,13,0,0,4,5,0,1,33,65,98
p_240,14,0,e_1,301,338,398,14,0,0,4,5,0,2,37,60,97
p_234,14,0,e_1,314,338,398,12,2,0,8,5,1,3,24,60,84
p_224,13,0,e_1,335,343,398,5,3,0,13,5,1,3,8,55,63
p_223,13,0,e_1,339,343,398,5,2,0,14,4,1,3,4,55,59
p_226,12,0,e_1,331,348,398,8,3,1,13,5,1,3,17,50,67
p_219,11,0,e_1,342,353,398,5,3,1,13,1,1,2,11,45,56
p_229,9,0,e_1,323,361,398,12,2,1,10,5,1,2,38,37,75
p_227,9,0,e_1,326,361,398,12,3,1,11,5,1,3,35,37,72
p_220,9,0,e_1,342,361,398,7,3,1,13,1,1,2,19,37,56
p_218,9,0,e_1,343,361,398,7,3,1,13,1,1,3,18,37,55
p_212,9,0,e_1,348,361,398,7,5,2,12,4,1,3,13,37,50
p_206,6,0,e_1,362,372,398,7,3,1,9,4,1,3,10,26,36
p_221,4,0,e_2,341,348,412,13,3,1,2,5,0,1,7,64,71
p_214,4,0,e_2,346,348,412,11,4,1,4,5,0,2,2,64,66
p_215,6,0,e_2,346,356,412,9,4,1,4,5,0,2,10,56,66
p_225,10,0,e_2,333,370,412,9,3,1,0,3,0,0,37,42,79
p_198,9,0,e_2,368,375,412,3,3,0,10,5,1,3,7,37,44
p_197,8,0,e_2,375,380,412,1,3,0,9,4,1,2,5,32,37
p_192,5,0,e_2,380,391,412,3,3,0,8,1,1,2,11,21,32
p_199,2,0,e_2,368,402,412,10,3,2,10,5,1,2,34,10,44
p_175,2,0,e_2,399,402,412,1,4,0,3,4,1,3,3,10,13
p_205,1,0,e_2,362,407,412,12,3,2,8,5,1,1,45,5,50
p_186,1,0,e_2,391,407,412,5,3,2,5,1,1,2,16,5,21
p_237,5,0,e_3,313,323,414,19,1,1,2,5,0,1,10,91,101
p_230,5,0,e_3,323,323,414,16,2,2,5,2,0,2,0,91,91
p_235,8,0,e_3,314,336,414,16,2,1,2,5,0,2,22,78,100
p_239,13,0,e_3,305,353,414,13,0,0,0,3,0,0,48,61,109
p_211,14,0,e_3,348,358,414,3,4,0,11,5,1,3,10,56,66
p_208,13,0,e_3,355,363,414,2,4,1,13,5,1,3,8,51,59
p_217,8,0,e_3,345,380,414,7,3,1,11,5,1,2,35,34,69
p_191,7,0,e_3,382,385,414,1,3,0,8,4,1,2,3,29,32
p_196,5,0,e_3,376,393,414,4,3,1,9,4,1,2,17,21,38
p_222,3,0,e_3,339,401,414,14,2,1,9,5,1,1,62,13,75
p_185,2,0,e_3,392,406,414,3,2,1,5,1,1,1,14,8,22
p_233,2,0,e_0,319,328,428,20,3,3,0,3,0,0,9,100,109
p_232,5,0,e_0,320,339,428,17,3,2,0,3,0,1,19,89,108
p_231,10,0,e_0,320,356,428,12,3,1,0,5,0,2,36,72,108
p_228,11,0,e_0,325,361,428,10,3,1,1,5,0,3,36,67,103
p_213,12,0,e_0,347,366,428,3,4,1,7,5,1,2,19,62,81
p_207,12,0,e_0,355,366,428,3,5,1,10,2,1,2,11,62,73
p_203,12,0,e_0,365,366,428,1,3,0,12,5,1,2,1,62,63
p_200,12,0,e_0,367,368,428,30,3,3,12,5,1,2,1,60,61
p_202,13,0,e_0,365,373,428,30,3,3,12,5,1,2,8,55,63
p_201,13,0,e_0,366,373,428,30,3,3,12,5,1,2,7,55,62
p_194,11,0,e_0,377,381,428,28,4,4,12,4,1,2,4,47,51
p_195,9,0,e_0,376,389,428,30,3,3,13,4,1,1,13,39,52
p_204,8,0,e_0,364,394,428,5,3,0,12,5,1,1,30,34,64
p_188,8,0,e_0,390,394,428,28,3,3,9,4,1,2,4,34,38
p_189,7,0,e_0,387,399,428,30,3,3,10,4,1,2,12,29,41
p_156,1,0,e_0,428,433,516,23,6,5,0,3,1,4,5,83,88
p_174,3,0,e_0,402,441,516,30,3,3,7,4,1,2,39,75,114
p_171,3,0,e_0,408,441,516,29,3,3,5,4,1,4,33,75,108
p_155,3,0,e_0,434,441,516,20,5,4,1,5,1,4,7,75,82
p_184,5,0,e_0,393,449,516,30,3,3,8,1,1,1,56,67,123
p_182,5,0,e_0,394,449,516,30,3,3,8,4,1,2,55,67,122
p_178,5,0,e_0,398,449,516,29,4,4,7,1,1,2,51,67,118
p_179,6,0,e_0,397,454,516,28,4,4,8,4,1,2,57,62,119
p_176,6,0,e_0,398,454,516,28,4,4,7,4,1,3,56,62,118
p_187,7,0,e_0,391,459,516,28,3,3,9,4,1,2,68,57,125
p_154,7,0,e_0,438,459,516,15,5,4,2,5,1,5,21,57,78
p_147,7,0,e_0,450,459,516,11,4,3,5,5,1,4,9,57,66
p_153,8,0,e_0,438,464,516,14,5,4,2,5,1,4,26,52,78
p_146,10,0,e_0,451,472,516,8,4,3,5,5,1,4,21,44,65
p_132,7,0,e_0,463,483,516,8,4,1,8,2,1,3,20,33,53
p_216,1,0,e_1,346,403,516,14,4,1,12,4,1,3,57,113,170
p_209,2,0,e_1,354,408,516,13,4,1,11,4,1,3,54,108,162
p_210,4,0,e_1,353,416,516,11,4,1,11,4,1,2,63,100,163
p_177,9,0,e_1,398,433,516,25,4,4,0,3,1,5,35,83,118
p_173,10,0,e_1,405,438,516,22,3,3,1,5,1,5,33,78,111
p_193,12,0,e_1,378,446,516,26,4,4,4,4,1,3,68,70,138
p_164,12,0,e_1,416,446,516,16,3,1,4,5,1,4,30,70,100
p_161,13,0,e_1,418,451,516,14,4,1,4,5,1,4,33,65,98
p_190,14,0,e_1,382,456,516,24,4,4,4,4,1,3,74,60,134
p_180,14,0,e_1,396,456,516,21,4,4,1,4,1,4,60,60,120
p_165,14,0,e_1,416,456,516,14,3,0,4,5,1,4,40,60,100
p_162,14,0,e_1,417,456,516,14,3,0,4,5,1,4,39,60,99
p_158,14,0,e_1,426,456,516,11,5,0,7,5,1,5,30,60,90
p_151,15,0,e_1,443,461,516,7,5,0,11,5,1,4,18,55,73
p_149,15,0,e_1,444,461,516,7,5,0,12,5,1,5,17,55,72
p_167,7,0,e_2,412,435,524,24,3,3,0,3,1,3,23,89,112
p_170,10,0,e_2,408,446,524,22,3,3,1,4,1,1,38,78,116
p_169,11,0,e_2,410,451,524,20,3,3,0,4,1,2,41,73,114
p_183,12,0,e_2,393,456,524,23,3,3,5,4,1,2,63,68,131
p_168,15,0,e_2,412,467,524,15,3,3,0,5,0,4,55,57,112
p_130,9,0,e_2,469,487,524,5,4,0,15,4,1,2,18,37,55
p_138,7,0,e_2,456,495,524,10,4,3,12,5,1,2,39,29,68
p_125,4,0,e_2,474,506,524,9,5,4,13,4,1,4,32,18,50
p_143,2,0,e_2,451,514,524,16,4,3,11,5,1,2,63,10,73
p_107,1,0,e_2,512,519,524,2,6,0,2,4,1,5,7,5,12
p_163,4,0,e_3,417,428,524,24,3,3,0,5,0,3,11,96,107
p_166,5,0,e_3,415,433,524,23,2,2,0,5,0,2,18,91,109
p_160,10,0,e_3,421,450,524,16,4,2,2,5,0,4,29,74,103
p_181,11,0,e_3,395,455,524,24,3,3,5,4,1,2,60,69,129
p_159,11,0,e_3,424,455,524,14,5,1,3,5,0,5,31,69,100
p_157,12,0,e_3,427,460,524,8,4,4,4,3,0,4,33,64,97
p_145,12,0,e_3,451,460,524,6,4,1,10,5,1,3,9,64,73
p_140,13,0,e_3,455,465,524,4,3,1,11,5,1,2,10,59,69
p_137,13,0,e_3,458,465,524,3,4,1,12,5,1,3,7,59,66
p_172,14,0,e_3,405,470,524,18,2,2,2,1,1,1,65,54,119
p_123,12,0,e_3,474,478,524,1,4,0,13,4,1,3,4,46,50
p_128,10,0,e_3,471,486,524,4,3,0,14,4,1,2,15,38,53
p_120,10,0,e_3,481,486,524,2,4,0,12,4,1,3,5,38,43
p_131,9,0,e_3,467,491,524,6,3,1,13,5,1,2,24,33,57
p_121,9,0,e_3,480,491,524,3,4,1,12,4,1,3,11,33,44
p_136,2,0,e_0,460,524,630,14,3,2,7,5,1,3,64,106,170
p_150,3,0,e_0,444,529,630,17,5,4,4,5,1,4,85,101,186
p_148,3,0,e_0,447,529,630,16,5,4,5,5,1,5,82,101,183
p_133,4,0,e_0,463,534,630,11,4,1,8,2,1,4,71,96,167
p_118,4,0,e_0,488,534,630,6,3,2,6,4,1,4,46,96,142
p_105,4,0,e_0,515,534,630,28,7,7,0,3,1,6,19,96,115
p_129,5,0,e_0,470,539,630,9,3,2,10,5,1,5,69,91,160
p_122,5,0,e_0,477,539,630,7,5,3,9,4,1,6,62,91,153
p_119,5,0,e_0,483,539,630,6,4,3,7,1,1,5,56,91,147
p_96,5,0,e_0,527,539,630,24,7,5,3,5,1,8,12,91,103
p_126,6,0,e_0,473,544,630,8,4,3,10,4,1,5,71,86,157
p_94,6,0,e_0,528,544,630,23,7,4,3,2,1,7,16,86,102
p_89,7,0,e_0,537,549,630,20,7,3,5,5,1,7,12,81,93
p_100,10,0,e_0,522,560,630,21,6,6,1,5,0,8,38,70,108
p_113,11,0,e_0,496,565,630,27,4,4,4,4,1,4,69,65,134
p_144,4,0,e_1,451,530,636,14,4,3,13,2,1,3,79,106,185
p_104,7,0,e_1,516,541,636,25,7,7,0,3,1,6,25,95,120
p_93,7,0,e_1,529,541,636,22,7,3,4,3,0,6,12,95,107
p_152,10,0,e_1,439,552,636,12,5,3,10,5,1,3,113,84,197
p_134,12,0,e_1,462,560,636,4,4,2,15,4,1,3,98,76,174
p_139,13,0,e_1,456,565,636,4,4,1,14,5,1,3,109,71,180
p_124,14,0,e_1,474,570,636,29,5,5,12,4,1,4,96,66,162
p_88,14,0,e_1,538,570,636,12,7,1,6,5,1,6,32,66,98
p_79,14,0,e_1,549,570,636,10,6,1,9,5,1,6,21,66,87
p_75,14,0,e_1,563,570,636,7,5,1,13,5,1,5,7,66,73
p_142,15,0,e_1,452,575,636,5,4,0,13,5,1,4,123,61,184
p_141,15,0,e_1,455,575,636,4,4,0,14,2,1,3,120,61,181
p_87,15,0,e_1,539,575,636,11,6,6,7,5,1,6,36,61,97
p_72,15,0,e_1,569,575,636,4,5,0,14,2,1,4,6,61,67
p_66,12,0,e_1,577,586,636,5,5,2,15,4,1,4,9,50,59
p_110,1,0,e_3,501,529,642,6,4,0,7,4,1,3,28,113,141
p_106,4,0,e_3,512,540,642,29,6,6,3,4,1,5,28,102,130
p_98,6,0,e_3,524,548,642,6,6,6,0,3,1,6,24,94,118
p_135,7,0,e_3,461,553,642,9,3,2,12,5,1,2,92,89,181
p_116,7,0,e_3,490,553,642,2,3,0,9,4,1,2,63,89,152
p_114,9,0,e_3,494,561,642,30,3,3,9,4,1,2,67,81,148
p_117,12,0,e_3,490,572,642,27,3,3,9,4,1,2,82,70,152
p_68,14,0,e_3,574,580,642,4,4,1,12,5,1,3,6,62,68
p_112,15,0,e_3,497,585,642,22,4,4,7,4,1,3,88,57,145
p_50,10,0,e_3,592,602,642,3,5,0,13,4,1,4,10,40,50
p_77,6,0,e_3,557,616,642,16,5,3,8,5,1,4,59,26,85
p_57,6,0,e_3,587,616,642,9,5,0,15,4,1,4,29,26,55
p_54,6,0,e_3,590,616,642,8,5,0,14,4,1,4,26,26,52
p_61,5,0,e_3,583,621,642,10,5,0,15,5,1,4,38,21,59
p_45,5,0,e_3,597,621,642,6,6,2,11,4,1,5,24,21,45
p_99,1,0,e_2,522,529,646,30,6,6,0,4,1,5,7,117,124
p_102,2,0,e_2,521,534,646,29,6,6,1,4,1,4,13,112,125
p_108,5,0,e_2,509,545,646,29,6,6,3,4,1,4,36,101,137
p_83,5,0,e_2,546,547,646,19,6,4,5,5,1,4,1,99,100
p_95,6,0,e_2,527,552,646,24,7,4,0,5,0,6,25,94,119
p_115,10,0,e_2,494,566,646,29,4,4,7,1,1,3,72,80,152
p_97,10,0,e_2,526,566,646,20,7,2,0,5,0,6,40,80,120
p_109,14,0,e_2,506,580,646,21,6,6,4,1,1,3,74,66,140
p_127,15,0,e_2,473,585,646,28,4,4,13,4,1,3,112,61,173
p_111,15,0,e_2,501,585,646,22,5,5,5,4,1,4,84,61,145
p_52,11,0,e_2,591,599,646,3,5,0,14,4,1,4,8,47,55
p_41,10,0,e_2,600,604,646,1,7,0,11,4,1,5,4,42,46
p_63,8,0,e_2,581,612,646,8,5,1,14,5,1,3,31,34,65
p_73,6,0,e_2,568,620,646,13,5,2,10,5,1,3,52,26,78
p_59,6,0,e_2,584,620,646,9,5,0,15,2,1,4,36,26,62
p_51,1,0,e_1,591,641,730,13,5,3,11,1,1,5,50,89,139
p_78,4,0,e_1,555,652,730,19,5,3,11,5,1,5,97,78,175
p_55,4,0,e_1,590,652,730,10,5,2,11,1,1,5,62,78,140
p_42,4,0,e_1,600,652,730,7,7,3,9,1,1,5,52,78,130
p_40,4,0,e_1,601,652,730,6,7,2,9,1,1,6,51,78,129
p_35,4,0,e_1,640,652,730,27,4,4,1,2,0,6,12,78,90
p_86,6,0,e_1,541,660,730,20,6,4,7,2,1,5,119,70,189
p_60,9,0,e_1,584,671,730,12,5,0,12,4,1,5,87,59,146
p_53,9,0,e_1,590,671,730,5,5,0,11,1,1,5,81,59,140
p_69,10,0,e_1,573,676,730,8,4,1,15,5,1,4,103,54,157
p_58,10,0,e_1,586,676,730,5,5,0,12,4,1,5,90,54,144
p_74,11,0,e_1,567,681,730,9,5,2,13,5,1,4,114,49,163
p_65,12,0,e_1,578,686,730,5,5,2,14,4,1,5,108,44,152
p_28,6,0,e_1,679,706,730,14,2,1,11,5,1,3,27,24,51
p_30,5,0,e_1,676,711,730,16,2,1,10,5,1,2,35,19,54
p_84,3,0,e_2,546,657,740,21,6,4,5,2,1,4,111,83,194
p_38,4,0,e_2,627,662,740,30,4,4,5,4,1,2,35,78,113
p_62,5,0,e_2,582,667,740,11,5,1,14,5,1,4,85,73,158
p_32,5,0,e_2,657,667,740,22,3,2,3,5,1,4,10,73,83
p_31,5,0,e_2,662,667,740,20,3,2,4,3,1,3,5,73,78
p_33,8,0,e_2,647,678,740,21,4,1,0,5,0,4,31,62,93
p_46,13,0,e_2,596,695,740,29,6,6,12,4,1,5,99,45,144
p_25,7,0,e_2,703,715,740,6,1,0,11,4,1,1,12,25,37
p_27,2,0,e_2,693,732,740,13,2,0,13,5,1,1,39,8,47
p_64,1,0,e_3,579,647,742,15,4,1,14,2,1,3,68,95,163
p_81,2,0,e_3,547,652,742,22,5,4,6,2,1,4,105,90,195
p_56,2,0,e_3,588,652,742,12,5,2,14,4,1,4,64,90,154
p_48,2,0,e_3,593,652,742,11,6,3,13,4,1,5,59,90,149
p_37,7,0,e_3,633,669,742,25,3,3,2,4,1,2,36,73,109
p_44,15,0,e_3,598,695,742,26,6,6,11,4,1,5,97,47,144
p_39,15,0,e_3,609,695,742,23,6,6,8,4,1,5,86,47,133
p_34,15,0,e_3,643,695,742,15,4,0,0,5,0,4,52,47,99
p_90,2,0,e_0,536,638,744,25,7,6,4,5,1,6,102,106,208
p_71,2,0,e_0,569,638,744,17,5,2,12,5,1,6,69,106,175
p_85,3,0,e_0,542,643,744,23,6,5,6,5,1,7,101,101,202
p_82,3,0,e_0,547,643,744,21,6,4,7,5,1,7,96,101,197
p_70,3,0,e_0,572,643,744,15,4,1,12,5,1,5,71,101,172
p_43,3,0,e_0,599,643,744,8,7,3,7,1,1,7,44,101,145
p_49,5,0,e_0,592,651,744,8,6,2,8,4,1,7,59,93,152
p_80,6,0,e_0,548,656,744,18,6,4,7,5,1,7,108,88,196
p_47,6,0,e_0,594,656,744,6,6,1,8,1,1,7,62,88,150
p_76,7,0,e_0,559,661,744,14,6,2,10,2,1,6,102,83,185
p_67,8,0,e_0,574,666,744,10,4,1,13,5,1,6,92,78,170
p_36,11,0,e_0,635,677,744,21,4,4,1,5,0,8,42,67,109
p_101,12,0,e_0,521,682,744,19,6,6,1,5,0,7,161,62,223
p_103,13,0,e_0,517,687,744,19,7,7,0,5,0,6,170,57,227
p_92,13,0,e_0,533,687,744,15,7,1,4,5,1,7,154,57,211
p_18,2,0,e_3,768,777,785,2,0,0,0,3,0,0,9,8,17
p_26,3,0,e_1,698,741,800,12,1,0,9,4,1,2,43,59,102
p_24,5,0,e_1,707,749,800,7,1,0,6,4,1,2,42,51,93
p_23,5,0,e_1,709,749,800,6,1,0,6,4,1,2,40,51,91
p_20,9,0,e_1,737,763,800,23,1,1,2,5,0,3,26,37,63
p_22,10,0,e_1,712,768,800,30,1,1,5,4,1,1,56,32,88
p_21,10,0,e_1,732,768,800,23,1,1,0,5,0,3,36,32,68
p_19,12,0,e_2,740,778,840,18,1,1,0,3,1,0,38,62,100
p_16,13,0,e_2,774,783,840,12,1,0,11,5,0,2,9,57,66
p_17,15,0,e_2,772,791,840,14,1,0,10,5,0,1,19,49,68
p_13,11,0,e_2,794,805,840,11,0,0,14,4,1,0,11,35,46
p_91,13,0,e_0,535,785,842,15,7,1,4,5,1,6,250,57,307
p_29,15,0,e_0,678,793,842,6,2,0,11,5,1,2,115,49,164
p_15,15,0,e_0,782,793,842,16,1,1,12,5,0,2,11,49,60
p_14,15,0,e_0,790,793,842,15,0,0,14,5,1,1,3,49,52
p_12,13,0,e_0,796,801,842,13,0,0,15,4,1,0,5,41,46
p_8,1,0,e_2,847,853,858,15,1,1,0,3,0,0,6,5,11
p_9,2,0,e_0,845,854,862,15,1,1,0,3,0,0,9,8,17
p_4,1,0,e_0,864,870,875,11,1,0,0,3,0,0,6,5,11
p_11,11,0,e_1,810,846,883,11,0,0,0,3,0,0,36,37,73
p_5,5,0,e_1,860,866,883,8,2,1,7,4,1,0,6,17,23
p_10,14,0,e_3,810,855,901,14,0,0,0,3,0,0,45,46,91
p_7,12,0,e_3,851,863,901,3,1,1,13,5,0,1,12,38,50
p_3,1,0,e_0,876,882,901,7,1,0,0,3,0,0,6,19,25
p_2,3,0,e_0,878,890,901,4,1,0,0,5,0,1,12,11,23
p_1,2,0,e_1,889,898,906,2,1,0,0,3,0,0,9,8,17
p_6,14,0,e_2,858,903,947,29,2,2,0,3,0,0,45,44,89
p_299,3,0,e_1,7,18,29,3,0,0,0,3,0,0,11,11,22
p_296,1,0,e_3,20,26,31,1,0,0,0,3,0,0,6,5,11
p_298,4,0,e_2,10,25,47,4,0,0,0,3,0,0,15,22,37
p_295,5,0,e_2,22,30,47,5,1,0,3,5,0,1,8,17,25
p_288,1,0,e_2,49,54,75,9,3,2,0,3,0,0,5,21,26
p_285,2,0,e_2,54,59,75,7,3,2,1,2,0,1,5,16,21
p_286,3,0,e_2,51,64,75,7,3,2,0,5,0,1,13,11,24
p_290,4,0,e_3,43,50,88,6,1,1,2,5,0,1,7,38,45
p_291,6,0,e_3,35,58,88,6,0,0,0,3,0,0,23,30,53
p_289,7,0,e_3,47,63,88,4,2,0,3,5,0,2,16,25,41
p_282,6,0,e_3,62,68,88,1,2,0,7,5,1,1,6,20,26
p_283,10,0,e_1,55,63,109,5,3,0,8,5,0,1,8,46,54
p_281,10,0,e_1,63,65,109,27,2,2,10,5,1,1,2,44,46
p_292,11,0,e_1,30,70,109,19,1,1,0,3,0,0,40,39,79
p_274,4,0,e_1,84,93,109,27,1,1,7,4,1,0,9,16,25
p_275,2,0,e_1,84,101,109,29,1,1,7,4,1,1,17,8,25
p_300,8,0,e_0,4,30,110,8,0,0,0,3,0,0,26,80,106
p_297,12,0,e_0,18,44,110,12,0,0,4,5,0,1,26,66,92
p_294,13,0,e_0,23,49,110,13,1,0,6,5,0,2,26,61,87
p_293,15,0,e_0,26,57,110,16,0,0,7,5,0,3,31,53,84
p_284,14,0,e_0,55,62,110,9,3,0,15,5,1,2,7,48,55
p_287,12,0,e_0,51,70,110,8,3,0,13,5,1,1,19,40,59
p_280,12,0,e_0,65,70,110,25,2,2,14,4,1,1,5,40,45
p_276,5,0,e_0,82,93,110,27,1,1,8,4,1,0,11,17,28
p_279,2,0,e_2,76,85,175,2,1,0,0,3,0,0,9,90,99
p_277,10,0,e_2,81,111,175,22,1,1,1,5,0,2,30,64,94
p_278,15,0,e_2,80,128,175,18,1,1,0,5,0,1,48,47,95
p_272,15,0,e_2,105,128,175,12,1,0,8,5,1,2,23,47,70
p_269,4,0,e_1,146,160,176,7,1,0,0,3,0,0,14,16,30
p_267,1,0,e_1,153,171,176,8,1,0,2,5,0,1,18,5,23
p_271,11,0,e_3,127,130,179,5,1,1,10,5,0,1,3,49,52
p_273,13,0,e_3,95,138,179,13,0,0,0,3,0,0,43,41,84
p_258,5,0,e_2,175,192,209,26,1,1,0,3,1,0,17,17,34
p_252,2,0,e_2,212,220,228,8,2,1,0,3,0,0,8,8,16
p_254,3,0,e_3,199,202,245,11,1,1,2,5,0,1,3,43,46
p_256,8,0,e_3,191,219,245,8,0,0,0,3,0,0,28,26,54
p_270,7,0,e_0,133,157,246,7,2,1,0,3,0,0,24,89,113
p_268,10,0,e_0,150,168,246,29,1,1,5,5,0,1,18,78,96
p_263,12,0,e_0,163,176,246,23,1,1,8,5,1,3,13,70,83
p_261,12,0,e_0,170,176,246,21,1,1,10,5,1,4,6,70,76
p_260,13,0,e_0,171,181,246,20,1,1,11,5,1,4,10,65,75
p_266,15,0,e_0,155,189,246,23,1,1,7,5,0,2,34,57,91
p_257,12,0,e_0,179,200,246,12,0,0,13,5,1,4,21,46,67
p_255,10,0,e_0,192,208,246,10,1,0,15,4,1,3,16,38,54
p_262,6,0,e_0,164,222,246,29,1,1,9,5,1,4,58,24,82
p_259,6,0,e_0,174,222,246,26,1,1,12,5,1,5,48,24,72
p_264,5,0,e_0,162,227,246,30,1,1,8,5,1,2,65,19,84
p_251,4,0,e_0,228,232,246,1,1,0,5,4,1,0,4,14,18
p_265,12,0,e_1,157,214,274,25,1,1,3,5,0,2,57,60,117
p_253,15,0,e_1,208,225,274,10,2,0,10,5,0,1,17,49,66
p_250,7,0,e_1,236,251,274,26,1,1,12,4,1,0,15,23,38
p_249,7,0,e_1,238,251,274,25,1,1,11,4,1,1,13,23,36
p_248,7,0,e_1,246,251,274,7,0,0,9,4,1,1,5,23,28
p_244,2,0,e_3,271,279,287,2,0,0,0,3,0,0,8,8,16
p_245,9,0,e_2,269,298,327,9,0,0,0,3,0,0,29,29,58
p_247,12,0,e_0,248,287,329,12,0,0,0,3,0,0,39,42,81
p_246,12,0,e_0,257,287,329,12,0,0,2,5,0,1,30,42,72
p_243,8,0,e_0,285,301,329,23,1,1,11,5,0,1,16,28,44
p_233,2,0,e_0,319,321,329,12,3,2,3,4,1,0,2,8,10
p_221,4,0,e_2,341,355,373,14,5,3,0,3,0,0,14,18,32
p_210,4,0,e_2,353,355,373,14,4,3,3,5,0,2,2,18,20
p_209,2,0,e_2,354,363,373,16,4,3,4,5,0,2,9,10,19
p_216,1,0,e_2,346,368,373,16,4,2,1,5,0,1,22,5,27
p_205,1,0,e_2,362,368,373,15,3,2,2,1,1,1,6,5,11
p_222,3,0,e_0,339,350,385,16,5,4,0,3,0,0,11,35,46
p_214,4,0,e_0,346,355,385,13,4,2,2,5,0,1,9,30,39
p_215,6,0,e_0,346,363,385,11,4,2,2,5,0,2,17,22,39
p_206,6,0,e_0,362,363,385,10,3,2,6,5,1,1,1,22,23
p_199,2,0,e_0,368,377,385,13,5,1,5,4,1,0,9,8,17
p_242,4,0,e_1,287,302,392,4,0,0,0,3,0,0,15,90,105
p_241,13,0,e_1,300,331,392,13,0,0,4,5,0,1,31,61,92
p_239,13,0,e_1,305,331,392,13,0,0,4,5,1,2,26,61,87
p_240,14,0,e_1,301,336,392,14,0,0,4,3,0,1,35,56,91
p_234,14,0,e_1,314,336,392,14,3,0,7,5,1,2,22,56,78
p_224,13,0,e_1,335,341,392,7,4,0,14,2,1,4,6,51,57
p_226,12,0,e_1,331,346,392,7,4,0,13,5,1,4,15,46,61
p_228,11,0,e_1,325,351,392,8,4,0,11,5,1,4,26,41,67
p_219,11,0,e_1,342,351,392,7,4,1,13,4,1,4,9,41,50
p_229,9,0,e_1,323,359,392,9,4,1,11,5,1,3,36,33,69
p_220,9,0,e_1,342,359,392,9,4,2,13,4,1,4,17,33,50
p_218,9,0,e_1,343,359,392,9,4,2,13,4,1,4,16,33,49
p_212,9,0,e_1,348,359,392,8,4,3,12,4,1,4,11,33,44
p_217,8,0,e_1,345,364,392,9,4,2,12,1,1,3,19,28,47
p_232,5,0,e_1,320,375,392,13,4,2,10,5,1,2,55,17,72
p_238,2,0,e_3,311,320,436,2,0,0,0,3,0,0,9,116,125
p_237,5,0,e_3,313,331,436,11,2,1,0,5,0,2,18,105,123
p_236,8,0,e_3,313,342,436,8,1,0,0,5,0,1,29,94,123
p_235,8,0,e_3,314,342,436,8,3,0,0,5,0,3,28,94,122
p_227,9,0,e_3,326,347,436,7,4,1,4,5,1,3,21,89,110
p_231,10,0,e_3,320,352,436,8,2,0,2,2,0,2,32,84,116
p_225,10,0,e_3,333,352,436,5,4,0,5,5,1,3,19,84,103
p_213,12,0,e_3,347,360,436,5,3,1,9,5,1,2,13,76,89
p_207,12,0,e_3,355,360,436,6,4,2,10,5,1,3,5,76,81
p_223,13,0,e_3,339,365,436,6,4,0,7,5,1,3,26,71,97
p_208,13,0,e_3,355,365,436,5,4,1,10,5,1,3,10,71,81
p_202,13,0,e_3,365,367,436,2,4,1,13,5,1,3,2,69,71
p_201,13,0,e_3,366,367,436,2,5,1,13,5,1,4,1,69,70
p_211,14,0,e_3,348,372,436,5,4,0,9,5,1,3,24,64,88
p_203,12,0,e_3,365,380,436,3,3,1,13,2,1,2,15,56,71
p_186,1,0,e_0,391,396,485,8,7,3,0,3,0,0,5,89,94
p_185,2,0,e_0,392,401,485,7,6,3,0,5,0,1,9,84,93
p_182,5,0,e_0,394,412,485,4,6,2,1,5,0,2,18,73,91
p_160,10,0,e_0,421,429,485,23,9,9,8,5,1,2,8,56,64
p_181,11,0,e_0,395,434,485,28,6,6,1,2,0,2,39,51,90
p_169,11,0,e_0,410,434,485,25,9,9,5,5,1,2,24,51,75
p_159,11,0,e_0,424,434,485,22,9,9,9,5,1,3,10,51,61
p_157,12,0,e_0,427,439,485,20,9,9,10,5,1,3,12,46,58
p_153,8,0,e_0,438,453,485,16,10,3,12,5,1,3,15,32,47
p_163,4,0,e_0,417,467,485,30,10,10,6,5,1,1,50,18,68
p_144,4,0,e_0,451,467,485,23,10,9,8,4,1,3,16,18,34
p_155,3,0,e_0,434,472,485,28,10,10,11,2,1,2,38,13,51
p_136,2,0,e_0,460,477,485,23,10,9,6,4,1,2,17,8,25
p_230,5,0,e_1,323,409,486,13,4,2,11,5,1,4,86,77,163
p_184,5,0,e_1,393,409,486,4,6,2,0,5,0,1,16,77,93
p_178,5,0,e_1,398,409,486,3,7,2,1,5,0,1,11,77,88
p_167,7,0,e_1,412,417,486,28,10,10,6,5,1,2,5,69,74
p_177,9,0,e_1,398,425,486,29,7,7,1,5,0,1,27,61,88
p_173,10,0,e_1,405,430,486,27,9,9,4,5,0,2,25,56,81
p_170,10,0,e_1,408,430,486,26,9,9,5,2,0,2,22,56,78
p_164,12,0,e_1,416,438,486,23,9,9,7,5,1,4,22,48,70
p_152,10,0,e_1,439,446,486,14,10,2,12,4,1,2,7,40,47
p_154,7,0,e_1,438,457,486,17,10,4,12,4,1,1,19,29,48
p_147,7,0,e_1,450,457,486,20,9,5,9,4,1,3,7,29,36
p_166,5,0,e_1,415,465,486,30,9,9,6,5,1,3,50,21,71
p_133,4,0,e_1,463,470,486,20,10,8,5,4,1,2,7,16,23
p_150,3,0,e_1,444,475,486,25,11,8,10,4,1,3,31,11,42
p_196,5,0,e_2,376,393,486,8,4,3,0,3,0,0,17,93,110
p_193,12,0,e_2,378,416,486,30,5,5,0,5,0,1,38,70,108
p_183,12,0,e_2,393,416,486,27,6,6,5,2,0,2,23,70,93
p_161,13,0,e_2,418,421,486,21,10,10,12,5,1,2,3,65,68
p_190,14,0,e_2,382,426,486,28,6,6,1,5,0,2,44,60,104
p_180,14,0,e_2,396,426,486,24,7,7,5,5,1,2,30,60,90
p_172,14,0,e_2,405,426,486,23,9,9,9,5,1,2,21,60,81
p_165,14,0,e_2,416,426,486,21,9,9,12,2,1,2,10,60,70
p_162,14,0,e_2,417,426,486,20,10,10,12,5,1,2,9,60,69
p_158,14,0,e_2,426,428,486,18,9,9,14,5,1,1,2,58,60
p_168,15,0,e_2,412,433,486,20,10,10,11,5,1,2,21,53,74
p_138,7,0,e_2,456,459,486,19,11,7,8,4,1,2,3,27,30
p_148,3,0,e_2,447,473,486,25,10,8,11,4,1,0,26,13,39
p_143,2,0,e_2,451,478,486,25,9,8,10,4,1,1,27,8,35
p_110,1,0,e_2,501,506,511,16,10,2,0,3,0,0,5,5,10
p_107,1,0,e_2,512,517,546,14,10,9,0,3,0,0,5,29,34
p_106,4,0,e_2,512,528,546,10,10,7,0,5,0,1,16,18,34
p_105,4,0,e_2,515,528,546,10,10,7,1,5,0,2,13,18,31
p_102,2,0,e_2,521,536,546,11,10,7,2,5,1,1,15,10,25
p_99,1,0,e_2,522,541,546,11,11,6,2,5,1,2,19,5,24
p_116,7,0,e_1,490,513,560,12,10,4,0,3,0,0,23,47,70
p_114,9,0,e_1,494,521,560,9,10,3,1,5,0,1,27,39,66
p_104,7,0,e_1,516,529,560,7,10,5,7,5,1,2,13,31,44
p_98,6,0,e_1,524,534,560,6,10,3,8,4,1,2,10,26,36
p_95,6,0,e_1,527,534,560,6,10,3,8,4,1,3,7,26,33
p_94,6,0,e_1,528,534,560,5,10,2,7,1,1,2,6,26,32
p_108,5,0,e_1,509,539,560,10,10,0,6,5,0,2,30,21,51
p_85,3,0,e_1,542,547,560,6,11,4,4,4,1,1,5,13,18
p_90,2,0,e_1,536,552,560,8,11,5,6,4,1,1,16,8,24
p_81,2,0,e_1,547,552,560,5,11,3,3,1,1,1,5,8,13
p_156,1,0,e_3,428,441,576,1,9,0,2,4,1,8,13,135,148
p_175,2,0,e_3,399,446,576,6,7,3,8,4,1,6,47,130,177
p_174,3,0,e_3,402,451,576,4,9,2,7,4,1,8,49,125,174
p_171,3,0,e_3,408,451,576,3,9,1,6,1,1,8,43,125,168
p_192,5,0,e_3,380,459,576,7,4,3,12,4,1,3,79,117,196
p_179,6,0,e_3,397,464,576,2,6,1,8,1,1,5,67,112,179
p_176,6,0,e_3,398,464,576,2,7,1,8,1,1,6,66,112,178
p_191,7,0,e_3,382,469,576,5,5,3,12,4,1,4,87,107,194
p_189,7,0,e_3,387,469,576,4,6,2,11,4,1,5,82,107,189
p_187,7,0,e_3,391,469,576,2,7,1,9,4,1,6,78,107,185
p_135,7,0,e_3,461,469,576,18,10,7,5,5,1,9,8,107,115
p_132,7,0,e_3,463,469,576,17,10,7,6,5,1,9,6,107,113
p_204,8,0,e_3,364,474,576,7,2,1,13,2,1,1,110,102,212
p_197,8,0,e_3,375,474,576,5,4,2,13,4,1,3,99,102,201
p_188,8,0,e_3,390,474,576,2,7,1,10,4,1,6,84,102,186
p_118,4,0,e_0,488,502,584,15,10,4,0,3,0,0,14,82,96
p_115,10,0,e_0,494,522,584,8,10,3,1,5,0,1,28,62,90
p_113,11,0,e_0,496,527,584,7,10,3,2,5,0,2,31,57,88
p_103,13,0,e_0,517,535,584,30,10,10,8,5,1,2,18,49,67
p_92,13,0,e_0,533,535,584,27,12,12,13,5,1,1,2,49,51
p_86,6,0,e_0,541,558,584,3,11,1,12,4,1,0,17,26,43
p_80,6,0,e_0,548,558,584,1,11,0,9,4,1,2,10,26,36
p_78,4,0,e_0,555,566,584,2,11,1,7,4,1,2,11,18,29
p_82,3,0,e_0,547,571,584,4,11,3,9,4,1,1,24,13,37
p_71,2,0,e_0,569,576,584,30,12,12,3,4,1,1,7,8,15
p_84,3,0,e_2,546,557,654,4,11,3,0,3,1,4,11,97,108
p_96,5,0,e_2,527,565,654,6,10,3,4,3,1,2,38,89,127
p_77,6,0,e_2,557,570,654,29,11,11,3,2,0,4,13,84,97
p_91,13,0,e_2,535,593,654,27,11,11,2,4,1,3,58,61,119
p_88,14,0,e_2,538,598,654,25,11,11,2,4,1,3,60,56,116
p_79,14,0,e_2,549,598,654,23,11,11,1,5,0,5,49,56,105
p_75,14,0,e_2,563,598,654,20,11,11,5,5,1,5,35,56,91
p_68,14,0,e_2,574,598,654,16,12,12,7,5,1,3,24,56,80
p_87,15,0,e_2,539,603,654,24,11,11,2,4,1,4,64,51,115
p_72,15,0,e_2,569,603,654,17,12,12,6,2,1,3,34,51,85
p_44,15,0,e_2,598,603,654,10,11,0,14,2,1,3,5,51,56
p_46,13,0,e_2,596,611,654,12,11,2,13,5,1,3,15,43,58
p_48,2,0,e_2,593,646,654,24,12,10,13,2,1,2,53,8,61
p_73,6,0,e_1,568,580,656,27,12,12,2,5,0,2,12,76,88
p_76,7,0,e_1,559,585,656,28,11,11,0,3,1,0,26,71,97
p_67,8,0,e_1,574,590,656,22,12,12,4,5,0,5,16,66,82
p_63,8,0,e_1,581,590,656,21,11,7,6,5,1,7,9,66,75
p_69,10,0,e_1,573,598,656,21,12,12,4,5,0,4,25,58,83
p_58,10,0,e_1,586,598,656,17,11,5,7,5,1,7,12,58,70
p_74,11,0,e_1,567,603,656,22,12,12,2,5,0,1,36,53,89
p_52,11,0,e_1,591,603,656,15,12,4,8,5,1,6,12,53,65
p_66,12,0,e_1,577,608,656,18,11,3,5,5,0,6,31,48,79
p_65,12,0,e_1,578,608,656,18,11,3,5,5,0,7,30,48,78
p_47,6,0,e_1,594,628,656,20,12,8,9,5,1,6,34,28,62
p_62,5,0,e_1,582,633,656,24,11,9,6,5,1,7,51,23,74
p_61,5,0,e_1,583,633,656,23,11,9,7,5,1,8,50,23,73
p_45,5,0,e_1,597,633,656,20,11,9,10,2,1,6,36,23,59
p_42,4,0,e_1,600,638,656,21,11,9,10,5,1,6,38,18,56
p_64,1,0,e_1,579,661,688,29,11,11,6,2,0,6,82,27,109
p_70,3,0,e_1,572,669,688,28,12,12,4,5,0,3,97,19,116
p_43,3,0,e_1,599,669,688,22,11,9,10,5,1,6,70,19,89
p_40,4,0,e_1,601,674,688,20,11,8,10,5,1,7,73,14,87
p_38,4,0,e_1,627,674,688,15,7,4,6,4,1,5,47,14,61
p_32,5,0,e_2,657,675,692,8,7,3,0,3,0,0,18,17,35
p_31,5,0,e_2,662,675,692,7,7,2,1,5,0,1,13,17,30
p_56,2,0,e_0,588,592,694,24,11,10,1,5,0,2,4,102,106
p_59,6,0,e_0,584,606,694,22,11,8,0,3,1,1,22,88,110
p_57,6,0,e_0,587,606,694,21,11,8,1,5,0,2,19,88,107
p_54,6,0,e_0,590,606,694,20,12,8,1,5,0,3,16,88,104
p_60,9,0,e_0,584,617,694,19,11,6,0,3,1,0,33,77,110
p_53,9,0,e_0,590,617,694,5,10,10,1,5,0,3,27,77,104
p_50,10,0,e_0,592,622,694,6,12,12,2,2,0,2,30,72,102
p_41,10,0,e_0,600,622,694,15,11,5,4,5,1,3,22,72,94
p_39,15,0,e_0,609,639,694,8,9,0,6,5,1,2,30,55,85
p_36,11,0,e_0,635,653,694,6,7,2,14,5,1,2,18,41,59
p_33,8,0,e_0,647,664,694,7,7,5,13,4,1,3,17,30,47
p_37,7,0,e_0,633,669,694,10,7,2,13,5,1,1,36,25,61
p_35,4,0,e_0,640,680,694,12,7,1,15,4,1,2,40,14,54
p_125,4,0,e_3,474,590,708,18,10,7,8,2,1,9,116,118,234
p_55,4,0,e_3,590,590,708,0,10,10,4,3,0,10,0,118,118
p_129,5,0,e_3,470,597,708,18,8,7,7,5,1,7,127,111,238
p_122,5,0,e_3,477,597,708,16,11,6,9,5,1,10,120,111,231
p_119,5,0,e_3,483,597,708,15,11,5,10,5,1,10,114,111,225
p_83,5,0,e_3,546,597,708,2,11,1,7,1,1,10,51,111,162
p_49,5,0,e_3,592,597,708,1,12,12,4,3,1,11,5,111,116
p_126,6,0,e_3,473,602,708,16,9,6,8,5,1,8,129,106,235
p_93,7,0,e_3,529,607,708,4,10,2,11,4,1,9,78,101,179
p_89,7,0,e_3,537,607,708,2,11,0,9,4,1,10,70,101,171
p_198,9,0,e_3,368,615,708,6,4,1,13,5,1,3,247,93,340
p_195,9,0,e_3,376,615,708,4,4,1,13,4,1,3,239,93,332
p_131,9,0,e_3,467,615,708,14,9,5,7,5,1,8,148,93,241
p_130,9,0,e_3,469,615,708,14,8,5,7,5,1,7,146,93,239
p_121,9,0,e_3,480,615,708,12,10,6,9,5,1,9,135,93,228
p_24,5,0,e_0,707,724,741,5,9,9,0,3,0,0,17,17,34
p_23,5,0,e_0,709,724,741,25,9,7,0,5,0,1,15,17,32
p_27,2,0,e_2,693,702,764,2,10,0,0,3,0,0,9,62,71
p_26,3,0,e_2,698,707,764,29,10,10,1,5,0,1,9,57,66
p_25,7,0,e_2,703,721,764,24,9,9,2,5,1,1,18,43,61
p_22,10,0,e_2,712,732,764,19,8,5,4,5,1,1,20,32,52
p_29,15,0,e_1,678,735,788,23,9,9,3,4,1,0,57,53,110
p_19,12,0,e_1,740,746,788,10,7,3,14,4,1,2,6,42,48
p_21,10,0,e_1,732,754,788,14,7,5,14,5,0,1,22,34,56
p_20,9,0,e_1,737,759,788,14,7,6,15,4,1,1,22,29,51
p_51,1,0,e_3,591,713,822,3,11,11,4,3,1,10,122,109,231
p_30,5,0,e_3,676,727,822,4,8,0,9,4,1,7,51,95,146
p_28,6,0,e_3,679,732,822,1,9,0,7,4,1,8,53,90,143
p_146,10,0,e_3,451,746,822,17,9,3,3,2,1,8,295,76,371
p_128,10,0,e_3,471,746,822,13,9,4,7,5,1,8,275,76,351
p_120,10,0,e_3,481,746,822,11,11,5,9,5,1,10,265,76,341
p_100,10,0,e_3,522,746,822,2,10,1,12,4,1,9,224,76,300
p_97,10,0,e_3,526,746,822,2,10,1,12,4,1,9,220,76,296
p_194,11,0,e_3,377,751,822,2,4,1,13,4,1,3,374,71,445
p_200,12,0,e_3,367,756,822,3,4,1,13,2,1,3,389,66,455
p_145,12,0,e_3,451,756,822,15,10,1,3,5,1,9,305,66,371
p_134,12,0,e_3,462,756,822,12,10,2,6,5,1,9,294,66,360
p_123,12,0,e_3,474,756,822,10,10,3,8,2,1,9,282,66,348
p_117,12,0,e_3,490,756,822,7,10,3,11,5,1,9,266,66,332
p_101,12,0,e_3,521,756,822,1,10,0,13,4,1,9,235,66,301
p_8,1,0,e_2,847,851,864,21,3,3,0,5,0,1,4,13,17
p_9,2,0,e_2,845,856,864,21,3,3,0,3,0,0,11,8,19
p_13,11,0,e_1,794,830,865,28,4,4,0,3,0,0,36,35,71
p_11,11,0,e_1,810,830,865,23,4,4,4,5,0,1,20,35,55
p_18,2,0,e_0,768,776,868,14,3,1,0,3,0,0,8,92,100
p_12,13,0,e_0,796,811,868,26,4,4,8,5,1,1,15,57,72
p_10,14,0,e_0,810,816,868,20,4,4,13,2,1,1,6,52,58
p_17,15,0,e_0,772,821,868,30,3,3,1,5,0,1,49,47,96
p_15,15,0,e_0,782,821,868,28,3,3,3,5,1,1,39,47,86
p_14,15,0,e_0,790,821,868,25,4,4,6,5,1,1,31,47,78
p_4,1,0,e_1,864,870,875,16,4,2,0,3,1,0,6,5,11
p_3,1,0,e_0,876,882,887,14,2,1,0,3,0,0,6,5,11
p_2,3,0,e_1,878,890,903,11,2,1,0,3,0,0,12,13,25
p_1,2,0,e_1,889,895,903,9,3,1,3,5,0,1,6,8,14
p_7,12,0,e_3,851,860,924,9,3,3,9,5,0,3,9,64,73
p_140,13,0,e_3,455,865,924,13,10,1,4,5,1,9,410,59,469
p_139,13,0,e_3,456,865,924,13,11,1,4,5,1,10,409,59,468
p_137,13,0,e_3,458,865,924,12,10,1,5,2,1,9,407,59,466
p_16,13,0,e_3,774,865,924,1,3,0,14,4,1,2,91,59,150
p_124,14,0,e_3,474,870,924,8,9,1,8,2,1,8,396,54,450
p_109,14,0,e_3,506,870,924,2,10,1,14,5,1,9,364,54,418
p_6,14,0,e_3,858,870,924,4,4,1,12,5,0,4,12,54,66
p_151,15,0,e_3,443,875,924,14,10,0,1,5,1,9,432,49,481
p_149,15,0,e_3,444,875,924,13,11,0,2,5,1,10,431,49,480
p_142,15,0,e_3,452,875,924,12,10,0,3,5,1,9,423,49,472
p_141,15,0,e_3,455,875,924,11,11,0,4,5,1,10,420,49,469
p_127,15,0,e_3,473,875,924,7,9,0,8,2,1,8,402,49,451
p_112,15,0,e_3,497,875,924,2,10,0,13,5,1,9,378,49,427
p_111,15,0,e_3,501,875,924,2,10,0,13,5,1,9,374,49,423
p_5,5,0,e_3,860,941,1020,13,3,3,12,2,0,3,81,79,160
p_34,15,0,e_3,643,973,1020,1,7,0,14,5,1,6,330,47,377
p_299,3,0,e_1,7,19,30,3,0,0,0,3,0,0,12,11,23
p_296,1,0,e_3,20,25,30,1,0,0,0,3,0,0,5,5,10
p_298,4,0,e_2,10,24,46,4,0,0,0,3,0,0,14,22,36
p_295,5,0,e_2,22,29,46,5,1,0,3,5,0,1,7,17,24
p_288,1,0,e_2,49,55,76,9,3,2,0,3,0,0,6,21,27
p_285,2,0,e_2,54,60,76,7,3,2,1,5,0,2,6,16,22
p_286,3,0,e_2,51,65,76,7,3,2,0,5,0,1,14,11,25
p_290,4,0,e_3,43,49,87,6,1,1,2,5,0,1,6,38,44
p_291,6,0,e_3,35,57,87,6,0,0,0,3,0,0,22,30,52
p_289,7,0,e_3,47,62,87,4,2,0,3,5,0,2,15,25,40
p_282,6,0,e_3,62,67,87,1,1,0,7,4,1,0,5,20,25
p_300,8,0,e_0,4,30,112,8,0,0,0,3,0,0,26,82,108
p_297,12,0,e_0,18,44,112,12,0,0,4,5,0,1,26,68,94
p_294,13,0,e_0,23,49,112,13,1,0,6,5,0,2,26,63,89
p_293,15,0,e_0,26,57,112,16,1,1,7,5,0,3,31,55,86
p_284,14,0,e_0,55,62,112,9,3,0,14,5,1,1,7,50,57
p_280,12,0,e_0,65,70,112,25,2,2,13,4,1,1,5,42,47
p_283,10,0,e_0,55,78,112,5,3,0,15,5,1,2,23,34,57
p_276,5,0,e_0,82,95,112,27,1,1,9,4,1,0,13,17,30
p_292,11,0,e_1,30,65,114,11,0,0,0,3,1,0,35,49,84
p_287,12,0,e_1,51,70,114,8,3,0,7,5,0,1,19,44,63
p_281,10,0,e_1,63,78,114,27,2,2,11,5,0,2,15,36,51
p_274,4,0,e_1,84,98,114,27,1,1,8,4,1,1,14,16,30
p_275,2,0,e_1,84,106,114,29,1,1,8,4,1,0,22,8,30
p_279,2,0,e_2,76,84,176,2,1,0,0,3,1,0,8,92,100
p_277,10,0,e_2,81,110,176,22,1,1,1,5,0,2,29,66,95
p_278,15,0,e_2,80,127,176,17,1,1,1,5,0,1,47,49,96
p_272,15,0,e_2,105,127,176,12,1,0,8,5,1,2,22,49,71
p_270,7,0,e_2,133,153,176,8,2,1,13,4,1,0,20,23,43
p_269,4,0,e_0,146,161,177,7,1,0,0,3,0,0,15,16,31
p_267,1,0,e_0,153,172,177,7,1,0,2,5,0,1,19,5,24
p_271,11,0,e_3,127,130,181,5,1,1,10,5,0,1,3,51,54
p_273,13,0,e_3,95,138,181,13,0,0,0,3,0,0,43,43,86
p_264,5,0,e_3,162,164,181,1,1,0,6,4,1,0,2,17,19
p_254,3,0,e_3,199,210,223,3,0,0,0,3,0,0,11,13,24
p_252,2,0,e_3,212,215,223,1,1,0,3,4,1,0,3,8,11
p_262,6,0,e_1,164,171,241,29,1,1,4,5,0,2,7,70,77
p_268,10,0,e_1,150,185,241,29,1,1,0,3,0,0,35,56,91
p_265,12,0,e_1,157,193,241,25,1,1,2,5,0,1,36,48,84
p_263,12,0,e_1,163,193,241,23,1,1,4,5,0,2,30,48,78
p_261,12,0,e_1,170,193,241,22,1,1,6,2,0,2,23,48,71
p_257,12,0,e_1,179,193,241,19,1,1,8,5,1,4,14,48,62
p_260,13,0,e_1,171,198,241,20,1,1,6,5,1,2,27,43,70
p_259,6,0,e_1,174,221,241,26,1,1,6,5,1,3,47,20,67
p_258,5,0,e_2,175,193,246,27,1,1,0,3,1,0,18,53,71
p_256,8,0,e_2,191,204,246,8,0,0,5,5,0,1,13,42,55
p_255,10,0,e_2,192,212,246,10,0,0,5,5,0,2,20,34,54
p_251,4,0,e_2,228,232,246,4,0,0,5,4,1,0,4,14,18
p_266,15,0,e_0,155,224,273,23,1,1,2,5,0,2,69,49,118
p_253,15,0,e_0,208,224,273,12,1,0,10,5,0,1,16,49,65
p_250,7,0,e_0,236,250,273,7,0,0,12,4,1,0,14,23,37
p_249,7,0,e_0,238,250,273,7,0,0,11,4,1,1,12,23,35
p_248,7,0,e_0,246,250,273,7,0,0,8,4,1,1,4,23,27
p_244,2,0,e_2,271,279,287,2,0,0,0,3,0,0,8,8,16
p_245,9,0,e_1,269,277,330,9,0,0,7,5,0,1,8,53,61
p_247,12,0,e_1,248,288,330,12,0,0,0,3,0,0,40,42,82
p_246,12,0,e_1,257,288,330,12,0,0,2,5,0,1,31,42,73
p_243,8,0,e_1,285,302,330,8,0,0,11,5,1,1,17,28,45
p_233,2,0,e_1,319,322,330,13,1,1,3,4,1,0,3,8,11
p_222,3,0,e_1,339,351,374,15,2,2,0,3,0,0,12,23,35
p_221,4,0,e_1,341,356,374,14,3,2,0,5,0,1,15,18,33
p_214,4,0,e_1,346,356,374,12,3,1,2,5,0,4,10,18,28
p_210,4,0,e_1,353,356,374,13,3,2,3,5,1,3,3,18,21
p_209,2,0,e_1,354,364,374,15,3,2,3,5,1,3,10,10,20
p_216,1,0,e_1,346,369,374,16,3,2,1,5,0,2,23,5,28
p_205,1,0,e_1,362,369,374,14,2,1,3,4,1,3,7,5,12
p_242,4,0,e_0,287,302,394,4,0,0,0,3,0,0,15,92,107
p_241,13,0,e_0,300,331,394,13,0,0,3,5,0,1,31,63,94
p_239,13,0,e_0,305,331,394,13,0,0,5,5,1,2,26,63,89
p_240,14,0,e_0,301,336,394,14,0,0,4,3,0,1,35,58,93
p_234,14,0,e_0,314,336,394,14,1,0,8,5,1,2,22,58,80
p_224,13,0,e_0,335,341,394,6,2,0,14,2,1,2,6,53,59
p_226,12,0,e_0,331,346,394,7,2,0,13,2,1,2,15,48,63
p_228,11,0,e_0,325,351,394,8,2,0,11,5,1,2,26,43,69
p_218,9,0,e_0,343,359,394,8,3,2,13,4,1,2,16,35,51
p_212,9,0,e_0,348,359,394,9,3,2,12,4,1,3,11,35,46
p_217,8,0,e_0,345,364,394,9,3,2,12,1,1,2,19,30,49
p_206,6,0,e_0,362,372,394,9,2,1,9,4,1,1,10,22,32
p_199,2,0,e_0,368,386,394,11,1,0,7,4,1,1,18,8,26
p_238,2,0,e_2,311,319,417,2,0,0,0,3,0,0,8,98,106
p_237,5,0,e_2,313,330,417,5,1,1,0,5,0,1,17,87,104
p_232,5,0,e_2,320,330,417,9,1,1,2,5,1,1,10,87,97
p_230,5,0,e_2,323,330,417,13,2,2,3,5,1,1,7,87,94
p_229,9,0,e_2,323,344,417,8,2,1,3,5,1,1,21,73,94
p_227,9,0,e_2,326,344,417,7,2,1,4,5,1,2,18,73,91
p_220,9,0,e_2,342,344,417,9,3,2,8,5,1,2,2,73,75
p_225,10,0,e_2,333,349,417,4,2,0,6,5,1,1,16,68,84
p_219,11,0,e_2,342,354,417,7,3,1,9,5,1,2,12,63,75
p_213,12,0,e_2,347,359,417,4,3,1,9,5,1,2,12,58,70
p_207,12,0,e_2,355,359,417,4,3,2,11,5,1,2,4,58,62
p_208,13,0,e_2,355,364,417,3,3,1,11,5,1,1,9,53,62
p_203,12,0,e_2,365,369,417,2,2,1,13,4,1,1,4,48,52
p_200,12,0,e_2,367,369,417,2,2,1,13,4,1,2,2,48,50
p_195,9,0,e_2,376,380,417,2,2,0,10,4,1,2,4,37,41
p_236,8,0,e_3,313,340,420,8,0,0,0,3,0,0,27,80,107
p_235,8,0,e_3,314,340,420,8,1,0,0,5,0,1,26,80,106
p_231,10,0,e_3,320,348,420,8,1,0,2,5,0,1,28,72,100
p_223,13,0,e_3,339,359,420,5,2,0,8,5,0,2,20,61,81
p_211,14,0,e_3,348,364,420,4,2,0,10,5,1,1,16,56,72
p_202,13,0,e_3,365,369,420,1,1,0,14,4,1,0,4,51,55
p_201,13,0,e_3,366,369,420,1,2,0,14,4,1,1,3,51,54
p_198,9,0,e_3,368,383,420,4,1,0,13,1,1,0,15,37,52
p_191,7,0,e_3,382,391,420,2,1,0,9,1,1,0,9,29,38
p_174,3,0,e_3,402,405,420,1,3,0,4,4,1,2,3,15,18
p_185,2,0,e_3,392,410,420,5,2,0,7,4,1,1,18,10,28
p_186,1,0,e_3,391,415,420,6,1,0,7,1,1,0,24,5,29
p_175,2,0,e_2,399,425,485,3,3,0,5,4,1,2,26,60,86
p_163,4,0,e_2,417,433,485,27,1,1,0,3,1,4,16,52,68
p_196,5,0,e_2,376,438,485,6,2,1,10,4,1,1,62,47,109
p_192,5,0,e_2,380,438,485,5,2,1,9,4,1,2,58,47,105
p_184,5,0,e_2,393,438,485,2,3,0,7,4,1,2,45,47,92
p_182,5,0,e_2,394,438,485,2,3,0,6,4,1,3,44,47,91
p_189,7,0,e_2,387,446,485,1,2,0,8,4,1,1,59,39,98
p_154,7,0,e_2,438,446,485,8,1,1,5,5,1,4,8,39,47
p_204,8,0,e_2,364,451,485,6,1,0,13,4,1,0,87,34,121
p_197,8,0,e_2,375,451,485,3,2,1,11,4,1,1,76,34,110
p_153,8,0,e_2,438,451,485,7,1,1,5,5,1,4,13,34,47
p_144,4,0,e_2,451,465,485,11,3,2,8,4,1,3,14,20,34
p_155,3,0,e_2,434,470,485,14,1,1,4,5,1,4,36,15,51
p_150,3,0,e_2,444,470,485,10,1,1,7,5,1,4,26,15,41
p_148,3,0,e_2,447,470,485,9,1,1,7,5,1,3,23,15,38
p_215,6,0,e_1,346,394,494,11,3,2,1,5,0,3,48,100,148
p_187,7,0,e_1,391,399,494,30,1,1,5,5,0,5,8,95,103
p_188,8,0,e_1,390,404,494,29,1,1,5,5,0,4,14,90,104
p_194,11,0,e_1,377,415,494,30,2,2,1,5,0,1,38,79,117
p_193,12,0,e_1,378,420,494,29,2,2,1,5,0,2,42,74,116
p_183,12,0,e_1,393,420,494,25,3,3,6,2,0,5,27,74,101
p_161,13,0,e_1,418,425,494,18,1,1,11,5,1,4,7,69,76
p_190,14,0,e_1,382,430,494,25,2,2,2,5,0,3,48,64,112
p_180,14,0,e_1,396,430,494,22,3,3,6,5,1,5,34,64,98
p_172,14,0,e_1,405,430,494,19,3,3,8,5,1,3,25,64,89
p_165,14,0,e_1,416,430,494,17,1,1,11,5,1,4,14,64,78
p_162,14,0,e_1,417,430,494,17,1,1,11,5,1,4,13,64,77
p_158,14,0,e_1,426,430,494,13,1,0,13,5,1,4,4,64,68
p_168,15,0,e_1,412,435,494,17,2,2,10,5,1,4,23,59,82
p_159,11,0,e_1,424,449,494,11,1,0,13,5,1,4,25,45,70
p_160,10,0,e_3,421,454,512,10,0,0,0,3,0,0,33,58,91
p_152,10,0,e_3,439,454,512,5,1,0,5,5,0,1,15,58,73
p_145,12,0,e_3,451,462,512,3,2,0,9,5,0,2,11,50,61
p_131,9,0,e_3,467,473,512,2,2,0,11,4,1,1,6,39,45
p_130,9,0,e_3,469,473,512,1,3,0,10,4,1,2,4,39,43
p_147,7,0,e_3,450,481,512,4,1,1,9,5,0,1,31,31,62
p_132,7,0,e_3,463,481,512,5,2,0,12,4,1,1,18,31,49
p_126,6,0,e_3,473,486,512,3,2,1,9,1,1,1,13,26,39
p_122,5,0,e_3,477,491,512,3,3,2,8,4,1,2,14,21,35
p_119,5,0,e_3,483,491,512,2,3,1,7,4,1,2,8,21,29
p_118,4,0,e_3,488,496,512,2,2,1,6,4,1,1,8,16,24
p_110,1,0,e_3,501,507,512,2,1,0,3,4,1,0,6,5,11
p_178,5,0,e_0,398,412,515,30,3,3,1,5,0,3,14,103,117
p_179,6,0,e_0,397,417,515,29,3,3,0,5,0,1,20,98,118
p_176,6,0,e_0,398,417,515,29,3,3,1,5,0,4,19,98,117
p_167,7,0,e_0,412,422,515,25,2,2,5,2,0,4,10,93,103
p_177,9,0,e_0,398,430,515,26,3,3,1,5,0,2,32,85,117
p_173,10,0,e_0,405,435,515,23,3,3,3,5,0,4,30,80,110
p_170,10,0,e_0,408,435,515,22,3,3,4,5,0,5,27,80,107
p_181,11,0,e_0,395,440,515,25,3,3,0,3,0,0,45,75,120
p_169,11,0,e_0,410,440,515,21,2,2,5,5,0,5,30,75,105
p_164,12,0,e_0,416,445,515,19,1,1,6,5,1,6,29,70,99
p_157,12,0,e_0,427,445,515,11,1,0,8,5,1,5,18,70,88
p_151,15,0,e_0,443,456,515,9,1,0,11,5,1,2,13,59,72
p_149,15,0,e_0,444,456,515,8,1,0,12,2,1,2,12,59,71
p_142,15,0,e_0,452,456,515,6,3,0,14,5,1,2,4,59,63
p_141,15,0,e_0,455,456,515,5,3,0,15,2,1,2,1,59,60
p_107,1,0,e_3,512,518,599,1,0,0,0,3,0,0,6,81,87
p_102,2,0,e_3,521,523,599,10,3,2,2,5,1,2,2,76,78
p_106,4,0,e_3,512,531,599,4,1,1,0,3,0,1,19,68,87
p_105,4,0,e_3,515,531,599,4,2,0,0,5,0,2,16,68,84
p_96,5,0,e_3,527,536,599,12,6,3,3,5,1,5,9,63,72
p_98,6,0,e_3,524,541,599,12,5,2,2,5,1,4,17,58,75
p_95,6,0,e_3,527,541,599,11,6,2,3,5,1,5,14,58,72
p_94,6,0,e_3,528,541,599,11,7,2,3,5,1,6,13,58,71
p_104,7,0,e_3,516,546,599,6,2,0,1,5,0,2,30,53,83
p_93,7,0,e_3,529,546,599,10,7,1,3,5,1,6,17,53,70
p_89,7,0,e_3,537,546,599,8,6,1,5,5,1,5,9,53,62
p_100,10,0,e_3,522,557,599,8,4,0,2,2,1,3,35,42,77
p_97,10,0,e_3,526,557,599,8,6,0,2,5,1,5,31,42,73
p_73,6,0,e_3,568,571,599,1,5,0,7,4,1,4,3,28,31
p_78,4,0,e_3,555,579,599,6,5,0,10,5,1,4,24,20,44
p_171,3,0,e_1,408,505,600,29,3,3,9,5,1,3,97,95,192
p_133,4,0,e_1,463,510,600,8,2,1,7,4,1,3,47,90,137
p_125,4,0,e_1,474,510,600,5,3,2,5,4,1,4,36,90,126
p_129,5,0,e_1,470,515,600,5,3,2,6,4,1,4,45,85,130
p_108,5,0,e_1,509,515,600,26,1,1,4,5,1,6,6,85,91
p_138,7,0,e_1,456,523,600,7,3,1,10,4,1,1,67,77,144
p_135,7,0,e_1,461,523,600,5,2,0,8,4,1,3,62,77,139
p_114,9,0,e_1,494,531,600,25,2,2,0,5,0,5,37,69,106
p_146,10,0,e_1,451,536,600,1,2,0,11,4,1,1,85,64,149
p_115,10,0,e_1,494,536,600,25,2,2,0,3,1,5,42,64,106
p_113,11,0,e_1,496,541,600,23,1,1,0,5,0,6,45,59,104
p_101,12,0,e_1,521,546,600,10,4,0,7,5,1,5,25,54,79
p_103,13,0,e_1,517,551,600,12,3,0,5,5,1,4,34,49,83
p_92,13,0,e_1,533,551,600,9,6,0,9,5,1,4,18,49,67
p_91,13,0,e_1,535,551,600,8,6,0,10,2,1,3,16,49,65
p_156,1,0,e_2,428,490,603,17,1,1,3,5,1,4,62,113,175
p_143,2,0,e_2,451,495,603,9,2,1,8,2,1,2,44,108,152
p_136,2,0,e_2,460,495,603,10,3,0,5,4,1,4,35,108,143
p_116,7,0,e_2,490,512,603,28,2,2,1,5,1,5,22,91,113
p_120,10,0,e_2,481,523,603,27,3,3,1,4,1,4,42,80,122
p_123,12,0,e_2,474,531,603,27,3,3,2,1,1,2,57,72,129
p_117,12,0,e_2,490,531,603,23,3,3,1,2,0,5,41,72,113
p_124,14,0,e_2,474,539,603,25,3,3,2,1,1,3,65,64,129
p_109,14,0,e_2,506,539,603,17,2,2,5,5,1,5,33,64,97
p_88,14,0,e_2,538,539,603,9,6,0,14,2,1,1,1,64,65
p_127,15,0,e_2,473,546,603,24,2,2,3,4,1,2,73,57,130
p_112,15,0,e_2,497,546,603,19,1,1,2,5,1,5,49,57,106
p_111,15,0,e_2,501,546,603,18,1,1,3,5,1,5,45,57,102
p_87,15,0,e_2,539,546,603,9,6,0,14,5,1,2,7,57,64
p_79,14,0,e_2,549,551,603,7,5,0,15,4,1,2,2,52,54
p_166,5,0,e_0,415,532,631,26,1,1,6,5,1,5,117,99,216
p_121,9,0,e_0,480,546,631,28,3,3,10,4,1,3,66,85,151
p_128,10,0,e_0,471,551,631,30,3,3,12,1,1,2,80,80,160
p_134,12,0,e_0,462,559,631,30,2,2,14,4,1,2,97,72,169
p_140,13,0,e_0,455,564,631,3,3,0,15,5,1,2,109,67,176
p_139,13,0,e_0,456,564,631,3,3,0,15,2,1,3,108,67,175
p_137,13,0,e_0,458,564,631,2,3,0,15,1,1,2,106,67,173
p_75,14,0,e_0,563,569,631,25,5,5,13,5,1,1,6,62,68
p_74,11,0,e_0,567,580,631,26,5,5,14,5,1,1,13,51,64
p_69,10,0,e_0,573,585,631,26,6,6,13,4,1,1,12,46,58
p_60,9,0,e_0,584,590,631,24,5,5,10,1,1,3,6,41,47
p_67,8,0,e_0,574,595,631,28,6,6,13,4,1,2,21,36,57
p_63,8,0,e_0,581,595,631,26,6,6,11,4,1,2,14,36,50
p_59,6,0,e_0,584,603,631,27,5,5,10,1,1,2,19,28,47
p_57,6,0,e_0,587,603,631,26,6,6,10,4,1,4,16,28,44
p_48,2,0,e_0,593,639,689,29,8,8,8,4,1,4,46,50,96
p_43,3,0,e_0,599,644,689,27,7,4,7,4,1,4,45,45,90
p_55,4,0,e_0,590,649,689,28,6,6,9,1,1,3,59,40,99
p_42,4,0,e_0,600,649,689,26,7,4,7,4,1,5,49,40,89
p_40,4,0,e_0,601,649,689,26,7,4,7,4,1,5,48,40,88
p_35,4,0,e_0,640,649,689,15,4,2,2,5,1,5,9,40,49
p_62,5,0,e_0,582,654,689,29,6,6,11,4,1,2,72,35,107
p_61,5,0,e_0,583,654,689,28,6,6,10,4,1,3,71,35,106
p_49,5,0,e_0,592,654,689,26,8,8,9,4,1,4,62,35,97
p_45,5,0,e_0,597,654,689,26,7,7,8,4,1,4,57,35,92
p_54,6,0,e_0,590,659,689,26,6,6,9,1,1,4,69,30,99
p_47,6,0,e_0,594,659,689,25,7,7,8,4,1,5,65,30,95
p_37,7,0,e_0,633,664,689,14,5,4,0,5,0,5,31,25,56
p_32,5,0,e_0,657,672,689,10,2,0,5,5,1,2,15,17,32
p_31,5,0,e_0,662,672,689,9,1,0,7,5,1,2,10,17,27
p_51,1,0,e_2,591,608,695,1,7,0,2,4,1,4,17,87,104
p_71,2,0,e_2,569,613,695,4,7,2,8,4,1,2,44,82,126
p_56,2,0,e_2,588,613,695,30,6,6,3,4,1,3,25,82,107
p_85,3,0,e_2,542,618,695,11,5,2,14,5,1,1,76,77,153
p_82,3,0,e_2,547,618,695,10,5,1,15,4,1,1,71,77,148
p_80,6,0,e_2,548,629,695,7,5,1,15,4,1,1,81,66,147
p_53,9,0,e_2,590,640,695,23,6,6,3,4,1,3,50,55,105
p_36,11,0,e_2,635,648,695,10,5,2,8,5,1,3,13,47,60
p_66,12,0,e_2,577,653,695,22,7,7,6,4,1,2,76,42,118
p_33,8,0,e_2,647,667,695,10,3,2,11,5,1,3,20,28,48
p_38,4,0,e_2,627,681,695,19,5,4,5,5,1,3,54,14,68
p_70,3,0,e_1,572,611,696,3,6,1,7,4,1,2,39,85,124
p_83,5,0,e_1,546,619,696,8,5,1,12,5,1,2,73,77,150
p_86,6,0,e_1,541,624,696,8,5,2,11,5,1,2,83,72,155
p_77,6,0,e_1,557,624,696,8,5,0,12,4,1,2,67,72,139
p_76,7,0,e_1,559,629,696,3,5,0,11,4,1,2,70,67,137
p_41,10,0,e_1,600,640,696,20,7,3,0,5,0,6,40,56,96
p_65,12,0,e_1,578,648,696,22,7,7,6,4,1,3,70,48,118
p_46,13,0,e_1,596,653,696,18,7,7,1,4,1,5,57,43,100
p_30,5,0,e_1,676,679,696,5,1,0,6,4,1,0,3,17,20
p_99,1,0,e_3,522,604,709,11,4,2,2,5,1,3,82,105,187
p_64,1,0,e_3,579,604,709,3,6,2,4,4,1,5,25,105,130
p_90,2,0,e_3,536,609,709,13,5,3,5,5,1,4,73,100,173
p_81,2,0,e_3,547,609,709,11,5,1,7,5,1,4,62,100,162
p_84,3,0,e_3,546,614,709,10,4,1,7,2,1,3,68,95,163
p_58,10,0,e_3,586,637,709,23,5,5,3,4,1,4,51,72,123
p_50,10,0,e_3,592,637,709,21,7,7,1,4,1,6,45,72,117
p_52,11,0,e_3,591,642,709,21,6,6,2,4,1,5,51,67,118
p_68,14,0,e_3,574,653,709,21,6,6,5,4,1,5,79,56,135
p_72,15,0,e_3,569,658,709,21,6,6,6,4,1,5,89,51,140
p_44,15,0,e_3,598,658,709,15,7,7,0,3,1,7,60,51,111
p_39,15,0,e_3,609,658,709,13,6,0,2,2,1,5,49,51,100
p_34,15,0,e_3,643,658,709,4,3,0,11,5,1,2,15,51,66
p_28,6,0,e_3,679,687,709,2,1,0,8,4,1,0,8,22,30
p_27,2,0,e_3,693,701,709,2,1,0,4,4,1,0,8,8,16
p_24,5,0,e_2,707,725,742,25,1,1,0,3,0,0,18,17,35
p_23,5,0,e_3,709,727,744,5,0,0,0,3,0,0,18,17,35
p_26,3,0,e_1,698,709,766,30,2,2,0,3,0,0,11,57,68
p_25,7,0,e_1,703,723,766,25,1,1,1,5,0,1,20,43,63
p_22,10,0,e_1,712,734,766,10,1,0,4,5,1,1,22,32,54
p_21,10,0,e_1,732,734,766,24,1,1,9,5,1,1,2,32,34
p_29,15,0,e_0,678,736,787,24,1,1,3,4,1,0,58,51,109
p_19,12,0,e_0,740,747,787,19,1,1,14,4,1,1,7,40,47
p_20,9,0,e_0,737,758,787,23,1,1,15,4,1,0,21,29,50
p_13,11,0,e_0,794,830,865,11,0,0,0,3,0,0,36,35,71
p_11,11,0,e_0,810,830,865,11,0,0,4,5,0,1,20,35,55
p_18,2,0,e_1,768,777,867,2,0,0,0,3,0,0,9,90,99
p_16,13,0,e_1,774,812,867,13,0,0,1,5,0,1,38,55,93
p_14,15,0,e_1,790,820,867,15,0,0,6,5,1,1,30,47,77
p_12,13,0,e_2,796,813,872,13,0,0,7,5,0,1,17,59,76
p_10,14,0,e_2,810,818,872,14,0,0,12,5,0,2,8,54,62
p_17,15,0,e_2,772,823,872,15,0,0,0,3,0,0,51,49,100
p_15,15,0,e_2,782,823,872,15,0,0,3,5,0,1,41,49,90
p_4,1,0,e_2,864,867,872,23,4,3,2,4,1,0,3,5,8
p_3,1,0,e_0,876,881,886,19,3,2,0,3,0,0,5,5,10
p_2,3,0,e_1,878,890,903,17,3,2,0,3,0,0,12,13,25
p_1,2,0,e_1,889,895,903,14,3,1,3,5,0,1,6,8,14
p_8,1,0,e_3,847,851,942,3,1,1,0,5,0,1,4,91,95
p_9,2,0,e_3,845,856,942,2,0,0,0,3,0,0,11,86,97
p_5,5,0,e_3,860,867,942,20,3,2,3,5,1,2,7,75,82
p_7,12,0,e_3,851,890,942,11,1,0,1,2,0,1,39,52,91
p_6,14,0,e_3,858,898,942,12,2,0,2,5,1,1,40,44,84
p_296,1,0,e_3,20,25,30,1,0,0,0,3,0,0,5,5,10
p_299,3,0,e_1,7,19,30,3,0,0,0,3,0,0,12,11,23
p_298,4,0,e_2,10,24,46,4,0,0,0,3,0,0,14,22,36
p_295,5,0,e_2,22,29,46,5,1,0,3,5,0,1,7,17,24
p_288,1,0,e_2,49,54,97,9,3,2,0,3,0,0,5,43,48
p_285,2,0,e_2,54,59,97,7,3,2,1,2,0,1,5,38,43
p_286,3,0,e_2,51,64,97,7,3,2,0,5,0,1,13,33,46
p_282,6,0,e_2,62,75,97,7,3,1,2,5,1,1,13,22,35
p_279,2,0,e_2,76,89,97,8,1,0,6,4,1,0,13,8,21
p_275,2,0,e_2,84,89,97,5,2,0,3,4,1,2,5,8,13
p_290,4,0,e_3,43,50,106,6,1,1,2,5,0,1,7,56,63
p_291,6,0,e_3,35,58,106,6,0,0,0,3,0,0,23,48,71
p_289,7,0,e_3,47,63,106,4,2,0,3,5,0,2,16,43,59
p_283,10,0,e_3,55,74,106,5,3,0,5,5,1,2,19,32,51
p_292,11,0,e_1,30,65,110,11,0,0,0,3,1,0,35,45,80
p_287,12,0,e_1,51,70,110,8,3,0,7,5,0,1,19,40,59
p_280,12,0,e_1,65,70,110,5,2,0,11,2,0,1,5,40,45
p_274,4,0,e_1,84,96,110,3,2,0,8,4,1,0,12,14,26
p_300,8,0,e_0,4,31,111,8,0,0,0,3,0,0,27,80,107
p_297,12,0,e_0,18,45,111,12,0,0,4,5,0,1,27,66,93
p_294,13,0,e_0,23,50,111,13,1,0,6,5,0,2,27,61,88
p_293,15,0,e_0,26,58,111,16,1,1,7,5,0,3,32,53,85
p_284,14,0,e_0,55,63,111,9,3,0,14,5,1,1,8,48,56
p_281,10,0,e_0,63,77,111,3,2,0,14,4,1,0,14,34,48
p_276,5,0,e_0,82,94,111,3,2,0,9,4,1,0,12,17,29
p_269,4,0,e_1,146,161,177,6,1,0,0,3,0,0,15,16,31
p_267,1,0,e_1,153,172,177,7,1,0,1,5,0,1,19,5,24
p_277,10,0,e_3,81,138,178,28,1,1,8,4,1,0,57,40,97
p_271,11,0,e_3,127,143,178,5,1,0,6,5,0,1,16,35,51
p_273,13,0,e_2,95,138,199,21,2,2,1,4,1,1,43,61,104
p_278,15,0,e_2,80,146,199,24,1,1,5,4,1,1,66,53,119
p_272,15,0,e_2,105,146,199,15,1,1,2,5,0,2,41,53,94
p_268,10,0,e_2,150,163,199,29,1,1,14,4,1,0,13,36,49
p_262,6,0,e_2,164,177,199,29,1,1,10,4,1,1,13,22,35
p_259,6,0,e_2,174,177,199,25,1,1,7,4,1,2,3,22,25
p_264,5,0,e_2,162,182,199,30,1,1,10,1,1,0,20,17,37
p_258,5,0,e_2,175,182,199,26,1,1,6,4,1,2,7,17,24
p_254,3,0,e_2,199,211,224,11,1,1,0,3,0,0,12,13,25
p_252,2,0,e_2,212,216,224,8,1,1,3,4,1,0,4,8,12
p_270,7,0,e_0,133,157,238,6,2,2,0,3,0,0,24,81,105
p_263,12,0,e_0,163,174,238,23,1,1,8,5,1,1,11,64,75
p_261,12,0,e_0,170,174,238,20,1,1,11,5,1,2,4,64,68
p_260,13,0,e_0,171,179,238,19,1,1,11,5,1,2,8,59,67
p_266,15,0,e_0,155,187,238,23,1,1,6,5,0,1,32,51,83
p_257,12,0,e_0,179,198,238,12,0,0,13,2,1,1,19,40,59
p_255,10,0,e_0,192,206,238,10,1,0,14,4,1,1,14,32,46
p_256,8,0,e_3,191,217,245,8,0,0,0,3,0,0,26,28,54
p_251,4,0,e_3,228,231,245,1,1,0,5,4,1,0,3,14,17
p_265,12,0,e_1,157,215,275,25,1,1,3,5,0,2,58,60,118
p_253,15,0,e_1,208,226,275,10,1,0,10,5,0,1,18,49,67
p_250,7,0,e_1,236,252,275,26,1,1,12,4,1,0,16,23,39
p_249,7,0,e_1,238,252,275,25,1,1,11,4,1,1,14,23,37
p_248,7,0,e_1,246,252,275,7,0,0,9,4,1,1,6,23,29
p_244,2,0,e_3,271,280,288,2,0,0,0,3,0,0,9,8,17
p_247,12,0,e_0,248,286,326,12,0,0,0,3,0,0,38,40,78
p_246,12,0,e_0,257,286,326,12,0,0,2,5,0,1,29,40,69
p_238,2,0,e_0,311,318,326,23,1,1,4,4,1,0,7,8,15
p_243,8,0,e_2,285,295,331,23,1,1,5,5,0,1,10,36,46
p_245,9,0,e_2,269,300,331,9,0,0,0,3,0,0,31,31,62
p_233,2,0,e_2,319,323,331,20,2,2,3,4,1,0,4,8,12
p_242,4,0,e_1,287,301,395,4,0,0,0,3,0,0,14,94,108
p_236,8,0,e_1,313,315,395,16,1,1,8,5,1,2,2,80,82
p_235,8,0,e_1,314,315,395,16,2,1,8,5,1,3,1,80,81
p_231,10,0,e_1,320,323,395,12,2,1,9,5,1,2,3,72,75
p_241,13,0,e_1,300,334,395,13,0,0,4,5,0,1,34,61,95
p_240,14,0,e_1,301,339,395,14,0,0,4,3,0,1,38,56,94
p_234,14,0,e_1,314,339,395,12,2,0,8,5,1,3,25,56,81
p_223,13,0,e_1,339,344,395,4,2,0,14,4,1,2,5,51,56
p_226,12,0,e_1,331,349,395,7,3,1,12,5,1,3,18,46,64
p_213,12,0,e_1,347,349,395,2,5,1,13,4,1,4,2,46,48
p_218,9,0,e_1,343,360,395,7,3,1,13,1,1,2,17,35,52
p_212,9,0,e_1,348,360,395,5,5,1,12,4,1,4,12,35,47
p_215,6,0,e_1,346,371,395,9,4,1,13,4,1,3,25,24,49
p_206,6,0,e_1,362,371,395,6,4,1,9,4,1,2,9,24,33
p_230,5,0,e_1,323,376,395,16,2,2,10,2,1,2,53,19,72
p_237,5,0,e_3,313,323,412,19,1,1,2,5,0,1,10,89,99
p_232,5,0,e_3,320,323,412,17,2,1,4,5,0,2,3,89,92
p_229,9,0,e_3,323,337,412,12,1,1,5,2,0,1,14,75,89
p_239,13,0,e_3,305,351,412,13,0,0,0,3,0,0,46,61,107
p_224,13,0,e_3,335,351,412,4,3,0,9,5,1,2,16,61,77
p_211,14,0,e_3,348,356,412,2,5,0,12,5,1,4,8,56,64
p_198,9,0,e_3,368,373,412,2,4,0,11,4,1,3,5,39,44
p_217,8,0,e_3,345,378,412,7,3,1,11,5,1,2,33,34,67
p_197,8,0,e_3,375,378,412,1,4,0,9,4,1,3,3,34,37
p_196,5,0,e_3,376,389,412,3,4,0,8,4,1,3,13,23,36
p_192,5,0,e_3,380,389,412,3,4,0,8,4,1,3,9,23,32
p_221,4,0,e_3,341,394,412,12,2,1,10,5,1,1,53,18,71
p_185,2,0,e_3,392,402,412,2,3,0,4,4,1,2,10,10,20
p_175,2,0,e_3,399,402,412,1,3,0,3,4,1,2,3,10,13
p_216,1,0,e_3,346,407,412,13,4,1,12,5,1,3,61,5,66
p_222,3,0,e_2,339,344,427,14,2,1,2,5,0,1,5,83,88
p_225,10,0,e_2,333,367,427,8,3,1,0,3,0,0,34,60,94
p_203,12,0,e_2,365,375,427,30,4,4,9,5,1,3,10,52,62
p_200,12,0,e_2,367,375,427,29,4,4,10,5,1,3,8,52,60
p_195,9,0,e_2,376,386,427,30,4,4,12,4,1,2,10,41,51
p_204,8,0,e_2,364,391,427,4,4,0,9,5,1,2,27,36,63
p_189,7,0,e_2,387,396,427,29,4,4,9,4,1,2,9,31,40
p_187,7,0,e_2,391,396,427,28,3,3,8,1,1,2,5,31,36
p_179,6,0,e_2,397,401,427,27,3,3,7,4,1,2,4,26,30
p_184,5,0,e_2,393,406,427,29,4,4,8,4,1,2,13,21,34
p_174,3,0,e_2,402,414,427,29,2,2,6,4,1,2,12,13,25
p_171,3,0,e_2,408,414,427,28,1,1,5,4,1,2,6,13,19
p_205,1,0,e_2,362,422,427,12,4,2,9,5,1,1,60,5,65
p_227,9,0,e_0,326,355,428,12,3,1,0,5,0,1,29,73,102
p_220,9,0,e_0,342,355,428,7,3,1,5,5,0,2,13,73,86
p_228,11,0,e_0,325,363,428,10,3,1,0,3,1,0,38,65,103
p_219,11,0,e_0,342,363,428,5,3,1,5,5,0,2,21,65,86
p_207,12,0,e_0,355,368,428,10,4,0,9,2,0,3,13,60,73
p_208,13,0,e_0,355,373,428,11,4,0,9,2,0,4,18,55,73
p_202,13,0,e_0,365,373,428,29,4,4,11,5,1,4,8,55,63
p_201,13,0,e_0,366,373,428,28,4,4,11,5,1,4,7,55,62
p_194,11,0,e_0,377,381,428,27,5,5,12,4,1,2,4,47,51
p_188,8,0,e_0,390,392,428,27,3,3,9,4,1,3,2,36,38
p_191,7,0,e_0,382,397,428,30,4,4,11,4,1,2,15,31,46
p_176,6,0,e_0,398,402,428,27,3,3,7,4,1,3,4,26,30
p_182,5,0,e_0,394,407,428,29,3,3,8,4,1,3,13,21,34
p_178,5,0,e_0,398,407,428,28,3,3,7,4,1,3,9,21,30
p_214,4,0,e_0,346,412,428,11,4,1,6,5,0,2,66,16,82
p_156,1,0,e_0,428,433,466,25,4,3,0,5,0,2,5,33,38
p_209,2,0,e_0,354,438,466,13,5,1,9,2,0,2,84,28,112
p_155,3,0,e_0,434,443,466,21,4,3,1,5,1,2,9,23,32
p_210,4,0,e_0,353,448,466,11,5,1,9,5,0,3,95,18,113
p_148,3,0,e_0,447,453,466,17,4,1,4,3,1,3,6,13,19
p_143,2,0,e_0,451,458,466,17,4,1,3,4,1,4,7,8,15
p_199,2,0,e_1,368,403,517,9,5,3,7,4,1,2,35,114,149
p_177,9,0,e_1,398,426,517,24,3,3,0,5,0,4,28,91,119
p_173,10,0,e_1,405,431,517,21,2,2,2,5,1,4,26,86,112
p_181,11,0,e_1,395,436,517,23,3,3,0,3,1,3,41,81,122
p_169,11,0,e_1,410,436,517,19,2,2,4,5,1,5,26,81,107
p_193,12,0,e_1,378,441,517,26,4,4,5,4,1,1,63,76,139
p_183,12,0,e_1,393,441,517,22,3,3,0,4,1,3,48,76,124
p_164,12,0,e_1,416,441,517,17,4,1,6,5,1,6,25,76,101
p_157,12,0,e_1,427,441,517,14,4,1,9,5,1,7,14,76,90
p_161,13,0,e_1,418,446,517,16,4,1,6,5,1,7,28,71,99
p_190,14,0,e_1,382,451,517,23,4,4,3,4,1,2,69,66,135
p_180,14,0,e_1,396,451,517,20,3,3,0,5,0,4,55,66,121
p_172,14,0,e_1,405,451,517,18,2,2,2,5,1,4,46,66,112
p_165,14,0,e_1,416,451,517,15,4,1,6,5,1,6,35,66,101
p_162,14,0,e_1,417,451,517,15,3,1,6,5,1,6,34,66,100
p_186,1,0,e_3,391,417,528,4,3,1,5,4,1,2,26,111,137
p_167,7,0,e_3,412,437,528,7,2,2,0,3,1,2,25,91,116
p_170,10,0,e_3,408,448,528,21,1,1,1,4,1,0,40,80,120
p_160,10,0,e_3,421,448,528,18,4,1,2,5,1,3,27,80,107
p_168,15,0,e_3,412,465,528,15,3,0,0,5,0,3,53,63,116
p_141,15,0,e_3,455,465,528,3,4,0,12,5,1,3,10,63,73
p_123,12,0,e_3,474,476,528,1,6,0,13,4,1,5,2,52,54
p_130,9,0,e_3,469,487,528,5,5,0,14,4,1,4,18,41,59
p_121,9,0,e_3,480,487,528,2,7,0,11,4,1,6,7,41,48
p_135,7,0,e_3,461,495,528,9,5,1,14,5,1,4,34,33,67
p_116,7,0,e_3,490,495,528,1,6,0,8,4,1,5,5,33,38
p_122,5,0,e_3,477,503,528,7,6,2,12,4,1,5,26,25,51
p_144,4,0,e_3,451,508,528,15,3,1,11,5,1,2,57,20,77
p_125,4,0,e_3,474,508,528,9,6,2,13,4,1,5,34,20,54
p_150,3,0,e_3,444,513,528,18,3,2,9,5,1,2,69,15,84
p_146,10,0,e_2,451,459,541,9,4,1,8,5,0,2,8,82,90
p_159,11,0,e_2,424,464,541,16,4,1,1,4,1,0,40,77,117
p_137,13,0,e_2,458,472,541,4,4,1,10,5,0,3,14,69,83
p_158,14,0,e_2,426,477,541,12,4,1,0,3,1,1,51,64,115
p_124,14,0,e_2,474,477,541,29,6,6,13,5,1,5,3,64,67
p_127,15,0,e_2,473,482,541,28,6,6,13,5,1,4,9,59,68
p_117,12,0,e_2,490,493,541,26,6,6,13,4,1,3,3,48,51
p_126,6,0,e_2,473,513,541,7,6,2,13,5,1,3,40,28,68
p_129,5,0,e_2,470,518,541,9,6,2,13,5,1,3,48,23,71
p_108,5,0,e_2,509,518,541,29,4,4,7,4,1,3,9,23,32
p_133,4,0,e_2,463,523,541,12,6,1,11,5,1,3,60,18,78
p_106,4,0,e_2,512,523,541,29,4,4,6,4,1,3,11,18,29
p_105,4,0,e_2,515,523,541,29,3,3,6,4,1,2,8,18,26
p_102,2,0,e_2,521,531,541,30,2,2,5,4,1,1,10,10,20
p_99,1,0,e_2,522,536,541,30,2,2,4,1,1,1,14,5,19
p_154,7,0,e_0,438,489,592,16,3,2,2,2,1,3,51,103,154
p_153,8,0,e_0,438,494,592,15,3,2,2,2,1,2,56,98,154
p_114,9,0,e_0,494,499,592,28,5,5,8,2,1,2,5,93,98
p_152,10,0,e_0,439,504,592,13,3,1,2,5,1,4,65,88,153
p_120,10,0,e_0,481,504,592,1,7,0,5,5,0,3,23,88,111
p_115,10,0,e_0,494,504,592,27,5,5,8,2,1,3,10,88,98
p_113,11,0,e_0,496,509,592,26,5,5,8,5,1,3,13,83,96
p_109,14,0,e_0,506,520,592,20,5,5,10,5,1,3,14,72,86
p_112,15,0,e_0,497,525,592,22,5,5,9,5,1,4,28,67,95
p_111,15,0,e_0,501,525,592,21,5,5,9,5,1,4,24,67,91
p_103,13,0,e_0,517,533,592,19,2,2,13,5,1,4,16,59,75
p_101,12,0,e_0,521,538,592,20,2,2,14,5,1,4,17,54,71
p_100,10,0,e_0,522,546,592,21,2,2,14,5,1,5,24,46,70
p_97,10,0,e_0,526,546,592,21,2,2,15,4,1,6,20,46,66
p_104,7,0,e_0,516,557,592,25,3,3,13,5,1,3,41,35,76
p_163,4,0,e_1,417,531,639,25,4,3,6,5,1,6,114,108,222
p_166,5,0,e_1,415,536,639,25,4,3,5,5,1,5,121,103,224
p_119,5,0,e_1,483,536,639,5,7,2,9,4,1,7,53,103,156
p_147,7,0,e_1,450,544,639,13,3,1,14,5,1,4,94,95,189
p_138,7,0,e_1,456,544,639,11,4,1,15,2,1,5,88,95,183
p_132,7,0,e_1,463,544,639,8,6,0,13,1,1,5,81,95,176
p_131,9,0,e_1,467,552,639,6,5,0,12,4,1,5,85,87,172
p_128,10,0,e_1,471,557,639,4,6,0,12,4,1,6,86,82,168
p_145,12,0,e_1,451,565,639,7,3,1,14,2,1,4,114,74,188
p_134,12,0,e_1,462,565,639,4,6,1,14,4,1,6,103,74,177
p_140,13,0,e_1,455,570,639,5,4,1,15,5,1,5,115,69,184
p_139,13,0,e_1,456,570,639,5,4,1,15,2,1,5,114,69,183
p_151,15,0,e_1,443,578,639,7,3,0,12,5,1,4,135,61,196
p_149,15,0,e_1,444,578,639,6,4,0,12,5,1,5,134,61,195
p_142,15,0,e_1,452,578,639,4,4,0,14,5,1,5,126,61,187
p_110,1,0,e_3,501,533,644,5,5,4,6,4,1,4,32,111,143
p_107,1,0,e_3,512,533,644,2,4,1,3,4,1,3,21,111,132
p_136,2,0,e_3,460,538,644,15,4,1,13,5,1,3,78,106,184
p_94,6,0,e_3,528,552,644,6,2,2,0,3,1,2,24,92,116
p_93,7,0,e_3,529,557,644,7,3,0,0,5,0,3,28,87,115
p_92,13,0,e_3,533,577,644,12,3,0,1,2,0,3,44,67,111
p_91,13,0,e_3,535,577,644,12,5,0,1,5,1,4,42,67,109
p_88,14,0,e_3,538,582,644,12,4,0,2,2,1,3,44,62,106
p_79,14,0,e_3,549,582,644,9,5,0,5,5,1,4,33,62,95
p_75,14,0,e_3,563,582,644,6,3,0,8,5,1,2,19,62,81
p_68,14,0,e_3,574,582,644,2,4,0,12,5,1,3,8,62,70
p_66,12,0,e_3,577,590,644,3,3,1,13,5,1,2,13,54,67
p_52,11,0,e_3,591,595,644,1,6,0,12,4,1,5,4,49,53
p_58,10,0,e_3,586,600,644,3,6,1,13,4,1,5,14,44,58
p_60,9,0,e_3,584,605,644,5,5,1,14,4,1,4,21,39,60
p_76,7,0,e_2,559,564,649,14,3,2,6,5,0,1,5,85,90
p_87,15,0,e_2,539,590,649,13,5,0,1,4,1,0,51,59,110
p_46,13,0,e_2,596,598,649,28,6,6,14,4,1,4,2,51,53
p_41,10,0,e_2,600,609,649,30,7,7,13,4,1,4,9,40,49
p_59,6,0,e_2,584,623,649,8,5,2,13,5,1,2,39,26,65
p_57,6,0,e_2,587,623,649,7,7,4,14,5,1,3,36,26,62
p_54,6,0,e_2,590,623,649,6,6,3,15,2,1,4,33,26,59
p_47,6,0,e_2,594,623,649,5,7,3,14,4,1,4,29,26,55
p_61,5,0,e_2,583,628,649,9,5,3,13,5,1,1,45,21,66
p_49,5,0,e_2,592,628,649,7,7,5,15,4,1,4,36,21,57
p_45,5,0,e_2,597,628,649,6,6,4,13,1,1,4,31,21,52
p_55,4,0,e_2,590,633,649,8,6,5,15,2,1,3,43,16,59
p_38,4,0,e_2,627,633,649,30,6,6,5,4,1,3,6,16,22
p_56,2,0,e_2,588,641,649,11,7,6,14,5,1,3,53,8,61
p_32,5,0,e_2,657,675,692,8,5,2,0,3,0,0,18,17,35
p_31,5,0,e_2,662,675,692,7,4,2,1,5,0,1,13,17,30
p_43,3,0,e_3,599,655,708,7,6,4,10,4,1,5,56,53,109
p_42,4,0,e_3,600,660,708,6,6,4,10,1,1,5,60,48,108
p_40,4,0,e_3,601,660,708,6,7,4,10,4,1,6,59,48,107
p_62,5,0,e_3,582,665,708,9,4,0,14,2,1,3,83,43,126
p_73,6,0,e_3,568,670,708,12,3,2,10,5,1,2,102,38,140
p_63,8,0,e_3,581,678,708,6,3,0,14,2,1,2,97,30,127
p_33,8,0,e_3,647,678,708,8,5,0,0,5,0,5,31,30,61
p_28,6,0,e_3,679,686,708,2,2,0,8,4,1,1,7,22,29
p_30,5,0,e_3,676,691,708,4,2,1,7,5,1,1,15,17,32
p_64,1,0,e_0,579,597,710,14,4,1,3,4,1,5,18,113,131
p_90,2,0,e_0,536,602,710,22,5,3,12,4,1,6,66,108,174
p_81,2,0,e_0,547,602,710,22,5,4,10,4,1,6,55,108,163
p_71,2,0,e_0,569,602,710,15,4,2,5,4,1,5,33,108,141
p_85,3,0,e_0,542,607,710,22,5,4,11,4,1,6,65,103,168
p_84,3,0,e_0,546,607,710,21,5,4,10,4,1,6,61,103,164
p_82,3,0,e_0,547,607,710,21,5,4,10,4,1,6,60,103,163
p_70,3,0,e_0,572,607,710,13,4,2,4,4,1,5,35,103,138
p_118,4,0,e_0,488,612,710,5,6,2,7,2,0,2,124,98,222
p_78,4,0,e_0,555,612,710,17,4,2,7,4,1,6,57,98,155
p_96,5,0,e_0,527,617,710,25,3,3,15,4,1,6,90,93,183
p_83,5,0,e_0,546,617,710,19,5,4,10,4,1,6,71,93,164
p_98,6,0,e_0,524,622,710,25,2,2,15,5,1,6,98,88,186
p_95,6,0,e_0,527,622,710,24,3,3,15,4,1,6,95,88,183
p_86,6,0,e_0,541,622,710,19,5,3,12,4,1,6,81,88,169
p_27,2,0,e_2,693,701,743,3,1,0,0,3,0,0,8,42,50
p_26,3,0,e_2,698,706,743,30,1,1,1,5,0,1,8,37,45
p_25,7,0,e_2,703,720,743,24,1,1,2,5,1,1,17,23,40
p_23,5,0,e_3,709,726,743,5,0,0,0,3,0,0,17,17,34
p_51,1,0,e_1,591,644,751,11,6,5,12,4,1,5,53,107,160
p_48,2,0,e_1,593,649,751,9,7,5,11,1,1,6,56,102,158
p_67,8,0,e_1,574,669,751,8,4,2,14,5,1,3,95,82,177
p_53,9,0,e_1,590,674,751,3,6,1,12,4,1,4,84,77,161
p_69,10,0,e_1,573,679,751,6,4,2,13,5,1,2,106,72,178
p_50,10,0,e_1,592,679,751,2,7,1,11,4,1,6,87,72,159
p_74,11,0,e_1,567,684,751,7,3,2,12,5,1,2,117,67,184
p_65,12,0,e_1,578,689,751,3,4,1,15,4,1,3,111,62,173
p_72,15,0,e_1,569,700,751,4,4,0,13,5,1,3,131,51,182
p_29,15,0,e_1,678,700,751,23,2,2,10,2,1,3,22,51,73
p_22,10,0,e_1,712,717,751,10,1,0,11,4,1,1,5,34,39
p_24,5,0,e_1,707,734,751,25,1,1,13,4,1,0,27,17,44
p_18,2,0,e_1,768,776,784,2,0,0,0,3,0,0,8,8,16
p_35,4,0,e_0,640,724,820,27,6,6,11,2,1,3,84,96,180
p_80,6,0,e_0,548,732,820,17,5,3,10,4,1,6,184,88,272
p_77,6,0,e_0,557,732,820,15,3,2,7,4,1,5,175,88,263
p_89,7,0,e_0,537,737,820,17,5,1,12,1,1,6,200,83,283
p_37,7,0,e_0,633,737,820,26,5,5,8,5,1,3,104,83,187
p_20,9,0,e_0,737,745,820,23,1,1,7,2,1,3,8,75,83
p_21,10,0,e_0,732,750,820,24,1,1,6,2,1,3,18,70,88
p_36,11,0,e_0,635,755,820,22,5,5,9,5,1,3,120,65,185
p_19,12,0,e_0,740,760,820,19,1,1,8,5,1,4,20,60,80
p_44,15,0,e_0,598,771,820,25,6,6,1,5,1,6,173,49,222
p_39,15,0,e_0,609,771,820,23,6,6,3,5,1,5,162,49,211
p_34,15,0,e_0,643,771,820,15,5,5,11,5,1,4,128,49,177
p_16,13,0,e_0,774,779,820,13,0,0,14,4,1,0,5,41,46
p_8,1,0,e_3,847,853,858,1,0,0,0,3,0,0,6,5,11
p_13,11,0,e_1,794,830,865,11,0,0,0,3,0,0,36,35,71
p_11,11,0,e_1,810,830,865,11,0,0,5,5,0,1,20,35,55
p_12,13,0,e_2,796,813,870,13,0,0,7,5,0,1,17,57,74
p_10,14,0,e_2,810,818,870,14,0,0,12,5,0,2,8,52,60
p_17,15,0,e_2,772,823,870,15,0,0,0,3,0,0,51,47,98
p_15,15,0,e_2,782,823,870,15,0,0,3,5,0,1,41,47,88
p_14,15,0,e_2,790,823,870,15,0,0,5,5,0,1,33,47,80
p_4,1,0,e_1,864,870,875,8,1,1,0,3,1,0,6,5,11
p_3,1,0,e_1,876,882,887,4,1,0,0,3,0,0,6,5,11
p_5,5,0,e_3,860,877,894,5,0,0,0,3,0,0,17,17,34
p_2,3,0,e_2,878,890,901,2,1,0,0,3,0,0,12,11,23
p_1,2,0,e_1,889,898,906,29,1,1,0,3,0,0,9,8,17
p_9,2,0,e_0,845,854,938,2,0,0,0,3,0,0,9,84,93
p_7,12,0,e_0,851,886,938,11,1,0,1,5,0,1,35,52,87
p_6,14,0,e_0,858,894,938,14,0,0,3,5,1,1,36,44,80
p_299,3,0,e_1,7,19,30,3,0,0,0,3,0,0,12,11,23
p_296,1,0,e_3,20,25,30,1,0,0,0,3,0,0,5,5,10
p_298,4,0,e_2,10,25,47,4,0,0,0,3,0,0,15,22,37
p_295,5,0,e_2,22,30,47,5,1,0,3,5,0,1,8,17,25
p_290,4,0,e_3,43,49,87,6,1,1,2,5,0,1,6,38,44
p_291,6,0,e_3,35,57,87,6,0,0,0,3,0,0,22,30,52
p_289,7,0,e_3,47,62,87,3,2,0,4,5,0,2,15,25,40
p_279,2,0,e_3,76,79,87,1,1,0,3,4,1,0,3,8,11
p_288,1,0,e_2,49,55,98,3,2,2,0,3,0,0,6,43,49
p_285,2,0,e_2,54,60,98,7,3,2,1,5,0,2,6,38,44
p_286,3,0,e_2,51,65,98,7,3,2,0,5,0,1,14,33,47
p_282,6,0,e_2,62,76,98,13,1,0,2,5,1,1,14,22,36
p_275,2,0,e_2,84,90,98,29,3,3,4,4,1,0,6,8,14
p_283,10,0,e_1,55,63,109,4,3,0,8,5,0,1,8,46,54
p_281,10,0,e_1,63,63,109,27,1,1,10,2,0,1,0,46,46
p_292,11,0,e_1,30,70,109,11,0,0,0,3,0,0,40,39,79
p_276,5,0,e_1,82,90,109,26,3,3,7,4,1,0,8,19,27
p_274,4,0,e_1,84,95,109,27,3,3,7,4,1,1,11,14,25
p_300,8,0,e_0,4,31,109,8,0,0,0,3,0,0,27,78,105
p_297,12,0,e_0,18,45,109,12,0,0,4,5,0,1,27,64,91
p_294,13,0,e_0,23,50,109,12,1,0,6,5,0,2,27,59,86
p_293,15,0,e_0,26,58,109,16,1,1,7,5,0,3,32,51,83
p_284,14,0,e_0,55,63,109,8,3,0,14,5,1,2,8,46,54
p_287,12,0,e_0,51,71,109,8,3,0,13,5,1,1,20,38,58
p_280,12,0,e_0,65,71,109,24,1,1,14,4,1,1,6,38,44
p_267,1,0,e_2,153,159,164,10,2,1,0,3,0,0,6,5,11
p_277,10,0,e_3,81,119,193,22,2,2,2,4,1,1,38,74,112
p_273,13,0,e_3,95,130,193,15,2,1,2,5,0,2,35,63,98
p_278,15,0,e_3,80,138,193,17,1,1,2,4,1,0,58,55,113
p_272,15,0,e_3,105,138,193,10,3,0,5,5,0,3,33,55,88
p_271,11,0,e_3,127,152,193,7,3,2,12,5,1,2,25,41,66
p_268,10,0,e_3,150,157,193,1,2,0,11,4,1,1,7,36,43
p_262,6,0,e_3,164,171,193,2,2,0,8,4,1,1,7,22,29
p_264,5,0,e_3,162,176,193,4,1,0,9,4,1,0,14,17,31
p_258,5,0,e_2,175,192,231,30,1,1,0,3,0,1,17,39,56
p_259,6,0,e_2,174,197,231,29,2,2,0,3,0,0,23,34,57
p_256,8,0,e_2,191,205,231,22,1,1,5,5,0,2,14,26,40
p_270,7,0,e_0,133,157,234,9,3,1,0,3,0,0,24,77,101
p_266,15,0,e_0,155,183,234,26,2,2,6,5,0,1,28,51,79
p_257,12,0,e_0,179,194,234,23,1,1,14,5,1,1,15,40,55
p_255,10,0,e_0,192,202,234,10,0,0,12,4,1,1,10,32,42
p_269,4,0,e_1,146,160,234,9,2,1,0,3,0,0,14,74,88
p_265,12,0,e_1,157,186,234,28,1,1,3,5,0,1,29,48,77
p_263,12,0,e_1,163,186,234,26,2,2,5,5,1,1,23,48,71
p_261,12,0,e_1,170,186,234,24,3,3,7,5,1,1,16,48,64
p_260,13,0,e_1,171,191,234,23,2,2,7,5,1,1,20,43,63
p_252,2,0,e_1,212,226,234,25,2,1,6,4,1,0,14,8,22
p_250,7,0,e_0,236,260,283,12,3,1,0,3,0,0,24,23,47
p_248,7,0,e_0,246,260,283,9,3,1,2,5,0,1,14,23,37
p_249,7,0,e_1,238,261,284,11,3,1,0,3,0,0,23,23,46
p_244,2,0,e_2,271,279,287,7,2,1,0,3,0,0,8,8,16
p_254,3,0,e_3,199,211,302,3,0,0,0,3,0,0,12,91,103
p_253,15,0,e_3,208,249,302,13,1,0,2,5,0,1,41,53,94
p_247,12,0,e_3,248,260,302,3,3,0,15,5,1,2,12,42,54
p_246,12,0,e_3,257,260,302,1,3,0,13,4,1,2,3,42,45
p_245,9,0,e_3,269,271,302,1,2,0,10,4,1,1,2,31,33
p_251,4,0,e_3,228,288,302,18,2,1,8,5,1,1,60,14,74
p_242,4,0,e_1,287,301,315,30,1,1,0,3,0,0,14,14,28
p_233,2,0,e_1,319,328,362,13,2,2,0,3,0,0,9,34,43
p_232,5,0,e_1,320,339,362,10,2,1,0,3,0,1,19,23,42
p_230,5,0,e_1,323,339,362,11,3,2,0,5,0,2,16,23,39
p_221,4,0,e_1,341,344,362,6,2,1,5,4,1,1,3,18,21
p_222,3,0,e_1,339,349,362,8,3,2,5,4,1,0,10,13,23
p_216,1,0,e_1,346,357,362,8,2,0,4,4,1,1,11,5,16
p_205,1,0,e_1,362,368,373,5,3,2,0,3,0,0,6,5,11
p_237,5,0,e_3,313,331,384,5,0,0,0,3,0,0,18,53,71
p_235,8,0,e_3,314,342,384,8,1,1,0,3,0,1,28,42,70
p_229,9,0,e_3,323,347,384,7,2,0,2,5,0,2,24,37,61
p_227,9,0,e_3,326,347,384,5,3,0,4,5,0,3,21,37,58
p_220,9,0,e_3,342,347,384,1,2,0,8,5,1,1,5,37,42
p_218,9,0,e_3,343,347,384,1,2,0,8,5,1,1,4,37,41
p_217,8,0,e_3,345,352,384,1,2,0,9,5,1,1,7,32,39
p_215,6,0,e_3,346,360,384,3,2,0,9,2,1,1,14,24,38
p_214,4,0,e_3,346,368,384,5,3,0,9,2,1,2,22,16,38
p_210,4,0,e_3,353,368,384,4,3,1,8,4,1,2,15,16,31
p_209,2,0,e_3,354,376,384,6,3,2,8,4,1,2,22,8,30
p_199,2,0,e_3,368,376,384,2,2,0,4,1,1,1,8,8,16
p_243,8,0,e_0,285,312,390,27,2,2,0,3,0,0,27,78,105
p_241,13,0,e_0,300,329,390,17,1,1,4,5,0,1,29,61,90
p_239,13,0,e_0,305,329,390,13,0,0,6,5,0,3,24,61,85
p_240,14,0,e_0,301,334,390,14,0,0,5,5,0,2,33,56,89
p_234,14,0,e_0,314,334,390,14,2,2,8,5,1,2,20,56,76
p_224,13,0,e_0,335,339,390,7,3,0,14,4,1,3,4,51,55
p_226,12,0,e_0,331,344,390,7,2,0,13,5,1,2,13,46,59
p_228,11,0,e_0,325,349,390,8,3,0,12,5,1,2,24,41,65
p_219,11,0,e_0,342,349,390,3,2,0,12,4,1,3,7,41,48
p_225,10,0,e_0,333,354,390,5,3,0,14,2,1,2,21,36,57
p_212,9,0,e_0,348,359,390,30,4,4,11,1,1,1,11,31,42
p_206,6,0,e_0,362,370,390,30,3,3,8,4,1,0,8,20,28
p_186,1,0,e_0,391,397,402,1,0,0,0,3,0,0,6,5,11
p_238,2,0,e_2,311,320,430,2,0,0,0,3,0,0,9,110,119
p_236,8,0,e_2,313,340,430,8,1,1,0,5,0,1,27,90,117
p_231,10,0,e_2,320,348,430,9,2,0,2,2,0,1,28,82,110
p_213,12,0,e_2,347,356,430,5,4,0,10,5,1,2,9,74,83
p_207,12,0,e_2,355,356,430,26,4,4,12,5,1,3,1,74,75
p_223,13,0,e_2,339,361,430,6,3,0,8,2,1,1,22,69,91
p_208,13,0,e_2,355,361,430,25,4,4,12,5,1,3,6,69,75
p_211,14,0,e_2,348,366,430,25,4,4,10,5,1,2,18,64,82
p_202,13,0,e_2,365,371,430,22,3,3,14,5,1,3,6,59,65
p_201,13,0,e_2,366,371,430,21,3,3,14,4,1,3,5,59,64
p_203,12,0,e_2,365,376,430,23,3,3,14,5,1,2,11,54,65
p_200,12,0,e_2,367,376,430,22,3,3,14,4,1,3,9,54,63
p_194,11,0,e_2,377,381,430,21,1,1,12,4,1,2,4,49,53
p_198,9,0,e_2,368,389,430,25,2,2,14,4,1,3,21,41,62
p_195,9,0,e_2,376,389,430,23,1,1,12,4,1,2,13,41,54
p_185,2,0,e_3,392,400,482,2,0,0,0,3,0,0,8,82,90
p_177,9,0,e_3,398,423,482,11,2,1,2,5,0,2,25,59,84
p_173,10,0,e_3,405,428,482,9,3,1,3,5,1,2,23,54,77
p_181,11,0,e_3,395,433,482,10,1,0,1,5,0,1,38,49,87
p_169,11,0,e_3,410,433,482,6,4,0,5,5,1,3,23,49,72
p_159,11,0,e_3,424,433,482,4,5,1,9,5,1,4,9,49,58
p_164,12,0,e_3,416,438,482,5,5,0,7,5,1,4,22,44,66
p_157,12,0,e_3,427,438,482,2,4,0,10,2,1,3,11,44,55
p_154,7,0,e_3,438,455,482,5,2,0,12,4,1,1,17,27,44
p_166,5,0,e_3,415,463,482,11,4,3,6,5,1,3,48,19,67
p_144,4,0,e_3,451,468,482,4,3,2,8,4,1,2,17,14,31
p_133,4,0,e_3,463,468,482,1,2,0,5,4,1,1,5,14,19
p_174,3,0,e_0,402,414,483,17,3,2,0,3,0,0,12,69,81
p_163,4,0,e_0,417,419,483,13,6,4,4,5,1,2,2,64,66
p_167,7,0,e_0,412,430,483,10,4,3,3,5,0,2,18,53,71
p_170,10,0,e_0,408,441,483,8,4,1,1,5,0,1,33,42,75
p_160,10,0,e_0,421,441,483,5,6,2,4,5,1,2,20,42,62
p_152,10,0,e_0,439,441,483,2,3,0,10,5,1,4,2,42,44
p_153,8,0,e_0,438,449,483,10,2,0,9,5,1,3,11,34,45
p_147,7,0,e_0,450,454,483,1,3,0,8,4,1,2,4,29,33
p_155,3,0,e_0,434,468,483,10,3,1,8,5,1,2,34,15,49
p_150,3,0,e_0,444,468,483,8,3,2,10,4,1,3,24,15,39
p_148,3,0,e_0,447,468,483,7,3,2,9,4,1,3,21,15,36
p_136,2,0,e_0,460,473,483,4,3,2,5,4,1,2,13,10,23
p_156,1,0,e_0,428,478,483,13,4,2,6,5,1,2,50,5,55
p_196,5,0,e_1,376,393,484,27,1,1,0,3,0,0,17,91,108
p_193,12,0,e_1,378,416,484,20,1,1,0,5,0,1,38,68,106
p_183,12,0,e_1,393,416,484,12,1,0,5,5,1,2,23,68,91
p_161,13,0,e_1,418,421,484,6,6,0,12,5,1,2,3,63,66
p_190,14,0,e_1,382,426,484,17,1,1,2,5,0,2,44,58,102
p_180,14,0,e_1,396,426,484,13,2,0,6,5,1,2,30,58,88
p_172,14,0,e_1,405,426,484,11,3,0,9,5,1,2,21,58,79
p_165,14,0,e_1,416,426,484,7,6,0,12,5,1,2,10,58,68
p_162,14,0,e_1,417,426,484,7,6,0,12,5,1,2,9,58,67
p_158,14,0,e_1,426,428,484,4,5,0,14,5,1,1,2,56,58
p_168,15,0,e_1,412,433,484,10,4,0,11,5,1,2,21,51,72
p_138,7,0,e_1,456,459,484,30,3,3,8,4,1,1,3,25,28
p_143,2,0,e_1,451,476,484,6,4,3,9,4,1,0,25,8,33
p_118,4,0,e_1,488,502,518,15,1,1,0,3,0,0,14,16,30
p_110,1,0,e_1,501,513,518,15,2,2,4,3,0,0,12,5,17
p_119,5,0,e_0,483,500,559,15,1,1,0,3,1,0,17,59,76
p_116,7,0,e_0,490,508,559,11,1,1,2,5,0,1,18,51,69
p_114,9,0,e_0,494,516,559,7,1,1,3,5,0,2,22,43,65
p_104,7,0,e_0,516,524,559,5,2,1,9,4,1,3,8,35,43
p_98,6,0,e_0,524,529,559,8,2,1,7,1,1,3,5,30,35
p_95,6,0,e_0,527,529,559,8,3,1,7,4,1,4,2,30,32
p_108,5,0,e_0,509,534,559,9,2,2,7,5,1,1,25,25,50
p_96,5,0,e_0,527,534,559,8,3,0,6,4,1,4,7,25,32
p_106,4,0,e_0,512,539,559,9,2,2,8,5,1,2,27,20,47
p_105,4,0,e_0,515,539,559,8,2,1,9,2,1,3,24,20,44
p_85,3,0,e_0,542,544,559,7,1,0,4,4,1,2,2,15,17
p_90,2,0,e_0,536,549,559,9,2,1,5,4,1,2,13,10,23
p_107,1,0,e_0,512,554,559,11,2,1,8,5,1,3,42,5,47
p_175,2,0,e_2,399,438,570,18,3,2,7,1,1,3,39,132,171
p_171,3,0,e_2,408,443,570,15,4,3,5,4,1,5,35,127,162
p_192,5,0,e_2,380,451,570,26,1,1,11,4,1,3,71,119,190
p_184,5,0,e_2,393,451,570,5,1,0,8,1,1,2,58,119,177
p_182,5,0,e_2,394,451,570,5,1,0,8,1,1,2,57,119,176
p_178,5,0,e_2,398,451,570,16,2,1,7,4,1,4,53,119,172
p_179,6,0,e_2,397,456,570,15,2,1,8,4,1,2,59,114,173
p_176,6,0,e_2,398,456,570,14,2,1,7,1,1,3,58,114,172
p_191,7,0,e_2,382,461,570,24,1,1,11,4,1,3,79,109,188
p_189,7,0,e_2,387,461,570,7,0,0,9,4,1,4,74,109,183
p_187,7,0,e_2,391,461,570,7,0,0,9,4,1,3,70,109,179
p_135,7,0,e_2,461,461,570,29,3,3,7,2,1,5,0,109,109
p_132,7,0,e_2,463,465,570,28,2,2,7,5,1,5,2,105,107
p_204,8,0,e_2,364,470,570,27,3,3,13,5,1,1,106,100,206
p_197,8,0,e_2,375,470,570,24,1,1,12,4,1,3,95,100,195
p_120,10,0,e_3,481,514,580,10,0,0,0,3,1,0,33,66,99
p_115,10,0,e_3,494,514,580,7,1,0,3,5,0,1,20,66,86
p_113,11,0,e_3,496,519,580,7,1,0,4,5,0,1,23,61,84
p_101,12,0,e_3,521,524,580,3,2,1,11,5,1,1,3,56,59
p_103,13,0,e_3,517,529,580,2,2,0,11,5,1,1,12,51,63
p_97,10,0,e_3,526,540,580,4,2,1,12,5,1,1,14,40,54
p_80,6,0,e_3,548,554,580,2,3,0,8,4,1,2,6,26,32
p_78,4,0,e_3,555,562,580,2,3,0,6,4,1,2,7,18,25
p_84,3,0,e_3,546,567,580,6,1,0,9,4,1,0,21,13,34
p_82,3,0,e_3,547,567,580,5,2,0,8,4,1,1,20,13,33
p_81,2,0,e_3,547,572,580,6,2,1,8,4,1,1,25,8,33
p_71,2,0,e_3,569,572,580,1,2,0,3,4,1,1,3,8,11
p_99,1,0,e_1,522,526,639,13,3,1,0,5,0,1,4,113,117
p_102,2,0,e_1,521,531,639,13,2,1,0,3,0,0,10,108,118
p_94,6,0,e_1,528,545,639,7,3,0,1,5,1,1,17,94,111
p_92,13,0,e_1,533,568,639,29,2,2,2,5,1,1,35,71,106
p_91,13,0,e_1,535,568,639,29,2,2,3,5,1,2,33,71,104
p_88,14,0,e_1,538,573,639,26,2,2,4,5,1,2,35,66,101
p_79,14,0,e_1,549,573,639,23,4,4,7,5,1,3,24,66,90
p_75,14,0,e_1,563,573,639,20,3,3,11,5,1,4,10,66,76
p_87,15,0,e_1,539,578,639,25,2,2,4,5,1,3,39,61,100
p_72,15,0,e_1,569,578,639,18,2,2,13,5,1,4,9,61,70
p_68,14,0,e_1,574,583,639,18,1,1,14,5,1,3,9,56,65
p_66,12,0,e_1,577,591,639,19,1,1,15,2,1,3,14,48,62
p_65,12,0,e_1,578,591,639,18,1,1,15,4,1,4,13,48,61
p_74,11,0,e_1,567,596,639,22,2,2,13,2,1,3,29,43,72
p_52,11,0,e_1,591,596,639,9,3,0,12,4,1,3,5,43,48
p_56,2,0,e_3,588,591,667,9,2,2,1,5,0,2,3,76,79
p_55,4,0,e_3,590,599,667,6,2,2,2,2,0,2,9,68,77
p_42,4,0,e_3,600,601,667,4,6,2,4,5,1,5,1,66,67
p_62,5,0,e_3,582,606,667,5,0,0,0,3,0,0,24,61,85
p_61,5,0,e_3,583,606,667,5,1,1,0,3,0,1,23,61,84
p_49,5,0,e_3,592,606,667,5,5,1,2,5,1,4,14,61,75
p_45,5,0,e_3,597,606,667,3,6,1,4,5,1,5,9,61,70
p_59,6,0,e_3,584,611,667,6,1,0,0,5,0,1,27,56,83
p_57,6,0,e_3,587,611,667,5,2,0,1,5,0,2,24,56,80
p_54,6,0,e_3,590,611,667,4,3,0,2,5,0,3,21,56,77
p_47,6,0,e_3,594,611,667,4,6,0,2,5,1,5,17,56,73
p_41,10,0,e_3,600,625,667,6,7,0,4,5,1,6,25,42,67
p_37,7,0,e_3,633,636,667,1,5,0,8,4,1,4,3,31,34
p_38,4,0,e_3,627,647,667,6,4,0,10,4,1,3,20,20,40
p_35,4,0,e_3,640,647,667,2,5,0,6,4,1,4,7,20,27
p_73,6,0,e_0,568,580,670,27,2,2,2,5,0,1,12,90,102
p_76,7,0,e_0,559,585,670,28,4,4,0,3,0,0,26,85,111
p_67,8,0,e_0,574,590,670,24,1,1,4,5,0,4,16,80,96
p_63,8,0,e_0,581,590,670,8,0,0,6,5,1,5,9,80,89
p_60,9,0,e_0,584,595,670,9,2,0,7,2,1,4,11,75,86
p_69,10,0,e_0,573,600,670,22,1,1,4,5,0,3,27,70,97
p_58,10,0,e_0,586,600,670,9,2,0,7,5,1,5,14,70,84
p_46,13,0,e_0,596,611,670,10,6,0,9,5,1,3,15,59,74
p_44,15,0,e_0,598,619,670,11,5,5,9,5,1,4,21,51,72
p_39,15,0,e_0,609,619,670,10,6,0,12,5,1,4,10,51,61
p_70,3,0,e_0,572,657,670,29,1,1,4,5,0,2,85,13,98
p_64,1,0,e_0,579,665,670,29,1,1,6,5,0,5,86,5,91
p_125,4,0,e_2,474,584,696,28,1,1,9,2,1,7,110,112,222
p_129,5,0,e_2,470,589,696,29,1,1,8,5,1,5,119,107,226
p_122,5,0,e_2,477,589,696,26,1,1,9,5,1,9,112,107,219
p_83,5,0,e_2,546,589,696,4,2,0,6,4,1,10,43,107,150
p_126,6,0,e_2,473,594,696,27,1,1,9,5,1,6,121,102,223
p_86,6,0,e_2,541,594,696,4,1,0,7,1,1,10,53,102,155
p_93,7,0,e_2,529,599,696,6,2,1,9,4,1,9,70,97,167
p_89,7,0,e_2,537,599,696,4,2,1,8,4,1,10,62,97,159
p_188,8,0,e_2,390,604,696,8,0,0,9,4,1,3,214,92,306
p_131,9,0,e_2,467,609,696,25,1,1,7,5,1,5,142,87,229
p_130,9,0,e_2,469,609,696,25,1,1,8,5,1,6,140,87,227
p_121,9,0,e_2,480,609,696,22,1,1,10,2,1,9,129,87,216
p_146,10,0,e_2,451,614,696,28,3,3,5,2,1,4,163,82,245
p_128,10,0,e_2,471,614,696,23,1,1,8,5,1,6,143,82,225
p_100,10,0,e_2,522,614,696,4,3,1,11,4,1,9,92,82,174
p_51,1,0,e_3,591,672,713,9,3,3,2,2,0,3,81,41,122
p_48,2,0,e_3,593,677,713,8,5,3,2,5,1,4,84,36,120
p_43,3,0,e_3,599,682,713,1,5,5,4,3,1,4,83,31,114
p_28,6,0,e_3,679,693,713,4,2,0,2,5,1,1,14,20,34
p_40,4,0,e_1,601,653,743,12,7,3,10,1,1,2,52,90,142
p_77,6,0,e_1,557,661,743,30,4,4,9,5,1,3,104,82,186
p_53,9,0,e_1,590,672,743,7,2,0,12,1,1,2,82,71,153
p_50,10,0,e_1,592,677,743,8,5,0,12,4,1,3,85,66,151
p_34,15,0,e_1,643,694,743,20,5,5,1,5,0,4,51,49,100
p_29,15,0,e_1,678,694,743,13,2,0,10,5,1,1,16,49,65
p_24,5,0,e_1,707,726,743,27,1,1,11,4,1,0,19,17,36
p_23,5,0,e_1,709,726,743,26,1,1,10,4,1,1,17,17,34
p_27,2,0,e_0,693,701,763,8,1,0,0,3,0,0,8,62,70
p_26,3,0,e_0,698,706,763,2,1,0,1,5,0,1,8,57,65
p_25,7,0,e_0,703,720,763,26,1,1,2,5,1,1,17,43,60
p_22,10,0,e_0,712,731,763,10,0,0,4,5,1,1,19,32,51
p_20,9,0,e_3,737,762,799,10,1,1,1,5,0,1,25,37,62
p_21,10,0,e_3,732,767,799,10,0,0,0,3,0,0,35,32,67
p_32,5,0,e_2,657,713,804,27,3,3,11,1,1,5,56,91,147
p_31,5,0,e_2,662,713,804,26,3,3,10,4,1,7,51,91,142
p_30,5,0,e_2,676,713,804,3,2,0,6,4,1,7,37,91,128
p_33,8,0,e_2,647,724,804,26,4,4,13,1,1,4,77,80,157
p_36,11,0,e_2,635,735,804,26,6,6,14,5,1,3,100,69,169
p_145,12,0,e_2,451,740,804,26,4,4,5,5,1,5,289,64,353
p_134,12,0,e_2,462,740,804,23,2,2,7,5,1,6,278,64,342
p_123,12,0,e_2,474,740,804,20,1,1,9,2,1,6,266,64,330
p_117,12,0,e_2,490,740,804,10,1,0,12,5,1,9,250,64,314
p_19,12,0,e_2,740,742,804,10,2,0,12,5,1,3,2,62,64
p_140,13,0,e_2,455,747,804,24,3,3,6,2,1,5,292,57,349
p_139,13,0,e_2,456,747,804,24,3,3,6,5,1,6,291,57,348
p_137,13,0,e_2,458,747,804,24,3,3,6,5,1,6,289,57,346
p_124,14,0,e_2,474,752,804,18,1,1,9,2,1,8,278,52,330
p_109,14,0,e_2,506,752,804,7,2,0,15,4,1,9,246,52,298
p_13,11,0,e_1,794,810,861,21,1,1,6,5,0,1,16,51,67
p_11,11,0,e_1,810,812,861,11,0,0,11,5,1,1,2,49,51
p_16,13,0,e_1,774,820,861,25,1,1,0,3,0,0,46,41,87
p_12,13,0,e_1,796,820,861,18,1,1,7,5,0,2,24,41,65
p_8,1,0,e_3,847,851,864,3,1,1,0,5,0,1,4,13,17
p_9,2,0,e_3,845,856,864,2,0,0,0,3,0,0,11,8,19
p_18,2,0,e_0,768,776,866,8,1,0,0,3,0,0,8,90,98
p_10,14,0,e_0,810,814,866,14,0,0,13,5,1,1,4,52,56
p_17,15,0,e_0,772,819,866,24,1,1,1,5,0,1,47,47,94
p_15,15,0,e_0,782,819,866,20,1,1,4,5,1,1,37,47,84
p_14,15,0,e_0,790,819,866,18,1,1,6,5,1,1,29,47,76
p_4,1,0,e_3,864,869,874,1,0,0,0,3,1,0,5,5,10
p_3,1,0,e_0,876,882,887,1,0,0,0,3,0,0,6,5,11
p_151,15,0,e_2,443,851,900,26,3,3,3,2,1,4,408,49,457
p_149,15,0,e_2,444,851,900,26,3,3,3,5,1,5,407,49,456
p_142,15,0,e_2,452,851,900,23,4,4,5,5,1,6,399,49,448
p_141,15,0,e_2,455,851,900,22,3,3,6,5,1,6,396,49,445
p_127,15,0,e_2,473,851,900,18,1,1,9,5,1,6,378,49,427
p_112,15,0,e_2,497,851,900,11,2,0,14,5,1,10,354,49,403
p_111,15,0,e_2,501,851,900,9,2,0,14,5,1,9,350,49,399
p_7,12,0,e_2,851,862,900,11,2,0,15,4,1,0,11,38,49
p_2,3,0,e_3,878,890,903,3,0,0,0,3,0,0,12,13,25
p_1,2,0,e_3,889,895,903,1,1,0,3,5,0,1,6,8,14
p_5,5,0,e_1,860,878,951,26,1,1,0,3,1,1,18,73,91
p_6,14,0,e_1,858,907,951,18,1,1,1,4,1,0,49,44,93
p_299,3,0,e_1,7,19,30,3,0,0,0,3,0,0,12,11,23
p_296,1,0,e_3,20,26,31,1,0,0,0,3,0,0,6,5,11
p_298,4,0,e_2,10,24,46,4,0,0,0,3,0,0,14,22,36
p_295,5,0,e_2,22,29,46,5,1,0,4,5,0,1,7,17,24
p_290,4,0,e_3,43,50,88,6,1,1,2,5,0,1,7,38,45
p_291,6,0,e_3,35,58,88,6,0,0,0,3,0,0,23,30,53
p_289,7,0,e_3,47,63,88,4,2,0,3,5,0,2,16,25,41
p_279,2,0,e_3,76,80,88,1,1,0,3,4,1,0,4,8,12
p_288,1,0,e_2,49,55,98,3,2,2,0,3,0,0,6,43,49
p_285,2,0,e_2,54,60,98,7,3,2,1,2,0,1,6,38,44
p_286,3,0,e_2,51,65,98,7,3,2,0,5,0,1,14,33,47
p_282,6,0,e_2,62,76,98,13,1,0,2,5,1,1,14,22,36
p_275,2,0,e_2,84,90,98,29,3,3,4,4,1,0,6,8,14
p_300,8,0,e_0,4,30,110,8,0,0,0,3,0,0,26,80,106
p_297,12,0,e_0,18,44,110,12,0,0,4,5,0,1,26,66,92
p_294,13,0,e_0,23,49,110,13,1,0,6,5,0,2,26,61,87
p_293,15,0,e_0,26,57,110,16,0,0,7,5,0,3,31,53,84
p_284,14,0,e_0,55,62,110,9,3,0,15,5,1,1,7,48,55
p_283,10,0,e_0,55,76,110,5,3,0,15,5,1,2,21,34,55
p_276,5,0,e_0,82,93,110,27,3,3,8,4,1,0,11,17,28
p_292,11,0,e_1,30,65,112,11,0,0,0,3,1,0,35,47,82
p_287,12,0,e_1,51,70,112,8,3,0,7,5,0,1,19,42,61
p_280,12,0,e_1,65,70,112,25,1,1,11,2,0,2,5,42,47
p_281,10,0,e_1,63,78,112,27,1,1,11,5,0,2,15,34,49
p_274,4,0,e_1,84,98,112,27,3,3,9,4,1,0,14,14,28
p_269,4,0,e_2,146,160,176,9,1,0,0,3,0,0,14,16,30
p_267,1,0,e_2,153,171,176,10,2,1,2,5,0,1,18,5,23
p_270,7,0,e_1,133,157,182,10,2,1,0,3,0,0,24,25,49
p_264,5,0,e_1,162,165,182,4,1,0,6,4,1,0,3,17,20
p_277,10,0,e_3,81,120,190,22,2,2,2,4,1,1,39,70,109
p_273,13,0,e_3,95,131,190,15,2,1,2,5,0,2,36,59,95
p_278,15,0,e_3,80,139,190,17,1,1,2,1,1,0,59,51,110
p_272,15,0,e_3,105,139,190,10,3,0,5,5,0,3,34,51,85
p_268,10,0,e_3,150,156,190,2,1,0,12,4,1,0,6,34,40
p_262,6,0,e_3,164,170,190,2,1,0,8,4,1,0,6,20,26
p_254,3,0,e_1,199,210,223,3,0,0,0,3,0,0,11,13,24
p_252,2,0,e_1,212,215,223,2,0,0,3,4,1,0,3,8,11
p_271,11,0,e_0,127,163,238,7,3,2,0,3,0,0,36,75,111
p_263,12,0,e_0,163,168,238,26,1,1,11,2,0,1,5,70,75
p_260,13,0,e_0,171,173,238,23,1,1,12,5,1,2,2,65,67
p_266,15,0,e_0,155,181,238,25,1,1,9,5,0,1,26,57,83
p_261,12,0,e_0,170,192,238,24,1,1,12,5,1,1,22,46,68
p_257,12,0,e_0,179,192,238,21,1,1,15,5,1,4,13,46,59
p_255,10,0,e_0,192,200,238,10,0,0,12,1,1,3,8,38,46
p_256,8,0,e_0,191,208,238,8,0,0,12,4,1,3,17,30,47
p_259,6,0,e_0,174,216,238,29,1,1,13,5,1,2,42,22,64
p_258,5,0,e_0,175,221,238,30,1,1,13,5,1,3,46,17,63
p_265,12,0,e_2,157,214,274,28,1,1,3,5,0,2,57,60,117
p_253,15,0,e_2,208,225,274,15,0,0,10,5,0,1,17,49,66
p_249,7,0,e_2,238,251,274,7,0,0,11,4,1,0,13,23,36
p_248,7,0,e_2,246,251,274,7,0,0,9,4,1,1,5,23,28
p_244,2,0,e_0,271,280,288,2,0,0,0,3,0,0,9,8,17
p_251,4,0,e_1,228,243,313,4,0,0,0,3,0,0,15,70,85
p_250,7,0,e_1,236,254,313,7,0,0,2,5,0,1,18,59,77
p_247,12,0,e_1,248,271,313,12,0,0,5,5,1,1,23,42,65
p_246,12,0,e_1,257,271,313,12,0,0,7,5,1,1,14,42,56
p_245,9,0,e_1,269,282,313,9,0,0,11,5,1,1,13,31,44
p_243,8,0,e_1,285,287,313,8,0,0,9,4,1,0,2,26,28
p_237,5,0,e_1,313,330,385,5,1,0,0,3,1,0,17,55,72
p_232,5,0,e_1,320,330,385,9,2,1,2,5,0,2,10,55,65
p_235,8,0,e_1,314,341,385,8,2,0,0,5,0,1,27,44,71
p_231,10,0,e_1,320,349,385,8,2,0,2,5,0,2,29,36,65
p_225,10,0,e_1,333,349,385,5,3,0,6,5,1,2,16,36,52
p_221,4,0,e_1,341,369,385,7,4,2,8,5,1,1,28,16,44
p_210,4,0,e_1,353,369,385,15,5,1,9,4,1,1,16,16,32
p_209,2,0,e_1,354,377,385,16,5,1,9,4,1,1,23,8,31
p_199,2,0,e_1,368,377,385,13,6,1,4,4,1,2,9,8,17
p_242,4,0,e_0,287,302,392,4,0,0,0,3,1,0,15,90,105
p_241,13,0,e_0,300,331,392,13,0,0,4,5,0,1,31,61,92
p_240,14,0,e_0,301,336,392,14,0,0,4,3,0,1,35,56,91
p_234,14,0,e_0,314,336,392,14,2,0,7,5,1,2,22,56,78
p_223,13,0,e_0,339,341,392,7,3,0,14,4,1,2,2,51,53
p_226,12,0,e_0,331,346,392,8,4,0,13,2,1,2,15,46,61
p_228,11,0,e_0,325,351,392,9,4,0,11,5,1,2,26,41,67
p_212,9,0,e_0,348,359,392,1,5,0,12,4,1,1,11,33,44
p_206,6,0,e_0,362,370,392,10,6,2,9,4,1,1,8,22,30
p_205,1,0,e_0,362,387,392,15,6,2,9,4,1,0,25,5,30
p_239,13,0,e_2,305,347,398,13,0,0,0,3,0,0,42,51,93
p_224,13,0,e_2,335,347,398,8,3,0,9,5,0,1,12,51,63
p_213,12,0,e_2,347,352,398,4,5,0,13,2,0,2,5,46,51
p_219,11,0,e_2,342,357,398,3,4,0,12,5,0,1,15,41,56
p_204,8,0,e_2,364,368,398,8,6,2,9,4,1,1,4,30,34
p_215,6,0,e_2,346,376,398,4,4,1,13,2,0,1,30,22,52
p_196,5,0,e_2,376,381,398,8,7,3,6,1,1,0,5,17,22
p_238,2,0,e_3,311,320,436,2,0,0,0,3,0,0,9,116,125
p_233,2,0,e_3,319,320,436,12,1,1,2,2,0,1,1,116,117
p_230,5,0,e_3,323,333,436,11,3,2,2,5,1,2,10,103,113
p_236,8,0,e_3,313,344,436,8,1,0,0,5,0,1,31,92,123
p_217,8,0,e_3,345,346,436,2,3,1,8,5,1,2,1,90,91
p_229,9,0,e_3,323,351,436,7,2,0,2,5,1,1,28,85,113
p_227,9,0,e_3,326,351,436,6,4,0,3,5,1,3,25,85,110
p_220,9,0,e_3,342,351,436,1,4,0,8,5,1,3,9,85,94
p_218,9,0,e_3,343,351,436,1,4,0,8,5,1,3,8,85,93
p_207,12,0,e_3,355,362,436,6,6,2,10,5,1,5,7,74,81
p_208,13,0,e_3,355,367,436,5,5,1,10,5,1,4,12,69,81
p_202,13,0,e_3,365,367,436,3,6,1,12,5,1,5,2,69,71
p_201,13,0,e_3,366,367,436,2,7,1,13,5,1,6,1,69,70
p_211,14,0,e_3,348,372,436,6,5,0,8,5,1,4,24,64,88
p_203,12,0,e_3,365,380,436,4,6,2,12,5,1,5,15,56,71
p_186,1,0,e_0,391,397,490,8,10,5,0,3,1,0,6,93,99
p_185,2,0,e_0,392,402,490,7,9,5,0,5,0,1,10,88,98
p_184,5,0,e_0,393,413,490,4,9,2,0,5,0,2,20,77,97
p_160,10,0,e_0,421,430,490,23,10,10,7,5,1,4,9,60,69
p_181,11,0,e_0,395,435,490,28,9,9,1,5,0,4,40,55,95
p_159,11,0,e_0,424,435,490,21,10,10,8,5,1,5,11,55,66
p_183,12,0,e_0,393,440,490,27,9,9,0,5,0,3,47,50,97
p_153,8,0,e_0,438,454,490,16,10,3,12,5,1,3,16,36,52
p_147,7,0,e_0,450,459,490,14,9,4,9,4,1,4,9,31,40
p_138,7,0,e_0,456,459,490,3,8,8,8,4,1,4,3,31,34
p_166,5,0,e_0,415,467,490,29,11,11,5,5,1,2,52,23,75
p_163,4,0,e_0,417,472,490,30,10,10,6,5,1,3,55,18,73
p_133,4,0,e_0,463,472,490,21,7,6,6,4,1,4,9,18,27
p_150,3,0,e_0,444,477,490,19,10,7,11,4,1,3,33,13,46
p_148,3,0,e_0,447,477,490,19,9,7,10,4,1,4,30,13,43
p_193,12,0,e_1,378,423,495,30,8,8,2,4,1,0,45,72,117
p_161,13,0,e_1,418,428,495,21,10,10,11,5,0,4,10,67,77
p_190,14,0,e_1,382,433,495,28,8,8,1,4,1,1,51,62,113
p_180,14,0,e_1,396,433,495,24,9,9,3,5,0,2,37,62,99
p_172,14,0,e_1,405,433,495,23,10,10,6,5,0,2,28,62,90
p_165,14,0,e_1,416,433,495,20,10,10,10,5,0,4,17,62,79
p_162,14,0,e_1,417,433,495,20,10,10,10,5,0,4,16,62,78
p_158,14,0,e_1,426,433,495,18,10,10,12,5,1,4,7,62,69
p_168,15,0,e_1,412,438,495,20,10,10,9,5,0,3,26,57,83
p_152,10,0,e_1,439,455,495,14,10,2,15,4,1,1,16,40,56
p_146,10,0,e_1,451,455,495,11,8,2,11,4,1,2,4,40,44
p_167,7,0,e_1,412,466,495,28,10,10,8,5,0,2,54,29,83
p_135,7,0,e_1,461,466,495,18,7,5,9,4,1,3,5,29,34
p_132,7,0,e_1,463,466,495,18,7,5,8,4,1,3,3,29,32
p_129,5,0,e_1,470,474,495,18,6,5,6,4,1,2,4,21,25
p_179,6,0,e_2,397,418,522,2,9,1,0,3,1,0,21,104,125
p_176,6,0,e_2,398,418,522,2,9,1,0,5,0,1,20,104,124
p_177,9,0,e_2,398,429,522,29,9,9,0,5,0,1,31,93,124
p_173,10,0,e_2,405,434,522,27,10,10,2,5,0,2,29,88,117
p_170,10,0,e_2,408,434,522,26,11,11,3,5,0,3,26,88,114
p_169,11,0,e_2,410,439,522,24,11,11,3,5,0,3,29,83,112
p_164,12,0,e_2,416,444,522,22,10,10,6,5,0,4,28,78,106
p_157,12,0,e_2,427,444,522,20,10,10,9,5,1,4,17,78,95
p_151,15,0,e_2,443,455,522,14,10,0,12,5,1,3,12,67,79
p_149,15,0,e_2,444,455,522,13,10,0,12,2,1,3,11,67,78
p_142,15,0,e_2,452,455,522,12,8,0,14,5,1,4,3,67,70
p_140,13,0,e_2,455,463,522,9,7,7,15,2,1,3,8,59,67
p_139,13,0,e_2,456,463,522,9,8,8,15,4,1,4,7,59,66
p_137,13,0,e_2,458,463,522,13,8,1,14,4,1,4,5,59,64
p_145,12,0,e_2,451,468,522,9,8,0,14,5,1,3,17,54,71
p_216,1,0,e_3,346,441,570,9,3,1,8,2,1,2,95,129,224
p_156,1,0,e_3,428,441,570,1,10,0,2,4,1,9,13,129,142
p_175,2,0,e_3,399,446,570,6,9,4,8,4,1,8,47,124,171
p_222,3,0,e_3,339,451,570,8,3,2,7,5,1,2,112,119,231
p_174,3,0,e_3,402,451,570,4,10,2,7,1,1,9,49,119,168
p_171,3,0,e_3,408,451,570,3,11,2,6,4,1,10,43,119,162
p_214,4,0,e_3,346,456,570,6,4,1,8,5,1,3,110,114,224
p_192,5,0,e_3,380,461,570,7,7,3,12,4,1,6,81,109,190
p_182,5,0,e_3,394,461,570,4,9,2,9,4,1,8,67,109,176
p_178,5,0,e_3,398,461,570,3,9,1,8,4,1,8,63,109,172
p_191,7,0,e_3,382,469,570,5,8,3,12,4,1,7,87,101,188
p_189,7,0,e_3,387,469,570,4,9,2,11,4,1,8,82,101,183
p_187,7,0,e_3,391,469,570,2,10,1,9,4,1,9,78,101,179
p_197,8,0,e_3,375,474,570,6,6,2,14,4,1,5,99,96,195
p_188,8,0,e_3,390,474,570,2,10,1,10,4,1,9,84,96,180
p_143,2,0,e_1,451,503,583,19,8,7,11,4,1,2,52,80,132
p_144,4,0,e_1,451,511,583,17,8,6,11,4,1,3,60,72,132
p_125,4,0,e_1,474,511,583,18,5,4,5,1,1,2,37,72,109
p_108,5,0,e_1,509,516,583,10,6,5,3,5,1,3,7,67,74
p_104,7,0,e_1,516,524,583,6,7,4,5,2,1,3,8,59,67
p_114,9,0,e_1,494,532,583,9,6,2,0,3,1,3,38,51,89
p_115,10,0,e_1,494,537,583,8,6,2,0,3,1,2,43,46,89
p_100,10,0,e_1,522,537,583,2,7,1,6,5,1,4,15,46,61
p_97,10,0,e_1,526,537,583,1,8,0,7,5,1,4,11,46,57
p_89,7,0,e_1,537,548,583,2,9,0,10,4,1,4,11,35,46
p_94,6,0,e_1,528,553,583,4,9,1,8,5,1,5,25,30,55
p_80,6,0,e_1,548,553,583,30,9,9,7,1,1,6,5,30,35
p_96,5,0,e_1,527,558,583,6,8,3,7,5,1,4,31,25,56
p_83,5,0,e_1,546,558,583,2,9,1,7,4,1,5,12,25,37
p_106,4,0,e_1,512,563,583,10,6,4,4,5,1,3,51,20,71
p_136,2,0,e_0,460,498,588,23,8,6,7,4,1,3,38,90,128
p_116,7,0,e_0,490,515,588,12,6,3,0,5,0,2,25,73,98
p_117,12,0,e_0,490,532,588,7,6,2,0,5,0,1,42,56,98
p_101,12,0,e_0,521,532,588,30,7,7,8,5,1,3,11,56,67
p_103,13,0,e_0,517,537,588,30,7,7,7,5,1,2,20,51,71
p_92,13,0,e_0,533,537,588,27,9,9,12,5,1,2,4,51,55
p_91,13,0,e_0,535,537,588,26,9,9,12,5,1,2,2,51,53
p_86,6,0,e_0,541,560,588,1,10,0,12,4,1,2,19,28,47
p_77,6,0,e_0,557,560,588,28,10,10,7,4,1,4,3,28,31
p_105,4,0,e_0,515,568,588,10,6,4,7,2,1,1,53,20,73
p_85,3,0,e_0,542,573,588,4,10,1,12,4,1,3,31,15,46
p_90,2,0,e_0,536,578,588,7,9,2,13,2,1,1,42,10,52
p_64,1,0,e_0,579,583,588,27,9,8,2,4,1,0,4,5,9
p_99,1,0,e_1,522,588,657,11,7,4,7,5,1,4,66,69,135
p_81,2,0,e_1,547,593,657,4,10,0,7,1,1,5,46,64,110
p_71,2,0,e_1,569,593,657,28,10,10,3,4,1,3,24,64,88
p_84,3,0,e_1,546,598,657,4,9,1,7,4,1,5,52,59,111
p_82,3,0,e_1,547,598,657,3,10,0,7,1,1,5,51,59,110
p_78,4,0,e_1,555,603,657,30,10,10,6,4,1,5,48,54,102
p_42,4,0,e_1,600,603,657,18,7,6,3,5,1,5,3,54,57
p_40,4,0,e_1,601,603,657,18,7,6,3,5,1,5,2,54,56
p_61,5,0,e_1,583,608,657,22,9,8,0,3,1,4,25,49,74
p_49,5,0,e_1,592,608,657,19,8,7,2,2,1,5,16,49,65
p_45,5,0,e_1,597,608,657,18,7,6,3,5,1,5,11,49,60
p_59,6,0,e_1,584,613,657,20,9,7,0,5,0,6,29,44,73
p_57,6,0,e_1,587,613,657,19,9,7,1,2,0,6,26,44,70
p_47,6,0,e_1,594,613,657,18,8,7,2,5,1,5,19,44,63
p_60,9,0,e_1,584,624,657,17,9,5,0,5,0,5,40,33,73
p_110,1,0,e_2,501,527,662,15,6,1,5,4,1,7,26,135,161
p_107,1,0,e_2,512,527,662,13,6,4,2,4,1,8,15,135,150
p_155,3,0,e_2,434,535,662,28,10,10,10,2,1,2,101,127,228
p_118,4,0,e_2,488,540,662,15,7,3,7,4,1,7,52,122,174
p_122,5,0,e_2,477,545,662,16,6,4,10,4,1,5,68,117,185
p_119,5,0,e_2,483,545,662,15,7,4,9,4,1,6,62,117,179
p_126,6,0,e_2,473,550,662,16,5,4,11,4,1,5,77,112,189
p_154,7,0,e_2,438,555,662,17,10,4,11,2,1,2,117,107,224
p_131,9,0,e_2,467,563,662,15,7,3,12,1,1,2,96,99,195
p_130,9,0,e_2,469,563,662,14,6,3,12,4,1,3,94,99,193
p_128,10,0,e_2,471,568,662,13,6,3,12,4,1,3,97,94,191
p_74,11,0,e_2,567,573,662,20,10,10,10,5,1,5,6,89,95
p_134,12,0,e_2,462,578,662,13,7,1,13,4,1,4,116,84,200
p_66,12,0,e_2,577,578,662,16,9,2,12,5,1,8,1,84,85
p_65,12,0,e_2,578,580,662,16,9,2,12,5,1,7,2,82,84
p_56,2,0,e_0,588,597,665,23,9,8,0,3,0,0,9,68,77
p_55,4,0,e_0,590,605,665,20,9,7,0,5,0,3,15,60,75
p_54,6,0,e_0,590,613,665,19,9,7,0,5,0,1,23,52,75
p_53,9,0,e_0,590,624,665,16,9,5,0,5,0,2,34,41,75
p_50,10,0,e_0,592,629,665,14,8,4,0,5,0,4,37,36,73
p_41,10,0,e_0,600,629,665,12,7,4,3,5,1,4,29,36,65
p_37,7,0,e_0,633,640,665,22,1,0,9,4,1,0,7,25,32
p_35,4,0,e_0,640,651,665,9,3,1,7,1,1,0,11,14,25
p_102,2,0,e_3,521,578,686,10,6,3,12,4,1,5,57,108,165
p_98,6,0,e_3,524,592,686,5,7,2,11,1,1,6,68,94,162
p_95,6,0,e_3,527,592,686,5,8,2,11,4,1,7,65,94,159
p_93,7,0,e_3,529,597,686,3,9,1,10,4,1,8,68,89,157
p_198,9,0,e_3,368,605,686,6,6,1,13,5,1,5,237,81,318
p_195,9,0,e_3,376,605,686,4,7,1,13,4,1,6,229,81,310
p_121,9,0,e_3,480,605,686,12,5,4,9,5,1,4,125,81,206
p_120,10,0,e_3,481,610,686,11,6,4,9,5,1,5,129,76,205
p_194,11,0,e_3,377,615,686,2,7,1,13,4,1,6,238,71,309
p_113,11,0,e_3,496,615,686,7,6,2,12,5,1,5,119,71,190
p_200,12,0,e_3,367,620,686,3,6,1,13,2,1,5,253,66,319
p_123,12,0,e_3,474,620,686,10,5,1,8,2,1,4,146,66,212
p_124,14,0,e_3,474,628,686,8,5,1,8,2,1,4,154,58,212
p_109,14,0,e_3,506,628,686,1,7,0,15,5,1,6,122,58,180
p_141,15,0,e_3,455,633,686,11,7,7,4,3,1,6,178,53,231
p_30,5,0,e_0,676,693,722,28,5,5,0,3,0,0,17,29,46
p_28,6,0,e_0,679,698,722,26,5,5,1,5,0,1,19,24,43
p_26,3,0,e_0,698,709,722,23,4,4,6,2,1,1,11,13,24
p_27,2,0,e_0,693,714,722,26,4,4,5,2,0,1,21,8,29
p_43,3,0,e_1,599,668,761,20,7,6,3,5,1,4,69,93,162
p_38,4,0,e_1,627,673,761,12,3,1,9,4,1,1,46,88,134
p_34,15,0,e_1,643,708,761,27,3,3,4,4,1,1,65,53,118
p_29,15,0,e_1,678,708,761,17,5,5,5,5,1,1,30,53,83
p_22,10,0,e_1,712,725,761,13,4,2,14,4,1,2,13,36,49
p_25,7,0,e_1,703,736,761,18,4,3,14,5,1,1,33,25,58
p_24,5,0,e_1,707,744,761,19,4,3,15,5,1,2,37,17,54
p_23,5,0,e_1,709,744,761,19,4,3,15,4,1,2,35,17,52
p_51,1,0,e_2,591,667,784,23,9,7,15,5,1,7,76,117,193
p_48,2,0,e_2,593,672,784,22,8,7,15,2,1,9,79,112,191
p_70,3,0,e_2,572,677,784,27,9,8,11,5,1,6,105,107,212
p_62,5,0,e_2,582,685,784,22,9,8,12,5,1,7,103,99,202
p_73,6,0,e_2,568,690,784,24,10,10,10,5,1,5,122,94,216
p_76,7,0,e_2,559,695,784,26,10,10,8,5,1,5,136,89,225
p_67,8,0,e_2,574,700,784,21,9,6,11,5,1,7,126,84,210
p_63,8,0,e_2,581,700,784,19,9,6,12,5,1,7,119,84,203
p_69,10,0,e_2,573,708,784,20,9,4,11,5,1,6,135,76,211
p_58,10,0,e_2,586,708,784,16,9,4,14,5,1,8,122,76,198
p_52,11,0,e_2,591,713,784,13,9,3,15,5,1,9,122,71,193
p_46,13,0,e_2,596,721,784,10,7,2,15,4,1,10,125,63,188
p_88,14,0,e_2,538,726,784,24,9,9,4,5,1,7,188,58,246
p_79,14,0,e_2,549,726,784,22,9,9,6,2,1,6,177,58,235
p_75,14,0,e_2,563,726,784,18,9,9,9,2,1,5,163,58,221
p_32,5,0,e_3,657,703,788,3,4,0,8,4,1,3,46,85,131
p_31,5,0,e_3,662,703,788,2,5,0,7,4,1,4,41,85,126
p_33,8,0,e_3,647,714,788,3,2,0,11,1,1,1,67,74,141
p_36,11,0,e_3,635,725,788,4,1,0,15,4,1,0,90,63,153
p_127,15,0,e_3,473,739,788,7,5,0,8,2,1,4,266,49,315
p_112,15,0,e_3,497,739,788,3,6,0,12,5,1,5,242,49,291
p_111,15,0,e_3,501,739,788,1,6,0,14,2,1,5,238,49,287
p_44,15,0,e_3,598,739,788,8,7,0,7,5,1,6,141,49,190
p_39,15,0,e_3,609,739,788,5,6,0,10,5,1,5,130,49,179
p_20,9,0,e_3,737,759,788,6,2,0,15,5,1,1,22,29,51
p_18,2,0,e_0,768,776,866,5,1,0,0,3,0,0,8,90,98
p_17,15,0,e_0,772,817,866,20,1,1,1,5,0,1,45,49,94
p_15,15,0,e_0,782,817,866,17,1,1,3,5,1,1,35,49,84
p_14,15,0,e_0,790,817,866,15,0,0,6,5,1,1,27,49,76
p_11,11,0,e_0,810,831,866,11,0,0,13,5,1,1,21,35,56
p_13,11,0,e_1,794,810,867,11,0,0,6,5,0,1,16,57,73
p_16,13,0,e_1,774,818,867,22,1,1,0,3,0,0,44,49,93
p_12,13,0,e_1,796,818,867,13,0,0,6,5,0,2,22,49,71
p_10,14,0,e_1,810,823,867,14,0,0,11,5,1,1,13,44,57
p_3,1,0,e_0,876,882,887,19,3,2,0,3,0,0,6,5,11
p_21,10,0,e_2,732,816,888,7,2,1,15,4,1,1,84,72,156
p_19,12,0,e_2,740,824,888,3,2,0,13,4,1,3,84,64,148
p_68,14,0,e_2,574,832,888,15,9,1,11,5,1,8,258,56,314
p_87,15,0,e_2,539,837,888,23,10,10,4,3,1,7,298,51,349
p_72,15,0,e_2,569,837,888,15,10,10,10,5,1,6,268,51,319
p_5,5,0,e_2,860,869,888,20,3,2,8,4,1,0,9,19,28
p_4,1,0,e_2,864,883,888,23,3,2,7,4,1,1,19,5,24
p_2,3,0,e_1,878,890,903,16,3,2,0,3,0,0,12,13,25
p_1,2,0,e_1,889,895,903,14,2,1,3,5,0,1,6,8,14
p_8,1,0,e_3,847,851,940,3,1,1,0,5,0,1,4,89,93
p_9,2,0,e_3,845,856,940,2,0,0,0,3,0,0,11,84,95
p_7,12,0,e_3,851,888,940,11,2,0,1,5,1,1,37,52,89
p_6,14,0,e_3,858,896,940,12,2,0,2,5,1,1,38,44,82
p_299,3,0,e_1,7,19,32,3,0,0,0,3,0,0,12,13,25
p_296,1,0,e_1,20,27,32,23,1,1,3,4,1,0,7,5,12
p_298,4,0,e_2,10,24,46,4,0,0,0,3,0,0,14,22,36
p_295,5,0,e_2,22,29,46,18,1,1,4,5,0,1,7,17,24
p_300,8,0,e_0,4,30,98,8,0,0,0,3,0,0,26,68,94
p_292,11,0,e_0,30,41,98,16,2,2,8,2,0,1,11,57,68
p_294,13,0,e_0,23,49,98,12,1,0,6,5,0,1,26,49,75
p_287,12,0,e_0,51,54,98,8,2,1,13,4,1,1,3,44,47
p_282,6,0,e_0,62,74,98,11,2,1,10,4,1,2,12,24,36
p_285,2,0,e_0,54,88,98,17,2,2,12,1,1,1,34,10,44
p_275,2,0,e_0,84,88,98,8,3,0,3,4,1,2,4,10,14
p_288,1,0,e_0,49,93,98,20,2,2,13,2,1,0,44,5,49
p_297,12,0,e_3,18,57,121,12,0,0,0,3,0,0,39,64,103
p_293,15,0,e_3,26,68,121,13,1,0,2,5,0,1,42,53,95
p_277,10,0,e_3,81,85,121,1,2,0,11,4,1,1,4,36,40
p_274,4,0,e_3,84,105,121,6,3,0,10,4,1,2,21,16,37
p_279,2,0,e_3,76,113,121,11,1,0,13,4,1,0,37,8,45
p_286,3,0,e_2,51,59,130,17,2,2,1,5,0,1,8,71,79
p_289,7,0,e_2,47,73,130,14,2,2,0,3,0,0,26,57,83
p_283,10,0,e_2,55,84,130,8,2,1,2,5,0,2,29,46,75
p_281,10,0,e_2,63,84,130,7,2,1,4,5,1,2,21,46,67
p_280,12,0,e_2,65,92,130,4,2,1,5,5,1,2,27,38,65
p_290,4,0,e_1,43,49,137,19,2,2,2,5,0,1,6,88,94
p_291,6,0,e_1,35,57,137,19,2,2,0,3,0,0,22,80,102
p_284,14,0,e_1,55,83,137,4,2,1,5,5,1,1,28,54,82
p_278,15,0,e_1,80,88,137,27,2,2,13,5,1,1,8,49,57
p_276,5,0,e_1,82,120,137,6,3,1,14,2,1,1,38,17,55
p_269,4,0,e_1,146,161,177,13,1,1,0,3,0,0,15,16,31
p_267,1,0,e_1,153,172,177,13,1,1,2,5,0,1,19,5,24
p_270,7,0,e_2,133,157,182,14,1,1,0,3,0,0,24,25,49
p_264,5,0,e_2,162,165,182,14,1,1,6,4,1,0,3,17,20
p_273,13,0,e_0,95,139,200,24,3,3,1,4,1,0,44,61,105
p_272,15,0,e_0,105,147,200,19,2,2,2,5,0,1,42,53,95
p_268,10,0,e_0,150,164,200,5,1,1,14,4,1,0,14,36,50
p_262,6,0,e_0,164,178,200,13,3,2,10,1,1,0,14,22,36
p_259,6,0,e_0,174,178,200,11,3,1,7,4,1,1,4,22,26
p_258,5,0,e_0,175,183,200,11,3,1,7,4,1,1,8,17,25
p_254,3,0,e_0,199,211,224,7,2,1,0,3,1,0,12,13,25
p_252,2,0,e_0,212,216,224,5,1,0,3,4,1,0,4,8,12
p_271,11,0,e_3,127,163,232,11,0,0,0,3,0,0,36,69,105
p_263,12,0,e_3,163,168,232,7,2,1,11,5,1,1,5,64,69
p_266,15,0,e_3,155,179,232,7,1,0,8,5,0,1,24,53,77
p_261,12,0,e_3,170,190,232,6,2,1,12,5,1,1,20,42,62
p_257,12,0,e_3,179,190,232,3,2,0,15,4,1,1,11,42,53
p_255,10,0,e_3,192,198,232,2,2,0,12,4,1,1,6,34,40
p_256,8,0,e_3,191,206,232,4,1,0,12,4,1,0,15,26,41
p_251,4,0,e_0,228,243,257,27,1,1,0,3,0,0,15,14,29
p_260,13,0,e_2,171,223,266,5,3,1,4,4,1,0,52,43,95
p_249,7,0,e_2,238,243,266,7,1,0,9,4,1,0,5,23,28
p_265,12,0,e_1,157,215,275,9,2,1,3,5,0,2,58,60,118
p_253,15,0,e_1,208,226,275,23,1,1,10,5,0,1,18,49,67
p_248,7,0,e_1,246,252,275,4,1,0,9,4,1,0,6,23,29
p_250,7,0,e_3,236,259,316,7,0,0,0,3,0,0,23,57,80
p_247,12,0,e_3,248,276,316,8,1,0,4,5,0,1,28,40,68
p_242,4,0,e_3,287,302,316,5,1,0,9,4,1,0,15,14,29
p_244,2,0,e_2,271,277,331,12,2,1,0,5,0,1,6,54,60
p_245,9,0,e_2,269,300,331,5,2,1,0,3,0,0,31,31,62
p_238,2,0,e_2,311,323,331,30,2,2,6,4,1,0,12,8,20
p_246,12,0,e_0,257,295,337,5,2,0,0,3,1,0,38,42,80
p_237,5,0,e_0,313,318,337,26,2,2,6,4,1,0,5,19,24
p_233,2,0,e_0,319,329,337,23,2,2,5,4,1,0,10,8,18
p_243,8,0,e_1,285,312,394,1,1,0,0,3,0,0,27,82,109
p_241,13,0,e_1,300,329,394,22,2,2,4,5,0,1,29,65,94
p_240,14,0,e_1,301,334,394,20,2,2,4,5,0,2,33,60,93
p_234,14,0,e_1,314,334,394,16,3,3,8,5,1,3,20,60,80
p_224,13,0,e_1,335,339,394,8,5,0,14,4,1,2,4,55,59
p_226,12,0,e_1,331,344,394,10,5,1,13,5,1,2,13,50,63
p_218,9,0,e_1,343,355,394,9,4,3,12,1,1,2,12,39,51
p_212,9,0,e_1,348,355,394,10,5,4,11,4,1,4,7,39,46
p_236,8,0,e_1,313,360,394,23,2,2,8,5,1,2,47,34,81
p_217,8,0,e_1,345,360,394,10,4,3,12,4,1,3,15,34,49
p_206,6,0,e_1,362,368,394,10,4,2,8,4,1,3,6,26,32
p_214,4,0,e_1,346,376,394,14,4,3,12,4,1,3,30,18,48
p_210,4,0,e_1,353,376,394,14,4,3,9,4,1,4,23,18,41
p_222,3,0,e_1,339,381,394,17,5,4,13,4,1,2,42,13,55
p_209,2,0,e_1,354,386,394,16,4,3,9,4,1,4,32,8,40
p_232,5,0,e_3,320,333,428,20,2,2,1,5,0,2,13,95,108
p_235,8,0,e_3,314,344,428,23,2,2,1,4,1,1,30,84,114
p_231,10,0,e_3,320,352,428,15,3,1,1,5,0,3,32,76,108
p_228,11,0,e_3,325,357,428,12,4,1,3,5,0,4,32,71,103
p_239,13,0,e_3,305,365,428,21,1,1,4,4,1,0,60,63,123
p_211,14,0,e_3,348,370,428,5,4,0,9,5,1,3,22,58,80
p_198,9,0,e_3,368,387,428,5,5,0,14,5,1,4,19,41,60
p_204,8,0,e_3,364,392,428,7,4,1,13,5,1,3,28,36,64
p_187,7,0,e_3,391,397,428,1,3,0,8,1,1,2,6,31,37
p_179,6,0,e_3,397,402,428,1,3,0,7,4,1,2,5,26,31
p_174,3,0,e_3,402,413,428,3,3,0,6,4,1,2,11,15,26
p_199,2,0,e_3,368,418,428,13,4,1,13,5,1,3,50,10,60
p_185,2,0,e_3,392,418,428,6,4,1,8,1,1,3,26,10,36
p_175,2,0,e_3,399,418,428,5,4,1,7,4,1,3,19,10,29
p_205,1,0,e_3,362,423,428,15,3,2,12,5,1,2,61,5,66
p_230,5,0,e_2,323,348,429,19,4,3,2,4,1,1,25,81,106
p_229,9,0,e_2,323,362,429,15,4,2,2,1,1,0,39,67,106
p_220,9,0,e_2,342,362,429,10,5,3,3,5,0,3,20,67,87
p_225,10,0,e_2,333,367,429,11,4,2,0,5,0,2,34,62,96
p_219,11,0,e_2,342,372,429,7,5,1,3,5,0,3,30,57,87
p_213,12,0,e_2,347,377,429,6,4,1,5,5,0,5,30,52,82
p_207,12,0,e_2,355,377,429,6,4,2,7,5,1,5,22,52,74
p_203,12,0,e_2,365,377,429,3,4,1,10,5,1,4,12,52,64
p_200,12,0,e_2,367,377,429,3,4,1,10,2,1,3,10,52,62
p_194,11,0,e_2,377,382,429,1,5,0,12,4,1,4,5,47,52
p_195,9,0,e_2,376,390,429,3,5,0,12,2,1,3,14,39,53
p_197,8,0,e_2,375,395,429,5,5,1,12,5,1,2,20,34,54
p_188,8,0,e_2,390,395,429,1,4,0,9,1,1,3,5,34,39
p_176,6,0,e_2,398,403,429,1,4,0,7,4,1,2,5,26,31
p_196,5,0,e_2,376,408,429,7,5,2,12,5,1,3,32,21,53
p_221,4,0,e_0,341,351,449,15,5,4,1,5,0,2,10,98,108
p_215,6,0,e_0,346,359,449,12,4,3,3,5,0,3,13,90,103
p_227,9,0,e_0,326,370,449,14,5,3,3,4,1,1,44,79,123
p_193,12,0,e_0,378,381,449,30,5,5,11,5,1,1,3,68,71
p_223,13,0,e_0,339,386,449,7,5,0,0,5,0,1,47,63,110
p_208,13,0,e_0,355,386,449,4,4,1,5,5,1,3,31,63,94
p_202,13,0,e_0,365,386,449,2,4,1,8,5,1,2,21,63,84
p_201,13,0,e_0,366,386,449,2,4,1,8,5,1,2,20,63,83
p_190,14,0,e_0,382,391,449,27,5,5,12,5,1,3,9,58,67
p_183,12,0,e_0,393,399,449,26,4,4,14,4,1,3,6,50,56
p_177,9,0,e_0,398,410,449,28,4,4,12,4,1,4,12,39,51
p_191,7,0,e_0,382,418,449,4,5,2,12,5,1,2,36,31,67
p_167,7,0,e_0,412,418,449,26,4,4,9,4,1,3,6,31,37
p_192,5,0,e_0,380,426,449,6,5,2,12,2,1,1,46,23,69
p_166,5,0,e_0,415,426,449,28,3,3,8,4,1,3,11,23,34
p_189,7,0,e_1,387,417,514,2,4,1,2,4,1,0,30,97,127
p_173,10,0,e_1,405,428,514,25,4,4,3,5,0,3,23,86,109
p_181,11,0,e_1,395,433,514,27,4,4,0,5,0,1,38,81,119
p_169,11,0,e_1,410,433,514,23,4,4,5,5,0,4,23,81,104
p_164,12,0,e_1,416,438,514,20,3,3,7,2,0,4,22,76,98
p_157,12,0,e_1,427,438,514,18,4,4,10,5,1,5,11,76,87
p_180,14,0,e_1,396,446,514,23,3,3,0,5,0,2,50,68,118
p_172,14,0,e_1,405,446,514,21,4,4,3,5,0,3,41,68,109
p_165,14,0,e_1,416,446,514,18,3,3,7,2,0,5,30,68,98
p_162,14,0,e_1,417,446,514,18,3,3,7,2,0,5,29,68,97
p_158,14,0,e_1,426,446,514,16,4,4,9,5,1,5,20,68,88
p_168,15,0,e_1,412,451,514,18,4,4,5,5,0,4,39,63,102
p_151,15,0,e_1,443,451,514,10,3,0,13,5,1,2,8,63,71
p_140,13,0,e_1,455,459,514,9,4,1,14,4,1,3,4,55,59
p_145,12,0,e_1,451,464,514,11,4,2,15,2,1,1,13,50,63
p_216,1,0,e_2,346,434,535,17,4,3,5,5,0,4,88,101,189
p_171,3,0,e_2,408,442,535,1,4,0,5,4,1,2,34,93,127
p_184,5,0,e_2,393,450,535,3,4,1,8,4,1,3,57,85,142
p_182,5,0,e_2,394,450,535,3,4,1,8,4,1,3,56,85,141
p_178,5,0,e_2,398,450,535,2,4,1,7,4,1,3,52,85,137
p_154,7,0,e_2,438,458,535,16,3,3,2,5,1,3,20,77,97
p_153,8,0,e_2,438,463,535,15,3,3,2,5,1,4,25,72,97
p_170,10,0,e_2,408,471,535,24,4,4,5,4,1,1,63,64,127
p_152,10,0,e_2,439,471,535,13,3,2,2,5,1,5,32,64,96
p_146,10,0,e_2,451,471,535,13,4,3,5,5,1,3,20,64,84
p_128,10,0,e_2,471,471,535,8,3,2,10,2,1,2,0,64,64
p_139,13,0,e_2,456,484,535,8,4,1,6,5,1,3,28,51,79
p_137,13,0,e_2,458,484,535,7,4,1,7,5,1,3,26,51,77
p_114,9,0,e_2,494,498,535,2,5,1,10,4,1,3,4,37,41
p_116,7,0,e_2,490,506,535,5,5,2,11,4,1,2,16,29,45
p_160,10,0,e_3,421,460,538,22,3,3,2,4,1,2,39,78,117
p_159,11,0,e_3,424,465,538,20,3,3,1,4,1,2,41,73,114
p_161,13,0,e_3,418,473,538,19,2,2,2,1,1,1,55,65,120
p_149,15,0,e_3,444,481,538,10,3,0,5,5,0,3,37,57,94
p_142,15,0,e_3,452,481,538,8,4,0,7,5,0,4,29,57,86
p_141,15,0,e_3,455,481,538,7,4,0,8,5,0,4,26,57,83
p_127,15,0,e_3,473,481,538,2,3,0,13,5,1,2,8,57,65
p_120,10,0,e_3,481,498,538,7,4,0,15,2,1,3,17,40,57
p_115,10,0,e_3,494,498,538,1,5,0,11,4,1,4,4,40,44
p_121,9,0,e_3,480,503,538,6,4,0,15,5,1,3,23,35,58
p_126,6,0,e_3,473,514,538,11,2,1,13,2,1,1,41,24,65
p_122,5,0,e_3,477,519,538,11,3,1,14,5,1,2,42,19,61
p_102,2,0,e_3,521,530,538,3,2,0,5,4,1,1,9,8,17
p_186,1,0,e_0,391,454,569,7,4,1,14,2,1,2,63,115,178
p_156,1,0,e_0,428,454,569,25,3,3,5,4,1,2,26,115,141
p_155,3,0,e_0,434,462,569,22,3,3,4,4,1,1,28,107,135
p_163,4,0,e_0,417,467,569,28,2,2,7,4,1,3,50,102,152
p_144,4,0,e_0,451,467,569,19,4,4,0,5,0,4,16,102,118
p_147,7,0,e_0,450,478,569,16,4,4,0,5,0,3,28,91,119
p_138,7,0,e_0,456,478,569,14,4,4,1,5,1,3,22,91,113
p_135,7,0,e_0,461,478,569,13,4,3,3,2,1,2,17,91,108
p_134,12,0,e_0,462,495,569,8,4,2,3,2,1,2,33,74,107
p_123,12,0,e_0,474,495,569,5,3,1,6,5,1,2,21,74,95
p_117,12,0,e_0,490,495,569,30,5,5,10,5,1,2,5,74,79
p_124,14,0,e_0,474,503,569,3,3,1,6,5,1,2,29,66,95
p_112,15,0,e_0,497,508,569,25,4,4,12,5,1,2,11,61,72
p_111,15,0,e_0,501,508,569,24,4,4,14,5,1,3,7,61,68
p_109,14,0,e_0,506,513,569,24,3,3,14,5,1,2,7,56,63
p_110,1,0,e_1,501,519,632,8,4,2,3,4,1,4,18,113,131
p_143,2,0,e_1,451,524,632,21,4,4,15,4,1,2,73,108,181
p_136,2,0,e_1,460,524,632,18,4,3,13,4,1,3,64,108,172
p_150,3,0,e_1,444,529,632,18,3,3,13,5,1,2,85,103,188
p_148,3,0,e_1,447,529,632,21,4,4,14,5,1,2,82,103,185
p_133,4,0,e_1,463,534,632,15,4,2,12,4,1,3,71,98,169
p_118,4,0,e_1,488,534,632,9,5,4,6,4,1,5,46,98,144
p_132,7,0,e_1,463,545,632,12,4,2,12,1,1,3,82,87,169
p_131,9,0,e_1,467,553,632,10,3,2,12,4,1,4,86,79,165
p_130,9,0,e_1,469,553,632,9,3,2,11,4,1,5,84,79,163
p_103,13,0,e_1,517,567,632,22,2,2,0,5,0,6,50,65,115
p_92,13,0,e_1,533,567,632,19,2,2,4,5,1,4,34,65,99
p_88,14,0,e_1,538,572,632,14,2,2,5,5,1,3,34,60,94
p_79,14,0,e_1,549,572,632,14,3,1,8,5,1,3,23,60,83
p_66,12,0,e_1,577,580,632,7,3,1,13,4,1,6,3,52,55
p_107,1,0,e_2,512,540,647,6,3,2,5,4,1,2,28,107,135
p_99,1,0,e_2,522,540,647,4,3,1,3,4,1,2,18,107,125
p_125,4,0,e_2,474,551,647,13,3,1,10,5,1,2,77,96,173
p_106,4,0,e_2,512,551,647,3,3,2,5,4,1,2,39,96,135
p_105,4,0,e_2,515,551,647,2,2,1,5,4,1,2,36,96,132
p_129,5,0,e_2,470,556,647,13,3,2,10,2,1,1,86,91,177
p_119,5,0,e_2,483,556,647,10,5,3,13,5,1,3,73,91,164
p_108,5,0,e_2,509,556,647,3,3,1,7,4,1,2,47,91,138
p_80,6,0,e_2,548,561,647,22,3,2,3,5,1,3,13,86,99
p_77,6,0,e_2,557,561,647,20,3,2,5,5,1,2,4,86,90
p_76,7,0,e_2,559,566,647,18,3,2,5,5,1,2,7,81,88
p_91,13,0,e_2,535,586,647,18,2,2,0,5,0,3,51,61,112
p_75,14,0,e_2,563,591,647,10,3,1,6,5,1,2,28,56,84
p_68,14,0,e_2,574,591,647,6,3,1,9,5,1,3,17,56,73
p_52,11,0,e_2,591,602,647,4,5,0,14,4,1,4,11,45,56
p_90,2,0,e_3,536,546,650,29,2,2,1,4,1,1,10,104,114
p_81,2,0,e_3,547,548,650,26,3,2,2,5,1,2,1,102,103
p_101,12,0,e_3,521,580,650,23,1,1,5,4,1,0,59,70,129
p_87,15,0,e_3,539,591,650,15,2,0,0,5,0,2,52,59,111
p_72,15,0,e_3,569,591,650,6,3,0,9,5,1,2,22,59,81
p_46,13,0,e_3,596,599,650,1,6,0,14,4,1,5,3,51,54
p_50,10,0,e_3,592,610,650,5,5,0,15,4,1,4,18,40,58
p_63,8,0,e_3,581,618,650,10,3,1,12,5,1,2,37,32,69
p_62,5,0,e_3,582,629,650,13,4,1,12,5,1,3,47,21,68
p_61,5,0,e_3,583,629,650,12,5,1,13,5,1,4,46,21,67
p_55,4,0,e_3,590,634,650,11,5,0,15,5,1,4,44,16,60
p_38,4,0,e_3,627,634,650,1,4,0,5,4,1,3,7,16,23
p_64,1,0,e_3,579,645,650,17,3,1,12,5,1,2,66,5,71
p_51,1,0,e_3,591,645,650,14,5,0,15,2,1,4,54,5,59
p_85,3,0,e_0,542,580,687,26,3,2,7,4,1,4,38,107,145
p_84,3,0,e_0,546,580,687,25,2,2,6,4,1,5,34,107,141
p_82,3,0,e_0,547,580,687,25,3,2,6,4,1,5,33,107,140
p_96,5,0,e_0,527,588,687,28,3,3,10,4,1,3,61,99,160
p_83,5,0,e_0,546,588,687,23,3,2,6,4,1,5,42,99,141
p_98,6,0,e_0,524,593,687,28,3,3,11,4,1,2,69,94,163
p_95,6,0,e_0,527,593,687,27,3,3,10,4,1,5,66,94,160
p_94,6,0,e_0,528,593,687,26,3,3,10,1,1,4,65,94,159
p_86,6,0,e_0,541,593,687,23,3,2,7,4,1,4,52,94,146
p_104,7,0,e_0,516,598,687,29,2,2,13,4,1,1,82,89,171
p_93,7,0,e_0,529,598,687,25,3,3,10,4,1,4,69,89,158
p_89,7,0,e_0,537,598,687,23,3,3,8,4,1,5,61,89,150
p_100,10,0,e_0,522,609,687,24,3,3,11,4,1,2,87,78,165
p_97,10,0,e_0,526,609,687,23,3,3,11,4,1,3,83,78,161
p_113,11,0,e_0,496,614,687,29,5,5,12,5,1,1,118,73,191
p_32,5,0,e_3,657,675,692,5,0,0,0,3,0,0,18,17,35
p_31,5,0,e_3,662,675,692,4,1,0,1,5,0,1,13,17,30
p_56,2,0,e_2,588,655,723,14,5,1,13,5,1,4,67,68,135
p_59,6,0,e_2,584,669,723,11,5,1,13,5,1,3,85,54,139
p_57,6,0,e_2,587,669,723,10,5,1,13,5,1,4,82,54,136
p_67,8,0,e_2,574,677,723,12,3,2,9,5,1,2,103,46,149
p_60,9,0,e_2,584,682,723,8,5,1,13,5,1,4,98,41,139
p_53,9,0,e_2,590,682,723,8,5,0,14,2,1,4,92,41,133
p_41,10,0,e_2,600,687,723,3,6,0,11,4,1,5,87,36,123
p_26,3,0,e_2,698,710,723,6,1,1,7,4,1,1,12,13,25
p_27,2,0,e_2,693,715,723,8,1,1,8,4,1,0,22,8,30
p_71,2,0,e_1,569,640,742,19,3,2,13,5,1,4,71,102,173
p_70,3,0,e_1,572,645,742,18,3,2,14,2,1,4,73,97,170
p_43,3,0,e_1,599,645,742,10,6,4,8,4,1,7,46,97,143
p_78,4,0,e_1,555,650,742,22,3,2,9,5,1,2,95,92,187
p_42,4,0,e_1,600,650,742,9,6,3,7,4,1,7,50,92,142
p_40,4,0,e_1,601,650,742,9,6,3,7,4,1,7,49,92,141
p_49,5,0,e_1,592,655,742,10,6,2,10,4,1,5,63,87,150
p_45,5,0,e_1,597,655,742,8,7,2,8,4,1,7,58,87,145
p_73,6,0,e_1,568,660,742,16,3,2,13,5,1,3,92,82,174
p_54,6,0,e_1,590,660,742,9,6,0,10,4,1,5,70,82,152
p_47,6,0,e_1,594,660,742,8,6,2,9,4,1,7,66,82,148
p_69,10,0,e_1,573,674,742,10,3,2,14,4,1,5,101,68,169
p_58,10,0,e_1,586,674,742,6,5,1,11,4,1,5,88,68,156
p_74,11,0,e_1,567,679,742,11,3,2,13,5,1,2,112,63,175
p_36,11,0,e_1,635,679,742,23,2,2,0,5,0,7,44,63,107
p_30,5,0,e_3,676,709,762,30,1,1,5,4,1,0,33,53,86
p_24,5,0,e_3,707,709,762,5,2,1,4,5,0,2,2,53,55
p_23,5,0,e_3,709,709,762,4,1,1,5,2,0,1,0,53,53
p_25,7,0,e_3,703,719,762,4,1,0,3,5,0,1,16,43,59
p_22,10,0,e_3,712,730,762,5,2,0,5,5,1,1,18,32,50
p_48,2,0,e_0,593,695,791,13,6,4,6,5,1,4,102,96,198
p_35,4,0,e_0,640,703,791,29,2,2,12,4,1,4,63,88,151
p_37,7,0,e_0,633,714,791,27,3,3,14,4,1,3,81,77,158
p_33,8,0,e_0,647,719,791,23,1,1,11,4,1,5,72,72,144
p_65,12,0,e_0,578,733,791,7,3,1,2,5,0,6,155,58,213
p_44,15,0,e_0,598,744,791,28,7,7,7,5,1,4,146,47,193
p_39,15,0,e_0,609,744,791,25,6,6,10,2,1,4,135,47,182
p_20,9,0,e_2,737,762,835,29,1,1,1,5,0,1,25,73,98
p_21,10,0,e_2,732,767,835,30,1,1,0,3,0,0,35,68,103
p_19,12,0,e_2,740,775,835,25,1,1,2,5,0,2,35,60,95
p_17,15,0,e_2,772,786,835,14,1,0,11,5,1,1,14,49,63
p_15,15,0,e_2,782,786,835,12,2,0,14,5,1,1,4,49,53
p_13,11,0,e_2,794,800,835,12,3,2,13,4,1,0,6,35,41
p_28,6,0,e_1,679,762,840,28,2,2,11,2,1,1,83,78,161
p_34,15,0,e_1,643,791,840,16,2,2,3,5,1,6,148,49,197
p_29,15,0,e_1,678,791,840,19,2,2,11,2,1,1,113,49,162
p_12,13,0,e_1,796,799,840,9,3,1,14,4,1,0,3,41,44
p_8,1,0,e_2,847,853,858,6,1,0,0,3,0,0,6,5,11
p_18,2,0,e_3,768,776,868,2,0,0,0,3,0,0,8,92,100
p_16,13,0,e_3,774,811,868,12,1,0,1,5,0,1,37,57,94
p_10,14,0,e_3,810,816,868,3,2,1,13,2,1,1,6,52,58
p_14,15,0,e_3,790,821,868,9,2,0,6,5,1,1,31,47,78
p_11,11,0,e_0,810,845,884,6,2,1,0,3,0,0,35,39,74
p_5,5,0,e_0,860,865,884,28,1,1,7,4,1,0,5,19,24
p_4,1,0,e_0,864,879,884,30,1,1,5,4,1,1,15,5,20
p_3,1,0,e_3,876,882,901,1,0,0,0,3,0,0,6,19,25
p_2,3,0,e_3,878,890,901,3,1,0,0,5,0,1,12,11,23
p_1,2,0,e_0,889,898,906,1,2,0,0,3,0,0,9,8,17
p_9,2,0,e_1,845,853,923,6,1,0,0,3,0,0,8,70,78
p_7,12,0,e_1,851,885,923,23,1,1,2,5,0,1,34,38,72
p_6,14,0,e_2,858,902,946,19,1,1,0,3,1,0,44,44,88
p_299,3,0,e_1,7,18,29,3,0,0,0,3,0,0,11,11,22
p_296,1,0,e_3,20,25,30,1,0,0,0,3,0,0,5,5,10
p_298,4,0,e_2,10,25,47,4,0,0,0,3,0,0,15,22,37
p_295,5,0,e_2,22,30,47,5,1,0,3,5,0,1,8,17,25
p_290,4,0,e_3,43,50,82,6,1,1,2,5,0,1,7,32,39
p_291,6,0,e_3,35,58,82,6,0,0,0,3,0,0,23,24,47
p_286,3,0,e_3,51,69,82,5,3,1,4,5,1,2,18,13,31
p_288,1,0,e_3,49,77,82,7,2,1,4,5,0,2,28,5,33
p_285,2,0,e_2,54,56,100,5,4,1,1,5,0,1,2,44,46
p_282,6,0,e_2,62,70,100,29,3,3,4,5,1,1,8,30,38
p_289,7,0,e_2,47,75,100,4,2,0,0,3,0,0,28,25,53
p_279,2,0,e_2,76,92,100,29,1,1,7,4,1,0,16,8,24
p_275,2,0,e_2,84,92,100,28,2,2,4,4,1,1,8,8,16
p_300,8,0,e_0,4,30,112,8,0,0,0,3,0,0,26,82,108
p_297,12,0,e_0,18,44,112,12,0,0,4,5,0,1,26,68,94
p_294,13,0,e_0,23,49,112,13,1,0,6,5,0,2,26,63,89
p_293,15,0,e_0,26,57,112,16,1,1,7,5,0,3,31,55,86
p_284,14,0,e_0,55,62,112,9,4,0,14,5,1,1,7,50,57
p_280,12,0,e_0,65,70,112,22,3,3,14,4,1,1,5,42,47
p_281,10,0,e_0,63,78,112,25,3,3,14,4,1,0,15,34,49
p_276,5,0,e_0,82,95,112,5,2,2,9,4,1,0,13,17,30
p_283,10,0,e_1,55,63,113,5,4,0,8,5,0,2,8,50,58
p_292,11,0,e_1,30,68,113,11,0,0,0,3,0,0,38,45,83
p_287,12,0,e_1,51,73,113,8,4,0,6,5,0,1,22,40,62
p_274,4,0,e_1,84,99,113,26,2,2,9,4,1,0,15,14,29
p_277,10,0,e_3,81,114,182,20,2,2,0,4,1,1,33,68,101
p_273,13,0,e_3,95,125,182,13,2,1,4,5,0,2,30,57,87
p_278,15,0,e_3,80,133,182,16,1,1,1,4,1,0,53,49,102
p_267,1,0,e_3,153,177,182,8,1,0,9,4,1,0,24,5,29
p_269,4,0,e_1,146,147,183,7,1,0,4,5,0,1,1,36,37
p_270,7,0,e_1,133,158,183,22,1,0,0,3,0,0,25,25,50
p_264,5,0,e_1,162,166,183,1,2,0,6,4,1,0,4,17,21
p_272,15,0,e_2,105,153,206,8,3,0,0,3,0,0,48,53,101
p_265,12,0,e_2,157,164,206,25,2,2,14,4,1,0,7,42,49
p_262,6,0,e_2,164,184,206,29,2,2,12,1,1,0,20,22,42
p_259,6,0,e_2,174,184,206,26,2,2,9,4,1,1,10,22,32
p_258,5,0,e_2,175,189,206,27,2,2,9,4,1,1,14,17,31
p_254,3,0,e_3,199,210,221,3,0,0,0,3,0,0,11,11,22
p_252,2,0,e_2,212,220,228,1,1,0,0,3,0,0,8,8,16
p_268,10,0,e_0,150,159,235,30,1,1,7,5,0,1,9,76,85
p_271,11,0,e_0,127,164,235,6,2,1,0,3,0,0,37,71,108
p_263,12,0,e_0,163,169,235,23,2,2,11,2,1,1,6,66,72
p_261,12,0,e_0,170,171,235,21,2,2,12,5,1,1,1,64,65
p_260,13,0,e_0,171,176,235,20,2,2,12,5,1,1,5,59,64
p_266,15,0,e_0,155,184,235,23,2,2,9,5,0,2,29,51,80
p_257,12,0,e_0,179,195,235,19,1,1,14,5,1,1,16,40,56
p_255,10,0,e_0,192,203,235,10,0,0,13,4,1,1,11,32,43
p_251,4,0,e_2,228,243,277,4,0,0,0,3,0,0,15,34,49
p_249,7,0,e_2,238,254,277,7,0,0,3,5,0,1,16,23,39
p_256,8,0,e_1,191,217,291,8,0,0,0,3,0,0,26,74,100
p_253,15,0,e_1,208,240,291,12,1,0,5,5,0,1,32,51,83
p_247,12,0,e_1,248,251,291,12,0,0,13,4,1,0,3,40,43
p_244,2,0,e_1,271,283,291,16,1,1,6,4,1,0,12,8,20
p_250,7,0,e_0,236,259,316,7,0,0,0,3,0,0,23,57,80
p_248,7,0,e_0,246,259,316,7,0,0,3,5,0,1,13,57,70
p_246,12,0,e_0,257,276,316,12,0,0,6,5,0,1,19,40,59
p_243,8,0,e_0,285,290,316,6,1,1,10,4,1,0,5,26,31
p_245,9,0,e_3,269,299,330,9,0,0,0,3,0,0,30,31,61
p_238,2,0,e_3,311,322,330,4,1,0,6,4,1,0,11,8,19
p_242,4,0,e_2,287,302,394,9,1,1,0,3,0,0,15,92,107
p_241,13,0,e_2,300,331,394,26,1,1,3,5,0,1,31,63,94
p_240,14,0,e_2,301,336,394,25,1,1,4,3,0,1,35,58,93
p_234,14,0,e_2,314,336,394,20,2,2,8,5,1,3,22,58,80
p_228,11,0,e_2,325,347,394,21,1,1,11,5,1,3,22,47,69
p_225,10,0,e_2,333,352,394,14,1,1,13,5,1,3,19,42,61
p_215,6,0,e_2,346,366,394,14,2,2,11,1,1,3,20,28,48
p_206,6,0,e_2,362,366,394,11,4,3,7,4,1,4,4,28,32
p_237,5,0,e_2,313,371,394,30,2,2,7,5,1,2,58,23,81
p_221,4,0,e_2,341,376,394,18,1,1,13,4,1,3,35,18,53
p_214,4,0,e_2,346,376,394,16,2,2,11,1,1,4,30,18,48
p_199,2,0,e_2,368,384,394,13,4,2,6,4,1,3,16,10,26
p_216,1,0,e_2,346,389,394,19,2,2,11,1,1,4,43,5,48
p_233,2,0,e_0,319,328,404,1,2,0,0,3,0,0,9,76,85
p_232,5,0,e_0,320,339,404,28,2,2,0,3,0,2,19,65,84
p_217,8,0,e_0,345,350,404,12,2,2,7,5,1,3,5,54,59
p_229,9,0,e_0,323,355,404,23,1,1,1,5,0,3,32,49,81
p_218,9,0,e_0,343,355,404,12,2,2,6,5,1,3,12,49,61
p_231,10,0,e_0,320,360,404,23,2,2,0,3,0,1,40,44,84
p_204,8,0,e_0,364,368,404,9,4,3,9,4,1,3,4,36,40
p_196,5,0,e_0,376,379,404,9,2,1,6,4,1,3,3,25,28
p_210,4,0,e_0,353,384,404,14,3,3,9,5,1,3,31,20,51
p_222,3,0,e_0,339,389,404,19,1,1,5,2,1,2,50,15,65
p_209,2,0,e_0,354,394,404,15,3,3,9,2,1,3,40,10,50
p_186,1,0,e_0,391,399,404,10,4,3,3,4,1,1,8,5,13
p_236,8,0,e_1,313,332,410,27,2,2,2,5,0,1,19,78,97
p_235,8,0,e_1,314,332,410,27,2,2,2,5,0,2,18,78,96
p_227,9,0,e_1,326,337,410,22,1,1,6,5,0,3,11,73,84
p_239,13,0,e_1,305,351,410,24,1,1,0,3,0,0,46,59,105
p_224,13,0,e_1,335,351,410,13,1,0,8,5,1,3,16,59,75
p_223,13,0,e_1,339,351,410,11,1,0,9,5,1,2,12,59,71
p_211,14,0,e_1,348,356,410,9,2,0,12,5,1,3,8,54,62
p_220,9,0,e_1,342,373,410,12,2,2,10,5,1,2,31,37,68
p_198,9,0,e_1,368,373,410,6,4,2,11,4,1,3,5,37,42
p_197,8,0,e_1,375,378,410,6,2,1,9,4,1,2,3,32,35
p_230,5,0,e_1,323,389,410,27,1,1,5,5,0,2,66,21,87
p_192,5,0,e_1,380,389,410,8,4,3,8,4,1,2,9,21,30
p_185,2,0,e_1,392,400,410,8,4,3,4,4,1,1,8,10,18
p_205,1,0,e_1,362,405,410,16,4,3,12,4,1,2,43,5,48
p_212,9,0,e_3,348,361,442,10,2,2,5,5,0,2,13,81,94
p_219,11,0,e_3,342,369,442,10,1,1,3,5,0,1,27,73,100
p_226,12,0,e_3,331,374,442,12,0,0,0,3,0,0,43,68,111
p_213,12,0,e_3,347,374,442,7,2,0,5,5,0,2,27,68,95
p_207,12,0,e_3,355,374,442,5,3,0,7,5,0,3,19,68,87
p_203,12,0,e_3,365,374,442,4,4,1,10,5,1,3,9,68,77
p_200,12,0,e_3,367,374,442,3,4,1,11,5,1,3,7,68,75
p_208,13,0,e_3,355,379,442,6,3,0,7,5,0,3,24,63,87
p_202,13,0,e_3,365,379,442,3,4,0,10,5,1,3,14,63,77
p_201,13,0,e_3,366,379,442,3,4,0,10,5,1,3,13,63,76
p_193,12,0,e_3,378,384,442,3,3,0,13,2,1,2,6,58,64
p_194,11,0,e_3,377,389,442,2,3,0,13,5,1,2,12,53,65
p_195,9,0,e_3,376,397,442,5,2,1,12,5,1,1,21,45,66
p_188,8,0,e_3,390,402,442,3,3,1,11,4,1,2,12,40,52
p_191,7,0,e_3,382,407,442,5,4,2,12,4,1,3,25,35,60
p_184,5,0,e_2,393,411,506,5,4,3,0,3,1,1,18,95,113
p_182,5,0,e_2,394,411,506,5,4,3,0,3,1,3,17,95,112
p_177,9,0,e_2,398,425,506,30,4,4,1,5,0,4,27,81,108
p_160,10,0,e_2,421,430,506,24,6,6,8,5,1,4,9,76,85
p_181,11,0,e_2,395,435,506,29,4,4,0,5,0,3,40,71,111
p_183,12,0,e_2,393,440,506,28,4,4,0,3,1,2,47,66,113
p_157,12,0,e_2,427,440,506,21,6,6,9,5,1,4,13,66,79
p_190,14,0,e_2,382,448,506,28,5,5,2,4,1,2,66,58,124
p_158,14,0,e_2,426,448,506,19,7,7,9,5,1,4,22,58,80
p_146,10,0,e_2,451,462,506,8,6,0,14,4,1,3,11,44,55
p_153,8,0,e_2,438,470,506,23,7,7,11,5,1,3,32,36,68
p_154,7,0,e_2,438,475,506,24,7,7,12,5,1,4,37,31,68
p_147,7,0,e_2,450,475,506,5,7,0,14,4,1,3,25,31,56
p_138,7,0,e_2,456,475,506,4,6,0,12,4,1,4,19,31,50
p_126,6,0,e_2,473,480,506,18,4,3,8,4,1,4,7,26,33
p_173,10,0,e_0,405,436,518,27,6,6,0,5,0,1,31,82,113
p_170,10,0,e_0,408,436,518,27,5,5,1,5,0,2,28,82,110
p_161,13,0,e_0,418,447,518,22,6,6,4,5,0,3,29,71,100
p_180,14,0,e_0,396,452,518,25,4,4,2,4,1,1,56,66,122
p_172,14,0,e_0,405,452,518,23,6,6,0,5,0,1,47,66,113
p_162,14,0,e_0,417,452,518,21,6,6,4,5,0,3,35,66,101
p_168,15,0,e_0,412,457,518,21,5,5,2,5,0,2,45,61,106
p_151,15,0,e_0,443,457,518,15,7,0,12,5,1,3,14,61,75
p_149,15,0,e_0,444,457,518,15,7,0,12,5,1,3,13,61,74
p_142,15,0,e_0,452,457,518,13,6,0,14,2,1,3,5,61,66
p_141,15,0,e_0,455,457,518,13,6,0,15,5,1,3,2,61,63
p_139,13,0,e_0,456,465,518,10,6,0,15,5,1,3,9,53,62
p_134,12,0,e_0,462,470,518,8,4,0,14,4,1,3,8,48,56
p_128,10,0,e_0,471,478,518,4,3,0,12,4,1,2,7,40,47
p_121,9,0,e_0,480,483,518,14,5,3,10,4,1,3,3,35,38
p_167,7,0,e_1,412,433,520,29,5,5,0,5,0,1,21,87,108
p_152,10,0,e_1,439,444,520,21,7,7,9,5,1,3,5,76,81
p_169,11,0,e_1,410,449,520,26,5,5,0,3,1,0,39,71,110
p_159,11,0,e_1,424,449,520,23,6,6,4,5,0,4,25,71,96
p_164,12,0,e_1,416,454,520,23,5,5,1,5,0,3,38,66,104
p_145,12,0,e_1,451,454,520,10,6,0,11,5,1,2,3,66,69
p_140,13,0,e_1,455,459,520,11,6,0,12,5,1,2,4,61,65
p_137,13,0,e_1,458,459,520,10,5,0,13,2,1,2,1,61,62
p_165,14,0,e_1,416,466,520,21,5,5,1,5,0,2,50,54,104
p_130,9,0,e_1,469,483,520,4,4,0,14,4,1,2,14,37,51
p_135,7,0,e_1,461,491,520,3,5,0,13,5,1,2,30,29,59
p_119,5,0,e_1,483,499,520,17,6,5,9,1,1,2,16,21,37
p_143,2,0,e_1,451,510,520,10,6,5,11,5,1,2,59,10,69
p_136,2,0,e_1,460,510,520,9,5,4,13,2,1,2,50,10,60
p_110,1,0,e_1,501,515,520,16,8,2,5,4,1,1,14,5,19
p_156,1,0,e_3,428,447,574,2,6,1,3,4,1,5,19,127,146
p_175,2,0,e_3,399,452,574,7,5,4,9,4,1,4,53,122,175
p_174,3,0,e_3,402,457,574,5,5,3,8,4,1,4,55,117,172
p_171,3,0,e_3,408,457,574,4,5,2,7,4,1,4,49,117,166
p_163,4,0,e_3,417,462,574,1,5,0,5,1,1,4,45,112,157
p_178,5,0,e_3,398,467,574,4,4,3,9,4,1,3,69,107,176
p_166,5,0,e_3,415,467,574,1,5,0,6,4,1,4,52,107,159
p_179,6,0,e_3,397,472,574,3,3,2,9,1,1,2,75,102,177
p_176,6,0,e_3,398,472,574,3,5,2,9,4,1,4,74,102,176
p_189,7,0,e_3,387,477,574,5,4,2,12,4,1,3,90,97,187
p_187,7,0,e_3,391,477,574,4,4,2,11,4,1,3,86,97,183
p_132,7,0,e_3,463,477,574,3,4,0,4,5,1,3,14,97,111
p_131,9,0,e_3,467,485,574,4,3,0,5,5,1,2,18,89,107
p_120,10,0,e_3,481,490,574,12,5,3,8,5,1,4,9,84,93
p_123,12,0,e_3,474,498,574,12,4,1,6,5,1,3,24,76,100
p_148,3,0,e_0,447,529,584,10,6,4,13,2,1,2,82,55,137
p_144,4,0,e_0,451,534,584,8,6,3,14,2,1,2,83,50,133
p_122,5,0,e_0,477,539,584,18,5,4,10,1,1,2,62,45,107
p_96,5,0,e_0,527,539,584,7,8,4,2,5,0,5,12,45,57
p_98,6,0,e_0,524,544,584,7,8,5,2,5,0,4,20,40,60
p_95,6,0,e_0,527,544,584,6,9,4,3,5,0,5,17,40,57
p_94,6,0,e_0,528,544,584,6,8,4,3,2,0,4,16,40,56
p_86,6,0,e_0,541,544,584,4,8,2,5,5,1,4,3,40,43
p_93,7,0,e_0,529,549,584,5,8,3,3,2,0,4,20,35,55
p_89,7,0,e_0,537,549,584,3,8,1,4,5,1,5,12,35,47
p_80,6,0,e_0,548,554,584,2,9,1,7,5,1,5,6,30,36
p_83,5,0,e_0,546,559,584,4,8,1,6,5,1,4,13,25,38
p_78,4,0,e_0,555,564,584,2,9,0,6,4,1,4,9,20,29
p_85,3,0,e_0,542,569,584,6,9,1,5,5,1,4,27,15,42
p_84,3,0,e_0,546,569,584,5,9,1,6,5,1,5,23,15,38
p_155,3,0,e_2,434,517,630,29,7,7,11,5,1,3,83,113,196
p_150,3,0,e_2,444,517,630,11,7,4,13,5,1,4,73,113,186
p_133,4,0,e_2,463,522,630,6,4,3,10,4,1,3,59,108,167
p_125,4,0,e_2,474,522,630,20,6,5,7,1,1,4,48,108,156
p_118,4,0,e_2,488,522,630,17,5,4,5,4,1,2,34,108,142
p_106,4,0,e_2,512,522,630,11,7,0,1,5,0,3,10,108,118
p_105,4,0,e_2,515,522,630,11,7,6,2,5,0,3,7,108,115
p_129,5,0,e_2,470,527,630,8,4,3,8,4,1,3,57,103,160
p_108,5,0,e_2,509,527,630,11,7,1,0,5,0,3,18,103,121
p_104,7,0,e_2,516,535,630,7,7,4,3,2,0,2,19,95,114
p_100,10,0,e_2,522,546,630,3,8,2,4,5,1,3,24,84,108
p_97,10,0,e_2,526,546,630,2,8,1,5,2,1,3,20,84,104
p_91,13,0,e_2,535,557,630,28,8,8,7,2,1,2,22,73,95
p_87,15,0,e_2,539,565,630,25,8,8,8,5,1,3,26,65,91
p_74,11,0,e_2,567,579,630,21,9,9,15,4,1,2,12,51,63
p_107,1,0,e_1,512,525,640,14,7,0,2,4,1,1,13,115,128
p_101,12,0,e_1,521,560,640,1,9,0,0,5,0,1,39,80,119
p_92,13,0,e_1,533,565,640,28,8,8,3,5,1,1,32,75,107
p_88,14,0,e_1,538,570,640,26,8,8,5,5,1,2,32,70,102
p_79,14,0,e_1,549,570,640,23,9,9,9,5,1,3,21,70,91
p_75,14,0,e_1,563,570,640,20,9,9,13,5,1,3,7,70,77
p_72,15,0,e_1,569,575,640,16,9,9,14,2,1,2,6,65,71
p_68,14,0,e_1,574,580,640,14,8,8,15,5,1,4,6,60,66
p_66,12,0,e_1,577,588,640,17,8,3,15,4,1,4,11,52,63
p_65,12,0,e_1,578,588,640,17,8,3,14,4,1,5,10,52,62
p_69,10,0,e_1,573,596,640,20,9,9,15,5,1,3,23,44,67
p_58,10,0,e_1,586,596,640,17,8,5,12,4,1,5,10,44,54
p_50,10,0,e_1,592,596,640,15,8,5,11,4,1,5,4,44,48
p_53,9,0,e_1,590,601,640,16,8,6,12,4,1,4,11,39,50
p_76,7,0,e_1,559,609,640,28,9,9,12,5,1,3,50,31,81
p_43,3,0,e_1,599,651,686,20,8,7,10,4,1,4,52,35,87
p_42,4,0,e_1,600,656,686,18,8,7,9,1,1,4,56,30,86
p_35,4,0,e_1,640,656,686,10,4,2,0,3,1,4,16,30,46
p_61,5,0,e_1,583,661,686,23,8,8,14,4,1,4,78,25,103
p_45,5,0,e_1,597,661,686,18,7,7,10,4,1,4,64,25,89
p_32,5,0,e_1,657,661,686,4,3,1,4,5,1,2,4,25,29
p_73,6,0,e_1,568,666,686,26,9,9,14,5,1,2,98,20,118
p_116,7,0,e_3,490,597,690,13,4,3,10,5,1,3,107,93,200
p_114,9,0,e_3,494,605,690,10,6,3,11,5,1,5,111,85,196
p_115,10,0,e_3,494,610,690,9,5,3,11,5,1,4,116,80,196
p_41,10,0,e_3,600,610,690,12,8,5,8,5,1,7,10,80,90
p_113,11,0,e_3,496,615,690,7,7,2,12,5,1,6,119,75,194
p_117,12,0,e_3,490,620,690,8,4,2,10,5,1,3,130,70,200
p_103,13,0,e_3,517,625,690,1,7,0,14,1,1,6,108,65,173
p_124,14,0,e_3,474,630,690,10,5,1,6,5,1,4,156,60,216
p_109,14,0,e_3,506,630,690,2,7,1,14,5,1,6,124,60,184
p_127,15,0,e_3,473,635,690,9,3,0,6,5,1,2,162,55,217
p_112,15,0,e_3,497,635,690,3,8,0,12,5,1,7,138,55,193
p_111,15,0,e_3,501,635,690,2,7,0,13,5,1,6,134,55,189
p_39,15,0,e_3,609,635,690,5,7,0,10,5,1,6,26,55,81
p_36,11,0,e_3,635,649,690,4,3,0,15,4,1,2,14,41,55
p_37,7,0,e_3,633,663,690,8,3,0,15,5,1,2,30,27,57
p_99,1,0,e_0,522,589,698,12,8,5,1,5,0,3,67,109,176
p_90,2,0,e_0,536,594,698,8,8,2,4,5,1,4,58,104,162
p_81,2,0,e_0,547,594,698,6,9,1,6,5,1,5,47,104,151
p_71,2,0,e_0,569,594,698,30,9,9,3,4,1,2,25,104,129
p_56,2,0,e_0,588,594,698,24,8,8,1,5,0,4,6,104,110
p_82,3,0,e_0,547,599,698,5,9,1,6,5,1,5,52,99,151
p_55,4,0,e_0,590,604,698,21,8,8,1,5,1,3,14,94,108
p_59,6,0,e_0,584,612,698,21,8,8,0,5,0,3,28,86,114
p_57,6,0,e_0,587,612,698,20,8,8,1,5,0,4,25,86,111
p_54,6,0,e_0,590,612,698,19,8,8,1,5,1,3,22,86,108
p_52,11,0,e_0,591,629,698,14,8,4,1,5,1,5,38,69,107
p_46,13,0,e_0,596,637,698,10,7,2,2,5,1,5,41,61,102
p_44,15,0,e_0,598,645,698,8,8,0,3,2,1,5,47,53,100
p_34,15,0,e_0,643,645,698,28,4,4,14,5,1,2,2,53,55
p_33,8,0,e_0,647,668,698,3,4,0,15,4,1,1,21,30,51
p_64,1,0,e_2,579,635,706,28,8,8,11,4,1,4,56,71,127
p_102,2,0,e_2,521,640,706,11,9,5,4,3,1,2,119,66,185
p_48,2,0,e_2,593,640,706,22,8,8,8,4,1,6,47,66,113
p_70,3,0,e_2,572,645,706,28,9,9,13,4,1,3,73,61,134
p_40,4,0,e_2,601,650,706,18,8,7,6,4,1,6,49,56,105
p_62,5,0,e_2,582,655,706,23,8,8,11,4,1,5,73,51,124
p_49,5,0,e_2,592,655,706,20,8,8,8,4,1,6,63,51,114
p_77,6,0,e_2,557,660,706,30,9,9,13,2,1,2,103,46,149
p_47,6,0,e_2,594,660,706,18,8,8,8,4,1,6,66,46,112
p_67,8,0,e_2,574,668,706,22,8,7,12,4,1,4,94,38,132
p_63,8,0,e_2,581,668,706,20,8,7,11,4,1,5,87,38,125
p_60,9,0,e_2,584,673,706,18,8,6,10,4,1,6,89,33,122
p_28,6,0,e_2,679,684,706,27,2,2,8,4,1,0,5,22,27
p_27,2,0,e_2,693,698,706,7,2,2,3,4,1,0,5,8,13
p_26,3,0,e_3,698,701,728,5,2,2,2,5,0,2,3,27,30
p_38,4,0,e_3,627,706,728,13,3,2,13,5,1,2,79,22,101
p_31,5,0,e_3,662,711,728,2,2,0,7,1,1,1,49,17,66
p_23,5,0,e_3,709,711,728,1,2,0,4,5,1,1,2,17,19
p_51,1,0,e_0,591,703,748,24,8,8,1,5,1,4,112,45,157
p_30,5,0,e_0,676,717,748,29,2,2,6,4,1,1,41,31,72
p_25,7,0,e_0,703,725,748,4,3,0,1,2,0,1,22,23,45
p_24,5,0,e_2,707,724,775,1,2,0,0,3,0,0,17,51,68
p_22,10,0,e_2,712,741,775,25,1,1,1,5,0,1,29,34,63
p_21,10,0,e_2,732,741,775,10,0,0,7,5,1,1,9,34,43
p_20,9,0,e_2,737,746,775,9,0,0,9,5,1,1,9,29,38
p_29,15,0,e_1,678,733,782,19,2,2,2,4,1,0,55,49,104
p_19,12,0,e_1,740,744,782,12,0,0,13,4,1,0,4,38,42
p_18,2,0,e_0,768,776,784,2,0,0,0,3,0,0,8,8,16
p_13,11,0,e_0,794,830,867,12,1,1,0,3,0,0,36,37,73
p_11,11,0,e_0,810,830,867,7,2,2,4,5,0,1,20,37,57
p_9,2,0,e_0,845,859,867,7,1,0,7,4,1,0,14,8,22
p_12,13,0,e_3,796,814,871,10,1,1,7,5,0,1,18,57,75
p_10,14,0,e_3,810,819,871,4,2,1,12,5,0,2,9,52,61
p_17,15,0,e_3,772,824,871,15,0,0,0,3,0,0,52,47,99
p_16,13,0,e_2,774,816,873,17,1,1,0,3,1,0,42,57,99
p_14,15,0,e_2,790,824,873,10,1,0,5,5,0,1,34,49,83
p_8,1,0,e_2,847,868,873,7,1,0,8,4,1,0,21,5,26
p_15,15,0,e_1,782,830,879,13,1,0,0,3,0,0,48,49,97
p_4,1,0,e_1,864,874,879,1,2,0,4,4,1,0,10,5,15
p_3,1,0,e_2,876,881,886,22,1,1,0,3,0,0,5,5,10
p_2,3,0,e_1,878,890,901,19,1,1,0,3,1,0,12,11,23
p_1,2,0,e_2,889,897,905,17,1,1,0,3,0,0,8,8,16
p_7,12,0,e_3,851,909,947,24,1,1,6,4,1,0,58,38,96
p_5,5,0,e_0,860,884,957,28,2,2,2,4,1,1,24,73,97
p_6,14,0,e_0,858,913,957,20,2,2,2,4,1,1,55,44,99
p_296,1,0,e_3,20,25,30,1,0,0,0,3,0,0,5,5,10
p_299,3,0,e_1,7,19,30,3,0,0,0,3,0,0,12,11,23
p_298,4,0,e_2,10,25,47,4,0,0,0,3,0,0,15,22,37
p_295,5,0,e_2,22,30,47,5,1,0,3,5,0,1,8,17,25
p_288,1,0,e_2,49,54,97,9,3,2,0,3,0,0,5,43,48
p_285,2,0,e_2,54,59,97,7,3,2,1,2,0,1,5,38,43
p_286,3,0,e_2,51,64,97,7,3,2,0,5,0,1,13,33,46
p_282,6,0,e_2,62,75,97,7,2,1,3,5,1,1,13,22,35
p_279,2,0,e_2,76,89,97,8,1,0,6,4,1,0,13,8,21
p_275,2,0,e_2,84,89,97,5,2,1,3,4,1,3,5,8,13
p_290,4,0,e_3,43,50,108,6,1,1,2,5,0,1,7,58,65
p_291,6,0,e_3,35,58,108,6,0,0,0,3,0,0,23,50,73
p_289,7,0,e_3,47,63,108,4,2,0,3,5,0,2,16,45,61
p_283,10,0,e_3,55,74,108,5,3,0,5,5,1,2,19,34,53
p_281,10,0,e_3,63,74,108,3,2,0,7,2,1,1,11,34,45
p_274,4,0,e_3,84,94,108,3,1,0,7,4,1,0,10,14,24
p_292,11,0,e_1,30,65,108,11,0,0,0,3,1,0,35,43,78
p_287,12,0,e_1,51,70,108,8,3,0,7,5,0,1,19,38,57
p_280,12,0,e_1,65,70,108,5,2,0,11,5,1,1,5,38,43
p_300,8,0,e_0,4,31,109,8,0,0,0,3,0,0,27,78,105
p_297,12,0,e_0,18,45,109,12,0,0,4,5,0,1,27,64,91
p_294,13,0,e_0,23,50,109,13,1,0,5,5,0,2,27,59,86
p_293,15,0,e_0,26,58,109,16,1,1,7,5,0,3,32,51,83
p_284,14,0,e_0,55,63,109,9,3,0,14,5,1,1,8,46,54
p_276,5,0,e_0,82,92,109,3,1,0,8,4,1,0,10,17,27
p_267,1,0,e_3,153,158,163,1,0,0,0,3,0,0,5,5,10
p_269,4,0,e_1,146,160,174,4,0,0,0,3,0,0,14,14,28
p_264,5,0,e_3,162,180,197,5,0,0,0,3,1,0,18,17,35
p_258,5,0,e_3,175,180,197,1,1,0,4,5,0,1,5,17,22
p_277,10,0,e_2,81,129,201,28,1,1,5,4,1,2,48,72,120
p_271,11,0,e_2,127,134,201,11,0,0,10,5,0,3,7,67,74
p_273,13,0,e_2,95,142,201,21,1,1,0,4,1,2,47,59,106
p_278,15,0,e_2,80,150,201,24,1,1,5,4,1,1,70,51,121
p_272,15,0,e_2,105,150,201,16,1,1,2,5,0,3,45,51,96
p_265,12,0,e_2,157,161,201,13,0,0,13,4,1,0,4,40,44
p_262,6,0,e_2,164,181,201,6,1,0,12,4,1,0,17,20,37
p_259,6,0,e_2,174,181,201,3,1,0,8,4,1,1,7,20,27
p_252,2,0,e_2,212,220,228,2,0,0,0,3,0,0,8,8,16
p_270,7,0,e_0,133,156,241,7,0,0,0,3,0,0,23,85,108
p_268,10,0,e_0,150,167,241,10,0,0,5,5,0,1,17,74,91
p_263,12,0,e_0,163,175,241,12,1,0,9,5,1,2,12,66,78
p_261,12,0,e_0,170,175,241,10,1,0,11,5,1,2,5,66,71
p_260,13,0,e_0,171,180,241,11,1,0,11,5,1,2,9,61,70
p_266,15,0,e_0,155,188,241,15,1,0,7,2,0,1,33,53,86
p_257,12,0,e_0,179,199,241,17,0,0,13,2,1,1,20,42,62
p_255,10,0,e_0,192,207,241,21,1,1,14,4,1,2,15,34,49
p_256,8,0,e_0,191,215,241,24,1,1,14,4,1,1,24,26,50
p_251,4,0,e_2,228,242,276,4,0,0,0,3,1,0,14,34,48
p_250,7,0,e_2,236,253,276,7,0,0,2,5,0,1,17,23,40
p_249,7,0,e_2,238,253,276,7,0,0,3,5,0,2,15,23,38
p_248,7,0,e_2,246,253,276,7,0,0,5,5,1,1,7,23,30
p_244,2,0,e_3,271,279,287,2,0,0,0,3,0,0,8,8,16
p_254,3,0,e_1,199,211,298,3,0,0,0,3,0,0,12,87,99
p_253,15,0,e_1,208,249,298,15,0,0,2,5,0,1,41,49,90
p_247,12,0,e_1,248,260,298,12,0,0,15,5,1,1,12,38,50
p_246,12,0,e_1,257,260,298,12,0,0,13,4,1,1,3,38,41
p_243,8,0,e_0,285,295,331,22,1,1,5,5,0,1,10,36,46
p_245,9,0,e_0,269,300,331,9,0,0,0,3,0,0,31,31,62
p_233,2,0,e_0,319,323,331,13,1,1,3,4,1,0,4,8,12
p_222,3,0,e_0,339,350,373,15,3,2,0,3,0,0,11,23,34
p_221,4,0,e_0,341,355,373,14,3,2,0,5,0,1,14,18,32
p_214,4,0,e_0,346,355,373,12,3,1,2,5,0,3,9,18,27
p_210,4,0,e_0,353,355,373,12,4,2,4,5,1,2,2,18,20
p_209,2,0,e_0,354,363,373,14,4,2,4,3,1,1,9,10,19
p_216,1,0,e_0,346,368,373,15,3,1,2,5,0,2,22,5,27
p_205,1,0,e_0,362,368,373,14,2,1,2,4,1,2,6,5,11
p_238,2,0,e_1,311,320,376,2,0,0,0,3,0,0,9,56,65
p_237,5,0,e_1,313,331,376,11,1,1,0,5,0,1,18,45,63
p_232,5,0,e_1,320,331,376,9,1,1,2,5,1,1,11,45,56
p_230,5,0,e_1,323,331,376,12,2,2,2,5,1,2,8,45,53
p_229,9,0,e_1,323,345,376,8,2,1,2,5,1,1,22,31,53
p_227,9,0,e_1,326,345,376,7,2,1,3,5,1,2,19,31,50
p_220,9,0,e_1,342,345,376,9,3,2,8,5,1,1,3,31,34
p_218,9,0,e_1,343,345,376,8,3,2,9,5,1,1,2,31,33
p_215,6,0,e_1,346,356,376,10,2,1,9,4,1,0,10,20,30
p_242,4,0,e_2,287,301,393,4,0,0,0,3,0,0,14,92,106
p_241,13,0,e_2,300,330,393,13,0,0,4,3,0,0,30,63,93
p_239,13,0,e_2,305,330,393,13,0,0,5,5,1,2,25,63,88
p_240,14,0,e_2,301,335,393,14,0,0,4,3,0,1,34,58,92
p_234,14,0,e_2,314,335,393,14,1,0,8,5,1,2,21,58,79
p_224,13,0,e_2,335,340,393,6,2,0,14,2,1,2,5,53,58
p_226,12,0,e_2,331,345,393,7,2,0,13,5,1,2,14,48,62
p_228,11,0,e_2,325,350,393,8,2,0,11,5,1,2,25,43,68
p_219,11,0,e_2,342,350,393,7,3,1,13,4,1,2,8,43,51
p_212,9,0,e_2,348,358,393,9,4,3,11,4,1,2,10,35,45
p_217,8,0,e_2,345,363,393,9,3,2,12,1,1,1,18,30,48
p_206,6,0,e_2,362,371,393,9,2,1,8,4,1,1,9,22,31
p_199,2,0,e_2,368,385,393,12,5,4,7,4,1,1,17,8,25
p_236,8,0,e_3,313,339,433,8,0,0,0,3,0,0,26,94,120
p_235,8,0,e_3,314,339,433,8,1,0,0,5,0,1,25,94,119
p_231,10,0,e_3,320,347,433,8,1,0,2,5,0,1,27,86,113
p_225,10,0,e_3,333,347,433,4,2,0,6,5,0,2,14,86,100
p_213,12,0,e_3,347,355,433,4,2,1,10,2,1,1,8,78,86
p_207,12,0,e_3,355,357,433,4,3,2,12,5,1,2,2,76,78
p_223,13,0,e_3,339,362,433,5,2,0,8,5,1,1,23,71,94
p_208,13,0,e_3,355,362,433,3,3,1,12,2,1,2,7,71,78
p_211,14,0,e_3,348,367,433,4,3,0,10,5,1,2,19,66,85
p_202,13,0,e_3,365,372,433,1,4,0,14,5,1,3,7,61,68
p_201,13,0,e_3,366,372,433,1,5,0,14,5,1,4,6,61,67
p_203,12,0,e_3,365,377,433,3,3,1,13,5,1,2,12,56,68
p_200,12,0,e_3,367,377,433,2,4,1,14,4,1,3,10,56,66
p_194,11,0,e_3,377,382,433,1,3,0,12,4,1,2,5,51,56
p_198,9,0,e_3,368,390,433,5,4,2,14,4,1,3,22,43,65
p_196,5,0,e_0,376,394,481,7,4,2,0,3,0,0,18,87,105
p_192,5,0,e_0,380,394,481,7,4,3,0,5,0,1,14,87,101
p_190,14,0,e_0,382,423,481,27,4,4,1,5,0,1,41,58,99
p_180,14,0,e_0,396,423,481,24,5,5,5,5,1,1,27,58,85
p_172,14,0,e_0,405,423,481,22,8,8,8,5,1,1,18,58,76
p_168,15,0,e_0,412,428,481,20,8,8,10,5,1,1,16,53,69
p_154,7,0,e_0,438,454,481,10,7,2,12,4,1,1,16,27,43
p_147,7,0,e_0,450,454,481,20,7,3,8,4,1,2,4,27,31
p_144,4,0,e_0,451,465,481,23,7,6,8,4,1,2,14,16,30
p_155,3,0,e_0,434,470,481,15,8,5,13,4,1,0,36,11,47
p_150,3,0,e_0,444,470,481,25,8,6,10,4,1,2,26,11,37
p_148,3,0,e_0,447,470,481,24,8,6,9,4,1,2,23,11,34
p_173,10,0,e_1,405,411,483,26,8,8,8,5,0,2,6,72,78
p_170,10,0,e_1,408,411,483,25,8,8,9,5,0,3,3,72,75
p_181,11,0,e_1,395,416,483,27,5,5,5,5,0,1,21,67,88
p_169,11,0,e_1,410,416,483,24,8,8,10,2,0,2,6,67,73
p_193,12,0,e_1,378,421,483,30,4,4,0,3,0,0,43,62,105
p_183,12,0,e_1,393,421,483,26,4,4,4,5,0,1,28,62,90
p_164,12,0,e_1,416,421,483,22,9,9,11,2,1,3,5,62,67
p_161,13,0,e_1,418,426,483,20,8,8,11,5,1,3,8,57,65
p_165,14,0,e_1,416,431,483,20,9,9,11,2,1,2,15,52,67
p_162,14,0,e_1,417,431,483,19,8,8,11,5,1,3,14,52,66
p_158,14,0,e_1,426,431,483,18,8,8,13,2,1,2,5,52,57
p_157,12,0,e_1,427,439,483,19,8,8,13,5,1,2,12,44,56
p_166,5,0,e_1,415,462,483,29,9,9,11,5,1,2,47,21,68
p_133,4,0,e_1,463,467,483,20,8,7,5,4,1,1,4,16,20
p_136,2,0,e_1,460,475,483,22,8,7,6,4,1,1,15,8,23
p_185,2,0,e_2,392,401,483,7,4,2,0,3,1,0,9,82,91
p_182,5,0,e_2,394,412,483,3,6,1,0,5,0,1,18,71,89
p_167,7,0,e_2,412,420,483,28,8,8,5,2,1,1,8,63,71
p_177,9,0,e_2,398,428,483,29,6,6,1,5,0,2,30,55,85
p_160,10,0,e_2,421,433,483,22,9,9,7,5,1,2,12,50,62
p_159,11,0,e_2,424,438,483,21,8,8,8,5,1,3,14,45,59
p_152,10,0,e_2,439,443,483,9,8,0,11,4,1,3,4,40,44
p_153,8,0,e_2,438,451,483,9,8,1,11,4,1,2,13,32,45
p_163,4,0,e_2,417,465,483,29,8,8,6,5,1,2,48,18,66
p_143,2,0,e_2,451,473,483,25,7,6,8,1,1,2,22,10,32
p_156,1,0,e_2,428,478,483,30,8,8,9,2,1,3,50,5,55
p_118,4,0,e_2,488,503,519,14,11,3,0,3,0,0,15,16,31
p_110,1,0,e_2,501,514,519,15,10,1,3,5,0,1,13,5,18
p_107,1,0,e_2,512,514,519,13,10,8,2,4,1,1,2,5,7
p_119,5,0,e_1,483,501,554,15,10,4,0,3,0,0,18,53,71
p_116,7,0,e_1,490,509,554,11,10,3,1,5,0,1,19,45,64
p_114,9,0,e_1,494,517,554,8,10,2,3,5,0,2,23,37,60
p_98,6,0,e_1,524,528,554,5,11,3,7,4,1,2,4,26,30
p_108,5,0,e_1,509,533,554,9,10,6,7,2,1,1,24,21,45
p_96,5,0,e_1,527,533,554,5,10,3,6,4,1,3,6,21,27
p_106,4,0,e_1,512,538,554,9,11,6,8,5,1,2,26,16,42
p_105,4,0,e_1,515,538,554,9,10,6,8,5,1,3,23,16,39
p_90,2,0,e_1,536,546,554,6,12,4,4,4,1,1,10,8,18
p_186,1,0,e_3,391,438,573,8,3,2,9,4,1,2,47,135,182
p_175,2,0,e_3,399,443,573,5,6,2,7,1,1,5,44,130,174
p_174,3,0,e_3,402,448,573,4,7,2,7,4,1,6,46,125,171
p_171,3,0,e_3,408,448,573,2,8,0,5,4,1,7,40,125,165
p_184,5,0,e_3,393,456,573,3,5,1,8,4,1,4,63,117,180
p_178,5,0,e_3,398,456,573,2,6,1,7,4,1,5,58,117,175
p_179,6,0,e_3,397,461,573,2,5,1,8,4,1,4,64,112,176
p_176,6,0,e_3,398,461,573,2,6,1,8,4,1,5,63,112,175
p_191,7,0,e_3,382,466,573,4,3,2,11,4,1,2,84,107,191
p_189,7,0,e_3,387,466,573,3,4,2,10,4,1,3,79,107,186
p_187,7,0,e_3,391,466,573,2,3,1,9,4,1,2,75,107,182
p_138,7,0,e_3,456,466,573,18,9,6,5,5,1,8,10,107,117
p_135,7,0,e_3,461,466,573,17,8,6,6,2,1,7,5,107,112
p_132,7,0,e_3,463,466,573,17,8,6,6,5,1,7,3,107,110
p_204,8,0,e_3,364,471,573,7,2,1,13,5,1,1,107,102,209
p_120,10,0,e_0,481,514,582,10,10,4,0,3,0,0,33,68,101
p_115,10,0,e_0,494,514,582,7,10,2,4,5,0,1,20,68,88
p_113,11,0,e_0,496,519,582,6,10,2,4,5,0,1,23,63,86
p_101,12,0,e_0,521,524,582,30,10,10,11,5,1,2,3,58,61
p_103,13,0,e_0,517,529,582,29,11,11,11,5,1,2,12,53,65
p_97,10,0,e_0,526,540,582,30,10,10,12,5,1,2,14,42,56
p_104,7,0,e_0,516,551,582,6,10,4,10,5,1,1,35,31,66
p_86,6,0,e_0,541,556,582,1,12,0,10,4,1,1,15,26,41
p_80,6,0,e_0,548,556,582,30,12,12,8,4,1,4,8,26,34
p_78,4,0,e_0,555,564,582,1,12,0,6,4,1,3,9,18,27
p_85,3,0,e_0,542,569,582,4,11,3,10,4,1,2,27,13,40
p_82,3,0,e_0,547,569,582,3,12,2,8,4,1,3,22,13,35
p_81,2,0,e_0,547,574,582,4,12,3,8,4,1,3,27,8,35
p_71,2,0,e_0,569,574,582,29,13,13,3,4,1,1,5,8,13
p_99,1,0,e_2,522,527,636,10,11,6,0,5,0,1,5,109,114
p_102,2,0,e_2,521,532,636,10,10,6,0,3,0,0,11,104,115
p_95,6,0,e_2,527,546,636,4,10,2,1,2,0,1,19,90,109
p_94,6,0,e_2,528,546,636,4,10,2,1,5,1,2,18,90,108
p_92,13,0,e_2,533,569,636,26,11,11,2,5,1,1,36,67,103
p_91,13,0,e_2,535,569,636,25,11,11,3,5,1,2,34,67,101
p_88,14,0,e_2,538,574,636,24,11,11,3,5,1,2,36,62,98
p_79,14,0,e_2,549,574,636,22,12,12,6,5,1,3,25,62,87
p_75,14,0,e_2,563,574,636,19,12,12,11,5,1,3,11,62,73
p_68,14,0,e_2,574,576,636,16,12,1,14,5,1,2,2,60,62
p_87,15,0,e_2,539,581,636,23,11,11,4,5,1,3,42,55,97
p_72,15,0,e_2,569,581,636,16,13,13,13,5,1,3,12,55,67
p_66,12,0,e_2,577,592,636,17,12,3,14,5,1,2,15,44,59
p_65,12,0,e_2,578,592,636,17,12,3,14,5,1,3,14,44,58
p_74,11,0,e_2,567,597,636,21,13,13,13,5,1,3,30,39,69
p_55,4,0,e_0,590,596,660,22,12,10,2,5,0,2,6,64,70
p_62,5,0,e_0,582,601,660,23,12,9,0,3,1,0,19,59,78
p_61,5,0,e_0,583,601,660,22,11,9,0,5,0,1,18,59,77
p_49,5,0,e_0,592,601,660,21,12,9,3,5,0,4,9,59,68
p_45,5,0,e_0,597,601,660,20,11,9,4,5,1,4,4,59,63
p_59,6,0,e_0,584,606,660,21,11,8,0,5,0,1,22,54,76
p_57,6,0,e_0,587,606,660,20,12,8,1,5,0,2,19,54,73
p_54,6,0,e_0,590,606,660,20,12,8,2,5,0,2,16,54,70
p_47,6,0,e_0,594,606,660,19,11,8,3,5,0,5,12,54,66
p_41,10,0,e_0,600,620,660,14,10,4,5,5,1,6,20,40,60
p_42,4,0,e_0,600,640,660,20,10,8,5,5,1,5,40,20,60
p_38,4,0,e_0,627,640,660,14,6,3,8,4,1,4,13,20,33
p_43,3,0,e_0,599,645,660,21,10,8,5,5,1,4,46,15,61
p_48,2,0,e_0,593,650,660,23,12,9,3,5,0,4,57,10,67
p_51,1,0,e_0,591,655,660,25,12,10,3,5,0,3,64,5,69
p_77,6,0,e_1,557,578,672,28,12,12,0,3,0,0,21,94,115
p_73,6,0,e_1,568,578,672,25,13,13,3,5,0,2,10,94,104
p_76,7,0,e_1,559,583,672,27,12,12,0,5,0,1,24,89,113
p_67,8,0,e_1,574,588,672,22,12,6,5,5,0,4,14,84,98
p_63,8,0,e_1,581,588,672,20,12,6,7,5,1,5,7,84,91
p_60,9,0,e_1,584,593,672,18,12,5,7,5,1,4,9,79,88
p_69,10,0,e_1,573,598,672,20,12,4,5,5,0,3,25,74,99
p_58,10,0,e_1,586,598,672,17,12,4,8,5,1,5,12,74,86
p_50,10,0,e_1,592,598,672,16,12,4,9,2,1,3,6,74,80
p_46,13,0,e_1,596,609,672,12,11,2,10,5,1,3,13,63,76
p_44,15,0,e_1,598,617,672,9,10,0,10,5,1,3,19,55,74
p_39,15,0,e_1,609,617,672,7,8,0,13,2,1,3,8,55,63
p_37,7,0,e_1,633,643,672,10,6,2,10,4,1,2,10,29,39
p_35,4,0,e_1,640,654,672,12,7,1,8,4,1,3,14,18,32
p_70,3,0,e_1,572,659,672,27,13,13,4,5,0,2,87,13,100
p_64,1,0,e_1,579,677,682,28,12,12,6,5,1,4,98,5,103
p_31,5,0,e_0,662,680,697,6,9,2,0,3,0,0,18,17,35
p_30,5,0,e_0,676,680,697,3,9,0,4,5,0,1,4,17,21
p_84,3,0,e_3,546,584,707,3,11,2,6,1,1,10,38,123,161
p_125,4,0,e_3,474,589,707,17,9,5,9,5,1,8,115,118,233
p_129,5,0,e_3,470,594,707,17,6,5,8,2,1,5,124,113,237
p_122,5,0,e_3,477,594,707,16,10,5,9,5,1,9,117,113,230
p_83,5,0,e_3,546,594,707,1,10,0,6,1,1,9,48,113,161
p_126,6,0,e_3,473,599,707,16,7,5,8,5,1,6,126,108,234
p_93,7,0,e_3,529,604,707,3,10,2,10,4,1,9,75,103,178
p_89,7,0,e_3,537,604,707,1,11,0,8,4,1,10,67,103,170
p_197,8,0,e_3,375,609,707,4,4,1,12,4,1,3,234,98,332
p_188,8,0,e_3,390,609,707,1,3,0,9,4,1,2,219,98,317
p_195,9,0,e_3,376,614,707,3,4,0,12,4,1,3,238,93,331
p_131,9,0,e_3,467,614,707,14,7,4,7,5,1,6,147,93,240
p_130,9,0,e_3,469,614,707,13,7,4,8,5,1,6,145,93,238
p_121,9,0,e_3,480,614,707,11,11,4,10,5,1,10,134,93,227
p_146,10,0,e_3,451,619,707,17,8,2,3,5,1,7,168,88,256
p_27,2,0,e_1,693,701,717,2,11,0,0,3,0,0,8,16,24
p_26,3,0,e_1,698,706,717,29,11,11,1,5,0,1,8,11,19
p_40,4,0,e_2,601,650,740,20,10,8,10,4,1,2,49,90,139
p_53,9,0,e_2,590,667,740,17,12,5,12,4,1,2,77,73,150
p_52,11,0,e_2,591,675,740,15,12,4,12,1,1,2,84,65,149
p_34,15,0,e_2,643,689,740,30,7,7,2,5,0,3,46,51,97
p_29,15,0,e_2,678,689,740,22,10,10,12,5,1,1,11,51,62
p_25,7,0,e_2,703,715,740,24,10,10,11,4,1,0,12,25,37
p_23,5,0,e_2,709,723,740,25,10,8,9,4,1,1,14,17,31
p_18,2,0,e_1,768,777,785,14,2,1,0,3,0,0,9,8,17
p_24,5,0,e_0,707,724,789,5,10,10,0,3,0,0,17,65,82
p_20,9,0,e_0,737,738,789,14,8,6,9,5,1,1,1,51,52
p_22,10,0,e_0,712,743,789,19,10,5,1,5,0,1,31,46,77
p_21,10,0,e_0,732,743,789,14,8,5,7,5,1,1,11,46,57
p_19,12,0,e_0,740,751,789,10,7,3,9,5,1,1,11,38,49
p_56,2,0,e_3,588,715,825,2,11,11,4,3,1,10,127,110,237
p_32,5,0,e_3,657,726,825,7,8,3,12,1,1,7,69,99,168
p_28,6,0,e_3,679,731,825,1,10,0,7,4,1,9,52,94,146
p_33,8,0,e_3,647,739,825,6,7,4,14,1,1,6,92,86,178
p_128,10,0,e_3,471,747,825,12,7,3,8,5,1,6,276,78,354
p_100,10,0,e_3,522,747,825,1,11,0,11,4,1,10,225,78,303
p_36,11,0,e_3,635,752,825,5,6,1,14,5,1,5,117,73,190
p_145,12,0,e_3,451,757,825,15,7,1,3,5,1,6,306,68,374
p_134,12,0,e_3,462,757,825,12,8,2,6,5,1,7,295,68,363
p_123,12,0,e_3,474,757,825,10,8,2,8,5,1,7,283,68,351
p_117,12,0,e_3,490,757,825,6,10,3,12,5,1,9,267,68,335
p_140,13,0,e_3,455,762,825,12,9,1,5,5,1,8,307,63,370
p_139,13,0,e_3,456,762,825,12,9,1,5,5,1,8,306,63,369
p_137,13,0,e_3,458,762,825,12,9,1,5,5,1,8,304,63,367
p_124,14,0,e_3,474,767,825,8,8,1,8,5,1,7,293,58,351
p_13,11,0,e_0,794,829,868,29,4,4,0,3,0,0,35,39,74
p_11,11,0,e_0,810,829,868,24,4,4,5,5,0,1,19,39,58
p_9,2,0,e_0,845,858,868,22,3,3,6,4,1,0,13,10,23
p_8,1,0,e_0,847,863,868,22,3,3,5,4,1,1,16,5,21
p_10,14,0,e_2,810,826,880,21,4,4,9,5,0,1,16,54,70
p_15,15,0,e_2,782,831,880,29,3,3,0,3,0,0,49,49,98
p_14,15,0,e_2,790,831,880,27,4,4,2,5,0,1,41,49,90
p_4,1,0,e_2,864,875,880,17,4,3,4,4,1,0,11,5,16
p_12,13,0,e_1,796,838,881,27,4,4,0,3,0,0,42,43,85
p_5,5,0,e_1,860,864,881,14,4,4,6,4,1,0,4,17,21
p_3,1,0,e_0,876,882,903,15,2,1,0,3,0,0,6,21,27
p_2,3,0,e_0,878,890,903,18,1,0,0,5,0,1,12,13,25
p_1,2,0,e_0,889,895,903,10,1,0,3,5,1,1,6,8,14
p_7,12,0,e_3,851,863,925,10,3,3,8,5,0,3,12,62,74
p_16,13,0,e_3,774,868,925,2,2,1,15,1,1,1,94,57,151
p_109,14,0,e_3,506,873,925,1,10,0,15,4,1,9,367,52,419
p_6,14,0,e_3,858,873,925,5,4,1,11,5,0,4,15,52,67
p_151,15,0,e_3,443,878,925,13,7,0,2,2,1,6,435,47,482
p_149,15,0,e_3,444,878,925,13,8,0,2,5,1,7,434,47,481
p_142,15,0,e_3,452,878,925,11,9,0,4,5,1,8,426,47,473
p_141,15,0,e_3,455,878,925,10,9,0,5,2,1,8,423,47,470
p_127,15,0,e_3,473,878,925,7,8,0,8,5,1,7,405,47,452
p_112,15,0,e_3,497,878,925,1,10,0,14,5,1,9,381,47,428
p_111,15,0,e_3,501,878,925,1,10,0,14,5,1,9,377,47,424
p_17,15,0,e_3,772,878,925,2,2,0,15,2,1,1,106,47,153
