p_3,4,0,e_2,25,39,87,4,0,0,0,3,0,0,14,48,62
p_4,5,0,e_2,34,44,87,5,0,0,2,5,0,1,10,43,53
p_5,9,0,e_2,41,58,87,9,0,0,4,5,1,1,17,29,46
p_6,9,0,e_2,45,58,87,9,0,0,5,5,1,1,13,29,42
p_2,11,0,e_1,19,54,89,11,0,0,0,3,0,0,35,35,70
p_1,13,0,e_0,13,55,96,13,0,0,0,3,0,0,42,41,83
p_12,0,8,e_2,86,87,113,21,5,5,0,4,1,0,1,26,27
p_16,4,0,e_1,101,115,129,13,4,1,0,3,0,0,14,14,28
p_15,5,0,e_0,99,116,133,13,4,2,0,3,0,0,17,17,34
p_19,0,7,e_1,125,129,154,11,2,0,1,4,1,0,4,25,29
p_7,2,0,e_3,55,64,162,2,0,0,0,3,0,0,9,98,107
p_10,9,0,e_3,77,87,162,15,3,2,6,5,1,2,10,75,85
p_9,10,0,e_3,67,92,162,17,2,1,3,5,1,1,25,70,95
p_14,13,0,e_3,87,103,162,8,4,1,9,5,1,3,16,59,75
p_8,15,0,e_3,62,111,162,14,1,0,1,5,0,1,49,51,100
p_11,4,0,e_3,84,146,162,18,4,3,8,5,1,3,62,16,78
p_20,3,0,e_3,142,151,162,2,2,1,5,4,1,1,9,11,20
p_21,0,10,e_0,142,142,176,5,2,0,0,3,0,0,0,34,34
p_13,8,0,e_2,87,113,185,13,5,3,0,3,1,0,26,72,98
p_17,10,0,e_2,112,121,185,5,2,0,8,5,1,0,9,64,73
p_18,15,0,e_2,120,138,185,28,2,2,10,5,1,1,18,47,65
p_30,2,0,e_2,200,209,217,15,3,1,0,3,0,0,9,8,17
p_22,6,0,e_1,146,149,233,28,2,2,5,5,1,0,3,84,87
p_23,15,0,e_1,150,180,233,18,2,2,6,5,2,0,30,53,83
p_28,7,0,e_1,184,206,233,5,3,1,14,4,1,0,22,27,49
p_31,5,0,e_1,203,214,233,12,3,1,8,4,1,1,11,19,30
p_33,1,0,e_1,213,228,233,13,2,1,5,4,1,1,15,5,20
p_36,1,0,e_1,225,228,233,10,2,1,2,4,1,1,3,5,8
p_24,14,0,e_0,157,190,234,17,1,1,4,5,1,0,33,44,77
p_32,0,10,e_2,209,217,249,14,3,3,2,2,0,0,8,32,40
p_35,0,6,e_1,222,233,253,11,2,0,3,4,1,1,11,20,31
p_26,6,0,e_3,169,183,259,11,1,1,1,5,0,1,14,76,90
p_25,9,0,e_3,163,194,259,9,0,0,0,3,0,0,31,65,96
p_29,14,0,e_3,192,211,259,5,3,0,9,5,1,2,19,48,67
p_34,11,0,e_3,217,222,259,1,2,0,12,4,1,1,5,37,42
p_27,5,0,e_3,180,242,259,8,2,2,5,5,0,2,62,17,79
p_42,4,0,e_3,269,284,298,4,0,0,0,3,0,0,15,14,29
p_43,4,0,e_3,270,284,298,4,1,1,0,3,0,1,14,14,28
p_44,4,0,e_3,275,284,298,3,1,0,1,5,0,1,9,14,23
p_41,7,0,e_0,257,280,303,24,1,1,0,3,0,0,23,23,46
p_38,12,0,e_1,240,273,313,23,2,2,2,5,1,0,33,40,73
p_47,3,0,e_1,293,302,313,28,3,3,6,4,1,0,9,11,20
p_49,3,0,e_1,298,302,313,19,2,2,4,4,1,1,4,11,15
p_39,13,0,e_2,247,260,315,21,1,1,10,5,1,1,13,55,68
p_37,15,0,e_2,228,268,315,24,2,2,3,5,1,0,40,47,87
p_40,15,0,e_2,255,268,315,16,1,1,11,5,0,2,13,47,60
p_51,0,4,e_1,309,313,327,19,2,2,1,4,1,0,4,14,18
p_57,1,0,e_2,327,332,337,19,3,2,0,3,0,0,5,5,10
p_58,0,6,e_2,330,337,357,18,3,3,1,5,0,1,7,20,27
p_56,8,0,e_0,324,329,367,12,3,2,7,5,0,1,5,38,43
p_48,9,0,e_0,294,334,367,22,3,3,3,4,1,0,40,33,73
p_59,3,0,e_0,335,354,367,14,2,1,9,4,1,0,19,13,32
p_60,2,0,e_0,338,359,367,15,2,1,8,4,1,1,21,8,29
p_54,7,0,e_1,313,338,371,17,3,3,0,3,1,1,25,33,58
p_53,8,0,e_1,313,343,371,16,3,2,0,3,1,0,30,28,58
p_62,1,0,e_1,345,366,371,13,3,0,8,4,1,0,21,5,26
p_63,3,0,e_2,364,375,386,6,1,0,6,3,0,0,11,11,22
p_46,8,0,e_3,291,324,392,24,2,2,2,4,1,1,33,68,101
p_45,11,0,e_3,290,335,392,22,1,1,3,4,1,0,45,57,102
p_50,11,0,e_3,299,335,392,11,2,0,0,5,0,2,36,57,93
p_52,14,0,e_3,312,346,392,10,2,0,4,5,0,2,34,46,80
p_55,14,0,e_3,314,346,392,9,3,0,5,5,0,3,32,46,78
p_61,12,0,e_3,341,354,392,4,2,1,12,5,1,1,13,38,51
p_65,0,7,e_1,369,371,394,8,1,0,1,4,1,0,2,23,25
p_68,2,0,e_2,389,397,405,29,1,1,0,3,0,0,8,8,16
p_69,2,0,e_2,391,397,405,28,1,1,0,5,0,1,6,8,14
p_64,0,15,e_0,365,367,414,9,1,0,0,4,1,0,2,47,49
p_73,3,0,e_2,423,435,446,5,2,1,0,3,0,0,12,11,23
p_66,11,0,e_1,376,408,453,24,1,1,1,5,1,0,32,45,77
p_67,12,0,e_1,377,413,453,23,1,1,2,5,1,1,36,40,76
p_75,3,0,e_1,438,442,453,7,1,0,4,4,1,0,4,11,15
p_70,3,0,e_3,398,410,469,3,0,0,0,3,0,0,12,59,71
p_72,6,0,e_3,417,421,469,3,2,1,5,5,1,1,4,48,52
p_71,7,0,e_3,403,426,469,6,1,0,1,5,0,1,23,43,66
p_74,10,0,e_3,424,437,469,3,2,0,7,5,1,1,13,32,45
p_77,4,0,e_2,455,470,484,30,1,1,0,3,0,0,15,14,29
p_76,10,0,e_0,440,457,491,29,1,1,15,3,0,0,17,34,51
p_79,9,0,e_0,457,462,491,25,1,1,10,1,0,0,5,29,34
p_81,1,0,e_0,493,499,504,1,0,0,0,3,0,0,6,5,11
p_82,0,12,e_2,494,495,535,0,0,0,0,3,0,0,1,40,41
p_78,12,0,e_1,455,493,539,22,1,1,0,3,0,0,38,46,84
p_80,13,0,e_1,474,498,539,13,0,0,6,5,0,1,24,41,65
p_83,0,12,e_3,501,502,544,0,0,0,0,3,0,0,1,42,43
p_87,3,0,e_0,528,540,569,14,1,1,0,3,0,0,12,29,41
p_89,5,0,e_0,535,548,569,9,2,1,2,5,0,1,13,21,34
p_94,3,0,e_0,546,556,569,9,2,1,5,5,1,2,10,13,23
p_90,1,0,e_0,538,564,569,13,2,1,2,5,0,2,26,5,31
p_88,10,0,e_3,531,536,586,6,1,1,8,5,1,0,5,50,55
p_92,10,0,e_3,540,552,586,3,2,1,11,5,2,0,12,34,46
p_95,10,0,e_3,547,552,586,1,2,0,11,4,1,1,5,34,39
p_96,7,0,e_3,551,563,586,3,2,0,10,4,1,1,12,23,35
p_84,12,0,e_2,504,535,589,12,1,0,2,5,1,0,31,54,85
p_85,14,0,e_2,517,543,589,10,1,0,6,5,1,0,26,46,72
p_86,14,0,e_2,518,543,589,10,1,0,7,5,1,1,25,46,71
p_91,14,0,e_2,539,543,589,3,2,0,13,5,1,1,4,46,50
p_99,9,0,e_2,556,560,589,30,2,2,10,4,1,0,4,29,33
p_107,3,0,e_0,584,595,634,28,1,1,0,3,0,1,11,39,50
p_106,5,0,e_0,583,603,634,26,1,1,0,3,0,0,20,31,51
p_108,7,0,e_0,584,611,634,24,1,1,0,3,0,2,27,23,50
p_117,0,2,e_0,636,637,647,16,2,2,0,3,0,0,1,10,11
p_93,4,0,e_1,543,557,647,8,3,0,0,3,0,0,14,90,104
p_97,5,0,e_1,552,562,647,5,2,1,3,5,0,1,10,85,95
p_98,6,0,e_1,555,567,647,3,2,1,4,5,0,2,12,80,92
p_101,9,0,e_1,566,578,647,28,1,1,6,5,1,2,12,69,81
p_100,10,0,e_1,557,583,647,29,2,2,4,3,0,2,26,64,90
p_105,12,0,e_1,582,591,647,19,1,1,10,5,1,2,9,56,65
p_110,12,0,e_1,590,591,647,12,0,0,12,2,1,2,1,56,57
p_102,14,0,e_1,568,601,647,22,1,1,6,5,1,2,33,46,79
p_103,14,0,e_1,577,601,647,19,1,1,9,5,1,3,24,46,70
p_104,14,0,e_1,581,601,647,18,1,1,9,5,1,2,20,46,66
p_109,10,0,e_1,590,615,647,10,0,0,12,5,1,2,25,32,57
p_121,3,0,e_1,656,667,680,16,4,3,0,3,0,0,11,13,24
p_125,2,0,e_1,668,672,680,14,2,1,3,4,1,0,4,8,12
p_123,0,2,e_1,661,680,690,17,3,3,1,5,0,1,19,10,29
p_111,2,0,e_2,607,615,695,2,0,0,0,3,0,0,8,80,88
p_112,11,0,e_2,613,644,695,11,0,0,2,5,0,1,31,51,82
p_114,13,0,e_2,632,652,695,13,1,0,7,5,1,1,20,43,63
p_122,7,0,e_2,657,672,695,11,4,2,12,4,1,0,15,23,38
p_124,7,0,e_2,664,672,695,10,2,1,9,4,1,1,8,23,31
p_118,8,0,e_0,649,670,696,4,2,1,2,3,0,0,21,26,47
p_126,1,0,e_1,681,685,698,11,1,0,0,5,1,0,4,13,17
p_116,7,0,e_3,633,653,718,10,1,1,1,5,0,1,20,65,85
p_119,8,0,e_3,650,658,718,4,2,1,6,5,0,2,8,60,68
p_113,9,0,e_3,629,663,718,9,0,0,0,3,0,0,34,55,89
p_115,9,0,e_3,632,663,718,9,1,0,0,5,0,1,31,55,86
p_120,13,0,e_3,653,677,718,6,2,0,7,2,0,2,24,41,65
p_128,0,15,e_1,705,705,754,4,1,0,0,3,0,0,0,49,49
p_129,5,0,e_2,705,723,754,29,1,1,0,3,0,0,18,31,49
p_131,7,0,e_2,722,731,754,7,0,0,5,5,0,1,9,23,32
p_132,4,0,e_3,730,745,773,4,0,0,0,3,0,0,15,28,43
p_133,6,0,e_3,734,753,773,6,1,0,0,5,0,1,19,20,39
p_127,7,0,e_0,701,725,800,29,1,1,0,3,0,0,24,75,99
p_130,11,0,e_0,705,739,800,23,1,1,1,5,0,1,34,61,95
p_135,11,0,e_0,739,741,800,9,2,0,11,5,1,1,2,59,61
p_134,14,0,e_0,734,752,800,13,2,0,9,5,1,1,18,48,66
p_136,14,0,e_0,749,752,800,9,2,0,13,5,1,1,3,48,51
p_138,12,0,e_0,756,760,800,24,1,1,13,4,1,0,4,40,44
p_140,5,0,e_0,768,783,800,27,1,1,10,4,1,0,15,17,32
p_143,5,0,e_0,780,783,800,19,1,1,6,4,1,1,3,17,20
p_137,13,0,e_1,755,764,805,23,1,1,15,3,0,0,9,41,50
p_139,0,15,e_2,758,758,809,5,1,0,0,3,0,0,0,51,51
p_145,1,0,e_1,820,825,830,11,1,0,0,3,0,0,5,5,10
p_142,13,0,e_3,773,814,855,13,0,0,0,3,1,0,41,41,82
p_141,12,0,e_2,770,798,856,19,1,1,3,5,1,0,28,58,86
p_144,6,0,e_0,815,836,856,7,1,0,0,3,0,0,21,20,41
p_150,3,0,e_2,860,871,882,3,0,0,0,3,0,0,11,11,22
p_152,2,0,e_3,868,876,928,2,0,0,0,3,0,0,8,52,60
p_154,4,0,e_3,874,884,928,6,2,1,2,5,0,2,10,44,54
p_153,6,0,e_3,872,892,928,5,1,0,1,5,0,1,20,36,56
p_157,7,0,e_3,889,897,928,2,2,0,5,5,1,1,8,31,39
p_158,7,0,e_3,892,897,928,1,2,0,6,2,1,1,5,31,36
p_159,8,0,e_3,893,902,928,2,2,0,6,5,1,1,9,26,35
p_149,6,0,e_0,859,879,939,6,0,0,0,3,0,0,20,60,80
p_155,11,0,e_0,884,896,939,7,2,0,7,5,1,1,12,43,55
p_151,12,0,e_0,863,901,939,12,0,0,1,5,0,1,38,38,76
p_156,12,0,e_0,884,901,939,8,2,0,7,5,1,2,17,38,55
p_147,6,0,e_1,849,867,945,26,1,1,0,5,0,2,18,78,96
p_146,10,0,e_1,846,881,945,23,1,1,0,3,0,0,35,64,99
p_148,15,0,e_1,849,898,945,17,1,1,0,5,0,1,49,47,96
p_3,4,0,e_2,25,40,88,4,0,0,0,3,0,0,15,48,63
p_4,5,0,e_2,34,45,88,5,0,0,2,5,0,1,11,43,54
p_5,9,0,e_2,41,59,88,9,0,0,4,5,1,1,18,29,47
p_6,9,0,e_2,45,59,88,9,0,0,5,2,1,1,14,29,43
p_2,11,0,e_1,19,54,89,11,0,0,0,3,0,0,35,35,70
p_1,13,0,e_0,13,55,96,13,0,0,0,3,0,0,42,41,83
p_12,0,8,e_2,86,88,114,21,4,4,0,4,1,0,2,26,28
p_16,4,0,e_1,101,116,130,13,5,1,0,3,0,0,15,14,29
p_15,5,0,e_0,99,116,133,13,5,2,0,3,0,0,17,17,34
p_19,0,7,e_1,125,130,155,11,3,0,1,4,1,0,5,25,30
p_7,2,0,e_3,55,64,162,2,0,0,0,3,0,0,9,98,107
p_10,9,0,e_3,77,87,162,15,3,2,6,5,1,2,10,75,85
p_9,10,0,e_3,67,92,162,18,2,1,2,5,1,1,25,70,95
p_14,13,0,e_3,87,103,162,8,5,1,9,5,1,4,16,59,75
p_8,15,0,e_3,62,111,162,13,1,0,2,5,0,1,49,51,100
p_13,8,0,e_3,87,134,162,13,4,2,9,5,1,3,47,28,75
p_11,4,0,e_3,84,148,162,18,4,3,8,5,1,3,64,14,78
p_21,0,10,e_0,142,142,180,6,2,0,0,3,0,1,0,38,38
p_17,10,0,e_2,112,122,186,5,3,0,8,5,1,0,10,64,74
p_18,15,0,e_2,120,139,186,27,3,3,10,5,0,1,19,47,66
p_20,3,0,e_0,142,155,214,3,2,1,0,3,0,0,13,59,72
p_25,9,0,e_0,163,175,214,9,0,0,5,5,2,0,12,39,51
p_28,7,0,e_0,184,191,214,3,2,0,9,4,1,0,7,23,30
p_27,5,0,e_3,180,187,214,4,1,1,3,5,0,1,7,27,34
p_26,6,0,e_3,169,192,214,6,0,0,0,3,0,0,23,22,45
p_30,2,0,e_3,200,206,214,2,1,0,4,4,1,0,6,8,14
p_22,6,0,e_1,146,150,234,28,2,2,5,5,1,0,4,84,88
p_24,14,0,e_1,157,178,234,18,1,1,7,5,1,1,21,56,77
p_23,15,0,e_1,150,183,234,19,1,1,6,2,1,0,33,51,84
p_31,5,0,e_1,203,215,234,28,2,2,9,4,1,0,12,19,31
p_33,1,0,e_1,213,229,234,29,1,1,6,4,1,1,16,5,21
p_36,1,0,e_1,225,229,234,11,1,1,2,4,1,1,4,5,9
p_35,0,6,e_3,222,223,245,0,0,0,0,3,0,0,1,22,23
p_32,0,10,e_0,209,214,246,2,1,0,2,4,1,0,5,32,37
p_34,11,0,e_2,217,228,295,11,0,0,8,5,0,1,11,67,78
p_29,14,0,e_2,192,239,295,22,1,1,0,3,0,0,47,56,103
p_37,15,0,e_2,228,244,295,15,1,0,11,2,0,1,16,51,67
p_39,13,0,e_2,247,252,295,7,0,0,14,4,1,0,5,43,48
p_44,4,0,e_2,275,281,295,14,1,1,6,4,1,0,6,14,20
p_38,12,0,e_0,240,254,296,8,1,0,8,5,1,0,14,42,56
p_41,7,0,e_0,257,271,296,17,1,1,11,4,1,0,14,25,39
p_43,4,0,e_0,270,282,296,16,1,1,7,1,1,0,12,14,26
p_42,4,0,e_1,269,284,298,16,1,1,0,3,0,0,15,14,29
p_49,3,0,e_0,298,310,321,8,4,2,0,3,0,0,12,11,23
p_51,0,4,e_2,309,310,326,8,3,0,0,3,0,0,1,16,17
p_57,1,0,e_0,327,333,338,3,2,1,0,3,0,0,6,5,11
p_40,15,0,e_3,255,284,341,9,0,0,6,3,0,0,29,57,86
p_45,11,0,e_3,290,298,341,3,1,0,14,4,1,0,8,43,51
p_48,9,0,e_3,294,306,341,3,4,1,12,4,1,3,12,35,47
p_46,8,0,e_3,291,311,341,5,2,1,13,4,1,1,20,30,50
p_54,7,0,e_3,313,316,341,1,2,0,8,4,1,1,3,25,28
p_47,3,0,e_3,293,330,341,9,3,2,12,4,1,2,37,11,48
p_62,1,0,e_3,345,350,355,1,0,0,0,3,0,0,5,5,10
p_58,0,6,e_0,330,338,358,3,1,0,0,5,0,1,8,20,28
p_53,8,0,e_2,313,340,370,30,2,2,0,5,1,0,27,30,57
p_56,8,0,e_2,324,340,370,27,2,2,4,5,1,1,16,30,46
p_59,3,0,e_2,335,357,370,29,1,1,7,5,0,1,22,13,35
p_60,2,0,e_2,338,362,370,29,1,1,8,5,0,2,24,8,32
p_63,3,0,e_0,364,376,387,3,0,0,6,3,0,0,12,11,23
p_50,11,0,e_1,299,335,392,30,4,4,0,3,0,0,36,57,93
p_52,14,0,e_1,312,346,392,24,2,2,3,5,0,1,34,46,80
p_55,14,0,e_1,314,346,392,23,3,3,4,5,0,2,32,46,78
p_61,12,0,e_1,341,354,392,12,0,0,12,5,1,1,13,38,51
p_65,0,7,e_2,369,370,395,30,1,1,0,3,1,0,1,25,26
p_68,2,0,e_0,389,398,406,21,1,1,0,3,0,0,9,8,17
p_69,2,0,e_0,391,398,406,21,1,1,0,5,0,1,7,8,15
p_64,0,15,e_3,365,365,414,0,0,0,0,3,0,0,0,49,49
p_73,3,0,e_0,423,435,446,12,0,0,0,3,0,0,12,11,23
p_70,3,0,e_1,398,409,448,17,1,1,0,3,0,0,11,39,50
p_72,6,0,e_1,417,420,448,9,0,0,5,5,1,1,3,28,31
p_71,7,0,e_1,403,425,448,11,1,1,1,5,0,1,22,23,45
p_66,11,0,e_2,376,409,454,16,1,1,1,5,1,0,33,45,78
p_67,12,0,e_2,377,414,454,15,1,1,1,5,1,1,37,40,77
p_75,3,0,e_2,438,443,454,8,1,1,5,4,1,0,5,11,16
p_74,10,0,e_3,424,441,475,5,0,0,15,3,0,0,17,34,51
p_76,10,0,e_3,440,441,475,20,1,1,10,4,0,1,1,34,35
p_77,4,0,e_3,455,461,475,2,1,0,6,4,1,0,6,14,20
p_81,1,0,e_2,493,498,503,1,0,0,0,3,0,0,5,5,10
p_79,9,0,e_1,457,486,515,26,2,2,0,3,0,0,29,29,58
p_82,0,12,e_3,494,494,534,0,0,0,0,3,0,0,0,40,40
p_78,12,0,e_0,455,493,539,24,2,2,0,3,0,0,38,46,84
p_80,13,0,e_0,474,498,539,17,1,1,6,5,0,1,24,41,65
p_83,0,12,e_2,501,503,543,23,1,1,0,4,1,0,2,40,42
p_87,3,0,e_1,528,539,564,15,2,2,0,3,0,0,11,25,36
p_89,5,0,e_1,535,547,564,11,2,1,2,5,0,1,12,17,29
p_90,1,0,e_0,538,544,571,14,2,1,0,3,1,0,6,27,33
p_94,3,0,e_0,546,552,571,10,1,0,1,5,1,1,6,19,25
p_93,4,0,e_0,543,557,571,10,1,0,1,5,0,1,14,14,28
p_88,10,0,e_2,531,535,585,7,2,2,9,5,1,0,4,50,54
p_92,10,0,e_2,540,551,585,4,2,0,11,5,2,0,11,34,45
p_95,10,0,e_2,547,551,585,3,1,0,11,4,1,1,4,34,38
p_96,7,0,e_2,551,562,585,5,1,0,10,1,1,0,11,23,34
p_84,12,0,e_3,504,534,590,10,1,0,2,5,1,0,30,56,86
p_85,14,0,e_3,517,542,590,7,1,0,7,5,1,0,25,48,73
p_86,14,0,e_3,518,542,590,7,2,0,7,5,1,1,24,48,72
p_91,14,0,e_3,539,542,590,1,2,0,13,5,1,1,3,48,51
p_99,9,0,e_3,556,559,590,1,2,0,10,4,1,1,3,31,34
p_98,6,0,e_3,555,570,590,4,1,0,10,4,1,0,15,20,35
p_108,7,0,e_2,584,608,653,25,1,1,0,3,1,0,24,45,69
p_109,10,0,e_2,590,619,653,14,1,1,1,5,0,1,29,34,63
p_111,2,0,e_2,607,645,653,17,1,1,7,2,0,1,38,8,46
p_117,0,2,e_2,636,653,661,10,2,0,5,4,1,2,17,8,25
p_97,5,0,e_0,552,588,663,6,1,0,3,2,1,1,36,75,111
p_106,5,0,e_0,583,588,663,27,1,1,4,5,0,2,5,75,80
p_103,14,0,e_0,577,617,663,20,1,1,2,5,0,1,40,46,86
p_107,3,0,e_0,584,652,663,29,1,1,4,5,0,2,68,11,79
p_101,9,0,e_1,566,593,664,28,2,2,0,5,0,1,27,71,98
p_100,10,0,e_1,557,598,664,29,3,3,2,4,1,0,41,66,107
p_105,12,0,e_1,582,606,664,20,1,1,6,5,0,3,24,58,82
p_102,14,0,e_1,568,614,664,22,2,2,1,5,0,2,46,50,96
p_104,14,0,e_1,581,614,664,19,1,1,5,5,0,3,33,50,83
p_112,11,0,e_1,613,625,664,6,1,1,14,5,1,1,12,39,51
p_113,9,0,e_1,629,633,664,3,1,0,10,4,1,0,4,31,35
p_116,7,0,e_1,633,641,664,4,2,1,9,1,1,0,8,23,31
p_110,12,0,e_3,590,628,670,12,0,0,0,3,1,0,38,42,80
p_115,9,0,e_3,632,639,670,2,1,0,11,4,1,0,7,31,38
p_121,3,0,e_3,656,659,670,1,1,0,4,4,1,0,3,11,14
p_123,0,2,e_0,661,663,671,3,1,0,0,4,1,0,2,8,10
p_125,2,0,e_0,668,671,679,28,1,1,1,5,1,0,3,8,11
p_126,1,0,e_0,681,687,692,1,0,0,0,3,0,0,6,5,11
p_124,7,0,e_1,664,688,711,25,1,1,0,3,0,0,24,23,47
p_122,7,0,e_2,657,678,743,26,2,2,1,5,1,2,21,65,86
p_118,8,0,e_2,649,683,743,28,1,1,1,4,1,1,34,60,94
p_119,8,0,e_2,650,683,743,28,1,1,1,4,1,2,33,60,93
p_114,13,0,e_2,632,700,743,28,2,2,6,4,1,1,68,43,111
p_120,13,0,e_2,653,700,743,22,1,1,0,5,1,2,47,43,90
p_130,11,0,e_2,705,708,743,19,3,1,12,4,1,0,3,35,38
p_127,7,0,e_0,701,725,750,7,0,0,0,3,0,0,24,25,49
p_131,7,0,e_0,722,725,750,19,2,1,6,5,0,1,3,25,28
p_132,4,0,e_0,730,736,750,20,2,1,6,4,1,0,6,14,20
p_128,0,15,e_3,705,705,758,0,0,0,0,3,0,0,0,53,53
p_140,5,0,e_2,768,785,802,8,2,1,0,3,0,0,17,17,34
p_143,5,0,e_2,780,785,802,4,1,0,3,5,0,1,5,17,22
p_139,0,15,e_0,758,758,807,15,3,0,0,3,0,0,0,49,49
p_129,5,0,e_3,705,724,809,5,1,1,0,3,0,1,19,85,104
p_134,14,0,e_3,734,753,809,8,2,1,8,5,2,0,19,56,75
p_136,14,0,e_3,749,753,809,3,3,1,13,5,2,1,4,56,60
p_137,13,0,e_3,755,766,809,3,2,1,14,5,2,0,11,43,54
p_138,12,0,e_3,756,771,809,4,3,1,14,5,2,1,15,38,53
p_133,6,0,e_1,734,754,822,16,3,2,0,3,0,0,20,68,88
p_135,11,0,e_1,739,771,822,9,3,2,1,5,0,1,32,51,83
p_141,12,0,e_1,770,776,822,30,2,2,11,5,1,1,6,46,52
p_142,13,0,e_1,773,781,822,29,1,1,11,5,1,1,8,41,49
p_145,1,0,e_3,820,826,831,1,0,0,0,3,0,0,6,5,11
p_144,6,0,e_2,815,835,855,6,0,0,0,3,0,0,20,20,40
p_150,3,0,e_2,860,871,884,6,1,1,0,3,0,0,11,13,24
p_152,2,0,e_2,868,876,884,17,2,2,2,5,0,1,8,8,16
p_146,10,0,e_0,846,864,900,10,0,0,15,3,0,0,18,36,54
p_153,6,0,e_0,872,878,900,12,2,1,8,4,1,0,6,22,28
p_154,4,0,e_0,874,886,900,13,2,1,7,4,1,1,12,14,26
p_147,6,0,e_3,849,870,932,6,0,0,0,3,0,0,21,62,83
p_149,6,0,e_3,859,870,932,3,1,0,3,5,0,1,11,62,73
p_155,11,0,e_3,884,887,932,3,2,1,10,5,1,1,3,45,48
p_151,12,0,e_3,863,892,932,8,1,0,4,5,0,1,29,40,69
p_156,12,0,e_3,884,892,932,2,2,0,10,5,1,1,8,40,48
p_159,8,0,e_3,893,906,932,4,1,0,12,4,1,0,13,26,39
p_157,7,0,e_2,889,913,936,6,2,1,0,3,0,0,24,23,47
p_158,7,0,e_2,892,913,936,19,1,0,0,5,0,1,21,23,44
p_148,15,0,e_1,849,896,943,15,0,0,0,3,0,0,47,47,94
p_3,4,0,e_2,25,40,88,4,0,0,0,3,0,0,15,48,63
p_4,5,0,e_2,34,45,88,5,0,0,2,5,0,1,11,43,54
p_5,9,0,e_2,41,59,88,9,0,0,4,5,1,1,18,29,47
p_6,9,0,e_2,45,59,88,9,0,0,5,2,1,1,14,29,43
p_2,11,0,e_1,19,54,89,11,0,0,0,3,0,0,35,35,70
p_1,13,0,e_0,13,54,95,13,0,0,0,3,0,0,41,41,82
p_12,0,8,e_1,86,89,115,21,5,5,1,4,1,0,3,26,29
p_16,4,0,e_0,101,113,135,14,4,2,0,5,0,1,12,22,34
p_15,5,0,e_0,99,118,135,13,4,2,0,3,0,0,19,17,36
p_19,0,7,e_0,125,135,158,11,2,0,3,4,1,0,10,23,33
p_7,2,0,e_3,55,64,162,2,0,0,0,3,0,0,9,98,107
p_10,9,0,e_3,77,87,162,15,3,2,6,5,1,2,10,75,85
p_9,10,0,e_3,67,92,162,17,2,1,3,5,1,1,25,70,95
p_14,13,0,e_3,87,103,162,8,4,1,9,5,1,3,16,59,75
p_8,15,0,e_3,62,111,162,13,1,0,2,5,0,1,49,51,100
p_11,4,0,e_3,84,146,162,18,4,3,8,5,1,3,62,16,78
p_20,3,0,e_3,142,151,162,2,2,1,5,4,1,1,9,11,20
p_22,6,0,e_1,146,154,174,28,2,2,8,3,0,0,8,20,28
p_13,8,0,e_2,87,114,186,13,5,3,0,3,1,0,27,72,99
p_17,10,0,e_2,112,122,186,5,2,0,8,5,0,1,10,64,74
p_18,15,0,e_2,120,139,186,28,2,2,9,5,1,1,19,47,66
p_21,0,10,e_3,142,162,198,5,3,0,5,4,1,2,20,36,56
p_30,2,0,e_2,200,208,216,16,2,1,0,3,0,0,8,8,16
p_27,5,0,e_1,180,197,232,10,3,3,0,3,0,0,17,35,52
p_28,7,0,e_1,184,205,232,7,3,2,1,5,0,1,21,27,48
p_31,5,0,e_1,203,213,232,12,2,1,7,5,1,1,10,19,29
p_33,1,0,e_1,213,227,232,13,1,0,5,1,1,0,14,5,19
p_24,14,0,e_0,157,181,235,17,1,1,7,5,1,1,24,54,78
p_23,15,0,e_0,150,186,235,18,1,1,5,5,1,0,36,49,85
p_36,1,0,e_0,225,230,235,10,1,0,3,4,1,0,5,5,10
p_32,0,10,e_2,209,216,248,15,2,2,2,4,1,0,7,32,39
p_35,0,6,e_1,222,232,252,11,2,0,2,4,1,1,10,20,30
p_26,6,0,e_3,169,182,258,12,2,2,2,5,1,1,13,76,89
p_25,9,0,e_3,163,193,258,11,1,1,0,5,1,0,30,65,95
p_29,14,0,e_3,192,212,258,5,2,0,9,2,2,0,20,46,66
p_34,11,0,e_3,217,223,258,2,1,0,13,4,1,0,6,35,41
p_42,4,0,e_3,269,284,298,4,0,0,0,3,0,0,15,14,29
p_43,4,0,e_3,270,284,298,4,1,1,0,3,0,1,14,14,28
p_44,4,0,e_3,275,284,298,3,1,0,1,5,0,1,9,14,23
p_41,7,0,e_0,257,280,303,23,1,1,0,3,0,0,23,23,46
p_37,15,0,e_2,228,265,314,25,1,1,4,5,1,0,37,49,86
p_40,15,0,e_2,255,265,314,16,1,1,12,5,0,1,10,49,59
p_47,3,0,e_2,293,303,314,28,2,2,6,4,1,0,10,11,21
p_49,3,0,e_2,298,303,314,3,2,2,5,4,1,1,5,11,16
p_38,12,0,e_1,240,272,320,24,1,1,2,5,1,0,32,48,80
p_39,13,0,e_1,247,277,320,20,1,1,5,5,1,1,30,43,73
p_46,8,0,e_1,291,294,320,24,2,2,9,4,1,0,3,26,29
p_51,0,4,e_0,309,309,325,19,2,2,0,3,0,0,0,16,16
p_57,1,0,e_1,327,333,338,18,2,2,0,3,0,0,6,5,11
p_58,0,6,e_1,330,338,360,19,3,3,0,5,0,1,8,22,30
p_53,8,0,e_0,313,339,367,15,3,3,0,5,1,0,26,28,54
p_59,3,0,e_0,335,356,367,14,2,1,7,5,0,1,21,11,32
p_54,7,0,e_2,313,337,370,16,3,3,0,3,1,0,24,33,57
p_56,8,0,e_2,324,342,370,12,3,3,3,5,0,1,18,28,46
p_62,1,0,e_2,345,365,370,13,3,0,8,4,1,0,20,5,25
p_60,2,0,e_1,338,346,382,15,2,1,0,3,1,0,8,36,44
p_63,3,0,e_1,364,371,382,6,1,0,5,4,1,0,7,11,18
p_48,9,0,e_3,294,327,392,22,2,2,1,4,1,1,33,65,98
p_45,11,0,e_3,290,335,392,22,1,1,3,4,1,0,45,57,102
p_50,11,0,e_3,299,335,392,11,2,0,0,5,0,2,36,57,93
p_52,14,0,e_3,312,346,392,10,2,0,4,5,0,2,34,46,80
p_55,14,0,e_3,314,346,392,9,3,0,5,5,0,3,32,46,78
p_61,12,0,e_3,341,354,392,4,2,1,12,5,1,1,13,38,51
p_65,0,7,e_2,369,370,393,8,1,0,0,4,1,0,1,23,24
p_68,2,0,e_1,389,398,406,29,1,1,0,3,0,0,9,8,17
p_69,2,0,e_1,391,398,406,28,1,1,0,5,0,1,7,8,15
p_64,0,15,e_0,365,367,414,9,1,0,0,4,1,0,2,47,49
p_73,3,0,e_1,423,435,446,5,2,1,0,3,0,0,12,11,23
p_66,11,0,e_2,376,407,452,24,1,1,2,5,1,0,31,45,76
p_67,12,0,e_2,377,412,452,23,1,1,2,5,1,1,35,40,75
p_75,3,0,e_2,438,441,452,7,1,0,4,4,1,0,3,11,14
p_70,3,0,e_3,398,410,469,3,0,0,0,3,0,0,12,59,71
p_72,6,0,e_3,417,421,469,3,2,1,5,5,1,1,4,48,52
p_71,7,0,e_3,403,426,469,6,1,0,1,5,0,1,23,43,66
p_74,10,0,e_3,424,437,469,4,2,0,6,5,1,1,13,32,45
p_77,4,0,e_2,455,469,483,30,1,1,0,3,0,0,14,14,28
p_76,10,0,e_0,440,457,491,30,1,1,15,3,0,0,17,34,51
p_79,9,0,e_0,457,462,491,25,1,1,10,4,1,0,5,29,34
p_81,1,0,e_0,493,498,503,1,0,0,0,3,0,0,5,5,10
p_82,0,12,e_2,494,494,534,0,0,0,0,3,0,0,0,40,40
p_78,12,0,e_1,455,493,541,22,1,1,0,3,0,0,38,48,86
p_80,13,0,e_1,474,498,541,13,0,0,6,5,0,1,24,43,67
p_87,3,0,e_1,528,530,541,14,1,1,4,4,1,0,2,11,13
p_83,0,12,e_3,501,502,544,0,0,0,0,3,0,0,1,42,43
p_88,10,0,e_3,531,536,584,6,1,1,8,5,1,0,5,48,53
p_95,10,0,e_3,547,552,584,2,1,0,12,4,1,0,5,32,37
p_84,12,0,e_2,504,534,590,12,1,0,2,5,1,0,30,56,86
p_85,14,0,e_2,517,542,590,10,1,0,6,5,1,0,25,48,73
p_86,14,0,e_2,518,542,590,10,1,0,7,5,1,1,24,48,72
p_91,14,0,e_2,539,542,590,3,2,0,13,5,1,1,3,48,51
p_92,10,0,e_2,540,556,590,3,2,1,14,5,1,1,16,34,50
p_99,9,0,e_2,556,561,590,30,1,1,10,4,1,0,5,29,34
p_107,3,0,e_3,584,596,607,3,0,0,0,3,0,0,12,11,23
p_94,3,0,e_1,546,555,614,9,1,0,0,5,0,1,9,59,68
p_93,4,0,e_1,543,560,614,16,1,0,0,3,0,0,17,54,71
p_97,5,0,e_1,552,565,614,5,1,0,2,5,0,2,13,49,62
p_98,6,0,e_1,555,570,614,4,1,0,3,2,0,2,15,44,59
p_101,9,0,e_1,566,581,614,27,1,1,5,5,1,1,15,33,48
p_108,7,0,e_1,584,589,614,7,1,1,8,4,1,1,5,25,30
p_106,5,0,e_1,583,597,614,5,0,0,9,4,1,0,14,17,31
p_90,1,0,e_0,538,541,636,13,2,1,0,5,0,1,3,95,98
p_89,5,0,e_0,535,555,636,9,1,1,0,3,0,0,20,81,101
p_96,7,0,e_0,551,563,636,3,2,0,4,5,1,1,12,73,85
p_100,10,0,e_0,557,574,636,29,1,1,5,5,1,1,17,62,79
p_102,14,0,e_0,568,588,636,21,1,1,8,5,1,1,20,48,68
p_103,14,0,e_0,577,588,636,18,1,1,10,5,1,1,11,48,59
p_104,14,0,e_0,581,588,636,17,1,1,12,5,1,1,7,48,55
p_105,12,0,e_0,582,596,636,18,1,1,12,5,1,1,14,40,54
p_110,12,0,e_0,590,596,636,11,1,0,14,4,1,2,6,40,46
p_109,10,0,e_0,590,604,636,9,1,0,14,4,1,1,14,32,46
p_117,0,2,e_0,636,637,647,0,0,0,0,3,0,0,1,10,11
p_123,0,2,e_3,661,662,672,0,0,0,0,3,0,0,1,10,11
p_121,3,0,e_0,656,662,673,3,0,0,2,3,0,0,6,11,17
p_125,2,0,e_3,668,672,680,1,1,0,1,5,1,0,4,8,12
p_126,1,0,e_0,681,687,692,1,0,0,0,3,0,0,6,5,11
p_111,2,0,e_2,607,615,697,2,0,0,0,3,0,0,8,82,90
p_113,9,0,e_2,629,638,697,9,0,0,6,5,1,1,9,59,68
p_115,9,0,e_2,632,638,697,9,0,0,7,5,1,2,6,59,65
p_112,11,0,e_2,613,646,697,11,0,0,2,5,0,1,33,51,84
p_114,13,0,e_2,632,654,697,13,0,0,7,5,1,2,22,43,65
p_122,7,0,e_2,657,674,697,7,0,0,13,4,1,0,17,23,40
p_124,7,0,e_2,664,674,697,7,1,0,10,4,1,1,10,23,33
p_116,7,0,e_1,633,656,719,7,0,0,0,3,0,0,23,63,86
p_118,8,0,e_1,649,661,719,8,0,0,5,5,0,1,12,58,70
p_119,8,0,e_1,650,661,719,8,0,0,5,5,0,2,11,58,69
p_120,13,0,e_1,653,678,719,13,0,0,6,5,0,2,25,41,66
p_129,5,0,e_3,705,723,740,5,0,0,0,3,0,0,18,17,35
p_128,0,15,e_2,705,705,756,0,0,0,0,3,0,0,0,51,51
p_127,7,0,e_0,701,725,796,7,0,0,0,3,0,0,24,71,95
p_130,11,0,e_0,705,739,796,11,0,0,1,5,0,1,34,57,91
p_134,14,0,e_0,734,750,796,18,1,1,10,5,1,1,16,46,62
p_140,5,0,e_0,768,779,796,23,1,1,8,4,1,0,11,17,28
p_132,4,0,e_1,730,736,806,29,1,1,2,5,0,1,6,70,76
p_133,6,0,e_1,734,744,806,26,1,1,4,5,0,2,10,62,72
p_131,7,0,e_1,722,749,806,12,0,0,0,3,0,0,27,57,84
p_135,11,0,e_1,739,763,806,19,1,1,4,5,1,2,24,43,67
p_138,12,0,e_1,756,768,806,12,0,0,9,5,1,1,12,38,50
p_136,14,0,e_2,749,751,807,14,0,0,13,5,1,0,2,56,58
p_137,13,0,e_2,755,764,807,13,0,0,15,5,2,0,9,43,52
p_143,5,0,e_2,780,790,807,19,3,3,8,4,1,0,10,17,27
p_139,0,15,e_3,758,759,812,0,0,0,0,3,0,0,1,53,54
p_145,1,0,e_1,820,825,830,12,1,0,0,3,0,0,5,5,10
p_144,6,0,e_0,815,836,856,8,1,0,0,3,0,0,21,20,41
p_141,12,0,e_3,770,799,859,16,1,1,2,5,1,0,29,60,89
p_142,13,0,e_3,773,804,859,13,2,1,4,5,1,1,31,55,86
p_150,3,0,e_3,860,872,885,3,0,0,0,3,0,0,12,13,25
p_152,2,0,e_3,868,877,885,2,1,1,2,5,0,1,9,8,17
p_149,6,0,e_0,859,879,901,6,0,0,0,3,0,0,20,22,42
p_153,6,0,e_0,872,879,901,27,2,2,4,5,0,1,7,22,29
p_154,4,0,e_0,874,887,901,29,2,2,5,5,0,1,13,14,27
p_147,6,0,e_1,849,867,933,27,1,1,0,5,0,1,18,66,84
p_146,10,0,e_1,846,881,933,24,1,1,0,3,0,0,35,52,87
p_155,11,0,e_1,884,886,933,19,1,1,10,5,1,1,2,47,49
p_151,12,0,e_1,863,891,933,12,1,0,5,5,0,2,28,42,70
p_156,12,0,e_1,884,891,933,12,0,0,11,5,1,2,7,42,49
p_159,8,0,e_1,893,905,933,7,1,0,12,4,1,1,12,28,40
p_158,7,0,e_1,892,910,933,7,1,0,12,4,1,0,18,23,41
p_157,7,0,e_3,889,912,935,7,0,0,0,3,0,0,23,23,46
p_148,15,0,e_2,849,896,943,18,1,1,0,3,0,0,47,47,94
p_3,4,0,e_2,25,40,88,4,0,0,0,3,0,0,15,48,63
p_4,5,0,e_2,34,45,88,5,0,0,2,5,0,1,11,43,54
p_5,9,0,e_2,41,59,88,9,0,0,4,5,1,1,18,29,47
p_6,9,0,e_2,45,59,88,9,0,0,5,5,1,1,14,29,43
p_2,11,0,e_1,19,55,90,11,0,0,0,3,0,0,36,35,71
p_1,13,0,e_0,13,55,96,13,0,0,0,3,0,0,42,41,83
p_12,0,8,e_1,86,90,116,21,4,4,1,4,1,0,4,26,30
p_16,4,0,e_0,101,114,136,13,3,1,0,5,0,1,13,22,35
p_15,5,0,e_0,99,119,136,13,4,2,0,3,0,0,20,17,37
p_13,8,0,e_2,87,114,156,13,4,2,0,3,1,0,27,42,69
p_17,10,0,e_2,112,122,156,5,2,0,8,5,0,1,10,34,44
p_20,3,0,e_2,142,145,156,2,2,1,4,4,1,0,3,11,14
p_7,2,0,e_3,55,63,159,2,0,0,0,3,0,0,8,96,104
p_10,9,0,e_3,77,86,159,15,3,2,6,5,1,2,9,73,82
p_9,10,0,e_3,67,91,159,17,2,1,3,5,1,1,24,68,92
p_14,13,0,e_3,87,102,159,8,4,1,9,5,1,3,15,57,72
p_8,15,0,e_3,62,110,159,17,0,0,2,2,0,0,48,49,97
p_11,4,0,e_3,84,145,159,17,4,2,9,5,1,3,61,14,75
p_19,0,7,e_0,125,136,161,11,2,0,4,4,1,0,11,25,36
p_21,0,10,e_2,142,156,188,5,2,0,4,4,1,1,14,32,46
p_18,15,0,e_1,120,144,193,27,2,2,8,3,0,0,24,49,73
p_26,6,0,e_1,169,173,193,11,1,1,7,4,1,0,4,20,24
p_30,2,0,e_1,200,208,216,7,1,0,0,3,0,0,8,8,16
p_27,5,0,e_3,180,181,230,8,1,1,5,5,0,1,1,49,50
p_28,7,0,e_3,184,189,230,5,2,1,6,5,1,1,5,41,46
p_25,9,0,e_3,163,197,230,9,0,0,0,3,0,0,34,33,67
p_31,5,0,e_3,203,211,230,3,1,0,8,4,1,0,8,19,27
p_33,1,0,e_3,213,225,230,4,1,0,5,4,1,0,12,5,17
p_22,6,0,e_0,146,156,236,28,1,1,3,5,1,0,10,80,90
p_23,15,0,e_0,150,187,236,18,1,1,4,5,1,1,37,49,86
p_36,1,0,e_0,225,231,236,30,1,1,3,4,1,0,6,5,11
p_24,14,0,e_2,157,202,246,16,1,1,0,5,1,0,45,44,89
p_29,14,0,e_2,192,202,246,6,2,0,11,5,0,1,10,44,54
p_32,0,10,e_1,209,216,248,6,2,0,2,4,1,0,7,32,39
p_35,0,6,e_3,222,230,250,2,2,0,2,4,1,1,8,20,28
p_42,4,0,e_2,269,283,297,16,0,0,0,3,0,0,14,14,28
p_43,4,0,e_2,270,283,297,16,0,0,0,5,0,1,13,14,27
p_44,4,0,e_2,275,283,297,7,1,0,2,5,0,1,8,14,22
p_41,7,0,e_0,257,280,303,9,1,1,0,3,0,0,23,23,46
p_38,12,0,e_3,240,270,310,9,1,0,3,5,1,0,30,40,70
p_47,3,0,e_3,293,299,310,2,1,0,5,4,1,0,6,11,17
p_34,11,0,e_1,217,253,318,23,2,2,0,5,1,0,36,65,101
p_39,13,0,e_1,247,261,318,8,2,0,10,2,1,2,14,57,71
p_37,15,0,e_1,228,269,318,16,1,1,3,5,1,1,41,49,90
p_40,15,0,e_1,255,269,318,8,1,0,11,5,1,2,14,49,63
p_49,3,0,e_1,298,307,318,30,2,2,6,4,1,0,9,11,20
p_51,0,4,e_3,309,310,324,0,1,0,0,4,1,0,1,14,15
p_57,1,0,e_1,327,332,337,11,2,2,0,3,0,0,5,5,10
p_58,0,6,e_1,330,337,359,10,2,2,0,5,0,1,7,22,29
p_54,7,0,e_3,313,335,370,6,1,0,1,5,1,0,22,35,57
p_56,8,0,e_3,324,340,370,4,1,0,4,5,0,1,16,30,46
p_59,3,0,e_3,335,357,370,6,1,1,7,2,0,1,22,13,35
p_62,1,0,e_3,345,365,370,6,2,1,7,4,1,1,20,5,25
p_60,2,0,e_1,338,345,381,7,3,1,0,5,1,0,7,36,43
p_63,3,0,e_1,364,370,381,28,1,1,5,4,1,0,6,11,17
p_48,9,0,e_2,294,326,391,25,2,2,1,4,1,1,32,65,97
p_45,11,0,e_2,290,334,391,25,1,1,2,4,1,0,44,57,101
p_50,11,0,e_2,299,334,391,22,1,1,0,5,0,2,35,57,92
p_52,14,0,e_2,312,345,391,14,1,0,5,5,0,2,33,46,79
p_61,12,0,e_2,341,353,391,26,2,2,13,5,1,1,12,38,50
p_46,8,0,e_0,291,329,393,27,1,1,4,4,1,0,38,64,102
p_53,8,0,e_0,313,329,393,7,1,0,3,5,0,1,16,64,80
p_55,14,0,e_0,314,349,393,13,2,0,3,5,0,1,35,44,79
p_65,0,7,e_3,369,370,395,0,0,0,0,3,1,0,1,25,26
p_69,2,0,e_2,391,400,408,22,3,3,0,3,0,0,9,8,17
p_64,0,15,e_3,365,370,423,1,1,0,1,1,1,0,5,53,58
p_70,3,0,e_0,398,409,448,20,2,2,0,3,0,0,11,39,50
p_71,7,0,e_0,403,423,448,14,2,2,1,5,0,1,20,25,45
p_73,3,0,e_0,423,437,448,12,1,0,7,4,1,0,14,11,25
p_72,6,0,e_2,417,437,459,11,2,1,0,3,0,0,20,22,42
p_75,3,0,e_2,438,448,459,7,1,0,6,4,1,0,10,11,21
p_67,12,0,e_1,377,419,461,17,3,1,1,4,1,0,42,42,84
p_74,10,0,e_1,424,427,461,5,1,0,11,4,1,1,3,34,37
p_68,2,0,e_1,389,453,461,23,3,3,2,5,0,1,64,8,72
p_66,11,0,e_3,376,409,472,18,2,1,1,5,2,0,33,63,96
p_77,4,0,e_3,455,458,472,1,1,0,5,4,1,0,3,14,17
p_81,1,0,e_1,493,499,504,1,0,0,0,3,0,0,6,5,11
p_82,0,12,e_2,494,495,535,0,0,0,0,3,0,0,1,40,41
p_79,9,0,e_0,457,477,536,25,1,1,2,5,0,2,20,59,79
p_76,10,0,e_0,440,482,536,30,1,1,3,4,1,0,42,54,96
p_78,12,0,e_0,455,490,536,23,2,2,2,5,0,1,35,46,81
p_80,13,0,e_0,474,495,536,13,0,0,8,5,0,3,21,41,62
p_83,0,12,e_3,501,501,543,0,0,0,0,3,0,0,0,42,42
p_87,3,0,e_1,528,539,566,13,1,1,0,3,0,0,11,27,38
p_89,5,0,e_1,535,547,566,9,1,1,2,5,0,1,12,19,31
p_94,3,0,e_1,546,555,566,9,2,1,5,5,1,1,9,11,20
p_90,1,0,e_0,538,544,569,13,2,1,0,3,0,0,6,25,31
p_93,4,0,e_0,543,555,569,8,2,1,1,5,0,1,12,14,26
p_88,10,0,e_3,531,535,585,5,1,1,9,5,1,0,4,50,54
p_92,10,0,e_3,540,551,585,3,2,1,11,5,2,0,11,34,45
p_95,10,0,e_3,547,551,585,1,2,0,11,4,1,1,4,34,38
p_96,7,0,e_3,551,562,585,3,1,0,10,4,1,0,11,23,34
p_84,12,0,e_2,504,535,591,12,1,0,2,5,1,0,31,56,87
p_85,14,0,e_2,517,543,591,10,1,0,6,5,1,0,26,48,74
p_86,14,0,e_2,518,543,591,10,1,0,6,5,1,1,25,48,73
p_91,14,0,e_2,539,543,591,3,2,0,13,5,1,1,4,48,52
p_99,9,0,e_2,556,560,591,30,2,2,10,4,1,1,4,31,35
p_98,6,0,e_2,555,571,591,3,2,1,10,4,1,0,16,20,36
p_101,9,0,e_1,566,595,660,27,1,1,0,3,1,1,29,65,94
p_100,10,0,e_1,557,600,660,28,2,2,3,4,1,0,43,60,103
p_102,14,0,e_1,568,614,660,22,1,1,0,5,0,2,46,46,92
p_106,5,0,e_1,583,643,660,25,1,1,5,5,0,3,60,17,77
p_109,10,0,e_2,590,623,665,9,2,0,0,3,1,0,33,42,75
p_112,11,0,e_2,613,628,665,6,2,1,7,5,0,2,15,37,52
p_111,2,0,e_2,607,657,665,16,3,2,5,5,0,1,50,8,58
p_97,5,0,e_0,552,586,665,5,2,1,3,5,1,1,34,79,113
p_105,12,0,e_0,582,609,665,19,1,1,4,5,0,2,27,56,83
p_103,14,0,e_0,577,617,665,18,1,1,2,5,0,1,40,48,88
p_104,14,0,e_0,581,617,665,17,1,1,3,5,0,2,36,48,84
p_113,9,0,e_0,629,634,665,3,1,0,11,4,1,0,5,31,36
p_116,7,0,e_0,633,642,665,4,2,1,9,4,1,1,9,23,32
p_107,3,0,e_3,584,596,667,3,0,0,0,3,1,0,12,71,83
p_108,7,0,e_3,584,610,667,7,1,1,0,3,1,1,26,57,83
p_110,12,0,e_3,590,627,667,11,2,0,1,5,0,2,37,40,77
p_115,9,0,e_3,632,638,667,2,1,0,11,4,1,0,6,29,35
p_117,0,2,e_1,636,660,668,9,2,0,7,4,1,2,24,8,32
p_123,0,2,e_0,661,665,673,2,2,0,1,4,1,1,4,8,12
p_125,2,0,e_2,668,673,715,24,1,1,0,5,0,2,5,42,47
p_121,3,0,e_2,656,678,715,30,2,2,2,4,1,1,22,37,59
p_122,7,0,e_2,657,692,715,26,2,2,2,4,1,1,35,23,58
p_124,7,0,e_2,664,692,715,24,2,2,0,3,1,2,28,23,51
p_118,8,0,e_0,649,693,721,28,1,1,5,4,1,0,44,28,72
p_126,1,0,e_0,681,716,721,21,1,1,4,5,0,1,35,5,40
p_119,8,0,e_1,650,688,750,28,1,1,3,4,1,1,38,62,100
p_114,13,0,e_1,632,705,750,28,2,2,8,4,1,1,73,45,118
p_131,7,0,e_1,722,725,750,2,2,0,8,4,1,1,3,25,28
p_129,5,0,e_1,705,733,750,9,3,1,13,4,1,0,28,17,45
p_120,13,0,e_3,653,708,753,22,1,1,5,4,1,0,55,45,100
p_130,11,0,e_3,705,716,753,3,2,1,12,5,0,2,11,37,48
p_127,7,0,e_3,701,730,753,8,1,1,11,5,0,1,29,23,52
p_128,0,15,e_2,705,715,764,14,2,2,3,4,1,0,10,49,59
p_140,5,0,e_3,768,786,803,5,0,0,0,3,0,0,18,17,35
p_143,5,0,e_3,780,786,803,2,1,0,3,5,0,1,6,17,23
p_139,0,15,e_1,758,759,808,0,0,0,0,3,0,0,1,49,50
p_134,14,0,e_2,734,759,813,22,1,1,6,5,1,0,25,54,79
p_136,14,0,e_2,749,759,813,17,1,1,11,5,1,1,10,54,64
p_137,13,0,e_2,755,772,813,13,0,0,13,5,1,1,17,41,58
p_132,4,0,e_0,730,745,821,3,1,0,0,3,0,0,15,76,91
p_133,6,0,e_0,734,753,821,30,1,1,0,5,0,1,19,68,87
p_135,11,0,e_0,739,770,821,24,1,1,2,5,0,2,31,51,82
p_138,12,0,e_0,756,775,821,12,0,0,7,5,1,1,19,46,65
p_141,12,0,e_0,770,775,821,12,1,0,11,5,1,1,5,46,51
p_142,13,0,e_0,773,780,821,12,1,0,12,5,1,1,7,41,48
p_145,1,0,e_3,820,825,830,1,0,0,0,3,0,0,5,5,10
p_144,6,0,e_2,815,836,856,6,0,0,0,3,0,0,21,20,41
p_150,3,0,e_2,860,871,884,6,1,1,0,3,0,0,11,13,24
p_152,2,0,e_2,868,876,884,16,2,1,2,5,0,1,8,8,16
p_146,10,0,e_1,846,863,899,10,0,0,15,3,0,0,17,36,53
p_153,6,0,e_1,872,877,899,12,2,1,8,4,1,0,5,22,27
p_154,4,0,e_1,874,885,899,13,2,1,7,4,1,1,11,14,25
p_147,6,0,e_3,849,870,934,6,0,0,0,3,0,0,21,64,85
p_149,6,0,e_3,859,870,934,3,1,0,3,5,0,1,11,64,75
p_155,11,0,e_3,884,887,934,3,2,1,10,5,1,1,3,47,50
p_151,12,0,e_3,863,892,934,8,1,0,4,5,0,1,29,42,71
p_156,12,0,e_3,884,892,934,2,3,0,10,5,1,2,8,42,50
p_159,8,0,e_3,893,906,934,4,2,0,12,4,1,1,13,28,41
p_158,7,0,e_3,892,911,934,5,1,0,12,4,1,0,19,23,42
p_157,7,0,e_2,889,912,935,6,2,1,0,3,0,0,23,23,46
p_148,15,0,e_0,849,897,944,15,0,0,0,3,0,0,48,47,95
p_3,4,0,e_2,25,39,53,4,0,0,0,3,0,0,14,14,28
p_6,9,0,e_1,45,49,92,6,2,0,8,5,0,1,4,43,47
p_2,11,0,e_1,19,57,92,11,0,0,0,3,0,0,38,35,73
p_4,5,0,e_3,34,52,95,5,0,0,0,3,0,0,18,43,61
p_5,9,0,e_3,41,66,95,8,1,0,1,5,0,1,25,29,54
p_1,13,0,e_0,13,55,96,13,0,0,0,3,0,0,42,41,83
p_12,0,8,e_3,86,95,123,3,1,0,3,4,1,0,9,28,37
p_11,4,0,e_0,84,110,132,30,1,1,4,4,1,0,26,22,48
p_15,5,0,e_0,99,115,132,10,1,1,0,5,0,1,16,17,33
p_16,4,0,e_3,101,109,149,11,1,1,1,5,1,0,8,40,48
p_13,8,0,e_3,87,123,149,25,1,1,3,4,1,0,36,26,62
p_19,0,7,e_0,125,132,157,8,1,0,2,4,1,0,7,25,32
p_7,2,0,e_2,55,64,158,11,2,1,0,3,0,0,9,94,103
p_9,10,0,e_2,67,90,158,29,1,1,3,5,1,1,23,68,91
p_14,13,0,e_2,87,101,158,19,2,2,9,5,1,2,14,57,71
p_8,15,0,e_2,62,109,158,7,2,0,2,5,0,1,47,49,96
p_20,3,0,e_2,142,147,158,29,1,1,4,4,1,0,5,11,16
p_22,6,0,e_0,146,152,180,25,1,1,4,5,1,0,6,28,34
p_21,0,10,e_3,142,149,181,2,1,0,2,4,1,0,7,32,39
p_10,9,0,e_1,77,121,192,27,1,1,5,4,1,0,44,71,115
p_17,10,0,e_1,112,126,192,5,2,0,6,5,0,1,14,66,80
p_18,15,0,e_1,120,143,192,8,2,0,9,5,0,2,23,49,72
p_26,6,0,e_1,169,172,192,18,2,2,7,4,1,0,3,20,23
p_27,5,0,e_0,180,197,232,15,1,1,0,3,1,0,17,35,52
p_28,7,0,e_0,184,205,232,12,1,1,1,5,0,1,21,27,48
p_31,5,0,e_0,203,213,232,9,2,0,7,5,1,1,10,19,29
p_33,1,0,e_0,213,227,232,10,2,1,5,1,1,0,14,5,19
p_23,15,0,e_3,150,198,247,15,1,0,0,5,1,0,48,49,97
p_30,2,0,e_3,200,239,247,13,1,0,15,4,1,0,39,8,47
p_25,9,0,e_2,163,187,250,17,2,2,1,5,0,1,24,63,87
p_24,14,0,e_2,157,204,250,14,2,1,0,4,1,0,47,46,93
p_36,1,0,e_2,225,245,250,5,2,1,7,4,1,0,20,5,25
p_35,0,6,e_2,222,250,270,7,2,0,9,4,1,0,28,20,48
p_32,0,10,e_2,209,250,284,12,2,0,13,4,1,0,41,34,75
p_34,11,0,e_1,217,228,297,28,2,2,7,5,0,1,11,69,80
p_29,14,0,e_1,192,239,297,3,1,1,0,3,0,0,47,58,105
p_37,15,0,e_1,228,244,297,20,2,2,11,5,1,1,16,53,69
p_39,13,0,e_1,247,252,297,13,0,0,14,4,1,0,5,45,50
p_41,7,0,e_1,257,272,297,23,1,1,12,4,1,0,15,25,40
p_44,4,0,e_1,275,283,297,20,1,1,7,4,1,0,8,14,22
p_43,4,0,e_2,270,304,320,22,1,1,6,2,2,0,34,16,50
p_47,3,0,e_2,293,309,320,15,3,1,7,4,0,1,16,11,27
p_38,12,0,e_0,240,279,321,20,1,1,0,3,0,0,39,42,81
p_42,4,0,e_0,269,305,321,22,1,1,9,5,0,1,36,16,52
p_49,3,0,e_0,298,310,321,13,3,1,6,4,1,1,12,11,23
p_51,0,4,e_0,309,321,335,13,3,0,3,1,1,0,12,14,26
p_40,15,0,e_3,255,302,357,15,0,0,0,3,0,0,47,55,102
p_45,11,0,e_3,290,316,357,8,1,1,11,5,0,1,26,41,67
p_46,8,0,e_3,291,327,357,10,2,1,12,5,0,2,36,30,66
p_53,8,0,e_3,313,327,357,4,3,1,12,4,1,2,14,30,44
p_59,3,0,e_3,335,344,357,3,2,0,6,4,1,1,9,13,22
p_57,1,0,e_3,327,352,357,7,1,0,8,1,1,0,25,5,30
p_62,1,0,e_3,345,352,357,2,2,0,3,4,1,1,7,5,12
p_54,7,0,e_2,313,343,376,5,3,2,2,4,1,0,30,33,63
p_56,8,0,e_2,324,348,376,1,2,0,1,5,0,1,24,28,52
p_60,2,0,e_2,338,368,376,3,3,1,5,5,0,2,30,8,38
p_58,0,6,e_3,330,357,377,8,2,0,8,4,1,1,27,20,47
p_48,9,0,e_1,294,326,391,9,3,1,1,4,1,0,32,65,97
p_50,11,0,e_1,299,334,391,5,3,1,0,5,0,1,35,57,92
p_52,14,0,e_1,312,345,391,28,3,3,5,5,0,2,33,46,79
p_63,3,0,e_1,364,380,391,7,1,1,8,4,1,0,16,11,27
p_65,0,7,e_2,369,376,399,9,2,2,2,4,1,0,7,23,30
p_68,2,0,e_3,389,391,399,1,1,0,3,4,0,1,2,8,10
p_61,12,0,e_0,341,361,415,22,3,3,5,5,0,1,20,54,74
p_55,14,0,e_0,314,369,415,28,3,3,2,4,1,0,55,46,101
p_66,11,0,e_0,376,380,415,17,1,0,12,4,1,0,4,35,39
p_69,2,0,e_1,391,399,443,30,1,1,0,3,1,0,8,44,52
p_70,3,0,e_1,398,404,443,27,1,1,2,5,0,1,6,39,45
p_71,7,0,e_1,403,418,443,22,1,1,3,2,1,0,15,25,40
p_73,3,0,e_1,423,432,443,19,1,1,6,4,1,0,9,11,20
p_64,0,15,e_3,365,399,446,10,1,1,2,5,1,0,34,47,81
p_67,12,0,e_2,377,416,456,18,1,0,0,5,1,0,39,40,79
p_75,3,0,e_2,438,445,456,14,1,1,5,4,1,0,7,11,18
p_72,6,0,e_0,417,438,484,18,1,1,0,3,0,0,21,46,67
p_74,10,0,e_0,424,452,484,12,1,1,1,5,0,1,28,32,60
p_76,10,0,e_3,440,463,495,7,1,1,13,5,1,0,23,32,55
p_81,1,0,e_0,493,499,504,29,1,1,0,3,0,0,6,5,11
p_77,4,0,e_1,455,469,533,8,1,1,0,3,0,1,14,64,78
p_78,12,0,e_1,455,495,533,20,1,1,0,3,0,0,40,38,78
p_82,0,12,e_3,494,495,533,0,1,0,0,4,1,0,1,38,39
p_83,0,12,e_0,501,504,542,22,1,1,1,4,1,0,3,38,41
p_79,9,0,e_2,457,486,543,3,1,1,0,3,0,0,29,57,86
p_80,13,0,e_2,474,500,543,24,1,1,5,5,0,1,26,43,69
p_87,3,0,e_2,528,532,543,14,2,2,4,4,1,0,4,11,15
p_90,1,0,e_1,538,541,572,14,2,1,0,5,0,1,3,31,34
p_89,5,0,e_1,535,555,572,11,2,1,0,3,0,0,20,17,37
p_97,5,0,e_1,552,555,572,6,2,1,4,5,1,1,3,17,20
p_94,3,0,e_2,546,554,573,10,2,1,0,5,0,1,8,19,27
p_93,4,0,e_2,543,559,573,10,2,1,0,3,1,0,16,14,30
p_85,14,0,e_3,517,541,591,7,1,0,7,5,1,0,24,50,74
p_91,14,0,e_3,539,541,591,0,2,0,14,5,0,2,2,50,52
p_88,10,0,e_3,531,555,591,6,2,1,12,5,1,1,24,36,60
p_92,10,0,e_3,540,555,591,4,1,0,14,2,0,1,15,36,51
p_95,10,0,e_3,547,555,591,2,2,0,12,4,1,1,8,36,44
p_99,9,0,e_3,556,560,591,1,2,0,10,4,1,1,4,31,35
p_98,6,0,e_3,555,571,591,4,1,0,10,1,1,0,16,20,36
p_84,12,0,e_0,504,542,604,9,1,0,0,3,1,0,38,62,100
p_86,14,0,e_0,518,550,604,7,2,0,4,5,1,0,32,54,86
p_100,10,0,e_0,557,564,604,30,3,3,12,4,1,1,7,40,47
p_101,9,0,e_0,566,569,604,29,2,2,10,4,1,1,3,35,38
p_96,7,0,e_0,551,577,604,4,2,1,14,4,1,0,26,27,53
p_106,5,0,e_0,583,585,604,28,1,1,6,4,1,0,2,19,21
p_107,3,0,e_0,584,593,604,29,1,1,5,4,1,1,9,11,20
p_105,12,0,e_1,582,610,664,21,1,1,3,5,0,1,28,54,82
p_102,14,0,e_1,568,618,664,23,2,2,1,4,1,0,50,46,96
p_104,14,0,e_1,581,618,664,19,1,1,2,5,0,1,37,46,83
p_113,9,0,e_1,629,635,664,4,2,1,11,4,1,0,6,29,35
p_109,10,0,e_3,590,623,671,10,0,0,0,3,1,0,33,48,81
p_110,12,0,e_3,590,631,671,12,1,1,0,3,1,1,41,40,81
p_116,7,0,e_3,633,648,671,5,1,0,12,4,1,0,15,23,38
p_108,7,0,e_2,584,600,671,25,1,1,2,5,0,1,16,71,87
p_103,14,0,e_2,577,623,671,21,1,1,0,3,0,0,46,48,94
p_115,9,0,e_2,632,640,671,3,1,0,12,4,1,0,8,31,39
p_121,3,0,e_2,656,660,671,2,1,0,4,4,1,0,4,11,15
p_117,0,2,e_1,636,664,672,11,2,0,9,4,1,0,28,8,36
p_123,0,2,e_2,661,671,679,3,1,0,3,4,1,0,10,8,18
p_126,1,0,e_2,681,686,691,1,0,0,2,3,0,0,5,5,10
p_111,2,0,e_0,607,615,699,17,2,2,0,3,0,0,8,84,92
p_112,11,0,e_0,613,644,699,6,2,1,1,5,0,1,31,55,86
p_114,13,0,e_0,632,652,699,29,1,1,7,5,1,1,20,47,67
p_118,8,0,e_0,649,669,699,29,1,1,12,5,1,1,20,30,50
p_119,8,0,e_0,650,669,699,29,1,1,13,5,1,2,19,30,49
p_122,7,0,e_0,657,674,699,27,1,1,12,4,1,1,17,25,42
p_124,7,0,e_0,664,674,699,25,1,1,9,4,1,2,10,25,35
p_125,2,0,e_0,668,691,699,29,1,1,8,4,1,2,23,8,31
p_129,5,0,e_2,705,722,739,5,0,0,0,3,0,0,17,17,34
p_127,7,0,e_0,701,725,750,7,0,0,0,3,0,0,24,25,49
p_131,7,0,e_0,722,725,750,19,1,1,6,5,0,1,3,25,28
p_132,4,0,e_0,730,736,750,19,1,1,6,4,1,0,6,14,20
p_120,13,0,e_1,653,707,750,23,1,1,3,4,1,0,54,43,97
p_130,11,0,e_1,705,715,750,11,1,1,13,5,0,1,10,35,45
p_128,0,15,e_3,705,706,757,0,0,0,0,3,0,0,1,51,52
p_136,14,0,e_3,749,752,808,3,2,1,13,5,1,1,3,56,59
p_133,6,0,e_3,734,786,808,16,1,1,8,5,1,0,52,22,74
p_143,5,0,e_3,780,791,808,3,2,1,8,4,1,1,11,17,28
p_135,11,0,e_2,739,774,833,9,2,1,0,3,1,1,35,59,94
p_142,13,0,e_2,773,782,833,27,2,2,11,2,0,1,9,51,60
p_134,14,0,e_2,734,787,833,8,2,1,1,4,1,0,53,46,99
p_145,1,0,e_2,820,828,833,25,1,1,4,4,1,0,8,5,13
p_140,5,0,e_1,768,773,834,7,2,1,3,5,0,1,5,61,66
p_138,12,0,e_1,756,796,834,3,3,0,0,3,0,0,40,38,78
p_141,12,0,e_0,770,793,841,29,2,2,4,5,0,1,23,48,71
p_137,13,0,e_0,755,798,841,3,3,1,0,3,0,0,43,43,86
p_144,6,0,e_0,815,821,841,22,1,1,8,4,1,0,6,20,26
p_139,0,15,e_3,758,808,855,15,2,0,15,4,1,1,50,47,97
p_147,6,0,e_1,849,869,893,11,1,1,0,3,0,0,20,24,44
p_150,3,0,e_1,860,880,893,11,1,0,3,5,0,1,20,13,33
p_152,2,0,e_1,868,885,893,10,1,0,6,2,0,1,17,8,25
p_149,6,0,e_2,859,879,901,8,1,0,0,3,0,0,20,22,42
p_153,6,0,e_2,872,879,901,4,1,0,4,5,0,1,7,22,29
p_154,4,0,e_2,874,887,901,6,1,0,5,5,0,1,13,14,27
p_148,15,0,e_3,849,855,904,2,1,0,13,5,1,0,6,49,55
p_151,12,0,e_3,863,866,904,1,1,0,13,4,1,0,3,38,41
p_146,10,0,e_0,846,879,911,8,1,1,0,3,0,0,33,32,65
p_157,7,0,e_2,889,924,947,28,2,2,4,4,1,0,35,23,58
p_158,7,0,e_0,892,934,957,27,2,2,6,4,1,0,42,23,65
p_159,8,0,e_1,893,919,965,26,2,2,0,3,1,1,26,46,72
p_155,11,0,e_1,884,930,965,25,2,2,2,1,1,0,46,35,81
p_156,12,0,e_3,884,942,980,25,1,1,7,4,1,0,58,38,96
p_3,4,0,e_2,25,40,88,4,0,0,0,3,0,0,15,48,63
p_4,5,0,e_2,34,45,88,5,0,0,2,5,0,1,11,43,54
p_5,9,0,e_2,41,59,88,9,0,0,4,5,1,1,18,29,47
p_6,9,0,e_2,45,59,88,9,0,0,5,2,1,1,14,29,43
p_2,11,0,e_1,19,55,90,11,0,0,0,3,0,0,36,35,71
p_1,13,0,e_0,13,55,96,13,0,0,0,3,0,0,42,41,83
p_12,0,8,e_2,86,88,114,21,4,4,0,4,1,0,2,26,28
p_16,4,0,e_1,101,115,129,14,5,2,0,3,0,0,14,14,28
p_15,5,0,e_0,99,117,134,13,5,2,0,3,0,0,18,17,35
p_19,0,7,e_1,125,129,154,11,3,0,1,4,1,0,4,25,29
p_7,2,0,e_3,55,64,162,2,0,0,0,3,0,0,9,98,107
p_10,9,0,e_3,77,87,162,15,3,2,6,5,1,2,10,75,85
p_9,10,0,e_3,67,92,162,18,2,1,2,5,1,1,25,70,95
p_14,13,0,e_3,87,103,162,8,5,1,9,2,1,4,16,59,75
p_8,15,0,e_3,62,111,162,13,1,0,2,5,0,1,49,51,100
p_13,8,0,e_3,87,134,162,13,4,2,9,2,1,3,47,28,75
p_11,4,0,e_3,84,148,162,18,4,3,8,5,1,3,64,14,78
p_21,0,10,e_0,142,143,181,6,2,0,0,3,0,1,1,38,39
p_17,10,0,e_2,112,122,186,5,3,0,8,5,1,0,10,64,74
p_18,15,0,e_2,120,139,186,28,3,3,10,5,0,1,19,47,66
p_27,5,0,e_3,180,186,213,4,1,1,3,5,0,1,6,27,33
p_26,6,0,e_3,169,191,213,6,0,0,0,3,0,0,22,22,44
p_30,2,0,e_3,200,205,213,1,1,0,3,4,1,0,5,8,13
p_20,3,0,e_0,142,156,215,3,2,1,0,3,0,0,14,59,73
p_25,9,0,e_0,163,176,215,9,0,0,5,5,2,0,13,39,52
p_28,7,0,e_0,184,192,215,3,2,0,10,4,1,0,8,23,31
p_22,6,0,e_1,146,149,233,28,2,2,5,5,1,0,3,84,87
p_24,14,0,e_1,157,177,233,17,1,1,8,5,1,1,20,56,76
p_23,15,0,e_1,150,182,233,19,1,1,6,5,2,0,32,51,83
p_31,5,0,e_1,203,214,233,27,2,2,9,4,1,0,11,19,30
p_33,1,0,e_1,213,228,233,19,1,1,5,1,1,0,15,5,20
p_36,1,0,e_1,225,228,233,17,2,2,2,4,1,1,3,5,8
p_35,0,6,e_0,222,222,244,20,2,2,0,3,0,0,0,22,22
p_32,0,10,e_3,209,213,245,1,1,0,1,4,1,0,4,32,36
p_34,11,0,e_3,217,250,295,10,1,0,1,5,1,0,33,45,78
p_38,12,0,e_3,240,255,295,4,2,0,8,5,1,1,15,40,55
p_43,4,0,e_3,270,281,295,3,1,0,7,4,1,0,11,14,25
p_29,14,0,e_2,192,237,295,22,1,1,0,3,0,0,45,58,103
p_37,15,0,e_2,228,242,295,10,2,0,11,5,0,1,14,53,67
p_39,13,0,e_2,247,250,295,3,2,0,14,4,1,0,3,45,48
p_41,7,0,e_2,257,270,295,5,1,0,11,4,1,0,13,25,38
p_42,4,0,e_2,269,281,295,4,1,0,7,1,1,0,12,14,26
p_44,4,0,e_2,275,281,295,2,2,0,6,4,1,1,6,14,20
p_51,0,4,e_2,309,310,326,0,0,0,0,3,0,0,1,16,17
p_40,15,0,e_0,255,284,341,27,1,0,6,3,0,0,29,57,86
p_45,11,0,e_0,290,298,341,20,1,1,13,4,1,0,8,43,51
p_48,9,0,e_0,294,306,341,21,1,1,12,4,1,2,12,35,47
p_46,8,0,e_0,291,311,341,23,1,1,13,4,1,1,20,30,50
p_54,7,0,e_0,313,316,341,7,1,1,8,4,1,0,3,25,28
p_57,1,0,e_0,327,336,341,11,1,1,4,4,1,0,9,5,14
p_58,0,6,e_0,330,341,361,11,1,1,3,4,1,1,11,20,31
p_56,8,0,e_2,324,340,368,5,1,0,4,5,1,0,16,28,44
p_62,1,0,e_2,345,363,368,6,3,2,7,4,1,0,18,5,23
p_53,8,0,e_3,313,339,369,8,0,0,0,3,0,0,26,30,56
p_59,3,0,e_3,335,356,369,6,1,1,7,5,0,1,21,13,34
p_60,2,0,e_3,338,361,369,6,2,0,8,5,0,2,23,8,31
p_47,3,0,e_1,293,304,387,27,1,1,0,3,0,0,11,83,94
p_49,3,0,e_1,298,304,387,3,0,0,1,5,0,1,6,83,89
p_50,11,0,e_1,299,330,387,11,0,0,1,5,0,1,31,57,88
p_52,14,0,e_1,312,341,387,14,0,0,5,5,1,1,29,46,75
p_55,14,0,e_1,314,341,387,14,1,0,6,5,1,2,27,46,73
p_63,3,0,e_1,364,376,387,29,1,1,7,4,1,0,12,11,23
p_65,0,7,e_3,369,369,394,0,0,0,0,3,1,0,0,25,25
p_68,2,0,e_1,389,398,406,6,1,1,0,3,0,0,9,8,17
p_69,2,0,e_1,391,398,406,6,1,1,0,5,0,1,7,8,15
p_64,0,15,e_2,365,368,415,1,1,0,1,4,1,0,3,47,50
p_66,11,0,e_0,376,378,421,10,1,0,11,5,0,1,2,43,45
p_61,12,0,e_0,341,383,421,26,3,3,0,5,1,0,42,38,80
p_67,12,0,e_0,377,383,421,11,1,0,11,2,0,1,6,38,44
p_70,3,0,e_3,398,412,423,4,0,0,7,3,0,0,14,11,25
p_73,3,0,e_0,423,435,446,3,0,0,0,3,0,0,12,11,23
p_72,6,0,e_1,417,438,458,26,1,1,0,3,0,0,21,20,41
p_74,10,0,e_2,424,432,466,10,0,0,13,4,0,1,8,34,42
p_71,7,0,e_2,403,443,466,26,1,1,11,5,1,0,40,23,63
p_81,1,0,e_1,493,499,504,10,1,0,0,3,0,0,6,5,11
p_77,4,0,e_0,455,469,515,16,3,2,0,3,0,0,14,46,60
p_79,9,0,e_0,457,486,515,10,3,2,0,5,0,1,29,29,58
p_75,3,0,e_3,438,449,526,3,0,0,0,3,0,0,11,77,88
p_76,10,0,e_3,440,472,526,10,1,0,0,5,0,1,32,54,86
p_78,12,0,e_3,455,480,526,8,2,0,4,5,1,1,25,46,71
p_80,13,0,e_3,474,485,526,3,2,0,10,5,1,1,11,41,52
p_82,0,12,e_2,494,495,535,11,1,0,0,3,0,0,1,40,41
p_83,0,12,e_1,501,504,544,8,1,0,1,4,1,0,3,40,43
p_87,3,0,e_0,528,539,564,3,0,0,0,3,0,0,11,25,36
p_89,5,0,e_0,535,547,564,5,0,0,2,5,0,1,12,17,29
p_90,1,0,e_3,538,544,571,1,0,0,0,3,0,0,6,27,33
p_94,3,0,e_3,546,552,571,4,2,1,1,5,1,1,6,19,25
p_93,4,0,e_3,543,557,571,3,1,0,1,5,0,1,14,14,28
p_88,10,0,e_1,531,536,586,10,0,0,8,5,1,0,5,50,55
p_92,10,0,e_1,540,552,586,10,1,0,11,5,2,0,12,34,46
p_95,10,0,e_1,547,552,586,8,3,0,11,4,1,1,5,34,39
p_96,7,0,e_1,551,563,586,4,3,0,10,1,1,0,12,23,35
p_84,12,0,e_2,504,535,589,25,1,1,2,5,1,0,31,54,85
p_85,14,0,e_2,517,543,589,19,1,1,6,5,1,0,26,46,72
p_86,14,0,e_2,518,543,589,18,1,1,7,5,1,1,25,46,71
p_91,14,0,e_2,539,543,589,14,1,1,13,5,1,1,4,46,50
p_99,9,0,e_2,556,560,589,5,4,0,10,4,1,0,4,29,33
p_111,2,0,e_2,607,616,624,12,3,1,0,3,0,0,9,8,17
p_97,5,0,e_3,552,588,655,2,2,0,3,5,1,1,36,67,103
p_98,6,0,e_3,555,593,655,2,3,0,4,5,1,2,38,62,100
p_108,7,0,e_3,584,598,655,13,4,2,4,5,0,4,14,57,71
p_100,10,0,e_3,557,609,655,6,3,3,4,3,1,2,52,46,98
p_105,12,0,e_3,582,617,655,9,3,0,3,5,0,3,35,38,73
p_110,12,0,e_3,590,617,655,7,5,0,5,5,1,4,27,38,65
p_101,9,0,e_0,566,595,660,23,4,4,0,3,0,0,29,65,94
p_102,14,0,e_0,568,612,660,17,4,4,0,5,0,1,44,48,92
p_103,14,0,e_0,577,612,660,13,3,0,3,5,0,2,35,48,83
p_104,14,0,e_0,581,612,660,11,3,0,4,5,0,2,31,48,79
p_106,5,0,e_0,583,641,660,16,4,3,5,5,0,2,58,19,77
p_107,3,0,e_0,584,649,660,17,5,5,6,5,0,3,65,11,76
p_117,0,2,e_3,636,655,663,6,1,0,6,4,1,0,19,8,27
p_109,10,0,e_1,590,622,666,9,5,1,0,3,0,0,32,44,76
p_112,11,0,e_1,613,627,666,2,2,1,7,5,0,1,14,39,53
p_113,9,0,e_1,629,635,666,29,1,1,11,4,1,0,6,31,37
p_115,9,0,e_1,632,635,666,28,1,1,10,4,1,1,3,31,34
p_116,7,0,e_1,633,643,666,30,1,1,9,4,1,1,10,23,33
p_123,0,2,e_0,661,662,672,12,3,3,0,3,0,0,1,10,11
p_125,2,0,e_0,668,672,680,9,1,1,1,5,1,0,4,8,12
p_126,1,0,e_0,681,687,692,6,2,0,0,3,0,0,6,5,11
p_121,3,0,e_3,656,668,705,3,1,0,0,5,1,0,12,37,49
p_122,7,0,e_3,657,682,705,7,2,0,0,5,1,1,25,23,48
p_124,7,0,e_3,664,682,705,5,2,0,2,5,0,2,18,23,41
p_118,8,0,e_2,649,658,716,24,1,1,5,5,0,1,9,58,67
p_119,8,0,e_2,650,658,716,23,1,1,6,5,0,2,8,58,66
p_114,13,0,e_2,632,675,716,25,1,1,0,3,0,0,43,41,84
p_120,13,0,e_2,653,675,716,17,1,1,7,5,0,2,22,41,63
p_129,5,0,e_3,705,722,739,5,0,0,0,3,1,0,17,17,34
p_128,0,15,e_1,705,705,754,0,0,0,0,3,0,0,0,49,49
p_132,4,0,e_2,730,737,773,29,1,1,2,5,0,1,7,36,43
p_133,6,0,e_2,734,745,773,26,1,1,3,5,0,2,11,28,39
p_131,7,0,e_2,722,750,773,28,1,1,0,3,0,0,28,23,51
p_127,7,0,e_0,701,725,800,24,1,1,0,3,0,0,24,75,99
p_130,11,0,e_0,705,739,800,11,1,1,0,5,0,1,34,61,95
p_135,11,0,e_0,739,739,800,11,0,0,11,2,1,1,0,61,61
p_134,14,0,e_0,734,752,800,18,1,1,9,5,1,1,18,48,66
p_136,14,0,e_0,749,752,800,14,0,0,13,5,1,1,3,48,51
p_138,12,0,e_0,756,760,800,12,0,0,13,4,1,0,4,40,44
p_140,5,0,e_0,768,783,800,23,1,1,10,4,1,0,15,17,32
p_143,5,0,e_0,780,783,800,19,2,2,6,4,1,1,3,17,20
p_137,13,0,e_1,755,764,805,13,0,0,15,3,0,0,9,41,50
p_139,0,15,e_3,758,759,810,0,0,0,0,3,0,0,1,51,52
p_145,1,0,e_1,820,825,830,11,1,0,0,3,0,0,5,5,10
p_142,13,0,e_2,773,814,855,14,2,1,0,3,1,0,41,41,82
p_144,6,0,e_0,815,836,856,8,1,0,0,3,0,0,21,20,41
p_141,12,0,e_3,770,799,857,15,1,1,3,5,1,0,29,58,87
p_150,3,0,e_2,860,871,882,3,0,0,0,3,0,0,11,11,22
p_152,2,0,e_3,868,877,929,2,0,0,0,3,0,0,9,52,61
p_154,4,0,e_3,874,885,929,7,2,1,1,5,0,2,11,44,55
p_153,6,0,e_3,872,893,929,5,1,0,1,5,0,1,21,36,57
p_157,7,0,e_3,889,898,929,2,2,0,5,5,1,1,9,31,40
p_158,7,0,e_3,892,898,929,1,3,0,6,5,1,2,6,31,37
p_159,8,0,e_3,893,903,929,2,2,0,6,2,1,1,10,26,36
p_149,6,0,e_0,859,880,940,6,0,0,0,3,0,0,21,60,81
p_155,11,0,e_0,884,897,940,7,3,0,7,5,1,1,13,43,56
p_151,12,0,e_0,863,902,940,12,0,0,1,5,0,1,39,38,77
p_156,12,0,e_0,884,902,940,8,3,0,7,5,1,2,18,38,56
p_147,6,0,e_1,849,867,945,27,1,1,0,5,0,1,18,78,96
p_146,10,0,e_1,846,881,945,23,1,1,0,3,0,0,35,64,99
p_148,15,0,e_1,849,898,945,18,1,1,0,5,0,2,49,47,96
p_3,4,0,e_2,25,40,88,4,0,0,0,3,0,0,15,48,63
p_4,5,0,e_2,34,45,88,5,0,0,2,5,0,1,11,43,54
p_5,9,0,e_2,41,59,88,9,0,0,4,5,1,1,18,29,47
p_6,9,0,e_2,45,59,88,9,0,0,5,5,1,1,14,29,43
p_2,11,0,e_1,19,55,90,11,0,0,0,3,0,0,36,35,71
p_1,13,0,e_0,13,54,95,13,0,0,0,3,0,0,41,41,82
p_12,0,8,e_1,86,90,116,21,4,4,1,4,1,0,4,26,30
p_16,4,0,e_2,101,115,129,13,4,1,0,3,0,0,14,14,28
p_15,5,0,e_0,99,116,133,13,5,2,0,3,0,0,17,17,34
p_19,0,7,e_2,125,129,154,10,3,0,1,4,1,0,4,25,29
p_7,2,0,e_3,55,63,161,2,0,0,0,3,0,0,8,98,106
p_10,9,0,e_3,77,86,161,15,3,2,6,5,1,2,9,75,84
p_9,10,0,e_3,67,91,161,17,2,1,3,5,1,1,24,70,94
p_14,13,0,e_3,87,102,161,8,4,1,9,5,1,3,15,59,74
p_8,15,0,e_3,62,110,161,17,0,0,2,2,0,0,48,51,99
p_13,8,0,e_3,87,133,161,13,5,3,9,5,1,4,46,28,74
p_11,4,0,e_3,84,147,161,17,4,2,9,5,1,3,63,14,77
p_21,0,10,e_0,142,142,180,6,2,0,0,3,0,1,0,38,38
p_17,10,0,e_1,112,124,188,5,3,0,7,5,1,0,12,64,76
p_18,15,0,e_1,120,141,188,27,3,3,9,5,0,1,21,47,68
p_27,5,0,e_3,180,186,213,4,1,1,3,5,0,1,6,27,33
p_26,6,0,e_3,169,191,213,6,0,0,0,3,0,0,22,22,44
p_30,2,0,e_3,200,205,213,1,1,0,3,4,1,0,5,8,13
p_20,3,0,e_0,142,155,214,3,2,1,0,3,0,0,13,59,72
p_25,9,0,e_0,163,175,214,9,0,0,5,5,2,0,12,39,51
p_28,7,0,e_0,184,191,214,2,2,0,9,4,1,0,7,23,30
p_22,6,0,e_2,146,149,233,28,1,1,5,5,1,0,3,84,87
p_24,14,0,e_2,157,177,233,17,1,1,8,5,1,1,20,56,76
p_23,15,0,e_2,150,182,233,18,1,1,6,5,2,0,32,51,83
p_31,5,0,e_2,203,214,233,27,2,2,9,4,1,0,11,19,30
p_36,1,0,e_2,225,228,233,15,1,1,2,4,1,0,3,5,8
p_32,0,10,e_3,209,213,245,1,1,0,1,4,1,0,4,32,36
p_35,0,6,e_2,222,233,253,17,1,1,3,4,1,0,11,20,31
p_33,1,0,e_0,213,219,290,1,0,0,0,3,1,0,6,71,77
p_34,11,0,e_0,217,251,290,10,1,0,1,5,0,1,34,39,73
p_41,7,0,e_0,257,265,290,4,1,0,9,4,1,0,8,25,33
p_42,4,0,e_0,269,276,290,3,1,0,6,4,1,0,7,14,21
p_43,4,0,e_0,270,276,290,3,1,0,6,4,1,1,6,14,20
p_38,12,0,e_3,240,253,291,3,1,0,9,5,1,0,13,38,51
p_29,14,0,e_1,192,237,293,22,1,1,0,3,0,0,45,56,101
p_37,15,0,e_1,228,242,293,11,1,0,11,5,0,1,14,51,65
p_39,13,0,e_1,247,250,293,3,1,0,14,4,1,0,3,43,46
p_44,4,0,e_1,275,279,293,1,1,0,5,4,1,0,4,14,18
p_51,0,4,e_1,309,310,326,0,0,0,0,3,0,0,1,16,17
p_40,15,0,e_2,255,284,341,27,1,1,6,3,0,0,29,57,86
p_45,11,0,e_2,290,298,341,11,0,0,13,4,1,0,8,43,51
p_48,9,0,e_2,294,306,341,9,0,0,12,4,1,2,12,35,47
p_46,8,0,e_2,291,311,341,8,0,0,13,4,1,1,20,30,50
p_54,7,0,e_2,313,316,341,7,1,1,8,4,1,0,3,25,28
p_57,1,0,e_2,327,336,341,11,1,1,4,4,1,0,9,5,14
p_58,0,6,e_2,330,341,361,11,1,1,3,4,1,1,11,20,31
p_56,8,0,e_1,324,340,368,5,1,0,3,5,1,0,16,28,44
p_62,1,0,e_1,345,363,368,5,3,2,7,4,1,0,18,5,23
p_53,8,0,e_3,313,339,369,8,0,0,0,3,0,0,26,30,56
p_59,3,0,e_3,335,356,369,6,1,1,7,5,0,1,21,13,34
p_60,2,0,e_3,338,361,369,6,2,0,8,5,0,2,23,8,31
p_63,3,0,e_2,364,375,386,28,1,1,6,3,0,0,11,11,22
p_47,3,0,e_0,293,305,388,3,0,0,0,3,0,0,12,83,95
p_49,3,0,e_0,298,305,388,3,0,0,1,5,0,1,7,83,90
p_50,11,0,e_0,299,331,388,11,0,0,1,5,0,1,32,57,89
p_52,14,0,e_0,312,342,388,14,0,0,5,5,1,1,30,46,76
p_55,14,0,e_0,314,342,388,14,1,0,5,5,1,2,28,46,74
p_61,12,0,e_0,341,350,388,26,3,3,14,5,1,1,9,38,47
p_65,0,7,e_3,369,370,395,0,0,0,0,3,0,0,1,25,26
p_68,2,0,e_0,389,397,405,17,3,3,0,3,0,0,8,8,16
p_64,0,15,e_1,365,368,415,1,1,0,1,4,1,0,3,47,50
p_69,2,0,e_2,391,399,415,16,3,3,0,3,0,0,8,16,24
p_70,3,0,e_2,398,404,415,14,2,2,2,5,0,1,6,11,17
p_73,3,0,e_2,423,434,445,7,2,1,0,3,0,0,11,11,22
p_66,11,0,e_3,376,409,456,10,1,0,1,5,1,0,33,47,80
p_67,12,0,e_3,377,414,456,11,2,0,1,5,1,1,37,42,79
p_71,7,0,e_3,403,431,456,8,2,2,9,5,0,2,28,25,53
p_75,3,0,e_3,438,445,456,2,1,0,5,4,1,0,7,11,18
p_72,6,0,e_0,417,437,457,6,2,1,0,3,0,0,20,20,40
p_74,10,0,e_1,424,442,476,29,2,2,15,3,0,0,18,34,52
p_76,10,0,e_1,440,442,476,25,2,2,11,4,0,1,2,34,36
p_77,4,0,e_1,455,462,476,26,1,1,6,4,1,0,7,14,21
p_81,1,0,e_1,493,498,503,1,0,0,0,3,0,0,5,5,10
p_79,9,0,e_0,457,487,516,9,0,0,0,3,0,0,30,29,59
p_82,0,12,e_3,494,495,535,0,0,0,0,3,0,0,1,40,41
p_78,12,0,e_2,455,494,542,12,0,0,0,3,0,0,39,48,87
p_80,13,0,e_2,474,499,542,13,0,0,6,5,0,1,25,43,68
p_87,3,0,e_2,528,531,542,15,2,2,4,4,1,0,3,11,14
p_83,0,12,e_1,501,503,543,23,1,1,0,4,1,0,2,40,42
p_90,1,0,e_0,538,541,572,14,2,1,0,5,0,1,3,31,34
p_89,5,0,e_0,535,555,572,11,2,1,0,3,0,0,20,17,37
p_97,5,0,e_0,552,555,572,7,1,0,4,5,1,1,3,17,20
p_94,3,0,e_2,546,554,573,11,1,0,1,5,0,1,8,19,27
p_93,4,0,e_2,543,559,573,18,1,0,0,3,0,0,16,14,30
p_88,10,0,e_1,531,535,585,7,2,2,9,5,1,0,4,50,54
p_92,10,0,e_1,540,551,585,5,2,1,11,5,2,0,11,34,45
p_95,10,0,e_1,547,551,585,3,1,0,11,4,1,1,4,34,38
p_96,7,0,e_1,551,562,585,5,1,0,10,1,1,0,11,23,34
p_84,12,0,e_3,504,535,589,10,1,0,2,5,1,0,31,54,85
p_85,14,0,e_3,517,543,589,8,1,0,6,5,1,0,26,46,72
p_86,14,0,e_3,518,543,589,8,2,0,6,5,1,1,25,46,71
p_91,14,0,e_3,539,543,589,1,2,0,13,5,1,1,4,46,50
p_99,9,0,e_3,556,560,589,1,1,0,10,4,1,0,4,29,33
p_107,3,0,e_1,584,596,635,29,1,1,0,3,1,0,12,39,51
p_108,7,0,e_1,584,610,635,25,1,1,0,3,1,1,26,25,51
p_111,2,0,e_1,607,627,635,13,1,1,6,5,1,1,20,8,28
p_109,10,0,e_3,590,622,654,10,0,0,0,3,0,0,32,32,64
p_106,5,0,e_2,583,590,659,27,1,1,3,5,0,3,7,69,76
p_98,6,0,e_2,555,595,659,4,1,0,3,5,1,1,40,64,104
p_100,10,0,e_2,557,609,659,30,2,2,3,5,1,2,52,50,102
p_105,12,0,e_2,582,617,659,20,1,1,3,5,0,2,35,42,77
p_110,12,0,e_2,590,617,659,12,1,0,5,5,1,3,27,42,69
p_112,11,0,e_2,613,622,659,4,1,0,11,5,1,1,9,37,46
p_116,7,0,e_2,633,636,659,30,1,1,8,4,1,0,3,23,26
p_117,0,2,e_3,636,654,662,6,1,0,6,4,1,0,18,8,26
p_101,9,0,e_0,566,601,664,28,1,1,2,4,1,0,35,63,98
p_102,14,0,e_0,568,618,664,23,1,1,1,4,1,1,50,46,96
p_103,14,0,e_0,577,618,664,20,1,1,1,5,0,2,41,46,87
p_104,14,0,e_0,581,618,664,19,1,1,2,5,0,2,37,46,83
p_113,9,0,e_0,629,635,664,29,1,1,11,4,1,0,6,29,35
p_115,9,0,e_0,632,635,664,28,1,1,10,4,1,1,3,29,32
p_123,0,2,e_2,661,662,672,12,2,2,0,3,0,0,1,10,11
p_125,2,0,e_2,668,672,680,9,2,1,1,5,1,0,4,8,12
p_126,1,0,e_0,681,686,691,8,1,0,0,3,0,0,5,5,10
p_121,3,0,e_3,656,667,704,3,1,0,0,5,1,0,11,37,48
p_122,7,0,e_3,657,681,704,7,2,0,0,5,1,1,24,23,47
p_124,7,0,e_3,664,681,704,5,2,0,2,5,0,2,17,23,40
p_118,8,0,e_1,649,661,719,23,1,1,4,5,0,1,12,58,70
p_119,8,0,e_1,650,661,719,23,1,1,4,5,0,2,11,58,69
p_114,13,0,e_1,632,678,719,24,1,1,1,4,1,0,46,41,87
p_120,13,0,e_1,653,678,719,17,1,1,5,5,0,2,25,41,66
p_129,5,0,e_3,705,723,740,5,0,0,0,3,0,0,18,17,35
p_128,0,15,e_2,705,705,754,0,0,0,0,3,0,0,0,49,49
p_132,4,0,e_1,730,737,773,29,1,1,2,5,0,1,7,36,43
p_133,6,0,e_1,734,745,773,26,1,1,3,5,0,2,11,28,39
p_131,7,0,e_1,722,750,773,12,0,0,0,3,0,0,28,23,51
p_127,7,0,e_0,701,725,802,24,1,1,0,3,0,0,24,77,101
p_130,11,0,e_0,705,739,802,11,0,0,1,5,0,1,34,63,97
p_135,11,0,e_0,739,739,802,19,1,1,11,2,1,1,0,63,63
p_134,14,0,e_0,734,752,802,18,1,1,9,5,1,1,18,50,68
p_136,14,0,e_0,749,752,802,14,0,0,13,5,1,1,3,50,53
p_137,13,0,e_0,755,757,802,13,0,0,14,4,1,0,2,45,47
p_138,12,0,e_0,756,762,802,12,0,0,13,1,1,0,6,40,46
p_140,5,0,e_0,768,785,802,23,1,1,11,4,1,0,17,17,34
p_143,5,0,e_0,780,785,802,19,1,1,7,4,1,1,5,17,22
p_139,0,15,e_3,758,758,807,0,0,0,0,3,0,0,0,49,49
p_142,13,0,e_2,773,779,822,13,1,1,15,4,0,1,6,43,49
p_141,12,0,e_2,770,784,822,15,1,1,15,3,0,0,14,38,52
p_145,1,0,e_1,820,826,831,14,0,0,0,3,0,0,6,5,11
p_144,6,0,e_0,815,835,855,9,0,0,0,3,0,0,20,20,40
p_152,2,0,e_0,868,869,885,7,1,0,2,5,0,1,1,16,17
p_150,3,0,e_0,860,874,885,8,1,1,0,3,0,0,14,11,25
p_146,10,0,e_3,846,864,900,5,0,0,15,3,0,0,18,36,54
p_153,6,0,e_3,872,878,900,2,1,0,8,4,1,0,6,22,28
p_154,4,0,e_3,874,886,900,3,2,1,7,4,1,1,12,14,26
p_147,6,0,e_1,849,870,932,9,1,1,0,3,0,0,21,62,83
p_149,6,0,e_1,859,870,932,5,1,1,2,5,0,1,11,62,73
p_155,11,0,e_1,884,887,932,24,2,2,10,5,1,1,3,45,48
p_151,12,0,e_1,863,892,932,28,0,0,4,5,0,1,29,40,69
p_156,12,0,e_1,884,892,932,23,2,2,10,5,1,1,8,40,48
p_159,8,0,e_1,893,906,932,24,1,1,12,4,1,0,13,26,39
p_157,7,0,e_0,889,912,935,27,1,1,0,3,0,0,23,23,46
p_158,7,0,e_0,892,912,935,25,1,1,0,5,0,1,20,23,43
p_148,15,0,e_2,849,897,944,20,1,1,0,3,0,0,48,47,95
p_3,4,0,e_2,25,40,54,4,0,0,0,3,0,0,15,14,29
p_2,11,0,e_1,19,55,90,11,0,0,0,3,0,0,36,35,71
p_4,5,0,e_3,34,51,94,5,0,0,0,3,0,0,17,43,60
p_5,9,0,e_3,41,65,94,7,1,0,2,5,0,1,24,29,53
p_6,9,0,e_3,45,65,94,6,2,0,3,5,0,2,20,29,49
p_1,13,0,e_0,13,55,96,13,0,0,0,3,0,0,42,41,83
p_12,0,8,e_0,86,96,122,2,2,0,3,4,1,0,10,26,36
p_11,4,0,e_3,84,108,130,29,1,1,3,4,1,0,24,22,46
p_15,5,0,e_3,99,113,130,4,1,0,1,5,0,1,14,17,31
p_19,0,7,e_3,125,130,155,2,1,0,2,4,1,0,5,25,30
p_7,2,0,e_2,55,64,158,10,2,1,0,3,0,0,9,94,103
p_9,10,0,e_2,67,90,158,29,1,1,2,5,1,1,23,68,91
p_8,15,0,e_2,62,107,158,7,2,0,2,5,0,1,45,51,96
p_13,8,0,e_2,87,130,158,24,2,2,9,5,1,2,43,28,71
p_20,3,0,e_2,142,147,158,7,1,1,4,4,1,0,5,11,16
p_16,4,0,e_1,101,104,158,4,2,1,3,5,0,1,3,54,57
p_10,9,0,e_1,77,121,158,27,1,1,4,4,1,0,44,37,81
p_17,10,0,e_1,112,126,158,15,1,0,6,5,1,1,14,32,46
p_21,0,10,e_2,142,158,190,11,1,1,4,4,1,0,16,32,48
p_14,13,0,e_0,87,139,200,19,2,2,3,4,1,0,52,61,113
p_18,15,0,e_0,120,147,200,18,1,1,7,5,1,1,27,53,80
p_25,9,0,e_0,163,167,200,12,2,1,10,4,1,0,4,33,37
p_26,6,0,e_0,169,178,200,13,2,1,9,4,1,0,9,22,31
p_27,5,0,e_0,180,183,200,20,1,0,6,4,1,0,3,17,20
p_22,6,0,e_3,146,150,232,3,1,1,5,5,1,0,4,82,86
p_23,15,0,e_3,150,181,232,9,1,0,6,2,1,0,31,51,82
p_28,7,0,e_3,184,207,232,7,1,0,14,4,1,0,23,25,48
p_33,1,0,e_3,213,227,232,5,1,0,6,4,1,0,14,5,19
p_24,14,0,e_1,157,202,248,9,2,1,0,3,1,0,45,46,91
p_36,1,0,e_1,225,243,248,30,2,2,7,4,1,0,18,5,23
p_29,14,0,e_2,192,206,250,28,2,2,10,3,0,0,14,44,58
p_32,0,10,e_3,209,232,264,7,1,0,7,4,1,0,23,32,55
p_35,0,6,e_1,222,248,268,2,2,0,8,4,1,0,26,20,46
p_41,7,0,e_1,257,273,298,11,3,3,2,5,1,0,16,25,41
p_44,4,0,e_1,275,284,298,10,2,1,7,4,1,0,9,14,23
p_30,2,0,e_0,200,208,302,7,2,1,0,3,1,0,8,94,102
p_31,5,0,e_0,203,219,302,3,2,1,0,5,0,1,16,83,99
p_34,11,0,e_0,217,239,302,23,2,2,4,5,1,1,22,63,85
p_37,15,0,e_0,228,253,302,16,1,1,8,5,1,1,25,49,74
p_42,4,0,e_0,269,288,302,11,2,2,10,4,1,0,19,14,33
p_43,4,0,e_0,270,288,302,10,2,1,10,4,1,1,18,14,32
p_38,12,0,e_3,240,272,322,10,1,0,2,5,1,0,32,50,82
p_39,13,0,e_3,247,277,322,9,2,0,4,5,1,1,30,45,75
p_46,8,0,e_3,291,294,322,1,1,0,9,4,1,0,3,28,31
p_47,3,0,e_3,293,311,322,5,1,0,8,1,1,0,18,11,29
p_51,0,4,e_0,309,309,325,4,2,0,0,3,0,0,0,16,16
p_45,11,0,e_2,290,291,360,28,1,1,11,5,0,1,1,69,70
p_40,15,0,e_2,255,305,360,8,3,0,0,3,0,0,50,55,105
p_48,9,0,e_2,294,325,360,29,2,2,11,5,1,1,31,35,66
p_54,7,0,e_2,313,333,360,26,1,1,13,4,1,1,20,27,47
p_59,3,0,e_2,335,347,360,11,2,1,7,4,1,0,12,13,25
p_62,1,0,e_2,345,355,360,18,3,2,4,4,1,1,10,5,15
p_49,3,0,e_1,298,309,374,4,2,0,0,3,1,0,11,65,76
p_53,8,0,e_1,313,326,374,25,1,1,4,5,1,1,13,48,61
p_50,11,0,e_1,299,337,374,26,2,2,0,5,0,1,38,37,75
p_60,2,0,e_1,338,366,374,11,2,1,11,4,1,0,28,8,36
p_58,0,6,e_2,330,360,380,15,1,1,8,4,1,1,30,20,50
p_65,0,7,e_1,369,374,397,12,1,0,1,4,1,0,5,23,28
p_52,14,0,e_0,312,357,405,19,1,1,0,5,1,0,45,48,93
p_55,14,0,e_0,314,357,405,19,1,1,0,5,1,1,43,48,91
p_63,3,0,e_0,364,392,405,10,2,1,12,4,1,0,28,13,41
p_69,2,0,e_0,391,397,405,2,2,0,3,4,1,1,6,8,14
p_57,1,0,e_3,327,330,407,15,1,1,0,5,0,1,3,77,80
p_56,8,0,e_3,324,353,407,8,0,0,0,3,0,0,29,54,83
p_61,12,0,e_3,341,367,407,8,2,0,4,5,1,1,26,40,66
p_68,2,0,e_3,389,399,407,3,1,0,5,4,1,0,10,8,18
p_64,0,15,e_1,365,374,423,12,2,2,2,1,1,0,9,49,58
p_66,11,0,e_2,376,397,444,28,1,1,5,5,1,0,21,47,68
p_67,12,0,e_2,377,402,444,27,1,1,5,5,1,1,25,42,67
p_71,7,0,e_2,403,419,444,24,1,1,12,4,1,1,16,25,41
p_70,3,0,e_2,398,433,444,29,1,1,11,5,1,1,35,11,46
p_73,3,0,e_3,423,434,445,3,0,0,0,3,0,0,11,11,22
p_72,6,0,e_0,417,438,460,6,0,0,0,3,0,0,21,22,43
p_75,3,0,e_0,438,449,460,29,1,1,6,2,0,0,11,11,22
p_74,10,0,e_1,424,441,473,10,1,0,15,3,0,0,17,32,49
p_76,10,0,e_1,440,441,473,22,1,1,10,4,0,1,1,32,33
p_81,1,0,e_1,493,499,504,6,1,0,0,3,0,0,6,5,11
p_77,4,0,e_3,455,470,516,4,0,0,0,3,0,0,15,46,61
p_79,9,0,e_3,457,487,516,9,1,0,0,5,0,1,30,29,59
p_78,12,0,e_2,455,493,531,12,0,0,0,3,0,0,38,38,76
p_83,0,12,e_1,501,504,542,5,1,0,1,4,1,0,3,38,41
p_82,0,12,e_3,494,516,554,7,1,0,7,4,1,0,22,38,60
p_80,13,0,e_0,474,515,562,8,2,0,0,3,0,0,41,47,88
p_89,5,0,e_0,535,541,562,17,2,2,7,4,1,1,6,21,27
p_93,4,0,e_0,543,546,562,15,2,2,5,4,1,1,3,16,19
p_87,3,0,e_0,528,551,562,22,2,2,9,4,1,0,23,11,34
p_94,3,0,e_0,546,551,562,16,2,2,4,1,1,1,5,11,16
p_88,10,0,e_2,531,563,597,14,2,2,0,3,1,0,32,34,66
p_92,10,0,e_2,540,563,597,11,2,2,2,5,0,2,23,34,57
p_95,10,0,e_2,547,563,597,8,2,2,5,5,0,2,16,34,50
p_100,10,0,e_2,557,563,597,5,2,1,8,5,0,2,6,34,40
p_90,1,0,e_2,538,592,597,20,2,2,2,5,0,1,54,5,59
p_84,12,0,e_1,504,542,602,22,1,1,0,3,1,0,38,60,98
p_85,14,0,e_1,517,550,602,14,1,0,4,5,1,0,33,52,85
p_91,14,0,e_1,539,550,602,7,2,0,11,5,1,1,11,52,63
p_99,9,0,e_1,556,567,602,7,2,1,12,4,1,2,11,35,46
p_96,7,0,e_1,551,575,602,10,2,2,14,4,1,0,24,27,51
p_97,5,0,e_1,552,583,602,12,2,2,14,4,1,1,31,19,50
p_107,3,0,e_1,584,591,602,4,3,2,5,4,1,1,7,11,18
p_86,14,0,e_3,518,562,610,14,1,0,0,5,1,0,44,48,92
p_98,6,0,e_3,555,588,610,10,1,1,12,5,0,1,33,22,55
p_106,5,0,e_3,583,593,610,3,2,1,8,4,1,1,10,17,27
p_111,2,0,e_2,607,615,623,29,1,1,0,3,0,0,8,8,16
p_108,7,0,e_1,584,625,648,30,3,3,5,4,1,0,41,23,64
p_117,0,2,e_1,636,648,656,19,2,2,4,4,1,0,12,8,20
p_101,9,0,e_0,566,596,665,4,2,0,0,3,0,0,30,69,99
p_109,10,0,e_0,590,601,665,26,2,2,7,5,0,3,11,64,75
p_105,12,0,e_0,582,609,665,26,2,2,4,5,0,2,27,56,83
p_110,12,0,e_0,590,609,665,24,2,2,7,5,0,3,19,56,75
p_102,14,0,e_0,568,617,665,29,2,2,0,5,0,1,49,48,97
p_103,14,0,e_0,577,617,665,26,2,2,3,5,0,2,40,48,88
p_104,14,0,e_0,581,617,665,24,2,2,4,5,0,2,36,48,84
p_115,9,0,e_0,632,634,665,11,2,2,10,4,1,0,2,31,33
p_116,7,0,e_0,633,642,665,13,2,2,9,4,1,1,9,23,32
p_123,0,2,e_0,661,665,673,12,2,0,1,4,1,0,4,8,12
p_112,11,0,e_3,613,649,702,11,0,0,0,3,0,0,36,53,89
p_114,13,0,e_3,632,657,702,8,1,0,5,5,0,1,25,45,70
p_121,3,0,e_3,656,689,702,10,2,0,13,5,1,1,33,13,46
p_125,2,0,e_3,668,694,702,8,2,1,10,4,1,1,26,8,34
p_122,7,0,e_1,657,673,706,14,2,0,2,5,0,1,16,33,49
p_118,8,0,e_1,649,678,706,7,1,1,0,5,1,0,29,28,57
p_119,8,0,e_1,650,678,706,7,2,1,0,5,1,1,28,28,56
p_126,1,0,e_1,681,701,706,4,3,2,7,4,1,0,20,5,25
p_124,7,0,e_0,664,690,713,4,2,0,0,3,1,0,26,23,49
p_113,9,0,e_2,629,658,713,9,1,1,0,3,0,0,29,55,84
p_120,13,0,e_2,653,672,713,1,2,0,8,5,0,1,19,41,60
p_128,0,15,e_1,705,706,755,22,2,2,0,4,1,0,1,49,50
p_127,7,0,e_3,701,725,774,7,0,0,0,3,1,0,24,49,73
p_130,11,0,e_3,705,739,774,11,1,0,0,5,0,1,34,35,69
p_129,5,0,e_1,705,723,806,17,2,2,0,4,1,0,18,83,101
p_138,12,0,e_1,756,766,806,24,1,1,15,4,1,0,10,40,50
p_140,5,0,e_1,768,789,806,27,1,1,12,4,1,0,21,17,38
p_131,7,0,e_0,722,746,817,9,2,1,0,3,0,0,24,71,95
p_134,14,0,e_0,734,769,817,4,2,0,3,5,0,1,35,48,83
p_136,14,0,e_0,749,769,817,24,1,1,8,5,1,1,20,48,68
p_141,12,0,e_0,770,777,817,19,1,1,14,4,1,0,7,40,47
p_143,5,0,e_0,780,800,817,23,2,2,11,4,1,0,20,17,37
p_132,4,0,e_2,730,745,819,10,2,1,0,3,0,0,15,74,89
p_133,6,0,e_2,734,753,819,6,2,1,1,5,0,1,19,66,85
p_135,11,0,e_2,739,770,819,22,1,0,2,5,0,2,31,49,80
p_137,13,0,e_2,755,778,819,23,1,1,6,5,1,1,23,41,64
p_139,0,15,e_3,758,774,823,5,1,0,5,4,1,0,16,49,65
p_145,1,0,e_0,820,825,830,15,2,1,0,3,0,0,5,5,10
p_144,6,0,e_1,815,836,856,11,1,1,0,3,0,0,21,20,41
p_142,13,0,e_3,773,815,874,13,0,0,0,3,1,0,42,59,101
p_147,6,0,e_3,849,852,874,1,1,0,7,4,1,0,3,22,25
p_150,3,0,e_3,860,863,874,1,1,0,4,4,1,0,3,11,14
p_149,6,0,e_1,859,880,902,28,1,1,0,3,0,0,21,22,43
p_153,6,0,e_1,872,880,902,25,1,1,3,5,0,2,8,22,30
p_152,2,0,e_1,868,894,902,30,1,1,2,5,0,1,26,8,34
p_146,10,0,e_0,846,879,929,28,1,1,0,3,0,0,33,50,83
p_151,12,0,e_0,863,887,929,21,1,1,5,5,0,1,24,42,66
p_156,12,0,e_0,884,887,929,9,1,0,11,5,1,1,3,42,45
p_159,8,0,e_0,893,901,929,9,2,1,10,4,1,1,8,28,36
p_157,7,0,e_0,889,906,929,3,1,1,12,4,1,0,17,23,40
p_158,7,0,e_0,892,906,929,10,2,1,11,4,1,1,14,23,37
p_148,15,0,e_2,849,896,943,22,1,1,0,3,0,0,47,47,94
p_154,4,0,e_3,874,889,947,4,0,0,0,3,0,0,15,58,73
p_155,11,0,e_3,884,912,947,8,1,0,3,5,0,1,28,35,63
p_3,4,0,e_2,25,39,87,4,0,0,0,3,0,0,14,48,62
p_4,5,0,e_2,34,44,87,5,0,0,3,5,0,1,10,43,53
p_5,9,0,e_2,41,58,87,9,0,0,4,5,1,1,17,29,46
p_6,9,0,e_2,45,58,87,9,0,0,5,5,1,1,13,29,42
p_2,11,0,e_1,19,55,90,11,0,0,0,3,0,0,36,35,71
p_1,13,0,e_0,13,54,95,13,0,0,0,3,0,0,41,41,82
p_12,0,8,e_2,86,87,113,21,5,5,0,4,1,0,1,26,27
p_16,4,0,e_1,101,115,129,14,4,2,0,3,0,0,14,14,28
p_15,5,0,e_0,99,116,133,13,4,2,0,3,0,0,17,17,34
p_19,0,7,e_1,125,129,152,11,2,0,1,4,1,1,4,23,27
p_13,8,0,e_2,87,113,155,13,4,2,0,3,1,0,26,42,68
p_17,10,0,e_2,112,121,155,5,2,0,8,5,1,0,9,34,43
p_20,3,0,e_2,142,144,155,2,2,1,4,4,1,0,2,11,13
p_7,2,0,e_3,55,64,160,2,0,0,0,3,0,0,9,96,105
p_10,9,0,e_3,77,87,160,15,3,2,6,5,1,2,10,73,83
p_9,10,0,e_3,67,92,160,17,2,1,3,5,1,1,25,68,93
p_14,13,0,e_3,87,103,160,8,4,1,9,5,1,3,16,57,73
p_8,15,0,e_3,62,111,160,13,1,0,2,5,0,1,49,49,98
p_11,4,0,e_3,84,146,160,18,4,3,8,5,1,3,62,14,76
p_21,0,10,e_0,142,142,180,5,2,0,0,3,0,0,0,38,38
p_26,6,0,e_2,169,189,211,6,0,0,0,3,0,0,20,22,42
p_30,2,0,e_2,200,203,211,21,2,1,3,4,1,0,3,8,11
p_22,6,0,e_0,146,164,214,28,1,1,0,5,1,0,18,50,68
p_25,9,0,e_0,163,175,214,9,0,0,6,2,1,0,12,39,51
p_28,7,0,e_0,184,191,214,6,1,0,9,4,1,0,7,23,30
p_33,1,0,e_2,213,218,223,17,2,1,0,3,0,0,5,5,10
p_24,14,0,e_1,157,175,229,17,1,1,8,5,0,1,18,54,72
p_18,15,0,e_1,120,180,229,27,2,2,3,4,1,0,60,49,109
p_23,15,0,e_1,150,180,229,18,1,1,7,5,1,1,30,49,79
p_31,5,0,e_1,203,212,229,17,2,1,8,4,1,0,9,17,26
p_35,0,6,e_2,222,223,245,15,3,3,0,4,1,0,1,22,23
p_32,0,10,e_0,209,214,246,19,2,2,1,4,1,0,5,32,37
p_27,5,0,e_3,180,197,272,5,0,0,0,3,0,0,17,75,92
p_29,14,0,e_3,192,226,272,10,1,0,4,5,0,1,34,46,80
p_34,11,0,e_3,217,237,272,6,2,1,11,5,1,1,20,35,55
p_44,4,0,e_3,275,290,304,4,0,0,0,3,0,0,15,14,29
p_42,4,0,e_1,269,271,307,27,1,1,4,5,0,1,2,36,38
p_41,7,0,e_1,257,282,307,28,1,1,0,3,0,0,25,25,50
p_47,3,0,e_1,293,296,307,30,2,2,4,4,1,1,3,11,14
p_36,1,0,e_2,225,228,311,13,3,0,0,5,1,0,3,83,86
p_38,12,0,e_2,240,265,311,28,1,1,5,5,2,0,25,46,71
p_39,13,0,e_2,247,270,311,25,1,1,6,5,1,1,23,41,64
p_37,15,0,e_0,228,263,314,29,2,2,4,5,1,0,35,51,86
p_40,15,0,e_0,255,263,314,21,1,1,13,5,0,1,8,51,59
p_43,4,0,e_0,270,298,314,27,1,1,13,4,1,0,28,16,44
p_49,3,0,e_0,298,303,314,29,2,2,4,1,1,0,5,11,16
p_51,0,4,e_0,309,314,328,21,1,1,2,4,1,0,5,14,19
p_54,7,0,e_0,313,339,374,18,2,2,0,3,1,0,26,35,61
p_56,8,0,e_0,324,344,374,14,2,2,3,5,1,1,20,30,50
p_60,2,0,e_0,338,364,374,15,1,1,7,5,0,3,26,10,36
p_57,1,0,e_0,327,369,374,20,2,2,4,3,1,2,42,5,47
p_53,8,0,e_2,313,337,375,18,2,2,0,5,0,1,24,38,62
p_48,9,0,e_2,294,342,375,24,2,2,6,4,1,0,48,33,81
p_59,3,0,e_2,335,362,375,15,2,2,8,5,0,3,27,13,40
p_62,1,0,e_2,345,370,375,14,2,1,8,4,1,1,25,5,30
p_46,8,0,e_1,291,333,389,26,2,2,4,4,1,0,42,56,98
p_50,11,0,e_1,299,344,389,21,2,2,2,4,1,1,45,45,90
p_61,12,0,e_1,341,349,389,5,2,1,10,5,1,1,8,40,48
p_63,3,0,e_1,364,378,389,7,1,0,8,4,1,0,14,11,25
p_45,11,0,e_3,290,339,394,23,1,1,4,4,1,0,49,55,104
p_52,14,0,e_3,312,350,394,12,1,0,2,5,0,1,38,44,82
p_55,14,0,e_3,314,350,394,11,2,0,3,5,0,2,36,44,80
p_58,0,6,e_2,330,375,395,20,2,2,6,5,0,2,45,20,65
p_65,0,7,e_0,369,374,397,8,1,0,1,4,1,0,5,23,28
p_68,2,0,e_1,389,397,405,30,1,1,0,3,1,0,8,8,16
p_69,2,0,e_1,391,397,405,29,1,1,0,5,0,1,6,8,14
p_64,0,15,e_0,365,374,423,10,1,0,2,4,1,1,9,49,58
p_70,3,0,e_3,398,410,447,3,0,0,0,3,0,0,12,37,49
p_71,7,0,e_3,403,424,447,6,1,0,1,5,0,1,21,23,44
p_66,11,0,e_2,376,412,457,25,1,1,0,5,1,0,36,45,81
p_67,12,0,e_2,377,417,457,24,1,1,0,5,1,1,40,40,80
p_73,3,0,e_2,423,446,457,10,1,0,10,4,1,0,23,11,34
p_72,6,0,e_1,417,437,459,3,2,1,0,3,0,0,20,22,42
p_75,3,0,e_1,438,448,459,30,1,1,6,4,1,0,10,11,21
p_74,10,0,e_0,424,442,476,27,1,1,15,3,0,0,18,34,52
p_76,10,0,e_0,440,442,476,22,1,1,11,4,0,1,2,34,36
p_77,4,0,e_0,455,462,476,4,0,0,6,4,1,0,7,14,21
p_81,1,0,e_0,493,499,504,13,2,1,0,3,0,0,6,5,11
p_79,9,0,e_2,457,486,515,15,1,1,0,3,1,0,29,29,58
p_82,0,12,e_1,494,495,535,14,2,2,0,3,0,0,1,40,41
p_78,12,0,e_3,455,493,541,12,0,0,0,3,0,0,38,48,86
p_80,13,0,e_3,474,498,541,7,1,0,6,5,0,1,24,43,67
p_87,3,0,e_3,528,530,541,1,1,0,4,4,1,0,2,11,13
p_83,0,12,e_0,501,504,544,12,1,0,1,4,1,0,3,40,43
p_90,1,0,e_2,538,541,572,30,1,1,0,5,0,1,3,31,34
p_89,5,0,e_2,535,555,572,27,1,1,0,3,0,0,20,17,37
p_97,5,0,e_2,552,555,572,3,2,0,4,5,1,1,3,17,20
p_94,3,0,e_3,546,554,573,5,1,1,0,5,0,1,8,19,27
p_93,4,0,e_3,543,559,573,4,0,0,0,3,0,0,16,14,30
p_88,10,0,e_0,531,536,586,23,1,1,9,5,1,0,5,50,55
p_92,10,0,e_0,540,552,586,10,0,0,11,5,2,0,12,34,46
p_96,7,0,e_0,551,563,586,5,2,0,10,1,1,0,12,23,35
p_84,12,0,e_1,504,535,591,29,1,1,2,5,1,0,31,56,87
p_85,14,0,e_1,517,543,591,23,1,1,6,5,1,0,26,48,74
p_86,14,0,e_1,518,543,591,23,1,1,7,5,1,1,25,48,73
p_91,14,0,e_1,539,543,591,16,1,1,13,5,1,1,4,48,52
p_95,10,0,e_1,547,557,591,9,2,0,13,4,1,0,10,34,44
p_99,9,0,e_1,556,562,591,6,3,0,10,4,1,1,6,29,35
p_106,5,0,e_3,583,590,659,16,3,3,3,5,0,3,7,69,76
p_98,6,0,e_3,555,595,659,3,2,0,3,5,1,1,40,64,104
p_108,7,0,e_3,584,600,659,14,4,2,3,5,0,4,16,59,75
p_100,10,0,e_3,557,611,659,7,3,0,3,5,1,2,54,48,102
p_105,12,0,e_3,582,619,659,9,2,0,3,5,0,2,37,40,77
p_116,7,0,e_3,633,636,659,1,2,0,8,4,1,1,3,23,26
p_101,9,0,e_2,566,601,666,23,3,3,2,4,1,0,35,65,100
p_102,14,0,e_2,568,618,666,18,3,3,1,4,1,1,50,48,98
p_103,14,0,e_2,577,618,666,13,2,0,1,5,0,2,41,48,89
p_104,14,0,e_2,581,618,666,12,2,0,2,5,0,2,37,48,85
p_115,9,0,e_2,632,635,666,29,1,1,10,4,1,1,3,31,34
p_107,3,0,e_2,584,655,666,18,5,5,3,5,0,2,71,11,82
p_109,10,0,e_0,590,623,667,9,5,1,0,3,0,0,33,44,77
p_112,11,0,e_0,613,628,667,3,2,1,7,5,0,2,15,39,54
p_113,9,0,e_0,629,636,667,30,1,1,11,4,1,1,7,31,38
p_111,2,0,e_0,607,659,667,13,3,2,5,5,0,1,52,8,60
p_117,0,2,e_3,636,659,667,7,2,0,7,4,1,1,23,8,31
p_110,12,0,e_1,590,629,669,7,5,0,0,3,1,0,39,40,79
p_121,3,0,e_1,656,658,669,28,3,3,4,4,1,1,2,11,13
p_123,0,2,e_2,661,666,674,26,3,3,1,4,1,1,5,8,13
p_125,2,0,e_2,668,674,716,22,3,3,0,5,1,1,6,42,48
p_122,7,0,e_2,657,691,716,24,3,3,3,4,1,0,34,25,59
p_126,1,0,e_2,681,711,716,19,3,3,4,5,1,1,30,5,35
p_118,8,0,e_1,649,695,721,25,2,2,6,4,1,0,46,26,72
p_124,7,0,e_3,664,684,751,18,3,2,1,5,1,2,20,67,87
p_119,8,0,e_3,650,689,751,25,2,2,3,4,1,1,39,62,101
p_114,13,0,e_3,632,706,751,25,1,1,8,4,1,0,74,45,119
p_131,7,0,e_3,722,726,751,1,1,0,8,4,1,0,4,25,29
p_132,4,0,e_3,730,737,751,2,1,0,6,4,1,0,7,14,21
p_120,13,0,e_0,653,708,755,19,3,3,4,4,1,1,55,47,102
p_130,11,0,e_0,705,716,755,24,1,0,12,5,0,3,11,39,50
p_127,7,0,e_0,701,730,755,7,2,1,11,5,0,1,29,25,54
p_129,5,0,e_0,705,738,755,18,1,0,12,5,0,2,33,17,50
p_128,0,15,e_2,705,716,765,13,2,2,3,4,1,1,11,49,60
p_140,5,0,e_3,768,785,802,5,0,0,0,3,0,0,17,17,34
p_143,5,0,e_3,780,785,802,1,1,0,4,5,0,1,5,17,22
p_139,0,15,e_0,758,758,807,0,0,0,0,3,0,0,0,49,49
p_134,14,0,e_2,734,760,814,21,2,2,5,5,1,0,26,54,80
p_136,14,0,e_2,749,760,814,16,1,1,11,5,1,1,11,54,65
p_138,12,0,e_2,756,776,814,12,0,0,13,5,1,1,20,38,58
p_141,12,0,e_2,770,776,814,12,1,0,14,4,1,1,6,38,44
p_133,6,0,e_1,734,755,821,29,2,2,0,3,0,0,21,66,87
p_135,11,0,e_1,739,772,821,23,1,1,1,5,0,1,33,49,82
p_137,13,0,e_1,755,780,821,13,0,0,6,2,0,1,25,41,66
p_142,13,0,e_1,773,780,821,12,1,0,11,5,1,1,7,41,48
p_145,1,0,e_3,820,826,831,1,0,0,0,3,0,0,6,5,11
p_144,6,0,e_2,815,836,856,6,0,0,0,3,0,0,21,20,41
p_150,3,0,e_2,860,871,884,24,1,1,0,3,0,0,11,13,24
p_152,2,0,e_2,868,876,884,22,1,1,2,5,0,1,8,8,16
p_146,10,0,e_0,846,864,900,10,0,0,15,3,0,0,18,36,54
p_153,6,0,e_0,872,878,900,17,1,1,8,4,1,0,6,22,28
p_154,4,0,e_0,874,886,900,18,1,1,7,4,1,1,12,14,26
p_147,6,0,e_1,849,869,933,6,0,0,0,3,0,0,20,64,84
p_149,6,0,e_1,859,869,933,21,1,1,3,5,0,1,10,64,74
p_155,11,0,e_1,884,886,933,8,1,1,11,5,1,1,2,47,49
p_151,12,0,e_1,863,891,933,14,1,1,4,5,0,1,28,42,70
p_156,12,0,e_1,884,891,933,7,1,1,11,5,1,1,7,42,49
p_159,8,0,e_1,893,905,933,8,1,1,12,4,1,1,12,28,40
p_158,7,0,e_1,892,910,933,9,1,1,12,4,1,0,18,23,41
p_157,7,0,e_2,889,913,936,10,1,1,0,3,0,0,24,23,47
p_148,15,0,e_3,849,896,943,15,0,0,0,3,0,0,47,47,94
p_3,4,0,e_2,25,39,87,4,0,0,0,3,0,0,14,48,62
p_4,5,0,e_2,34,44,87,5,0,0,3,5,0,1,10,43,53
p_5,9,0,e_2,41,58,87,9,0,0,4,5,1,1,17,29,46
p_6,9,0,e_2,45,58,87,9,0,0,5,5,1,1,13,29,42
p_2,11,0,e_1,19,54,89,11,0,0,0,3,0,0,35,35,70
p_1,13,0,e_0,13,55,96,13,0,0,0,3,0,0,42,41,83
p_12,0,8,e_2,86,87,115,21,4,4,0,3,1,0,1,28,29
p_16,4,0,e_1,101,116,130,13,4,1,0,3,0,0,15,14,29
p_15,5,0,e_0,99,117,134,13,4,2,0,3,0,0,18,17,35
p_19,0,7,e_1,125,130,155,11,2,0,2,4,1,0,5,25,30
p_7,2,0,e_3,55,63,159,2,0,0,0,3,0,0,8,96,104
p_10,9,0,e_3,77,86,159,15,3,2,6,5,1,2,9,73,82
p_9,10,0,e_3,67,91,159,17,2,1,3,5,1,1,24,68,92
p_14,13,0,e_3,87,102,159,8,4,1,9,5,1,3,15,57,72
p_8,15,0,e_3,62,110,159,13,1,0,2,5,0,1,48,49,97
p_11,4,0,e_3,84,145,159,17,4,2,9,5,1,3,61,14,75
p_20,3,0,e_0,142,153,164,2,2,1,0,3,0,0,11,11,22
p_13,8,0,e_2,87,115,187,13,4,2,0,3,1,0,28,72,100
p_17,10,0,e_2,112,123,187,5,2,0,7,5,1,0,11,64,75
p_18,15,0,e_2,120,140,187,27,2,2,9,5,1,1,20,47,67
p_21,0,10,e_3,142,159,193,5,2,0,5,4,1,1,17,34,51
p_30,2,0,e_2,200,209,217,14,2,1,0,3,0,0,9,8,17
p_27,5,0,e_0,180,187,224,8,2,2,3,5,0,1,7,37,44
p_26,6,0,e_0,169,192,224,11,2,2,0,3,0,0,23,32,55
p_28,7,0,e_0,184,197,224,5,2,2,4,5,0,2,13,27,40
p_31,5,0,e_0,203,205,224,10,2,1,6,4,1,0,2,19,21
p_33,1,0,e_0,213,219,224,12,1,0,3,4,1,0,6,5,11
p_22,6,0,e_1,146,150,232,28,1,1,5,5,1,0,4,82,86
p_24,14,0,e_1,157,178,232,17,1,1,7,5,1,1,21,54,75
p_23,15,0,e_1,150,183,232,18,1,1,6,2,1,0,33,49,82
p_36,1,0,e_1,225,227,232,7,1,0,2,4,1,0,2,5,7
p_35,0,6,e_0,222,224,244,10,1,0,1,4,1,0,2,20,22
p_32,0,10,e_2,209,217,249,14,1,0,2,4,1,0,8,32,40
p_25,9,0,e_3,163,188,251,10,1,1,1,5,1,0,25,63,88
p_29,14,0,e_3,192,207,251,4,2,0,10,5,2,0,15,44,59
p_42,4,0,e_3,269,283,297,4,0,0,0,3,0,0,14,14,28
p_43,4,0,e_3,270,283,297,4,1,0,0,5,0,1,13,14,27
p_44,4,0,e_3,275,283,297,2,1,0,2,5,0,1,8,14,22
p_41,7,0,e_1,257,281,306,7,0,0,0,3,0,0,24,25,49
p_47,3,0,e_1,293,295,306,28,2,2,4,4,1,1,2,11,13
p_38,12,0,e_0,240,264,312,22,1,1,5,5,1,0,24,48,72
p_39,13,0,e_0,247,269,312,18,1,1,6,5,0,1,22,43,65
p_49,3,0,e_0,298,301,312,19,2,2,4,4,1,0,3,11,14
p_34,11,0,e_2,217,254,315,30,1,1,0,3,1,0,37,61,98
p_37,15,0,e_2,228,268,315,22,1,1,3,5,1,1,40,47,87
p_40,15,0,e_2,255,268,315,15,0,0,11,5,1,1,13,47,60
p_51,0,4,e_0,309,312,326,19,2,2,1,4,1,0,3,14,17
p_57,1,0,e_2,327,333,338,18,3,2,0,3,0,0,6,5,11
p_46,8,0,e_1,291,332,360,24,2,2,4,4,1,0,41,28,69
p_53,8,0,e_1,313,332,360,15,3,3,2,5,0,1,19,28,47
p_56,8,0,e_1,324,332,360,11,3,2,6,5,0,1,8,28,36
p_59,3,0,e_1,335,349,360,14,2,1,8,4,1,0,14,11,25
p_58,0,6,e_2,330,338,360,18,3,3,0,5,0,1,8,22,30
p_54,7,0,e_0,313,337,362,16,3,3,0,5,1,0,24,25,49
p_62,1,0,e_0,345,357,362,13,2,1,5,4,1,0,12,5,17
p_60,2,0,e_2,338,346,382,14,2,1,0,3,1,0,8,36,44
p_63,3,0,e_2,364,371,382,6,1,0,5,4,1,0,7,11,18
p_48,9,0,e_3,294,326,391,22,2,2,1,4,1,1,32,65,97
p_45,11,0,e_3,290,334,391,21,1,1,2,4,1,0,44,57,101
p_50,11,0,e_3,299,334,391,11,2,0,0,5,0,2,35,57,92
p_52,14,0,e_3,312,345,391,9,2,0,5,5,0,2,33,46,79
p_55,14,0,e_3,314,345,391,9,3,0,5,5,0,3,31,46,77
p_61,12,0,e_3,341,353,391,3,2,1,13,5,1,1,12,38,50
p_65,0,7,e_1,369,369,394,7,1,0,0,3,0,0,0,25,25
p_68,2,0,e_2,389,397,405,28,1,1,0,3,0,0,8,8,16
p_64,0,15,e_0,365,366,415,9,1,0,0,3,0,0,1,49,50
p_69,2,0,e_3,391,399,441,2,0,0,0,3,1,0,8,42,50
p_70,3,0,e_3,398,404,441,1,1,0,2,5,0,1,6,37,43
p_71,7,0,e_3,403,418,441,10,1,0,3,2,1,0,15,23,38
p_73,3,0,e_2,423,435,446,3,1,0,0,3,0,0,12,11,23
p_66,11,0,e_1,376,408,455,24,1,1,1,5,1,0,32,47,79
p_67,12,0,e_1,377,413,455,23,1,1,1,5,1,1,36,42,78
p_72,6,0,e_1,417,433,455,13,1,0,11,4,1,0,16,22,38
p_75,3,0,e_1,438,444,455,28,1,1,5,4,1,0,6,11,17
p_74,10,0,e_0,424,442,476,25,1,1,15,3,0,0,18,34,52
p_77,4,0,e_0,455,462,476,16,2,2,6,4,1,0,7,14,21
p_81,1,0,e_0,493,498,503,10,1,0,0,3,0,0,5,5,10
p_79,9,0,e_1,457,487,516,10,2,2,0,3,0,0,30,29,59
p_76,10,0,e_3,440,473,527,10,0,0,0,3,1,0,33,54,87
p_78,12,0,e_3,455,481,527,8,1,0,4,5,0,1,26,46,72
p_80,13,0,e_3,474,486,527,3,2,0,10,5,1,1,12,41,53
p_82,0,12,e_2,494,494,534,11,1,0,0,3,0,0,0,40,40
p_83,0,12,e_0,501,503,543,8,1,0,1,4,1,0,2,40,42
p_87,3,0,e_1,528,539,566,3,0,0,0,3,0,0,11,27,38
p_89,5,0,e_1,535,547,566,5,0,0,2,5,0,1,12,19,31
p_94,3,0,e_1,546,555,566,4,2,1,5,5,1,1,9,11,20
p_90,1,0,e_3,538,544,569,1,0,0,0,3,0,0,6,25,31
p_93,4,0,e_3,543,555,569,3,1,0,1,5,0,1,12,14,26
p_88,10,0,e_0,531,535,585,10,0,0,9,5,1,0,4,50,54
p_95,10,0,e_0,547,551,585,9,2,0,11,4,1,0,4,34,38
p_96,7,0,e_0,551,562,585,4,2,0,10,4,1,0,11,23,34
p_84,12,0,e_2,504,534,592,26,1,1,2,5,1,0,30,58,88
p_85,14,0,e_2,517,542,592,19,1,1,6,5,1,0,25,50,75
p_86,14,0,e_2,518,542,592,19,1,1,7,5,1,1,24,50,74
p_91,14,0,e_2,539,542,592,14,1,0,13,5,1,1,3,50,53
p_92,10,0,e_2,540,556,592,10,1,0,14,5,1,1,16,36,52
p_99,9,0,e_2,556,561,592,25,2,2,10,4,1,1,5,31,36
p_98,6,0,e_2,555,572,592,28,2,2,10,1,1,0,17,20,37
p_111,2,0,e_2,607,615,623,15,3,1,0,3,0,0,8,8,16
p_97,5,0,e_3,552,586,663,2,2,0,3,5,1,1,34,77,111
p_106,5,0,e_3,583,586,663,19,2,1,4,5,0,2,3,77,80
p_108,7,0,e_3,584,594,663,17,3,1,4,5,0,3,10,69,79
p_103,14,0,e_3,577,617,663,12,1,0,2,5,0,1,40,46,86
p_107,3,0,e_3,584,652,663,21,2,2,4,5,0,2,68,11,79
p_101,9,0,e_1,566,595,664,22,2,2,0,5,0,1,29,69,98
p_100,10,0,e_1,557,600,664,24,2,2,3,4,1,0,43,64,107
p_105,12,0,e_1,582,608,664,12,2,1,5,5,0,3,26,56,82
p_110,12,0,e_1,590,608,664,10,4,1,8,5,0,4,18,56,74
p_102,14,0,e_1,568,616,664,14,1,1,0,5,0,2,48,48,96
p_104,14,0,e_1,581,616,664,11,2,0,5,5,0,3,35,48,83
p_113,9,0,e_1,629,633,664,1,2,0,10,4,1,0,4,31,35
p_116,7,0,e_1,633,641,664,2,2,0,9,4,1,0,8,23,31
p_109,10,0,e_0,590,623,665,12,4,1,0,3,0,0,33,42,75
p_112,11,0,e_0,613,628,665,4,3,1,7,5,0,1,15,37,52
p_115,9,0,e_0,632,636,665,1,2,0,10,4,1,0,4,29,33
p_117,0,2,e_3,636,663,671,8,2,0,8,4,1,1,27,8,35
p_123,0,2,e_0,661,665,673,1,1,0,1,4,1,0,4,8,12
p_125,2,0,e_3,668,671,679,1,1,0,1,5,1,0,3,8,11
p_126,1,0,e_1,681,686,691,1,0,0,0,3,0,0,5,5,10
p_124,7,0,e_0,664,690,713,7,1,0,0,3,1,0,26,23,49
p_118,8,0,e_2,649,659,721,26,2,2,5,5,0,1,10,62,72
p_119,8,0,e_2,650,659,721,25,2,2,5,5,0,2,9,62,71
p_114,13,0,e_2,632,676,721,27,2,2,0,3,0,0,44,45,89
p_120,13,0,e_2,653,676,721,20,1,1,6,5,0,2,23,45,68
p_122,7,0,e_2,657,696,721,25,1,1,7,5,0,3,39,25,64
p_121,3,0,e_2,656,710,721,29,1,1,7,5,0,2,54,11,65
p_128,0,15,e_3,705,705,758,0,1,1,0,3,0,1,0,53,53
p_132,4,0,e_2,730,745,773,20,2,1,0,3,0,0,15,28,43
p_133,6,0,e_2,734,753,773,16,2,1,1,5,0,1,19,20,39
p_127,7,0,e_1,701,724,795,7,0,0,0,3,0,0,23,71,94
p_130,11,0,e_1,705,738,795,11,2,2,1,5,0,1,33,57,90
p_134,14,0,e_1,734,749,795,8,2,1,10,5,1,1,15,46,61
p_140,5,0,e_1,768,778,795,7,2,0,8,4,1,0,10,17,27
p_129,5,0,e_3,705,724,807,5,0,0,0,3,0,0,19,83,102
p_136,14,0,e_3,749,753,807,3,2,1,13,5,2,0,4,54,58
p_138,12,0,e_3,756,769,807,4,2,1,14,5,2,0,13,38,51
p_131,7,0,e_0,722,745,810,19,2,1,0,3,0,0,23,65,88
p_135,11,0,e_0,739,759,810,9,2,1,5,5,0,1,20,51,71
p_137,13,0,e_0,755,767,810,3,2,1,10,5,1,1,12,43,55
p_143,5,0,e_0,780,793,810,4,1,0,9,4,1,0,13,17,30
p_139,0,15,e_2,758,773,824,15,2,0,5,4,1,0,15,51,66
p_145,1,0,e_1,820,825,830,1,0,0,0,3,0,0,5,5,10
p_144,6,0,e_0,815,835,855,6,0,0,0,3,0,0,20,20,40
p_141,12,0,e_2,770,811,875,30,1,1,1,4,1,0,41,64,105
p_142,13,0,e_2,773,816,875,28,1,1,0,5,1,1,43,59,102
p_147,6,0,e_2,849,853,875,6,1,1,7,4,1,0,4,22,26
p_150,3,0,e_2,860,864,875,24,1,1,4,4,1,0,4,11,15
p_149,6,0,e_0,859,880,902,21,1,1,0,3,0,0,21,22,43
p_153,6,0,e_0,872,880,902,17,1,1,4,5,0,2,8,22,30
p_152,2,0,e_0,868,894,902,22,1,1,2,5,0,1,26,8,34
p_154,4,0,e_2,874,889,923,18,1,1,0,3,1,0,15,34,49
p_157,7,0,e_2,889,900,923,10,1,1,4,3,0,0,11,23,34
p_158,7,0,e_2,892,900,923,9,1,1,4,5,1,1,8,23,31
p_146,10,0,e_1,846,879,929,10,0,0,0,3,0,0,33,50,83
p_151,12,0,e_1,863,887,929,14,1,1,5,5,0,1,24,42,66
p_156,12,0,e_1,884,887,929,7,1,1,11,5,1,2,3,42,45
p_155,11,0,e_1,884,892,929,8,1,1,11,5,1,1,8,37,45
p_159,8,0,e_1,893,903,929,8,1,1,11,4,1,0,10,26,36
p_148,15,0,e_3,849,896,943,15,0,0,0,3,0,0,47,47,94
p_3,4,0,e_2,25,40,88,4,0,0,0,3,0,0,15,48,63
p_4,5,0,e_2,34,45,88,5,0,0,2,5,0,1,11,43,54
p_5,9,0,e_2,41,59,88,9,0,0,4,5,1,1,18,29,47
p_6,9,0,e_2,45,59,88,9,0,0,5,2,1,1,14,29,43
p_2,11,0,e_1,19,55,90,11,0,0,0,3,0,0,36,35,71
p_1,13,0,e_0,13,54,95,13,0,0,0,3,0,0,41,41,82
p_12,0,8,e_2,86,88,114,21,4,4,0,4,1,0,2,26,28
p_16,4,0,e_1,101,116,130,13,4,1,0,3,0,0,15,14,29
p_15,5,0,e_0,99,116,133,13,5,2,0,3,0,0,17,17,34
p_19,0,7,e_0,125,133,158,11,3,0,2,4,1,0,8,25,33
p_7,2,0,e_3,55,63,161,2,0,0,0,3,0,0,8,98,106
p_10,9,0,e_3,77,86,161,15,3,2,6,5,1,2,9,75,84
p_9,10,0,e_3,67,91,161,17,2,1,3,5,1,1,24,70,94
p_14,13,0,e_3,87,102,161,8,5,1,9,5,1,4,15,59,74
p_8,15,0,e_3,62,110,161,13,1,0,2,5,0,1,48,51,99
p_13,8,0,e_3,87,133,161,13,4,2,9,5,1,3,46,28,74
p_11,4,0,e_3,84,147,161,17,4,2,9,5,1,3,63,14,77
p_21,0,10,e_1,142,142,178,6,2,0,0,3,0,0,0,36,36
p_17,10,0,e_2,112,122,186,5,3,0,8,5,1,0,10,64,74
p_18,15,0,e_2,120,139,186,27,3,3,10,5,0,1,19,47,66
p_22,6,0,e_0,146,153,235,28,2,2,4,5,1,0,7,82,89
p_23,15,0,e_0,150,184,235,18,1,1,5,5,1,1,34,51,85
p_28,7,0,e_0,184,210,235,5,3,1,15,4,1,0,26,25,51
p_33,1,0,e_0,213,230,235,13,2,1,7,4,1,0,17,5,22
p_30,2,0,e_2,200,209,237,15,3,1,0,3,0,0,9,28,37
p_31,5,0,e_2,203,220,237,11,3,1,0,5,0,1,17,17,34
p_20,3,0,e_1,142,155,238,2,2,1,0,3,0,1,13,83,96
p_24,14,0,e_1,157,192,238,17,1,1,3,5,2,0,35,46,81
p_36,1,0,e_1,225,233,238,10,2,1,3,4,1,0,8,5,13
p_35,0,6,e_1,222,238,258,11,2,0,5,4,1,0,16,20,36
p_26,6,0,e_3,169,183,259,11,1,1,1,5,0,1,14,76,90
p_25,9,0,e_3,163,194,259,9,0,0,0,3,0,0,31,65,96
p_29,14,0,e_3,192,211,259,5,3,0,9,5,1,2,19,48,67
p_34,11,0,e_3,217,222,259,2,2,0,13,4,1,1,5,37,42
p_27,5,0,e_3,180,242,259,8,2,2,5,5,0,2,62,17,79
p_32,0,10,e_0,209,235,267,14,3,3,7,1,1,0,26,32,58
p_42,4,0,e_3,269,283,297,4,0,0,0,3,0,0,14,14,28
p_43,4,0,e_3,270,283,297,4,1,0,0,5,0,1,13,14,27
p_44,4,0,e_3,275,283,297,2,1,0,2,5,0,1,8,14,22
p_38,12,0,e_0,240,275,315,23,2,2,1,5,1,0,35,40,75
p_47,3,0,e_0,293,304,315,28,1,1,7,4,1,0,11,11,22
p_41,7,0,e_1,257,263,328,24,1,1,6,2,1,1,6,65,71
p_39,13,0,e_1,247,283,328,21,1,1,3,5,1,0,36,45,81
p_48,9,0,e_1,294,297,328,22,1,1,10,4,1,1,3,31,34
p_46,8,0,e_1,291,302,328,24,1,1,11,4,1,0,11,26,37
p_51,0,4,e_0,309,315,329,19,1,1,2,4,1,0,6,14,20
p_37,15,0,e_2,228,284,335,24,2,2,3,4,1,0,56,51,107
p_40,15,0,e_2,255,284,335,16,1,1,5,5,0,1,29,51,80
p_45,11,0,e_2,290,298,335,21,1,1,14,4,1,0,8,37,45
p_57,1,0,e_2,327,330,335,19,3,2,2,4,1,0,3,5,8
p_58,0,6,e_1,330,330,352,19,3,3,0,3,0,0,0,22,22
p_60,2,0,e_2,338,343,361,15,2,1,0,5,0,1,5,18,23
p_59,3,0,e_2,335,348,361,14,3,1,0,3,1,0,13,13,26
p_62,1,0,e_2,345,356,361,14,2,1,2,5,1,1,11,5,16
p_63,3,0,e_1,364,375,386,6,1,0,6,3,0,0,11,11,22
p_49,3,0,e_3,298,309,392,3,0,0,0,3,0,0,11,83,94
p_54,7,0,e_3,313,323,392,17,3,2,4,5,1,2,10,69,79
p_50,11,0,e_3,299,337,392,11,1,0,0,5,0,1,38,55,93
p_52,14,0,e_3,312,348,392,10,2,0,4,5,1,1,36,44,80
p_55,14,0,e_3,314,348,392,10,4,0,4,5,1,3,34,44,78
p_53,8,0,e_0,313,343,395,16,4,2,0,4,1,0,30,52,82
p_56,8,0,e_0,324,343,395,13,3,2,3,5,1,1,19,52,71
p_61,12,0,e_0,341,357,395,4,2,1,8,5,0,1,16,38,54
p_65,0,7,e_1,369,386,411,8,1,0,5,4,0,1,17,25,42
p_69,2,0,e_3,391,400,416,2,0,0,0,3,1,0,9,16,25
p_70,3,0,e_3,398,405,416,1,1,0,2,5,0,1,7,11,18
p_64,0,15,e_2,365,365,418,9,1,0,0,3,0,0,0,53,53
p_68,2,0,e_1,389,394,434,29,1,1,0,5,1,0,5,40,45
p_71,7,0,e_1,403,411,434,5,2,0,4,5,2,0,8,23,31
p_73,3,0,e_3,423,435,446,3,0,0,0,3,0,0,12,11,23
p_72,6,0,e_0,417,437,457,6,0,0,0,3,0,0,20,20,40
p_66,11,0,e_2,376,402,467,24,1,1,2,5,1,0,26,65,91
p_67,12,0,e_2,377,407,467,23,1,1,3,5,1,1,30,60,90
p_74,10,0,e_2,424,435,467,10,1,1,13,4,1,0,11,32,43
p_77,4,0,e_3,455,470,484,4,0,0,0,3,0,0,15,14,29
p_81,1,0,e_2,493,499,504,1,0,0,0,3,0,0,6,5,11
p_79,9,0,e_0,457,487,516,9,1,0,0,3,0,0,30,29,59
p_75,3,0,e_1,438,450,527,29,1,1,0,3,0,0,12,77,89
p_76,10,0,e_1,440,473,527,22,1,1,0,5,0,1,33,54,87
p_78,12,0,e_1,455,481,527,12,0,0,4,5,1,1,26,46,72
p_80,13,0,e_1,474,486,527,20,1,1,10,5,1,1,12,41,53
p_82,0,12,e_3,494,495,535,0,0,0,0,3,0,0,1,40,41
p_83,0,12,e_2,501,504,544,23,1,1,1,4,1,0,3,40,43
p_87,3,0,e_0,528,539,564,15,2,2,0,3,0,0,11,25,36
p_89,5,0,e_0,535,547,564,11,1,1,2,5,0,1,12,17,29
p_90,1,0,e_1,538,543,570,15,2,1,0,3,0,0,5,27,32
p_94,3,0,e_1,546,551,570,11,1,0,1,5,1,1,5,19,24
p_93,4,0,e_1,543,556,570,10,1,0,1,2,0,0,13,14,27
p_88,10,0,e_2,531,536,586,7,2,2,8,5,1,0,5,50,55
p_92,10,0,e_2,540,552,586,5,2,1,11,5,2,0,12,34,46
p_96,7,0,e_2,551,563,586,5,2,1,10,1,1,0,12,23,35
p_84,12,0,e_3,504,535,593,10,1,0,2,5,1,0,31,58,89
p_85,14,0,e_3,517,543,593,8,1,0,6,5,1,0,26,50,76
p_86,14,0,e_3,518,543,593,8,2,0,6,5,1,1,25,50,75
p_91,14,0,e_3,539,543,593,1,2,0,13,5,1,1,4,50,54
p_95,10,0,e_3,547,557,593,3,1,0,13,4,1,0,10,36,46
p_99,9,0,e_3,556,562,593,1,3,0,10,4,1,2,6,31,37
p_98,6,0,e_3,555,573,593,4,2,0,10,4,1,1,18,20,38
p_111,2,0,e_3,607,616,624,2,0,0,0,3,0,0,9,8,17
p_101,9,0,e_0,566,593,662,29,2,2,0,5,0,1,27,69,96
p_100,10,0,e_0,557,598,662,30,3,3,2,4,1,0,41,64,105
p_105,12,0,e_0,582,606,662,21,1,1,6,5,0,3,24,56,80
p_102,14,0,e_0,568,614,662,23,2,2,1,5,0,2,46,48,94
p_104,14,0,e_0,581,614,662,20,1,1,5,5,0,3,33,48,81
p_113,9,0,e_0,629,631,662,9,0,0,10,4,1,0,2,31,33
p_116,7,0,e_0,633,639,662,19,1,1,9,4,1,0,6,23,29
p_107,3,0,e_2,584,597,666,30,1,1,0,4,1,0,13,69,82
p_109,10,0,e_2,590,620,666,21,1,1,1,5,0,1,30,46,76
p_110,12,0,e_2,590,628,666,19,1,1,1,5,0,2,38,38,76
p_97,5,0,e_1,552,587,666,7,2,1,3,5,1,1,35,79,114
p_106,5,0,e_1,583,587,666,28,1,1,4,5,0,2,4,79,83
p_108,7,0,e_1,584,595,666,26,1,1,4,5,0,2,11,71,82
p_103,14,0,e_1,577,618,666,21,1,1,2,5,0,1,41,48,89
p_112,11,0,e_1,613,629,666,10,1,0,13,5,1,1,16,37,53
p_115,9,0,e_1,632,637,666,9,0,0,11,4,1,0,5,29,34
p_117,0,2,e_0,636,662,670,26,1,1,8,4,1,1,26,8,34
p_123,0,2,e_0,661,662,670,18,4,4,0,4,1,0,1,8,9
p_125,2,0,e_1,668,677,685,13,4,1,0,3,0,0,9,8,17
p_126,1,0,e_2,681,687,692,11,3,2,0,3,0,0,6,5,11
p_124,7,0,e_0,664,687,710,10,4,1,0,5,1,0,23,23,46
p_118,8,0,e_3,649,659,721,13,1,1,5,5,0,1,10,62,72
p_119,8,0,e_3,650,659,721,13,2,1,5,5,0,2,9,62,71
p_114,13,0,e_3,632,676,721,13,0,0,0,3,0,0,44,45,89
p_120,13,0,e_3,653,676,721,7,2,0,6,5,0,2,23,45,68
p_122,7,0,e_3,657,696,721,11,3,1,8,5,0,3,39,25,64
p_121,3,0,e_3,656,710,721,16,2,2,7,5,0,2,54,11,65
p_127,7,0,e_1,701,724,749,29,2,2,0,3,0,0,23,25,48
p_131,7,0,e_1,722,724,749,7,0,0,7,5,0,1,2,25,27
p_132,4,0,e_1,730,735,749,4,0,0,5,4,1,0,5,14,19
p_128,0,15,e_0,705,710,757,5,2,0,1,4,1,0,5,47,52
p_129,5,0,e_2,705,723,804,30,2,2,0,3,0,1,18,81,99
p_130,11,0,e_2,705,743,804,24,2,2,0,3,0,0,38,61,99
p_134,14,0,e_2,734,754,804,14,0,0,8,5,1,1,20,50,70
p_136,14,0,e_2,749,754,804,10,2,0,13,5,1,1,5,50,55
p_137,13,0,e_2,755,759,804,7,2,0,14,4,1,0,4,45,49
p_138,12,0,e_2,756,764,804,6,2,0,14,4,1,1,8,40,48
p_140,5,0,e_2,768,787,804,7,2,1,11,4,1,0,19,17,36
p_143,5,0,e_2,780,787,804,4,1,0,7,4,1,1,7,17,24
p_133,6,0,e_3,734,755,807,6,0,0,0,3,0,0,21,52,73
p_135,11,0,e_3,739,772,807,10,1,0,1,5,0,1,33,35,68
p_139,0,15,e_1,758,758,807,15,2,2,0,3,0,0,0,49,49
p_142,13,0,e_0,773,778,821,28,1,1,15,4,0,1,5,43,48
p_141,12,0,e_0,770,783,821,1,2,0,15,3,0,0,13,38,51
p_145,1,0,e_3,820,825,830,1,0,0,0,3,0,0,5,5,10
p_144,6,0,e_2,815,836,856,6,0,0,0,3,0,0,21,20,41
p_150,3,0,e_2,860,872,885,24,1,1,0,3,0,0,12,13,25
p_152,2,0,e_2,868,877,885,22,1,1,2,5,0,1,9,8,17
p_146,10,0,e_1,846,864,900,10,0,0,15,3,0,0,18,36,54
p_153,6,0,e_1,872,878,900,17,1,1,8,4,1,0,6,22,28
p_154,4,0,e_1,874,886,900,18,1,1,7,4,1,1,12,14,26
p_147,6,0,e_0,849,870,932,6,0,0,0,3,0,0,21,62,83
p_149,6,0,e_0,859,870,932,21,1,1,3,5,0,1,11,62,73
p_155,11,0,e_0,884,887,932,8,1,1,10,5,1,1,3,45,48
p_151,12,0,e_0,863,892,932,14,1,1,4,5,0,1,29,40,69
p_156,12,0,e_0,884,892,932,7,1,1,10,5,1,2,8,40,48
p_159,8,0,e_0,893,906,932,8,1,1,12,4,1,0,13,26,39
p_157,7,0,e_2,889,912,935,10,1,1,0,3,0,0,23,23,46
p_158,7,0,e_2,892,912,935,9,1,1,0,5,0,1,20,23,43
p_148,15,0,e_3,849,896,943,15,0,0,0,3,0,0,47,47,94
p_3,4,0,e_2,25,39,53,4,0,0,0,3,0,0,14,14,28
p_7,2,0,e_2,55,64,72,10,2,1,0,3,0,0,9,8,17
p_6,9,0,e_1,45,49,92,6,2,0,8,5,0,1,4,43,47
p_2,11,0,e_1,19,57,92,11,0,0,0,3,0,0,38,35,73
p_1,13,0,e_0,13,55,96,13,0,0,0,3,0,0,42,41,83
p_12,0,8,e_1,86,92,118,15,1,1,2,4,1,0,6,26,32
p_16,4,0,e_0,101,113,135,8,2,1,0,5,0,1,12,22,34
p_15,5,0,e_0,99,118,135,7,2,1,0,3,0,0,19,17,36
p_11,4,0,e_2,84,92,138,12,2,1,1,5,0,1,8,46,54
p_10,9,0,e_2,77,109,138,9,2,1,0,3,0,0,32,29,61
p_4,5,0,e_3,34,51,138,5,0,0,0,3,0,0,17,87,104
p_5,9,0,e_3,41,65,138,7,1,0,2,5,0,1,24,73,97
p_9,10,0,e_3,67,70,138,11,2,1,9,5,1,1,3,68,71
p_8,15,0,e_3,62,87,138,7,2,0,8,5,1,1,25,51,76
p_14,13,0,e_3,87,95,138,2,2,0,15,4,1,1,8,43,51
p_13,8,0,e_3,87,112,138,7,1,0,15,4,1,0,25,26,51
p_19,0,7,e_0,125,135,158,4,1,0,3,4,1,0,10,23,33
p_21,0,10,e_2,142,142,176,0,0,0,0,3,0,0,0,34,34
p_17,10,0,e_1,112,126,192,28,1,1,6,5,1,0,14,66,80
p_18,15,0,e_1,120,143,192,21,1,1,8,5,0,1,23,49,72
p_26,6,0,e_1,169,172,192,5,2,1,7,4,1,0,3,20,23
p_20,3,0,e_3,142,154,207,3,0,0,0,3,0,0,12,53,65
p_22,6,0,e_3,146,165,207,5,1,0,1,5,0,1,19,42,61
p_25,9,0,e_3,163,176,207,3,2,0,6,5,1,1,13,31,44
p_27,5,0,e_3,180,190,207,3,1,0,8,4,1,0,10,17,27
p_23,15,0,e_0,150,184,235,13,2,0,5,5,1,0,34,51,85
p_28,7,0,e_0,184,210,235,30,2,2,15,4,1,0,26,25,51
p_33,1,0,e_0,213,230,235,19,1,1,7,4,1,0,17,5,22
p_36,1,0,e_0,225,230,235,17,2,2,3,4,1,1,5,5,10
p_24,14,0,e_2,157,190,238,10,2,0,4,5,1,0,33,48,81
p_31,5,0,e_2,203,219,238,26,1,1,10,4,1,1,16,19,35
p_30,2,0,e_2,200,230,238,30,1,1,11,4,1,0,30,8,38
p_32,0,10,e_3,209,209,243,0,0,0,0,3,0,0,0,34,34
p_35,0,6,e_0,222,235,255,19,2,2,3,4,1,1,13,20,33
p_41,7,0,e_0,257,262,287,6,1,0,6,3,0,0,5,25,30
p_42,4,0,e_0,269,273,287,5,1,0,5,4,1,0,4,14,18
p_29,14,0,e_1,192,236,292,21,1,1,0,3,1,0,44,56,100
p_37,15,0,e_1,228,241,292,10,2,0,11,5,0,1,13,51,64
p_38,12,0,e_1,240,252,292,3,2,0,15,5,1,1,12,40,52
p_43,4,0,e_1,270,278,292,5,1,0,7,4,1,0,8,14,22
p_34,11,0,e_3,217,248,299,9,1,0,2,5,1,0,31,51,82
p_39,13,0,e_3,247,256,299,2,1,0,11,5,0,1,9,43,52
p_44,4,0,e_3,275,285,299,3,1,0,7,4,1,0,10,14,24
p_49,3,0,e_3,298,310,321,3,0,0,0,3,1,0,12,11,23
p_51,0,4,e_3,309,321,335,3,0,0,3,2,0,0,12,14,26
p_47,3,0,e_1,293,303,350,29,1,1,0,5,0,1,10,47,57
p_54,7,0,e_1,313,317,350,26,1,1,6,5,1,1,4,33,37
p_46,8,0,e_1,291,322,350,25,1,1,0,3,1,0,31,28,59
p_53,8,0,e_1,313,322,350,24,1,1,6,5,1,2,9,28,37
p_57,1,0,e_1,327,345,350,6,1,1,7,4,1,0,18,5,23
p_59,3,0,e_3,335,340,353,1,1,0,4,4,0,1,5,13,18
p_62,1,0,e_3,345,348,353,1,1,0,2,4,1,0,3,5,8
p_40,15,0,e_2,255,303,356,28,1,0,0,3,0,0,48,53,101
p_48,9,0,e_2,294,323,356,23,1,1,12,5,0,1,29,33,62
p_56,8,0,e_2,324,328,356,7,1,0,9,4,1,0,4,28,32
p_60,2,0,e_2,338,348,356,1,2,0,5,4,1,0,10,8,18
p_58,0,6,e_3,330,353,373,5,1,1,3,5,1,0,23,20,43
p_45,11,0,e_0,290,325,382,22,1,1,0,3,0,0,35,57,92
p_50,11,0,e_0,299,325,382,11,1,0,3,5,0,1,26,57,83
p_52,14,0,e_0,312,336,382,19,1,1,7,5,0,1,24,46,70
p_55,14,0,e_0,314,336,382,18,1,1,8,5,0,2,22,46,68
p_61,12,0,e_0,341,344,382,21,1,1,13,4,1,0,3,38,41
p_63,3,0,e_1,364,376,387,6,1,1,0,3,0,0,12,11,23
p_68,2,0,e_1,389,397,405,12,2,2,0,3,0,0,8,8,16
p_69,2,0,e_1,391,397,405,12,2,2,0,5,0,1,6,8,14
p_65,0,7,e_0,369,382,405,7,1,1,4,4,1,0,13,23,36
p_64,0,15,e_2,365,366,415,9,1,1,0,3,0,0,1,49,50
p_71,7,0,e_0,403,405,430,4,1,0,7,5,1,1,2,25,27
p_70,3,0,e_0,398,419,430,15,1,0,5,5,1,0,21,11,32
p_66,11,0,e_3,376,394,439,5,0,0,6,3,0,0,18,45,63
p_67,12,0,e_3,377,399,439,6,1,0,6,5,0,1,22,40,62
p_73,3,0,e_3,423,428,439,2,1,0,5,4,1,0,5,11,16
p_72,6,0,e_1,417,437,457,30,1,1,0,3,0,0,20,20,40
p_75,3,0,e_0,438,450,461,27,1,1,0,3,0,0,12,11,23
p_74,10,0,e_2,424,441,475,24,2,2,15,3,0,0,17,34,51
p_77,4,0,e_2,455,461,475,12,1,1,6,4,1,0,6,14,20
p_81,1,0,e_0,493,499,504,10,1,0,0,3,0,0,6,5,11
p_79,9,0,e_1,457,487,516,10,2,2,0,3,0,0,30,29,59
p_76,10,0,e_3,440,473,527,10,0,0,0,3,0,0,33,54,87
p_78,12,0,e_3,455,481,527,8,1,0,4,5,0,1,26,46,72
p_80,13,0,e_3,474,486,527,3,2,0,10,5,1,1,12,41,53
p_82,0,12,e_2,494,495,535,11,1,0,0,3,0,0,1,40,41
p_83,0,12,e_0,501,504,542,9,1,0,1,4,1,0,3,38,41
p_87,3,0,e_1,528,539,570,3,0,0,0,3,0,0,11,31,42
p_89,5,0,e_1,535,547,570,14,1,1,2,5,0,1,12,23,35
p_93,4,0,e_1,543,552,570,12,1,1,4,5,1,2,9,18,27
p_94,3,0,e_1,546,557,570,12,1,1,5,2,1,2,11,13,24
p_90,1,0,e_1,538,565,570,17,1,1,3,5,0,2,27,5,32
p_84,12,0,e_2,504,535,593,25,1,1,2,5,1,0,31,58,89
p_85,14,0,e_2,517,543,593,19,1,1,6,5,1,0,26,50,76
p_91,14,0,e_2,539,543,593,12,1,0,13,5,1,1,4,50,54
p_95,10,0,e_2,547,557,593,5,1,0,13,4,1,0,10,36,46
p_99,9,0,e_2,556,562,593,3,2,1,10,4,1,2,6,31,37
p_98,6,0,e_2,555,573,593,6,2,1,10,4,1,1,18,20,38
p_88,10,0,e_3,531,563,599,10,0,0,0,3,0,0,32,36,68
p_92,10,0,e_3,540,563,599,8,1,0,2,5,0,1,23,36,59
p_97,5,0,e_3,552,580,599,8,1,1,7,5,0,1,28,19,47
p_107,3,0,e_3,584,588,599,1,1,0,4,4,1,0,4,11,15
p_86,14,0,e_0,518,550,600,19,1,1,4,5,1,0,32,50,82
p_100,10,0,e_0,557,564,600,2,2,0,12,4,1,1,7,36,43
p_101,9,0,e_0,566,569,600,1,2,0,10,4,1,1,3,31,34
p_96,7,0,e_0,551,577,600,7,1,1,14,4,1,0,26,23,49
p_111,2,0,e_0,607,616,624,2,0,0,0,3,0,0,9,8,17
p_106,5,0,e_1,583,587,666,30,1,1,4,5,0,2,4,79,83
p_108,7,0,e_1,584,595,666,27,2,2,4,5,0,3,11,71,82
p_105,12,0,e_1,582,612,666,23,1,1,4,5,0,1,30,54,84
p_110,12,0,e_1,590,612,666,21,1,1,6,5,1,3,22,54,76
p_102,14,0,e_1,568,620,666,25,2,2,0,4,1,0,52,46,98
p_103,14,0,e_1,577,620,666,22,2,2,2,5,0,1,43,46,89
p_104,14,0,e_1,581,620,666,21,1,1,3,5,0,1,39,46,85
p_113,9,0,e_1,629,637,666,9,0,0,12,4,1,0,8,29,37
p_109,10,0,e_2,590,625,667,23,1,1,1,4,1,0,35,42,77
p_112,11,0,e_2,613,630,667,11,0,0,6,5,0,1,17,37,54
p_115,9,0,e_2,632,638,667,9,0,0,11,4,1,0,6,29,35
p_117,0,2,e_1,636,666,674,14,1,1,9,1,1,0,30,8,38
p_123,0,2,e_1,661,666,674,9,3,3,1,4,1,0,5,8,13
p_125,2,0,e_2,668,676,684,5,2,1,0,3,0,0,8,8,16
p_126,1,0,e_1,681,686,691,2,1,0,2,3,0,0,5,5,10
p_116,7,0,e_3,633,657,692,7,0,0,0,3,0,0,24,35,59
p_122,7,0,e_3,657,659,692,2,3,1,7,5,1,2,2,33,35
p_118,8,0,e_3,649,664,692,4,1,0,4,5,0,1,15,28,43
p_119,8,0,e_3,650,664,692,3,2,0,5,5,0,2,14,28,42
p_121,3,0,e_3,656,681,692,6,2,1,7,5,0,2,25,11,36
p_114,13,0,e_0,632,673,716,13,0,0,0,3,0,0,41,43,84
p_120,13,0,e_0,653,673,716,7,2,0,6,5,0,1,20,43,63
p_124,7,0,e_0,664,693,716,9,2,0,10,5,0,1,29,23,52
p_129,5,0,e_1,705,719,750,25,2,1,1,5,0,1,14,31,45
p_127,7,0,e_1,701,727,750,7,0,0,0,3,0,0,26,23,49
p_131,7,0,e_1,722,727,750,18,1,1,6,5,1,1,5,23,28
p_128,0,15,e_3,705,705,754,0,0,0,0,3,0,0,0,49,49
p_132,4,0,e_0,730,745,773,19,1,1,0,3,0,0,15,28,43
p_133,6,0,e_0,734,753,773,16,1,1,1,5,0,1,19,20,39
p_130,11,0,e_2,705,740,799,11,0,0,0,3,0,0,35,59,94
p_135,11,0,e_2,739,740,799,9,1,1,11,5,0,2,1,59,60
p_134,14,0,e_2,734,751,799,8,1,1,9,5,0,1,17,48,65
p_136,14,0,e_2,749,751,799,3,1,1,13,5,1,1,2,48,50
p_138,12,0,e_2,756,759,799,3,1,1,13,4,1,0,3,40,43
p_140,5,0,e_2,768,782,799,7,1,0,10,4,1,0,14,17,31
p_137,13,0,e_3,755,763,806,2,0,0,15,3,0,0,8,43,51
p_143,5,0,e_3,780,789,806,3,1,0,8,4,1,0,9,17,26
p_139,0,15,e_1,758,759,810,14,1,0,0,3,0,0,1,51,52
p_145,1,0,e_3,820,826,831,1,0,0,0,3,0,0,6,5,11
p_144,6,0,e_2,815,835,855,6,0,0,0,3,0,0,20,20,40
p_142,13,0,e_0,773,815,856,27,1,1,0,3,0,0,42,41,83
p_141,12,0,e_1,770,799,857,29,1,1,2,5,1,0,29,58,87
p_150,3,0,e_2,860,872,885,23,2,2,0,3,0,0,12,13,25
p_152,2,0,e_2,868,877,885,21,2,2,2,5,0,1,9,8,17
p_149,6,0,e_1,859,880,902,20,2,2,0,3,0,0,21,22,43
p_153,6,0,e_1,872,880,902,16,2,2,4,5,0,1,8,22,30
p_154,4,0,e_1,874,888,902,18,2,2,4,5,0,1,14,14,28
p_147,6,0,e_0,849,876,936,24,2,2,2,4,1,0,27,60,87
p_155,11,0,e_0,884,893,936,8,2,1,8,5,1,1,9,43,52
p_151,12,0,e_0,863,898,936,13,2,1,2,5,0,1,35,38,73
p_156,12,0,e_0,884,898,936,7,2,1,8,5,1,1,14,38,52
p_146,10,0,e_3,846,879,943,10,0,0,0,3,0,0,33,64,97
p_148,15,0,e_3,849,896,943,15,1,0,0,5,0,1,47,47,94
p_157,7,0,e_2,889,913,944,10,2,1,0,3,0,0,24,31,55
p_158,7,0,e_2,892,913,944,9,2,1,0,5,0,1,21,31,52
p_159,8,0,e_2,893,918,944,8,2,1,0,5,0,1,25,26,51
p_3,4,0,e_2,25,40,88,4,0,0,0,3,0,0,15,48,63
p_4,5,0,e_2,34,45,88,5,0,0,2,5,0,1,11,43,54
p_5,9,0,e_2,41,59,88,9,0,0,4,5,1,1,18,29,47
p_6,9,0,e_2,45,59,88,9,0,0,5,5,1,1,14,29,43
p_2,11,0,e_1,19,55,90,11,0,0,0,3,0,0,36,35,71
p_1,13,0,e_0,13,54,95,13,0,0,0,3,0,0,41,41,82
p_12,0,8,e_1,86,90,116,21,5,5,1,4,1,0,4,26,30
p_16,4,0,e_0,101,113,135,14,4,2,0,5,0,1,12,22,34
p_15,5,0,e_0,99,118,135,13,4,2,0,3,0,0,19,17,36
p_13,8,0,e_2,87,114,156,13,4,2,0,3,1,0,27,42,69
p_17,10,0,e_2,112,122,156,5,2,0,8,5,0,1,10,34,44
p_20,3,0,e_2,142,145,156,2,2,1,4,4,1,0,3,11,14
p_7,2,0,e_3,55,64,160,2,0,0,0,3,0,0,9,96,105
p_10,9,0,e_3,77,87,160,15,3,2,6,5,1,2,10,73,83
p_9,10,0,e_3,67,92,160,18,2,1,2,5,1,1,25,68,93
p_14,13,0,e_3,87,103,160,8,4,1,9,5,1,3,16,57,73
p_8,15,0,e_3,62,111,160,13,1,0,2,5,0,1,49,49,98
p_11,4,0,e_3,84,146,160,18,4,3,8,5,1,3,62,14,76
p_19,0,7,e_0,125,135,160,11,2,0,3,4,1,0,10,25,35
p_21,0,10,e_2,142,156,188,5,2,0,4,4,1,1,14,32,46
p_18,15,0,e_1,120,144,193,28,2,2,8,3,0,0,24,49,73
p_26,6,0,e_1,169,173,193,11,1,1,7,4,1,0,4,20,24
p_30,2,0,e_1,200,208,216,16,2,1,0,3,0,0,8,8,16
p_27,5,0,e_2,180,205,224,8,1,1,7,5,1,0,25,19,44
p_33,1,0,e_2,213,219,224,13,1,0,3,4,1,0,6,5,11
p_22,6,0,e_0,146,155,239,28,1,1,3,5,1,0,9,84,93
p_24,14,0,e_0,157,183,239,17,1,1,6,5,2,1,26,56,82
p_23,15,0,e_0,150,188,239,18,1,1,4,5,1,1,38,51,89
p_31,5,0,e_0,203,220,239,12,2,1,10,4,1,0,17,19,36
p_36,1,0,e_0,225,234,239,10,1,0,4,4,1,0,9,5,14
p_35,0,6,e_2,222,224,244,11,1,0,0,4,1,0,2,20,22
p_32,0,10,e_1,209,216,248,15,2,2,2,4,1,0,7,32,39
p_28,7,0,e_3,184,187,258,5,1,1,6,5,0,1,3,71,74
p_25,9,0,e_3,163,195,258,9,0,0,0,3,0,0,32,63,95
p_29,14,0,e_3,192,212,258,6,2,0,8,5,1,1,20,46,66
p_34,11,0,e_3,217,223,258,2,1,0,13,4,1,0,6,35,41
p_42,4,0,e_3,269,283,297,4,0,0,0,3,0,0,14,14,28
p_43,4,0,e_3,270,283,297,4,1,0,0,5,0,1,13,14,27
p_44,4,0,e_3,275,283,297,2,1,0,2,5,0,1,8,14,22
p_41,7,0,e_0,257,280,303,7,0,0,0,3,0,0,23,23,46
p_38,12,0,e_2,240,264,312,24,1,1,5,5,1,0,24,48,72
p_39,13,0,e_2,247,269,312,20,1,1,7,5,0,1,22,43,65
p_49,3,0,e_2,298,301,312,19,2,2,4,4,1,0,3,11,14
p_37,15,0,e_1,228,265,314,25,1,1,4,5,1,0,37,49,86
p_40,15,0,e_1,255,265,314,16,1,1,12,5,0,1,10,49,59
p_47,3,0,e_1,293,303,314,28,3,3,6,4,1,0,10,11,21
p_51,0,4,e_2,309,312,326,18,2,2,1,4,1,0,3,14,17
p_54,7,0,e_1,313,337,362,16,3,3,0,3,1,0,24,25,49
p_57,1,0,e_1,327,357,362,18,3,2,4,5,0,1,30,5,35
p_62,1,0,e_1,345,357,362,13,2,1,5,4,1,1,12,5,17
p_53,8,0,e_0,313,329,365,15,3,2,3,5,0,1,16,36,52
p_48,9,0,e_0,294,334,365,22,3,3,3,4,1,0,40,31,71
p_59,3,0,e_0,335,354,365,14,2,1,9,4,1,0,19,11,30
p_56,8,0,e_2,324,340,368,12,3,2,4,5,1,0,16,28,44
p_60,2,0,e_2,338,360,368,14,2,1,8,5,0,1,22,8,30
p_58,0,6,e_1,330,362,382,18,3,3,5,5,0,2,32,20,52
p_46,8,0,e_3,291,323,391,24,2,2,2,4,1,1,32,68,100
p_45,11,0,e_3,290,334,391,21,1,1,2,4,1,0,44,57,101
p_50,11,0,e_3,299,334,391,11,2,0,0,5,0,2,35,57,92
p_52,14,0,e_3,312,345,391,10,2,0,4,5,0,2,33,46,79
p_55,14,0,e_3,314,345,391,9,3,0,5,5,0,3,31,46,77
p_61,12,0,e_3,341,353,391,3,2,1,13,5,1,1,12,38,50
p_65,0,7,e_2,369,370,395,7,1,0,0,3,0,0,1,25,26
p_64,0,15,e_0,365,365,416,9,1,0,0,3,1,1,0,51,51
p_68,2,0,e_2,389,412,420,28,1,1,5,5,1,0,23,8,31
p_69,2,0,e_3,391,399,441,2,0,0,0,3,1,0,8,42,50
p_70,3,0,e_3,398,404,441,5,0,0,2,2,0,0,6,37,43
p_71,7,0,e_3,403,418,441,4,2,0,3,5,1,1,15,23,38
p_66,11,0,e_1,376,399,444,24,1,1,4,5,1,0,23,45,68
p_67,12,0,e_1,377,404,444,23,1,1,5,5,1,1,27,40,67
p_72,6,0,e_1,417,424,444,13,1,0,8,4,1,0,7,20,27
p_73,3,0,e_2,423,434,445,3,1,0,0,3,0,0,11,11,22
p_63,3,0,e_0,364,378,467,6,1,0,0,3,1,0,14,89,103
p_74,10,0,e_0,424,433,467,25,1,1,13,4,1,0,9,34,43
p_75,3,0,e_0,438,456,467,28,1,1,9,4,1,0,18,11,29
p_77,4,0,e_1,455,469,483,12,1,1,0,3,0,0,14,14,28
p_81,1,0,e_0,493,498,503,10,1,0,0,3,0,0,5,5,10
p_79,9,0,e_2,457,486,515,10,2,2,0,3,0,0,29,29,58
p_76,10,0,e_3,440,473,527,20,1,1,0,4,1,0,33,54,87
p_78,12,0,e_3,455,481,527,8,1,0,4,5,0,1,26,46,72
p_80,13,0,e_3,474,486,527,3,2,0,10,5,1,1,12,41,53
p_82,0,12,e_1,494,494,534,11,1,0,0,3,0,0,0,40,40
p_83,0,12,e_0,501,503,543,8,1,0,0,4,1,0,2,40,42
p_87,3,0,e_2,528,540,567,3,0,0,0,3,0,0,12,27,39
p_89,5,0,e_2,535,548,567,5,0,0,2,5,0,1,13,19,32
p_94,3,0,e_2,546,556,567,4,2,1,5,5,1,1,10,11,21
p_90,1,0,e_3,538,544,569,1,0,0,0,3,0,0,6,25,31
p_93,4,0,e_3,543,555,569,3,1,0,1,5,0,1,12,14,26
p_88,10,0,e_0,531,535,585,10,0,0,9,5,1,0,4,50,54
p_92,10,0,e_0,540,551,585,10,1,0,11,5,2,0,11,34,45
p_95,10,0,e_0,547,551,585,8,2,0,11,4,1,1,4,34,38
p_96,7,0,e_0,551,562,585,4,2,0,10,4,1,0,11,23,34
p_84,12,0,e_1,504,534,590,26,1,1,2,5,1,0,30,56,86
p_85,14,0,e_1,517,542,590,19,1,1,7,5,1,0,25,48,73
p_86,14,0,e_1,518,542,590,19,1,1,7,5,1,1,24,48,72
p_91,14,0,e_1,539,542,590,14,1,1,13,5,1,1,3,48,51
p_99,9,0,e_1,556,559,590,25,2,2,10,4,1,1,3,31,34
p_98,6,0,e_1,555,570,590,2,2,2,10,4,1,0,15,20,35
p_101,9,0,e_2,566,596,661,22,2,2,0,3,1,1,30,65,95
p_100,10,0,e_2,557,601,661,24,2,2,3,4,1,0,44,60,104
p_102,14,0,e_2,568,615,661,16,2,2,0,5,0,2,47,46,93
p_106,5,0,e_2,583,644,661,19,3,2,5,5,0,3,61,17,78
p_109,10,0,e_1,590,622,664,12,4,2,0,3,1,0,32,42,74
p_112,11,0,e_1,613,627,664,4,3,1,7,5,0,2,14,37,51
p_111,2,0,e_1,607,656,664,14,4,1,5,5,0,1,49,8,57
p_97,5,0,e_3,552,586,665,2,2,0,3,5,1,1,34,79,113
p_105,12,0,e_3,582,609,665,12,2,1,4,5,0,2,27,56,83
p_103,14,0,e_3,577,617,665,12,1,0,2,5,0,1,40,48,88
p_104,14,0,e_3,581,617,665,11,2,0,3,5,0,2,36,48,84
p_116,7,0,e_3,633,640,665,2,2,0,9,4,1,1,7,25,32
p_107,3,0,e_3,584,654,665,20,3,2,5,5,0,3,70,11,81
p_108,7,0,e_0,584,608,665,16,4,2,0,3,1,0,24,57,81
p_110,12,0,e_0,590,625,665,10,4,1,1,5,0,1,35,40,75
p_113,9,0,e_0,629,636,665,2,2,0,11,4,1,0,7,29,36
p_115,9,0,e_0,632,636,665,1,2,0,10,4,1,1,4,29,33
p_117,0,2,e_0,636,665,673,8,3,0,9,4,1,0,29,8,37
p_123,0,2,e_0,661,665,673,1,2,0,1,4,1,1,4,8,12
p_124,7,0,e_0,664,690,721,23,2,2,0,3,1,1,26,31,57
p_118,8,0,e_0,649,695,721,26,2,2,5,4,1,0,46,26,72
p_125,2,0,e_1,668,672,722,23,1,1,1,5,0,2,4,50,54
p_121,3,0,e_1,656,677,722,30,2,2,2,4,1,1,21,45,66
p_119,8,0,e_1,650,694,722,26,2,2,4,4,1,1,44,28,72
p_126,1,0,e_1,681,717,722,20,1,1,4,5,1,1,36,5,41
p_122,7,0,e_2,657,684,751,25,2,2,1,4,1,1,27,67,94
p_114,13,0,e_2,632,704,751,26,2,2,9,4,1,1,72,47,119
p_130,11,0,e_2,705,712,751,2,2,0,13,4,1,0,7,39,46
p_131,7,0,e_2,722,726,751,1,3,0,8,4,1,0,4,25,29
p_132,4,0,e_2,730,737,751,2,2,1,6,4,1,0,7,14,21
p_120,13,0,e_3,653,706,751,20,1,1,3,1,1,0,53,45,98
p_127,7,0,e_3,701,726,751,7,1,1,12,5,0,1,25,25,50
p_129,5,0,e_3,705,734,751,8,2,0,13,5,0,2,29,17,46
p_128,0,15,e_0,705,721,772,13,2,2,5,4,1,0,16,51,67
p_140,5,0,e_3,768,785,802,5,0,0,0,3,0,0,17,17,34
p_143,5,0,e_3,780,785,802,2,1,0,3,5,0,1,5,17,22
p_139,0,15,e_2,758,758,807,0,0,0,0,3,0,0,0,49,49
p_133,6,0,e_1,734,754,820,29,1,1,0,3,0,0,20,66,86
p_135,11,0,e_1,739,771,820,23,1,1,1,5,0,1,32,49,81
p_137,13,0,e_1,755,779,820,13,0,0,6,5,1,1,24,41,65
p_138,12,0,e_0,756,759,823,12,0,0,11,5,1,1,3,64,67
p_134,14,0,e_0,734,767,823,21,1,1,4,5,1,0,33,56,89
p_136,14,0,e_0,749,767,823,16,1,1,9,5,1,1,18,56,74
p_142,13,0,e_0,773,780,823,12,1,0,15,4,1,1,7,43,50
p_141,12,0,e_0,770,785,823,12,1,0,15,5,2,0,15,38,53
p_145,1,0,e_1,820,825,830,10,1,1,0,3,1,0,5,5,10
p_144,6,0,e_3,815,836,856,6,0,0,0,3,0,0,21,20,41
p_150,3,0,e_3,860,872,885,3,0,0,0,3,0,0,12,13,25
p_152,2,0,e_3,868,877,885,2,1,1,2,5,0,1,9,8,17
p_146,10,0,e_2,846,864,900,23,1,1,15,3,0,0,18,36,54
p_153,6,0,e_2,872,878,900,27,2,2,8,4,1,0,6,22,28
p_154,4,0,e_2,874,886,900,29,2,2,7,4,1,1,12,14,26
p_147,6,0,e_0,849,869,933,26,1,1,0,3,0,0,20,64,84
p_149,6,0,e_0,859,869,933,6,0,0,3,5,0,1,10,64,74
p_155,11,0,e_0,884,886,933,11,0,0,11,5,1,1,2,47,49
p_151,12,0,e_0,863,891,933,12,1,0,4,5,0,1,28,42,70
p_156,12,0,e_0,884,891,933,12,0,0,11,5,1,1,7,42,49
p_159,8,0,e_0,893,905,933,8,1,0,12,4,1,1,12,28,40
p_158,7,0,e_0,892,910,933,7,1,0,12,4,1,0,18,23,41
p_157,7,0,e_3,889,913,936,7,0,0,0,3,0,0,24,23,47
p_148,15,0,e_1,849,896,943,17,1,1,0,3,0,0,47,47,94
p_3,4,0,e_2,25,39,53,4,0,0,0,3,0,0,14,14,28
p_5,9,0,e_1,41,48,91,8,1,0,7,5,0,1,7,43,50
p_2,11,0,e_1,19,56,91,11,0,0,0,3,0,0,37,35,72
p_4,5,0,e_3,34,52,95,5,0,0,0,3,0,0,18,43,61
p_6,9,0,e_3,45,66,95,6,1,0,3,5,0,1,21,29,50
p_1,13,0,e_0,13,54,95,13,0,0,0,3,0,0,41,41,82
p_12,0,8,e_3,86,95,123,3,1,0,3,4,1,0,9,28,37
p_11,4,0,e_0,84,109,131,30,1,1,4,4,1,0,25,22,47
p_15,5,0,e_0,99,114,131,10,1,1,1,5,0,1,15,17,32
p_16,4,0,e_3,101,109,149,10,1,1,2,5,1,0,8,40,48
p_13,8,0,e_3,87,123,149,24,1,1,2,4,1,0,36,26,62
p_19,0,7,e_0,125,131,156,8,1,0,2,4,1,0,6,25,31
p_7,2,0,e_2,55,64,158,10,2,1,0,3,0,0,9,94,103
p_9,10,0,e_2,67,90,158,29,1,1,2,5,1,1,23,68,91
p_14,13,0,e_2,87,101,158,19,2,2,9,5,1,2,14,57,71
p_8,15,0,e_2,62,109,158,7,2,0,2,5,0,1,47,49,96
p_20,3,0,e_2,142,147,158,29,1,1,5,4,1,0,5,11,16
p_22,6,0,e_0,146,151,179,25,1,1,5,5,1,0,5,28,33
p_21,0,10,e_3,142,149,181,2,1,0,2,4,1,0,7,32,39
p_10,9,0,e_1,77,120,189,27,1,1,5,4,1,0,43,69,112
p_17,10,0,e_1,112,125,189,5,2,0,7,5,0,1,13,64,77
p_18,15,0,e_1,120,142,189,8,2,0,9,2,0,1,22,47,69
p_27,5,0,e_0,180,198,233,15,2,1,0,3,0,0,18,35,53
p_28,7,0,e_0,184,206,233,12,2,1,1,5,0,1,22,27,49
p_30,2,0,e_0,200,223,233,13,2,1,5,5,1,1,23,10,33
p_33,1,0,e_0,213,228,233,10,2,1,5,4,1,1,15,5,20
p_36,1,0,e_0,225,228,233,5,2,0,2,4,1,1,3,5,8
p_23,15,0,e_3,150,198,247,15,1,0,0,5,1,0,48,49,97
p_26,6,0,e_3,169,227,247,18,2,2,6,5,1,1,58,20,78
p_25,9,0,e_2,163,187,250,17,2,2,1,5,0,1,24,63,87
p_24,14,0,e_2,157,204,250,14,2,1,0,3,1,0,47,46,93
p_31,5,0,e_2,203,233,250,9,2,1,14,5,1,1,30,17,47
p_35,0,6,e_0,222,233,253,8,2,0,2,1,1,1,11,20,31
p_32,0,10,e_0,209,233,267,12,2,0,7,4,1,1,24,34,58
p_34,11,0,e_1,217,227,296,28,2,2,8,5,0,1,10,69,79
p_29,14,0,e_1,192,238,296,3,2,1,0,3,0,0,46,58,104
p_37,15,0,e_1,228,243,296,21,1,1,11,5,1,1,15,53,68
p_38,12,0,e_1,240,254,296,20,1,1,14,5,1,1,14,42,56
p_41,7,0,e_1,257,271,296,16,1,1,11,4,1,0,14,25,39
p_44,4,0,e_1,275,282,296,13,1,1,6,4,1,0,7,14,21
p_42,4,0,e_0,269,289,303,16,1,1,10,3,0,0,20,14,34
p_43,4,0,e_0,270,289,303,15,1,1,10,4,0,1,19,14,33
p_51,0,4,e_0,309,309,325,7,2,0,0,3,0,0,0,16,16
p_39,13,0,e_3,247,289,336,13,0,0,0,3,0,0,42,47,89
p_45,11,0,e_3,290,297,336,2,1,0,13,4,1,0,7,39,46
p_47,3,0,e_3,293,323,336,9,2,1,12,4,1,1,30,13,43
p_57,1,0,e_3,327,331,336,1,1,0,2,4,1,0,4,5,9
p_58,0,6,e_3,330,336,356,1,1,0,1,1,1,0,6,20,26
p_40,15,0,e_2,255,303,358,13,1,0,0,3,0,0,48,55,103
p_48,9,0,e_2,294,323,358,3,3,1,12,5,0,2,29,35,64
p_46,8,0,e_2,291,328,358,5,2,1,11,5,0,1,37,30,67
p_53,8,0,e_2,313,328,358,28,2,2,12,4,1,2,15,30,45
p_56,8,0,e_2,324,328,358,25,1,1,9,4,1,1,4,30,34
p_59,3,0,e_2,335,345,358,27,1,1,6,4,1,0,10,13,23
p_60,2,0,e_2,338,350,358,10,1,1,5,4,1,1,12,8,20
p_49,3,0,e_1,298,310,375,8,2,0,0,3,0,0,12,65,77
p_54,7,0,e_1,313,324,375,29,2,2,3,5,1,1,11,51,62
p_50,11,0,e_1,299,338,375,30,2,2,0,3,0,1,39,37,76
p_62,1,0,e_1,345,370,375,9,1,1,9,4,1,0,25,5,30
p_63,3,0,e_2,364,375,386,3,0,0,0,3,0,0,11,11,22
p_65,0,7,e_1,369,375,398,5,1,0,1,1,1,0,6,23,29
p_68,2,0,e_2,389,397,405,27,1,1,0,3,0,0,8,8,16
p_61,12,0,e_0,341,351,405,11,1,0,9,5,0,1,10,54,64
p_52,14,0,e_0,312,359,405,22,2,2,0,5,1,0,47,46,93
p_55,14,0,e_0,314,359,405,22,2,2,1,5,1,1,45,46,91
p_69,2,0,e_0,391,397,405,27,1,1,4,4,1,0,6,8,14
p_64,0,15,e_3,365,385,434,6,0,0,6,3,0,0,20,49,69
p_73,3,0,e_2,423,434,445,15,2,1,0,3,0,0,11,11,22
p_66,11,0,e_1,376,412,457,22,1,1,0,5,1,0,36,45,81
p_67,12,0,e_1,377,417,457,20,1,1,0,5,1,1,40,40,80
p_70,3,0,e_1,398,446,457,23,1,1,7,5,0,2,48,11,59
p_75,3,0,e_1,438,446,457,11,1,0,5,4,1,1,8,11,19
p_71,7,0,e_3,403,408,483,18,1,1,5,5,1,0,5,75,80
p_76,10,0,e_3,440,451,483,4,1,0,14,4,1,0,11,32,43
p_72,6,0,e_0,417,438,484,14,2,1,0,3,0,0,21,46,67
p_74,10,0,e_0,424,452,484,8,2,1,1,5,0,1,28,32,60
p_81,1,0,e_0,493,499,504,1,0,0,0,3,0,0,6,5,11
p_77,4,0,e_2,455,469,533,5,1,0,0,3,0,0,14,64,78
p_78,12,0,e_2,455,495,533,27,1,1,0,3,0,1,40,38,78
p_82,0,12,e_3,494,494,534,0,0,0,0,3,0,0,0,40,40
p_83,0,12,e_0,501,504,542,23,1,1,1,4,1,0,3,38,41
p_79,9,0,e_1,457,486,543,30,1,1,0,3,1,0,29,57,86
p_80,13,0,e_1,474,500,543,20,1,1,5,5,0,1,26,43,69
p_87,3,0,e_1,528,532,543,15,2,2,4,4,1,0,4,11,15
p_90,1,0,e_2,538,540,571,14,2,1,1,5,0,1,2,31,33
p_89,5,0,e_2,535,554,571,11,2,1,0,3,0,0,19,17,36
p_97,5,0,e_2,552,554,571,6,2,1,5,5,1,1,2,17,19
p_94,3,0,e_1,546,555,574,10,2,1,0,5,0,1,9,19,28
p_93,4,0,e_1,543,560,574,10,2,1,0,3,0,0,17,14,31
p_85,14,0,e_3,517,542,592,7,1,0,7,5,1,0,25,50,75
p_91,14,0,e_3,539,542,592,1,2,0,13,5,0,2,3,50,53
p_88,10,0,e_3,531,556,592,7,2,2,11,5,1,1,25,36,61
p_92,10,0,e_3,540,556,592,4,2,0,14,5,0,2,16,36,52
p_95,10,0,e_3,547,556,592,3,2,0,13,4,1,1,9,36,45
p_99,9,0,e_3,556,561,592,1,2,0,10,1,1,1,5,31,36
p_98,6,0,e_3,555,572,592,4,1,0,10,1,1,0,17,20,37
p_84,12,0,e_0,504,542,604,10,1,0,0,3,1,0,38,62,100
p_86,14,0,e_0,518,550,604,7,2,0,4,5,1,0,32,54,86
p_100,10,0,e_0,557,564,604,30,3,3,12,4,1,1,7,40,47
p_101,9,0,e_0,566,569,604,29,2,2,10,4,1,1,3,35,38
p_96,7,0,e_0,551,577,604,5,2,1,14,4,1,0,26,27,53
p_106,5,0,e_0,583,585,604,28,1,1,6,4,1,0,2,19,21
p_107,3,0,e_0,584,593,604,29,1,1,5,1,1,0,9,11,20
p_111,2,0,e_0,607,616,624,13,1,1,0,3,0,0,9,8,17
p_105,12,0,e_2,582,609,663,21,1,1,3,5,0,1,27,54,81
p_110,12,0,e_2,590,609,663,18,2,2,6,5,0,2,19,54,73
p_102,14,0,e_2,568,617,663,23,2,2,1,4,1,0,49,46,95
p_104,14,0,e_2,581,617,663,19,1,1,3,5,0,1,36,46,82
p_113,9,0,e_2,629,634,663,20,1,0,11,4,1,0,5,29,34
p_109,10,0,e_3,590,624,666,20,1,1,0,4,1,0,34,42,76
p_112,11,0,e_3,613,629,666,5,1,0,6,5,0,1,16,37,53
p_115,9,0,e_3,632,637,666,1,1,0,10,4,1,0,5,29,34
p_117,0,2,e_2,636,663,671,9,1,0,9,4,1,0,27,8,35
p_123,0,2,e_2,661,663,671,1,1,0,1,4,1,0,2,8,10
p_108,7,0,e_1,584,600,671,25,1,1,2,5,0,1,16,71,87
p_103,14,0,e_1,577,623,671,21,1,1,0,3,0,0,46,48,94
p_116,7,0,e_1,633,646,671,3,2,1,11,4,1,0,13,25,38
p_121,3,0,e_1,656,660,671,30,1,1,4,4,1,0,4,11,15
p_125,2,0,e_3,668,677,685,2,0,0,0,3,0,0,9,8,17
p_126,1,0,e_1,681,687,692,30,1,1,0,3,0,0,6,5,11
p_124,7,0,e_2,664,688,711,23,1,1,0,5,1,0,24,23,47
p_118,8,0,e_0,649,659,719,27,1,1,5,5,0,1,10,60,70
p_119,8,0,e_0,650,659,719,27,1,1,5,5,0,2,9,60,69
p_114,13,0,e_0,632,676,719,28,1,1,0,3,0,0,44,43,87
p_120,13,0,e_0,653,676,719,21,1,1,6,5,0,2,23,43,66
p_122,7,0,e_0,657,696,719,26,1,1,8,5,0,2,39,23,62
p_128,0,15,e_3,705,705,758,0,1,1,0,3,0,1,0,53,53
p_132,4,0,e_2,730,745,773,19,2,1,0,3,0,0,15,28,43
p_133,6,0,e_2,734,753,773,16,2,1,0,5,0,1,19,20,39
p_127,7,0,e_1,701,724,795,7,0,0,0,3,0,0,23,71,94
p_130,11,0,e_1,705,738,795,11,1,1,1,5,0,1,33,57,90
p_134,14,0,e_1,734,749,795,8,2,1,10,5,1,1,15,46,61
p_140,5,0,e_1,768,778,795,7,1,0,8,4,1,0,10,17,27
p_129,5,0,e_3,705,724,807,5,0,0,0,3,0,0,19,83,102
p_136,14,0,e_3,749,753,807,3,2,1,13,5,2,0,4,54,58
p_138,12,0,e_3,756,769,807,4,2,1,14,5,2,0,13,38,51
p_131,7,0,e_0,722,745,810,19,2,1,0,3,0,0,23,65,88
p_135,11,0,e_0,739,759,810,9,2,1,5,5,0,1,20,51,71
p_137,13,0,e_0,755,767,810,3,2,1,10,5,1,1,12,43,55
p_143,5,0,e_0,780,793,810,4,1,0,9,4,1,0,13,17,30
p_139,0,15,e_2,758,773,824,15,2,2,5,4,1,0,15,51,66
p_145,1,0,e_1,820,825,830,1,0,0,0,3,0,0,5,5,10
p_144,6,0,e_0,815,835,855,6,0,0,0,3,0,0,20,20,40
p_141,12,0,e_2,770,811,875,30,1,1,1,4,1,0,41,64,105
p_142,13,0,e_2,773,816,875,28,1,1,0,3,1,1,43,59,102
p_147,6,0,e_2,849,853,875,6,1,1,7,4,1,0,4,22,26
p_150,3,0,e_2,860,864,875,24,1,1,4,4,1,0,4,11,15
p_149,6,0,e_0,859,879,901,21,1,1,0,3,0,0,20,22,42
p_153,6,0,e_0,872,879,901,17,1,1,4,5,0,2,7,22,29
p_152,2,0,e_0,868,893,901,22,1,1,2,5,0,1,25,8,33
p_154,4,0,e_2,874,889,923,18,1,1,0,3,1,0,15,34,49
p_157,7,0,e_2,889,900,923,10,1,1,4,3,0,0,11,23,34
p_146,10,0,e_1,846,878,930,10,0,0,0,3,0,0,32,52,84
p_151,12,0,e_1,863,886,930,14,1,1,5,5,0,1,23,44,67
p_156,12,0,e_1,884,886,930,7,1,1,11,5,1,1,2,44,46
p_155,11,0,e_1,884,891,930,8,1,1,12,5,1,1,7,39,46
p_159,8,0,e_1,893,902,930,8,1,1,11,4,1,1,9,28,37
p_158,7,0,e_1,892,907,930,9,1,1,11,4,1,0,15,23,38
p_148,15,0,e_3,849,896,943,15,0,0,0,3,0,0,47,47,94
p_3,4,0,e_2,25,40,88,4,0,0,0,3,0,0,15,48,63
p_4,5,0,e_2,34,45,88,5,0,0,2,5,0,1,11,43,54
p_5,9,0,e_2,41,59,88,9,0,0,4,5,1,1,18,29,47
p_6,9,0,e_2,45,59,88,9,0,0,5,2,1,1,14,29,43
p_2,11,0,e_1,19,54,89,11,0,0,0,3,0,0,35,35,70
p_1,13,0,e_0,13,55,96,13,0,0,0,3,0,0,42,41,83
p_12,0,8,e_1,86,89,115,21,4,4,1,4,1,0,3,26,29
p_16,4,0,e_2,101,116,130,13,4,1,0,3,0,0,15,14,29
p_15,5,0,e_0,99,116,133,13,5,2,0,3,0,0,17,17,34
p_19,0,7,e_2,125,130,155,11,3,0,2,4,1,0,5,25,30
p_7,2,0,e_3,55,63,163,2,0,0,0,3,0,0,8,100,108
p_10,9,0,e_3,77,86,163,15,3,2,6,5,1,2,9,77,86
p_9,10,0,e_3,67,91,163,17,2,1,3,5,1,1,24,72,96
p_14,13,0,e_3,87,102,163,8,4,1,9,5,1,3,15,61,76
p_8,15,0,e_3,62,110,163,17,0,0,2,2,0,0,48,53,101
p_13,8,0,e_3,87,133,163,13,5,3,9,5,1,4,46,30,76
p_11,4,0,e_3,84,147,163,17,4,2,9,5,1,3,63,16,79
p_20,3,0,e_3,142,152,163,2,2,1,5,4,1,1,10,11,21
p_21,0,10,e_0,142,142,176,5,2,0,0,3,0,0,0,34,34
p_17,10,0,e_1,112,123,187,5,3,0,7,5,1,0,11,64,75
p_18,15,0,e_1,120,140,187,27,3,3,9,5,0,1,20,47,67
p_30,2,0,e_1,200,209,217,17,3,1,0,3,0,0,9,8,17
p_22,6,0,e_2,146,150,232,28,3,3,5,5,1,0,4,82,86
p_23,15,0,e_2,150,181,232,19,2,2,6,2,1,0,31,51,82
p_31,5,0,e_2,203,213,232,13,3,1,8,4,1,0,10,19,29
p_33,1,0,e_2,213,227,232,13,2,0,5,4,1,0,14,5,19
p_24,14,0,e_0,157,190,236,18,1,1,4,5,1,0,33,46,79
p_36,1,0,e_0,225,231,236,10,2,1,3,4,1,0,6,5,11
p_32,0,10,e_1,209,217,249,15,3,3,2,2,0,0,8,32,40
p_35,0,6,e_2,222,232,252,12,3,0,3,4,1,1,10,20,30
p_26,6,0,e_3,169,184,262,11,1,1,1,5,0,1,15,78,93
p_28,7,0,e_3,184,189,262,5,2,1,6,2,0,2,5,73,78
p_25,9,0,e_3,163,197,262,9,0,0,0,3,0,0,34,65,99
p_29,14,0,e_3,192,214,262,6,3,0,8,5,1,2,22,48,70
p_34,11,0,e_3,217,225,262,2,2,0,13,4,1,1,8,37,45
p_27,5,0,e_3,180,245,262,8,2,2,5,5,0,2,65,17,82
p_42,4,0,e_3,269,283,297,4,0,0,0,3,0,0,14,14,28
p_43,4,0,e_3,270,283,297,4,1,0,0,5,0,1,13,14,27
p_44,4,0,e_3,275,283,297,3,1,0,1,5,0,1,8,14,22
p_41,7,0,e_0,257,281,304,24,1,1,0,3,0,0,24,23,47
p_38,12,0,e_2,240,272,312,24,2,2,2,5,1,0,32,40,72
p_47,3,0,e_2,293,301,312,28,3,3,5,4,1,0,8,11,19
p_49,3,0,e_2,298,301,312,19,2,2,4,4,1,1,3,11,14
p_39,13,0,e_1,247,260,315,22,1,1,9,5,1,1,13,55,68
p_37,15,0,e_1,228,268,315,26,2,2,3,5,1,0,40,47,87
p_40,15,0,e_1,255,268,315,17,1,1,11,5,0,2,13,47,60
p_51,0,4,e_2,309,312,326,18,2,2,1,4,1,0,3,14,17
p_57,1,0,e_1,327,332,337,18,3,2,0,3,0,0,5,5,10
p_58,0,6,e_1,330,337,357,18,3,3,1,5,0,1,7,20,27
p_53,8,0,e_0,313,330,368,15,3,2,3,5,0,1,17,38,55
p_48,9,0,e_0,294,335,368,22,3,3,3,4,1,0,41,33,74
p_60,2,0,e_0,338,358,368,14,2,1,8,4,1,0,20,10,30
p_62,1,0,e_0,345,363,368,13,2,1,6,4,1,1,18,5,23
p_54,7,0,e_2,313,337,370,16,3,3,0,5,1,0,24,33,57
p_56,8,0,e_2,324,342,370,12,3,2,4,5,1,1,18,28,46
p_59,3,0,e_2,335,359,370,14,2,1,7,5,0,2,24,11,35
p_63,3,0,e_1,364,375,386,6,1,0,6,3,0,0,11,11,22
p_46,8,0,e_3,291,323,391,24,2,2,2,4,1,1,32,68,100
p_45,11,0,e_3,290,334,391,21,1,1,2,4,1,0,44,57,101
p_50,11,0,e_3,299,334,391,11,2,0,0,5,0,2,35,57,92
p_52,14,0,e_3,312,345,391,10,2,0,4,5,0,2,33,46,79
p_55,14,0,e_3,314,345,391,9,3,0,5,5,0,3,31,46,77
p_61,12,0,e_3,341,353,391,3,2,1,13,5,1,1,12,38,50
p_65,0,7,e_2,369,370,395,7,1,0,0,3,1,0,1,25,26
p_68,2,0,e_1,389,397,405,28,1,1,0,3,0,0,8,8,16
p_64,0,15,e_0,365,368,415,8,1,0,1,4,1,0,3,47,50
p_69,2,0,e_3,391,400,444,2,0,0,0,3,0,0,9,44,53
p_70,3,0,e_3,398,405,444,1,1,0,2,5,0,1,7,39,46
p_71,7,0,e_3,403,419,444,4,2,0,3,5,1,1,16,25,41
p_72,6,0,e_3,417,424,444,2,2,1,6,5,1,1,7,20,27
p_73,3,0,e_1,423,434,445,3,2,0,0,3,0,0,11,11,22
p_66,11,0,e_2,376,409,454,24,1,1,1,5,1,0,33,45,78
p_67,12,0,e_2,377,414,454,22,1,1,1,5,1,1,37,40,77
p_75,3,0,e_2,438,443,454,29,1,1,5,4,1,0,5,11,16
p_74,10,0,e_0,424,441,475,26,1,1,15,3,0,0,17,34,51
p_77,4,0,e_0,455,461,475,4,0,0,6,4,1,0,6,14,20
p_81,1,0,e_0,493,499,504,1,0,0,0,3,0,0,6,5,11
p_79,9,0,e_2,457,487,516,9,0,0,0,3,0,0,30,29,59
p_76,10,0,e_1,440,477,531,21,1,1,1,4,1,0,37,54,91
p_78,12,0,e_1,455,485,531,12,0,0,3,5,0,1,30,46,76
p_80,13,0,e_1,474,490,531,13,0,0,9,5,0,2,16,41,57
p_82,0,12,e_3,494,494,534,0,0,0,0,3,0,0,0,40,40
p_83,0,12,e_0,501,504,544,23,1,1,1,4,1,0,3,40,43
p_90,1,0,e_1,538,543,548,14,2,1,0,3,0,0,5,5,10
p_87,3,0,e_2,528,540,569,15,2,2,0,3,0,0,12,29,41
p_93,4,0,e_2,543,545,569,10,1,0,4,5,1,1,2,24,26
p_89,5,0,e_2,535,550,569,11,2,1,1,5,0,1,15,19,34
p_94,3,0,e_2,546,558,569,10,1,0,4,5,1,1,12,11,23
p_88,10,0,e_0,531,536,586,7,2,2,9,5,1,0,5,50,55
p_92,10,0,e_0,540,552,586,4,2,0,11,5,2,0,12,34,46
p_95,10,0,e_0,547,552,586,3,1,0,11,4,1,1,5,34,39
p_96,7,0,e_0,551,563,586,4,1,0,10,1,1,0,12,23,35
p_84,12,0,e_3,504,534,590,10,1,0,2,5,1,0,30,56,86
p_85,14,0,e_3,517,542,590,7,1,0,7,5,1,0,25,48,73
p_86,14,0,e_3,518,542,590,7,2,0,7,5,1,1,24,48,72
p_91,14,0,e_3,539,542,590,1,2,0,13,5,1,1,3,48,51
p_99,9,0,e_3,556,559,590,1,2,0,10,4,1,1,3,31,34
p_98,6,0,e_3,555,570,590,4,1,0,10,4,1,0,15,20,35
p_111,2,0,e_0,607,615,623,2,0,0,0,3,0,0,8,8,16
p_97,5,0,e_1,552,570,651,6,1,0,0,3,0,0,18,81,99
p_101,9,0,e_1,566,584,651,28,2,2,4,5,0,2,18,67,85
p_100,10,0,e_1,557,589,651,30,3,3,1,5,0,1,32,62,94
p_105,12,0,e_1,582,597,651,21,1,1,9,5,1,3,15,54,69
p_110,12,0,e_1,590,597,651,12,0,0,10,5,1,2,7,54,61
p_102,14,0,e_1,568,605,651,23,2,2,5,5,0,3,37,46,83
p_103,14,0,e_1,577,605,651,20,1,1,7,5,1,3,28,46,74
p_104,14,0,e_1,581,605,651,19,1,1,8,5,1,3,24,46,70
p_112,11,0,e_1,613,616,651,11,0,0,12,4,1,0,3,35,38
p_107,3,0,e_2,584,595,654,29,1,1,0,3,0,1,11,59,70
p_106,5,0,e_2,583,603,654,27,1,1,0,3,0,0,20,51,71
p_108,7,0,e_2,584,611,654,25,1,1,0,5,0,2,27,43,70
p_109,10,0,e_2,590,622,654,10,0,0,2,5,0,3,32,32,64
p_117,0,2,e_1,636,651,659,25,1,1,5,4,1,0,15,8,23
p_121,3,0,e_1,656,664,675,15,1,1,1,5,1,0,8,11,19
p_123,0,2,e_1,661,675,683,17,1,1,2,5,0,1,14,8,22
p_126,1,0,e_1,681,688,693,10,1,0,1,5,1,0,7,5,12
p_122,7,0,e_2,657,681,706,11,1,1,0,3,0,0,24,25,49
p_124,7,0,e_2,664,681,706,9,1,1,1,5,0,1,17,25,42
p_125,2,0,e_2,668,698,706,13,1,1,3,5,0,1,30,8,38
p_114,13,0,e_3,632,673,714,13,0,0,0,3,0,0,41,41,82
p_116,7,0,e_0,633,653,718,19,1,1,0,5,0,1,20,65,85
p_118,8,0,e_0,649,658,718,13,1,1,6,5,0,2,9,60,69
p_119,8,0,e_0,650,658,718,12,1,1,6,5,0,3,8,60,68
p_113,9,0,e_0,629,663,718,9,0,0,0,3,0,0,34,55,89
p_115,9,0,e_0,632,663,718,17,1,1,0,5,0,1,31,55,86
p_120,13,0,e_0,653,677,718,7,1,0,7,2,0,2,24,41,65
p_128,0,15,e_2,705,706,757,3,1,0,0,3,1,0,1,51,52
p_132,4,0,e_3,730,745,759,4,0,0,0,3,0,0,15,14,29
p_127,7,0,e_1,701,725,798,27,1,1,0,3,0,0,24,73,97
p_130,11,0,e_1,705,739,798,22,1,1,0,5,0,1,34,59,93
p_134,14,0,e_1,734,750,798,14,1,0,9,5,1,1,16,48,64
p_136,14,0,e_1,749,750,798,19,1,1,14,5,1,1,1,48,49
p_138,12,0,e_1,756,758,798,19,1,1,13,4,1,0,2,40,42
p_140,5,0,e_1,768,781,798,23,1,1,9,4,1,0,13,17,30
p_133,6,0,e_0,734,743,799,6,1,0,3,5,0,1,9,56,65
p_131,7,0,e_0,722,748,799,7,0,0,0,3,0,0,26,51,77
p_135,11,0,e_0,739,762,799,9,1,0,5,5,0,2,23,37,60
p_143,5,0,e_0,780,782,799,19,3,3,6,4,1,0,2,17,19
p_129,5,0,e_2,705,725,806,28,1,1,0,3,1,0,20,81,101
p_137,13,0,e_2,755,765,806,18,1,1,14,5,2,0,10,41,51
p_139,0,15,e_3,758,759,812,0,0,0,0,3,1,0,1,53,54
p_145,1,0,e_1,820,825,830,12,1,0,0,3,0,0,5,5,10
p_144,6,0,e_0,815,835,855,8,1,0,0,3,0,0,20,20,40
p_141,12,0,e_3,770,799,859,15,1,1,3,5,1,0,29,60,89
p_142,13,0,e_3,773,804,859,13,2,1,4,5,1,1,31,55,86
p_150,3,0,e_0,860,871,882,3,0,0,0,3,0,0,11,11,22
p_152,2,0,e_3,868,876,928,2,0,0,0,3,0,0,8,52,60
p_154,4,0,e_3,874,884,928,7,2,1,1,5,0,2,10,44,54
p_153,6,0,e_3,872,892,928,5,1,0,1,5,0,1,20,36,56
p_157,7,0,e_3,889,897,928,2,2,0,5,5,1,1,8,31,39
p_158,7,0,e_3,892,897,928,1,2,0,6,5,1,1,5,31,36
p_159,8,0,e_3,893,902,928,2,2,0,6,5,1,1,9,26,35
p_147,6,0,e_2,849,869,929,27,1,1,0,3,0,0,20,60,80
p_149,6,0,e_2,859,869,929,6,0,0,3,5,0,1,10,60,70
p_155,11,0,e_2,884,886,929,7,2,2,10,5,1,1,2,43,45
p_151,12,0,e_2,863,891,929,12,0,0,4,5,0,1,28,38,66
p_156,12,0,e_2,884,891,929,8,2,2,10,5,1,1,7,38,45
p_146,10,0,e_1,846,879,943,24,1,1,0,3,0,0,33,64,97
p_148,15,0,e_1,849,896,943,18,1,1,0,5,0,1,47,47,94
p_3,4,0,e_2,25,40,88,4,0,0,0,3,0,0,15,48,63
p_4,5,0,e_2,34,45,88,5,0,0,2,5,0,1,11,43,54
p_5,9,0,e_2,41,59,88,9,0,0,4,5,1,1,18,29,47
p_6,9,0,e_2,45,59,88,9,0,0,5,2,1,1,14,29,43
p_2,11,0,e_1,19,54,89,11,0,0,0,3,0,0,35,35,70
p_1,13,0,e_0,13,54,95,13,0,0,0,3,0,0,41,41,82
p_12,0,8,e_2,86,88,114,21,4,4,0,4,1,0,2,26,28
p_16,4,0,e_1,101,115,129,14,5,2,0,3,0,0,14,14,28
p_15,5,0,e_0,99,116,133,13,5,2,0,3,0,0,17,17,34
p_19,0,7,e_1,125,129,154,11,3,0,1,4,1,0,4,25,29
p_7,2,0,e_3,55,64,162,2,0,0,0,3,0,0,9,98,107
p_10,9,0,e_3,77,87,162,15,3,2,6,5,1,2,10,75,85
p_9,10,0,e_3,67,92,162,17,2,1,3,5,1,1,25,70,95
p_14,13,0,e_3,87,103,162,8,5,1,9,5,1,4,16,59,75
p_8,15,0,e_3,62,111,162,14,1,0,1,5,0,1,49,51,100
p_13,8,0,e_3,87,134,162,13,4,2,9,2,1,3,47,28,75
p_11,4,0,e_3,84,148,162,18,4,3,8,5,1,3,64,14,78
p_21,0,10,e_0,142,143,181,6,2,0,0,3,0,1,1,38,39
p_17,10,0,e_2,112,122,186,5,3,0,8,5,1,0,10,64,74
p_18,15,0,e_2,120,139,186,28,3,3,9,5,0,1,19,47,66
p_27,5,0,e_3,180,187,214,4,1,1,3,5,0,1,7,27,34
p_26,6,0,e_3,169,192,214,6,0,0,0,3,0,0,23,22,45
p_30,2,0,e_3,200,206,214,2,1,0,4,4,1,0,6,8,14
p_20,3,0,e_0,142,156,215,3,2,1,0,3,0,0,14,59,73
p_25,9,0,e_0,163,176,215,9,0,0,5,5,2,0,13,39,52
p_28,7,0,e_0,184,192,215,3,2,0,10,4,1,0,8,23,31
p_22,6,0,e_1,146,149,233,28,2,2,5,5,1,0,3,84,87
p_24,14,0,e_1,157,177,233,17,1,1,7,5,1,1,20,56,76
p_23,15,0,e_1,150,182,233,19,1,1,6,5,2,0,32,51,83
p_31,5,0,e_1,203,214,233,28,2,2,9,4,1,0,11,19,30
p_33,1,0,e_1,213,228,233,29,1,1,5,4,1,1,15,5,20
p_36,1,0,e_1,225,228,233,11,1,1,2,4,1,1,3,5,8
p_35,0,6,e_3,222,223,245,0,0,0,0,3,0,0,1,22,23
p_32,0,10,e_0,209,215,247,2,1,0,2,4,1,0,6,32,38
p_34,11,0,e_2,217,227,294,11,0,0,8,5,0,1,10,67,77
p_29,14,0,e_2,192,238,294,22,1,1,0,3,0,0,46,56,102
p_37,15,0,e_2,228,243,294,15,1,0,11,5,1,1,15,51,66
p_39,13,0,e_2,247,251,294,7,0,0,14,4,1,0,4,43,47
p_43,4,0,e_2,270,280,294,16,1,1,7,4,1,0,10,14,24
p_44,4,0,e_2,275,280,294,14,1,1,6,4,1,1,5,14,19
p_38,12,0,e_0,240,255,295,7,1,0,8,5,1,0,15,40,55
p_41,7,0,e_0,257,272,295,17,1,1,12,4,1,0,15,23,38
p_42,4,0,e_1,269,283,297,16,1,1,0,3,0,0,14,14,28
p_51,0,4,e_0,309,310,326,9,2,0,0,3,0,0,1,16,17
p_40,15,0,e_3,255,285,342,9,0,0,6,3,0,0,30,57,87
p_45,11,0,e_3,290,299,342,3,1,0,14,4,1,0,9,43,52
p_48,9,0,e_3,294,307,342,4,3,1,13,4,1,2,13,35,48
p_46,8,0,e_3,291,312,342,5,2,1,13,4,1,1,21,30,51
p_54,7,0,e_3,313,317,342,1,1,0,8,4,1,0,4,25,29
p_57,1,0,e_3,327,337,342,3,1,0,4,4,1,0,10,5,15
p_58,0,6,e_3,330,342,362,3,2,0,3,4,1,1,12,20,32
p_53,8,0,e_1,313,340,368,30,2,2,0,3,0,0,27,28,55
p_60,2,0,e_1,338,360,368,29,1,1,7,5,0,1,22,8,30
p_56,8,0,e_0,324,340,370,27,1,1,4,5,1,0,16,30,46
p_59,3,0,e_0,335,357,370,28,2,2,7,5,0,1,22,13,35
p_62,1,0,e_0,345,365,370,10,1,1,7,4,1,1,20,5,25
p_63,3,0,e_3,364,375,386,3,0,0,6,3,0,0,11,11,22
p_47,3,0,e_2,293,305,388,10,3,2,0,3,1,0,12,83,95
p_49,3,0,e_2,298,305,388,8,4,2,1,5,0,1,7,83,90
p_50,11,0,e_2,299,331,388,30,3,3,1,5,0,1,32,57,89
p_52,14,0,e_2,312,342,388,24,1,1,5,5,1,1,30,46,76
p_55,14,0,e_2,314,342,388,24,2,2,6,5,1,2,28,46,74
p_61,12,0,e_2,341,350,388,18,1,1,14,5,1,1,9,38,47
p_65,0,7,e_0,369,370,395,5,1,0,0,3,1,0,1,25,26
p_68,2,0,e_2,389,398,406,2,0,0,0,3,0,0,9,8,17
p_64,0,15,e_0,365,370,421,6,1,0,1,4,1,0,5,51,56
p_69,2,0,e_3,391,400,444,2,0,0,0,3,0,0,9,44,53
p_70,3,0,e_3,398,405,444,1,1,0,2,5,0,1,7,39,46
p_71,7,0,e_3,403,419,444,4,2,0,3,5,1,1,16,25,41
p_72,6,0,e_3,417,424,444,2,2,1,6,5,1,1,7,20,27
p_73,3,0,e_2,423,435,446,3,2,0,0,3,0,0,12,11,23
p_66,11,0,e_1,376,411,456,22,1,1,0,3,0,0,35,45,80
p_67,12,0,e_1,377,416,456,21,1,1,0,5,0,1,39,40,79
p_75,3,0,e_1,438,445,456,29,1,1,5,4,1,0,7,11,18
p_74,10,0,e_0,424,441,475,26,1,1,15,3,0,0,17,34,51
p_76,10,0,e_0,440,441,475,21,1,1,10,4,0,1,1,34,35
p_77,4,0,e_0,455,461,475,4,0,0,6,4,1,0,6,14,20
p_81,1,0,e_0,493,499,504,1,0,0,0,3,0,0,6,5,11
p_79,9,0,e_1,457,486,515,9,0,0,0,3,0,0,29,29,58
p_82,0,12,e_3,494,494,534,0,0,0,0,3,0,0,0,40,40
p_78,12,0,e_2,455,493,541,12,0,0,0,3,0,0,38,48,86
p_80,13,0,e_2,474,498,541,13,0,0,6,5,0,1,24,43,67
p_87,3,0,e_2,528,530,541,15,2,2,4,4,1,0,2,11,13
p_83,0,12,e_0,501,504,544,23,1,1,1,4,1,0,3,40,43
p_90,1,0,e_1,538,540,573,14,2,1,0,5,0,1,2,33,35
p_94,3,0,e_1,546,548,573,10,1,0,3,5,1,1,2,25,27
p_89,5,0,e_1,535,556,573,11,2,1,0,3,0,0,21,17,38
p_97,5,0,e_1,552,556,573,6,1,0,4,5,1,1,4,17,21
p_88,10,0,e_0,531,536,586,7,2,2,8,5,1,0,5,50,55
p_92,10,0,e_0,540,552,586,4,2,0,11,5,2,0,12,34,46
p_95,10,0,e_0,547,552,586,3,1,0,12,4,1,1,5,34,39
p_96,7,0,e_0,551,563,586,4,1,0,10,1,1,0,12,23,35
p_84,12,0,e_3,504,534,588,10,1,0,2,5,1,0,30,54,84
p_85,14,0,e_3,517,542,588,7,1,0,7,5,1,0,25,46,71
p_86,14,0,e_3,518,542,588,7,2,0,7,5,1,1,24,46,70
p_91,14,0,e_3,539,542,588,1,2,0,13,5,1,1,3,46,49
p_99,9,0,e_3,556,559,588,1,1,0,10,4,1,0,3,29,32
p_107,3,0,e_1,584,594,633,28,1,1,0,5,0,1,10,39,49
p_106,5,0,e_1,583,602,633,27,1,1,0,3,0,0,19,31,50
p_108,7,0,e_1,584,610,633,24,1,1,0,5,0,2,26,23,49
p_117,0,2,e_3,636,636,646,0,0,0,0,3,0,0,0,10,10
p_93,4,0,e_2,543,558,646,10,1,0,0,3,0,0,15,88,103
p_98,6,0,e_2,555,566,646,4,1,0,3,5,0,1,11,80,91
p_101,9,0,e_2,566,577,646,28,1,1,6,2,1,1,11,69,80
p_100,10,0,e_2,557,582,646,29,2,2,4,3,0,1,25,64,89
p_105,12,0,e_2,582,590,646,20,1,1,10,2,1,1,8,56,64
p_110,12,0,e_2,590,590,646,12,0,0,12,2,1,2,0,56,56
p_102,14,0,e_2,568,600,646,23,1,1,6,5,1,2,32,46,78
p_103,14,0,e_2,577,600,646,20,1,1,9,5,1,2,23,46,69
p_104,14,0,e_2,581,600,646,18,1,1,10,5,1,2,19,46,65
p_109,10,0,e_2,590,614,646,10,0,0,12,2,1,1,24,32,56
p_123,0,2,e_2,661,662,672,11,1,1,0,3,0,0,1,10,11
p_125,2,0,e_2,668,672,680,7,2,1,1,5,1,0,4,8,12
p_126,1,0,e_2,681,687,692,5,1,0,0,3,0,0,6,5,11
p_111,2,0,e_0,607,615,697,2,0,0,0,3,0,0,8,82,90
p_113,9,0,e_0,629,638,697,9,0,0,6,5,1,1,9,59,68
p_115,9,0,e_0,632,638,697,9,0,0,7,5,1,2,6,59,65
p_112,11,0,e_0,613,646,697,11,0,0,2,5,0,1,33,51,84
p_114,13,0,e_0,632,654,697,13,0,0,7,5,1,2,22,43,65
p_124,7,0,e_0,664,674,697,4,2,0,10,4,1,0,10,23,33
p_121,3,0,e_3,656,661,698,1,0,0,2,3,0,0,5,37,42
p_122,7,0,e_3,657,675,698,5,1,0,2,5,0,1,18,23,41
p_116,7,0,e_1,633,657,720,7,0,0,0,3,0,0,24,63,87
p_118,8,0,e_1,649,662,720,6,0,0,5,5,0,1,13,58,71
p_119,8,0,e_1,650,662,720,6,0,0,5,5,0,2,12,58,70
p_120,13,0,e_1,653,679,720,11,0,0,6,5,0,2,26,41,67
p_129,5,0,e_3,705,723,740,5,0,0,0,3,0,0,18,17,35
p_128,0,15,e_2,705,705,754,0,0,0,0,3,0,0,0,49,49
p_132,4,0,e_1,730,737,773,29,1,1,2,5,0,1,7,36,43
p_133,6,0,e_1,734,745,773,26,1,1,3,5,0,2,11,28,39
p_131,7,0,e_1,722,750,773,12,0,0,0,3,0,0,28,23,51
p_127,7,0,e_0,701,725,802,7,0,0,0,3,0,0,24,77,101
p_130,11,0,e_0,705,739,802,11,0,0,1,5,0,1,34,63,97
p_135,11,0,e_0,739,741,802,11,0,0,11,5,1,1,2,61,63
p_134,14,0,e_0,734,752,802,18,1,1,9,5,1,1,18,50,68
p_136,14,0,e_0,749,752,802,14,0,0,13,5,1,1,3,50,53
p_137,13,0,e_0,755,757,802,13,0,0,14,4,1,0,2,45,47
p_138,12,0,e_0,756,762,802,12,0,0,13,1,1,0,6,40,46
p_140,5,0,e_0,768,785,802,23,1,1,10,4,1,0,17,17,34
p_143,5,0,e_0,780,785,802,19,1,1,6,4,1,1,5,17,22
p_139,0,15,e_3,758,759,808,0,0,0,0,3,0,0,1,49,50
p_142,13,0,e_2,773,779,822,14,1,1,15,4,0,1,6,43,49
p_141,12,0,e_2,770,784,822,16,1,1,15,3,0,0,14,38,52
p_145,1,0,e_1,820,826,831,14,0,0,0,3,0,0,6,5,11
p_144,6,0,e_0,815,835,855,9,0,0,0,3,0,0,20,20,40
p_150,3,0,e_0,860,871,884,8,1,1,0,3,0,0,11,13,24
p_152,2,0,e_0,868,876,884,7,1,0,2,5,0,1,8,8,16
p_146,10,0,e_3,846,864,900,5,0,0,15,3,0,0,18,36,54
p_153,6,0,e_3,872,878,900,2,1,0,8,4,1,0,6,22,28
p_154,4,0,e_3,874,886,900,3,2,1,7,4,1,1,12,14,26
p_147,6,0,e_1,849,869,933,9,1,1,0,3,0,0,20,64,84
p_149,6,0,e_1,859,869,933,5,1,1,3,5,0,1,10,64,74
p_155,11,0,e_1,884,886,933,24,2,2,10,5,1,1,2,47,49
p_151,12,0,e_1,863,891,933,18,1,1,4,5,0,1,28,42,70
p_156,12,0,e_1,884,891,933,23,2,2,10,5,1,2,7,42,49
p_159,8,0,e_1,893,905,933,24,1,1,12,4,1,1,12,28,40
p_158,7,0,e_1,892,910,933,26,1,1,12,4,1,0,18,23,41
p_157,7,0,e_0,889,912,935,27,1,1,0,3,0,0,23,23,46
p_148,15,0,e_2,849,897,944,20,1,1,0,3,0,0,48,47,95
p_3,4,0,e_2,25,39,87,4,0,0,0,3,0,0,14,48,62
p_4,5,0,e_2,34,44,87,5,0,0,3,5,0,1,10,43,53
p_5,9,0,e_2,41,58,87,9,0,0,4,5,1,1,17,29,46
p_6,9,0,e_2,45,58,87,9,0,0,5,5,1,1,13,29,42
p_2,11,0,e_1,19,55,90,11,0,0,0,3,0,0,36,35,71
p_1,13,0,e_0,13,55,96,13,0,0,0,3,0,0,42,41,83
p_12,0,8,e_2,86,87,115,21,4,4,0,3,1,0,1,28,29
p_16,4,0,e_1,101,116,130,13,4,1,0,3,0,0,15,14,29
p_15,5,0,e_0,99,117,134,13,4,2,0,3,0,0,18,17,35
p_19,0,7,e_1,125,130,155,11,2,0,2,4,1,0,5,25,30
p_7,2,0,e_3,55,63,159,2,0,0,0,3,0,0,8,96,104
p_10,9,0,e_3,77,86,159,15,3,2,6,5,1,2,9,73,82
p_9,10,0,e_3,67,91,159,17,2,1,3,5,1,1,24,68,92
p_14,13,0,e_3,87,102,159,8,4,1,9,5,1,3,15,57,72
p_8,15,0,e_3,62,110,159,17,0,0,2,2,0,0,48,49,97
p_11,4,0,e_3,84,145,159,18,4,3,8,5,1,3,61,14,75
p_21,0,10,e_0,142,143,179,5,2,0,0,3,0,0,1,36,37
p_13,8,0,e_2,87,115,187,13,4,2,0,3,1,0,28,72,100
p_17,10,0,e_2,112,123,187,5,2,0,7,5,1,0,11,64,75
p_18,15,0,e_2,120,140,187,27,2,2,9,5,1,1,20,47,67
p_20,3,0,e_0,142,156,221,2,2,1,0,3,0,1,14,65,79
p_28,7,0,e_0,184,190,221,5,1,1,9,4,1,2,6,31,37
p_26,6,0,e_0,169,195,221,11,1,1,7,5,2,0,26,26,52
p_27,5,0,e_0,180,200,221,8,1,1,10,4,1,1,20,21,41
p_30,2,0,e_0,200,211,221,5,1,0,5,4,1,0,11,10,21
p_33,1,0,e_0,213,216,221,3,1,0,2,4,1,0,3,5,8
p_25,9,0,e_3,163,193,224,9,0,0,0,3,0,0,30,31,61
p_31,5,0,e_3,203,207,224,1,1,0,6,4,1,0,4,17,21
p_22,6,0,e_1,146,150,232,28,1,1,5,5,1,0,4,82,86
p_24,14,0,e_1,157,178,232,17,1,1,7,5,1,1,21,54,75
p_23,15,0,e_1,150,183,232,18,1,1,6,2,1,0,33,49,82
p_36,1,0,e_1,225,227,232,11,1,1,2,4,1,0,2,5,7
p_35,0,6,e_3,222,224,244,0,1,0,0,4,1,0,2,20,22
p_32,0,10,e_0,209,221,253,5,1,0,2,4,1,1,12,32,44
p_41,7,0,e_3,257,262,287,1,0,0,6,3,0,0,5,25,30
p_42,4,0,e_3,269,273,287,1,1,0,5,4,1,0,4,14,18
p_43,4,0,e_3,270,273,287,1,2,0,5,4,1,1,3,14,17
p_34,11,0,e_2,217,228,295,21,1,1,7,5,0,1,11,67,78
p_29,14,0,e_2,192,239,295,23,0,0,0,3,0,0,47,56,103
p_37,15,0,e_2,228,244,295,14,1,0,11,5,1,1,16,51,67
p_39,13,0,e_2,247,252,295,7,0,0,14,4,1,0,5,43,48
p_44,4,0,e_2,275,281,295,30,1,1,6,4,1,0,6,14,20
p_47,3,0,e_3,293,304,315,3,0,0,0,3,0,0,11,11,22
p_49,3,0,e_3,298,304,315,2,1,0,1,5,0,1,6,11,17
p_38,12,0,e_0,240,261,321,7,1,0,6,5,1,0,21,60,81
p_40,15,0,e_0,255,272,321,9,0,0,10,5,0,1,17,49,66
p_46,8,0,e_0,291,295,321,8,0,0,9,4,1,0,4,26,30
p_51,0,4,e_3,309,315,329,2,1,0,2,4,1,0,6,14,20
p_57,1,0,e_0,327,332,337,4,1,1,0,3,0,0,5,5,10
p_59,3,0,e_3,335,341,356,1,0,0,4,3,0,0,6,15,21
p_60,2,0,e_3,338,346,356,2,1,1,4,4,0,1,8,10,18
p_62,1,0,e_3,345,351,356,1,1,0,2,1,1,0,6,5,11
p_58,0,6,e_0,330,337,357,4,0,0,1,5,0,1,7,20,27
p_54,7,0,e_2,313,318,359,24,1,1,5,5,0,1,5,41,46
p_53,8,0,e_2,313,323,359,23,1,1,5,5,0,2,10,36,46
p_56,8,0,e_2,324,325,359,5,1,0,8,5,1,1,1,34,35
p_48,9,0,e_2,294,330,359,9,1,0,0,3,1,0,36,29,65
p_45,11,0,e_1,290,326,383,11,0,0,0,3,0,0,36,57,93
p_50,11,0,e_1,299,326,383,10,1,0,2,5,0,1,27,57,84
p_52,14,0,e_1,312,337,383,17,1,1,7,5,0,1,25,46,71
p_55,14,0,e_1,314,337,383,14,0,0,7,5,0,2,23,46,69
p_61,12,0,e_1,341,345,383,19,1,1,13,4,1,0,4,38,42
p_63,3,0,e_0,364,375,386,3,0,0,6,3,0,0,11,11,22
p_65,0,7,e_3,369,369,394,0,0,0,0,3,0,0,0,25,25
p_69,2,0,e_1,391,399,407,16,3,3,0,3,0,0,8,8,16
p_64,0,15,e_2,365,365,414,0,0,0,0,3,0,0,0,49,49
p_68,2,0,e_0,389,398,414,17,3,3,0,3,0,0,9,16,25
p_70,3,0,e_0,398,403,414,13,2,2,2,2,0,0,5,11,16
p_73,3,0,e_1,423,434,445,6,2,1,0,3,0,0,11,11,22
p_66,11,0,e_3,376,408,455,10,1,0,1,5,1,0,32,47,79
p_67,12,0,e_3,377,413,455,10,2,0,2,5,1,1,36,42,78
p_71,7,0,e_3,403,430,455,7,2,2,10,5,0,2,27,25,52
p_75,3,0,e_3,438,444,455,2,1,0,5,4,1,0,6,11,17
p_72,6,0,e_0,417,437,457,5,2,1,0,3,0,0,20,20,40
p_74,10,0,e_2,424,441,475,29,2,2,15,3,0,0,17,34,51
p_77,4,0,e_2,455,461,475,4,0,0,6,4,1,0,6,14,20
p_81,1,0,e_2,493,498,503,1,0,0,0,3,0,0,5,5,10
p_79,9,0,e_0,457,487,516,9,0,0,0,3,0,0,30,29,59
p_76,10,0,e_1,440,477,531,24,2,2,1,4,1,0,37,54,91
p_78,12,0,e_1,455,485,531,12,0,0,3,5,0,1,30,46,76
p_80,13,0,e_1,474,490,531,13,0,0,9,5,0,2,16,41,57
p_82,0,12,e_3,494,494,534,0,0,0,0,3,0,0,0,40,40
p_83,0,12,e_2,501,503,543,23,1,1,0,4,1,0,2,40,42
p_90,1,0,e_1,538,543,548,14,2,1,0,3,0,0,5,5,10
p_87,3,0,e_0,528,539,568,15,2,2,0,3,0,0,11,29,40
p_93,4,0,e_0,543,544,568,10,2,1,4,5,1,1,1,24,25
p_89,5,0,e_0,535,549,568,11,2,1,2,5,0,1,14,19,33
p_94,3,0,e_0,546,557,568,10,2,1,4,5,1,1,11,11,22
p_88,10,0,e_2,531,535,585,7,2,2,9,5,1,0,4,50,54
p_95,10,0,e_2,547,551,585,3,2,0,11,4,1,0,4,34,38
p_96,7,0,e_2,551,562,585,4,2,1,10,4,1,0,11,23,34
p_84,12,0,e_3,504,534,592,10,1,0,2,5,1,0,30,58,88
p_85,14,0,e_3,517,542,592,8,1,0,6,5,1,0,25,50,75
p_86,14,0,e_3,518,542,592,7,2,0,7,5,1,1,24,50,74
p_91,14,0,e_3,539,542,592,1,2,0,13,5,1,1,3,50,53
p_92,10,0,e_3,540,556,592,4,2,0,14,5,1,1,16,36,52
p_99,9,0,e_3,556,561,592,1,2,0,10,1,1,1,5,31,36
p_98,6,0,e_3,555,572,592,4,1,0,10,1,1,0,17,20,37
p_111,2,0,e_3,607,616,624,2,0,0,0,3,0,0,9,8,17
p_109,10,0,e_2,590,622,654,20,1,1,0,3,0,0,32,32,64
p_97,5,0,e_1,552,570,655,6,2,1,0,3,0,0,18,85,103
p_101,9,0,e_1,566,584,655,29,2,2,4,5,0,2,18,71,89
p_100,10,0,e_1,557,589,655,30,3,3,1,5,0,1,32,66,98
p_110,12,0,e_1,590,597,655,18,1,1,10,5,1,3,7,58,65
p_102,14,0,e_1,568,605,655,23,2,2,4,5,0,3,37,50,87
p_103,14,0,e_1,577,605,655,21,1,1,7,5,1,3,28,50,78
p_104,14,0,e_1,581,605,655,20,1,1,8,5,1,3,24,50,74
p_112,11,0,e_1,613,616,655,10,1,0,12,4,1,2,3,39,42
p_106,5,0,e_1,583,636,655,28,1,1,9,2,1,2,53,19,72
p_107,3,0,e_1,584,644,655,30,1,1,9,2,1,3,60,11,71
p_117,0,2,e_2,636,654,662,25,1,1,6,4,1,0,18,8,26
p_108,7,0,e_0,584,606,665,26,1,1,0,5,0,1,22,59,81
p_105,12,0,e_0,582,623,665,21,1,1,0,3,0,0,41,42,83
p_113,9,0,e_0,629,634,665,9,0,0,10,4,1,0,5,31,36
p_115,9,0,e_0,632,634,665,9,1,1,10,4,1,1,2,31,33
p_116,7,0,e_0,633,642,665,19,1,1,9,1,1,0,9,23,32
p_123,0,2,e_0,661,665,673,17,2,2,1,4,1,0,4,8,12
p_125,2,0,e_0,668,673,681,13,2,1,0,5,1,0,5,8,13
p_126,1,0,e_0,681,687,692,10,1,0,0,3,0,0,6,5,11
p_122,7,0,e_2,657,679,702,11,1,1,1,5,1,0,22,23,45
p_121,3,0,e_1,656,667,704,15,2,1,0,3,0,0,11,37,48
p_124,7,0,e_1,664,681,704,10,2,1,2,5,0,1,17,23,40
p_118,8,0,e_3,649,658,716,13,1,1,5,5,0,1,9,58,67
p_119,8,0,e_3,650,658,716,12,2,1,6,5,0,2,8,58,66
p_114,13,0,e_3,632,675,716,13,0,0,0,3,0,0,43,41,84
p_120,13,0,e_3,653,675,716,6,2,0,7,5,0,2,22,41,63
p_127,7,0,e_0,701,724,749,28,1,1,0,3,0,0,23,25,48
p_131,7,0,e_0,722,724,749,7,0,0,6,5,0,1,2,25,27
p_132,4,0,e_0,730,735,749,4,0,0,6,4,1,0,5,14,19
p_128,0,15,e_2,705,706,757,3,1,0,0,3,0,0,1,51,52
p_133,6,0,e_3,734,755,775,6,0,0,0,3,0,0,21,20,41
p_130,11,0,e_1,705,740,799,22,1,1,0,3,0,0,35,59,94
p_135,11,0,e_1,739,740,799,10,1,0,11,5,0,2,1,59,60
p_134,14,0,e_1,734,751,799,14,0,0,9,5,0,1,17,48,65
p_136,14,0,e_1,749,751,799,10,1,0,14,5,1,1,2,48,50
p_138,12,0,e_1,756,759,799,24,1,1,13,4,1,0,3,40,43
p_140,5,0,e_1,768,782,799,27,1,1,9,4,1,0,14,17,31
p_143,5,0,e_1,780,782,799,5,0,0,6,4,1,1,2,17,19
p_129,5,0,e_2,705,725,806,28,1,1,0,3,0,1,20,81,101
p_137,13,0,e_2,755,765,806,23,1,1,15,5,2,0,10,41,51
p_139,0,15,e_0,758,758,811,6,1,0,0,3,0,0,0,53,53
p_145,1,0,e_2,820,825,830,1,0,0,0,3,0,0,5,5,10
p_144,6,0,e_1,815,835,855,6,0,0,0,3,0,0,20,20,40
p_141,12,0,e_0,770,798,858,20,1,1,3,5,1,0,28,60,88
p_142,13,0,e_0,773,803,858,17,1,1,4,5,1,1,30,55,85
p_152,2,0,e_1,868,869,885,22,1,1,2,5,0,1,1,16,17
p_150,3,0,e_1,860,874,885,24,2,2,0,3,0,0,14,11,25
p_149,6,0,e_0,859,879,901,21,2,1,0,3,0,0,20,22,42
p_153,6,0,e_0,872,879,901,18,2,1,4,5,0,1,7,22,29
p_154,4,0,e_0,874,887,901,19,2,1,4,5,0,1,13,14,27
p_146,10,0,e_2,846,879,931,10,0,0,0,3,0,0,33,52,85
p_151,12,0,e_2,863,887,931,14,2,1,5,5,0,1,24,44,68
p_156,12,0,e_2,884,887,931,8,2,1,11,5,1,2,3,44,47
p_155,11,0,e_2,884,892,931,9,2,1,11,5,1,1,8,39,47
p_159,8,0,e_2,893,903,931,9,2,1,11,4,1,1,10,28,38
p_158,7,0,e_2,892,908,931,10,2,1,11,1,1,0,16,23,39
p_157,7,0,e_1,889,913,936,11,2,1,0,3,0,0,24,23,47
p_147,6,0,e_3,849,869,945,6,1,1,0,3,0,1,20,76,96
p_148,15,0,e_3,849,898,945,15,0,0,0,3,0,0,49,47,96
p_3,4,0,e_2,25,40,54,4,0,0,0,3,0,0,15,14,29
p_6,9,0,e_1,45,48,91,6,2,0,8,5,0,1,3,43,46
p_2,11,0,e_1,19,56,91,11,0,0,0,3,0,0,37,35,72
p_4,5,0,e_3,34,51,94,5,0,0,0,3,0,0,17,43,60
p_5,9,0,e_3,41,65,94,7,1,0,2,5,0,1,24,29,53
p_1,13,0,e_0,13,54,95,13,0,0,0,3,0,0,41,41,82
p_12,0,8,e_0,86,95,123,3,2,0,3,4,1,0,9,28,37
p_15,5,0,e_0,99,112,149,12,1,1,1,5,1,0,13,37,50
p_13,8,0,e_0,87,123,149,24,2,2,2,4,1,0,36,26,62
p_16,4,0,e_3,101,108,154,12,1,1,2,5,0,1,7,46,53
p_10,9,0,e_3,77,125,154,26,1,1,5,4,1,0,48,29,77
p_7,2,0,e_2,55,63,157,10,2,1,0,3,0,0,8,94,102
p_14,13,0,e_2,87,98,157,19,2,2,9,5,1,2,11,59,70
p_8,15,0,e_2,62,106,157,7,2,0,2,2,0,0,44,51,95
p_11,4,0,e_2,84,141,157,29,2,2,8,5,1,1,57,16,73
p_20,3,0,e_2,142,146,157,1,1,0,4,4,1,0,4,11,15
p_19,0,7,e_0,125,149,172,9,1,0,8,4,1,0,24,23,47
p_21,0,10,e_0,142,149,183,4,1,0,2,4,1,0,7,34,41
p_9,10,0,e_1,67,123,189,29,1,1,8,4,1,0,56,66,122
p_17,10,0,e_1,112,123,189,5,2,0,6,5,0,1,11,66,77
p_18,15,0,e_1,120,140,189,7,2,0,9,5,0,1,20,49,69
p_22,6,0,e_1,146,169,189,26,1,1,13,4,1,0,23,20,43
p_28,7,0,e_0,184,194,223,14,2,1,10,4,0,1,10,29,39
p_27,5,0,e_0,180,202,223,17,2,1,9,5,1,0,22,21,43
p_30,2,0,e_0,200,213,223,14,2,1,5,4,1,1,13,10,23
p_33,1,0,e_0,213,218,223,11,1,0,2,4,1,0,5,5,10
p_35,0,6,e_0,222,223,245,9,1,0,0,3,1,0,1,22,23
p_25,9,0,e_2,163,186,249,19,1,1,2,5,0,1,23,63,86
p_24,14,0,e_2,157,203,249,16,1,1,0,3,1,0,46,46,92
p_31,5,0,e_2,203,232,249,20,1,0,14,2,1,0,29,17,46
p_26,6,0,e_3,169,174,252,20,1,1,4,5,0,1,5,78,83
p_23,15,0,e_3,150,203,252,16,1,1,1,4,1,0,53,49,102
p_36,1,0,e_3,225,247,252,7,1,0,8,4,1,0,22,5,27
p_32,0,10,e_3,209,252,284,14,1,0,14,4,1,0,43,32,75
p_34,11,0,e_1,217,227,288,30,1,1,8,5,0,1,10,61,71
p_29,14,0,e_1,192,238,288,4,2,1,0,3,0,0,46,50,96
p_38,12,0,e_1,240,246,288,21,2,2,14,4,1,0,6,42,48
p_41,7,0,e_1,257,263,288,12,1,1,9,4,1,0,6,25,31
p_42,4,0,e_1,269,274,288,11,1,1,5,4,1,0,5,14,19
p_43,4,0,e_1,270,274,288,11,1,1,5,4,1,1,4,14,18
p_44,4,0,e_3,275,304,320,9,1,1,7,5,1,0,29,16,45
p_47,3,0,e_3,293,309,320,4,1,1,7,4,0,1,16,11,27
p_39,13,0,e_0,247,268,327,18,1,1,6,5,0,1,21,59,80
p_37,15,0,e_0,228,276,327,22,2,2,0,5,1,0,48,51,99
p_46,8,0,e_0,291,299,327,26,1,1,11,4,1,0,8,28,36
p_49,3,0,e_0,298,316,327,3,2,1,8,1,1,0,18,11,29
p_51,0,4,e_3,309,320,334,3,1,0,3,4,1,0,11,14,25
p_57,1,0,e_0,327,333,338,13,2,2,0,3,0,0,6,5,11
p_58,0,6,e_0,330,338,358,13,2,2,0,5,0,1,8,20,28
p_40,15,0,e_2,255,302,359,15,1,0,0,3,0,0,47,57,104
p_48,9,0,e_2,294,322,359,25,2,2,12,5,0,1,28,37,65
p_56,8,0,e_2,324,327,359,7,2,0,9,4,1,1,3,32,35
p_54,7,0,e_2,313,332,359,25,1,1,12,4,1,1,19,27,46
p_59,3,0,e_2,335,346,359,9,1,1,7,4,1,0,11,13,24
p_62,1,0,e_2,345,354,359,16,2,2,3,1,1,0,9,5,14
p_45,11,0,e_1,290,325,382,24,1,1,0,3,0,0,35,57,92
p_50,11,0,e_1,299,325,382,21,2,2,3,5,0,1,26,57,83
p_52,14,0,e_1,312,336,382,19,1,1,7,5,0,1,24,46,70
p_55,14,0,e_1,314,336,382,18,2,2,8,5,0,2,22,46,68
p_60,2,0,e_1,338,374,382,9,1,1,14,4,1,0,36,8,44
p_63,3,0,e_0,364,376,387,9,1,0,6,3,0,0,12,11,23
p_53,8,0,e_3,313,348,402,24,1,1,2,4,1,0,35,54,89
p_61,12,0,e_3,341,362,402,6,1,0,6,5,0,1,21,40,61
p_68,2,0,e_3,389,394,402,2,1,0,4,4,1,0,5,8,13
p_69,2,0,e_3,391,394,402,1,2,0,3,4,1,1,3,8,11
p_65,0,7,e_0,369,387,410,10,1,0,5,4,0,1,18,23,41
p_64,0,15,e_2,365,366,417,11,1,0,0,3,0,0,1,51,52
p_70,3,0,e_0,398,424,435,28,1,1,3,5,1,0,26,11,37
p_72,6,0,e_3,417,423,451,4,1,1,4,5,0,1,6,28,34
p_71,7,0,e_3,403,428,451,7,0,0,0,3,0,0,25,23,48
p_67,12,0,e_1,377,420,460,25,1,1,2,4,1,0,43,40,83
p_73,3,0,e_1,423,449,460,5,2,1,12,4,1,0,26,11,37
p_66,11,0,e_2,376,403,466,27,1,1,2,5,1,0,27,63,90
p_74,10,0,e_2,424,434,466,4,2,0,13,4,1,0,10,32,42
p_81,1,0,e_2,493,498,503,12,2,1,0,3,0,0,5,5,10
p_75,3,0,e_0,438,449,506,1,1,0,0,3,0,0,11,57,68
p_79,9,0,e_0,457,469,506,15,2,1,5,5,1,1,12,37,49
p_76,10,0,e_0,440,474,506,24,1,1,0,5,0,1,34,32,66
p_77,4,0,e_3,455,469,533,4,0,0,0,3,0,0,14,64,78
p_78,12,0,e_3,455,495,533,12,1,0,0,5,0,1,40,38,78
p_82,0,12,e_0,494,506,544,12,1,1,4,4,1,0,12,38,50
p_83,0,12,e_0,501,506,544,11,1,0,1,4,1,0,5,38,43
p_80,13,0,e_1,474,515,562,8,2,0,0,3,0,0,41,47,88
p_89,5,0,e_1,535,541,562,15,1,1,7,4,1,1,6,21,27
p_93,4,0,e_1,543,546,562,13,2,1,5,4,1,1,3,16,19
p_87,3,0,e_1,528,551,562,29,1,1,9,4,1,0,23,11,34
p_94,3,0,e_1,546,551,562,13,2,1,4,1,1,1,5,11,16
p_86,14,0,e_0,518,552,600,21,1,1,4,5,1,0,34,48,82
p_95,10,0,e_0,547,566,600,6,2,0,13,5,0,1,19,34,53
p_97,5,0,e_0,552,583,600,9,2,1,14,4,1,1,31,17,48
p_99,9,0,e_3,556,562,601,4,2,1,7,5,0,2,6,39,45
p_88,10,0,e_3,531,567,601,21,1,1,1,4,1,0,36,34,70
p_92,10,0,e_3,540,567,601,8,2,0,2,5,0,2,27,34,61
p_90,1,0,e_3,538,596,601,18,1,1,1,5,0,1,58,5,63
p_84,12,0,e_2,504,542,604,28,1,1,0,3,0,0,38,62,100
p_85,14,0,e_2,517,550,604,21,1,1,4,5,0,1,33,54,87
p_91,14,0,e_2,539,550,604,13,2,0,11,5,0,2,11,54,65
p_100,10,0,e_2,557,564,604,2,3,0,12,4,1,2,7,40,47
p_96,7,0,e_2,551,575,604,8,2,1,14,4,1,0,24,29,53
p_98,6,0,e_2,555,580,604,7,2,1,13,4,1,1,25,24,49
p_106,5,0,e_2,583,585,604,30,2,2,6,4,1,0,2,19,21
p_107,3,0,e_2,584,593,604,2,2,0,5,1,1,0,9,11,20
p_111,2,0,e_2,607,615,623,2,0,0,0,3,0,0,8,8,16
p_108,7,0,e_0,584,623,646,28,2,2,5,4,1,0,39,23,62
p_117,0,2,e_0,636,646,654,19,2,2,3,4,1,0,10,8,18
p_101,9,0,e_1,566,596,665,17,2,0,0,3,0,0,30,69,99
p_109,10,0,e_1,590,601,665,23,2,2,7,5,0,3,11,64,75
p_105,12,0,e_1,582,609,665,23,2,2,5,5,0,2,27,56,83
p_110,12,0,e_1,590,609,665,21,2,2,7,5,0,3,19,56,75
p_102,14,0,e_1,568,617,665,26,2,2,0,5,0,1,49,48,97
p_103,14,0,e_1,577,617,665,23,2,2,3,5,0,2,40,48,88
p_104,14,0,e_1,581,617,665,22,2,2,4,5,0,2,36,48,84
p_115,9,0,e_1,632,634,665,7,1,1,10,4,1,0,2,31,33
p_116,7,0,e_1,633,642,665,13,2,2,9,4,1,1,9,23,32
p_123,0,2,e_1,661,665,673,12,2,0,1,4,1,0,4,8,12
p_125,2,0,e_1,668,673,681,8,2,1,0,5,1,0,5,8,13
p_126,1,0,e_1,681,687,692,4,2,1,0,3,0,0,6,5,11
p_119,8,0,e_2,650,656,692,7,2,1,6,5,0,1,6,36,42
p_113,9,0,e_2,629,661,692,8,1,1,0,3,0,0,32,31,63
p_124,7,0,e_2,664,669,692,4,2,0,8,4,1,0,5,23,28
p_112,11,0,e_3,613,648,699,11,0,0,0,3,0,0,35,51,86
p_114,13,0,e_3,632,656,699,7,1,0,6,5,0,1,24,43,67
p_120,13,0,e_3,653,656,699,1,2,0,12,5,1,1,3,43,46
p_121,3,0,e_3,656,688,699,10,1,0,13,4,1,0,32,11,43
p_122,7,0,e_0,657,671,702,6,2,0,3,5,0,1,14,31,45
p_118,8,0,e_0,649,676,702,7,2,1,0,5,1,0,27,26,53
p_127,7,0,e_1,701,725,750,7,0,0,0,3,0,0,24,25,49
p_132,4,0,e_1,730,736,750,19,1,1,6,4,1,0,6,14,20
p_128,0,15,e_3,705,705,756,0,0,0,0,3,0,0,0,51,51
p_129,5,0,e_2,705,723,756,5,0,0,0,3,0,0,18,33,51
p_131,7,0,e_2,722,731,756,19,1,1,5,2,0,0,9,25,34
p_133,6,0,e_2,734,736,756,16,1,1,7,4,1,0,2,20,22
p_130,11,0,e_0,705,740,801,11,0,0,0,3,0,0,35,61,96
p_135,11,0,e_0,739,740,801,9,1,1,11,2,0,1,1,61,62
p_134,14,0,e_0,734,753,801,7,1,1,9,5,0,1,19,48,67
p_137,13,0,e_0,755,758,801,2,2,0,14,4,1,0,3,43,46
p_140,5,0,e_0,768,784,801,7,1,0,10,4,1,0,16,17,33
p_136,14,0,e_3,749,751,805,3,1,1,13,5,1,0,2,54,56
p_143,5,0,e_3,780,788,805,2,1,0,7,4,1,0,8,17,25
p_139,0,15,e_2,758,758,807,15,1,0,0,3,0,0,0,49,49
p_145,1,0,e_3,820,826,831,1,0,0,0,3,0,0,6,5,11
p_138,12,0,e_1,756,794,840,3,1,0,0,3,0,0,38,46,84
p_141,12,0,e_1,770,794,840,29,1,1,4,5,0,1,24,46,70
p_142,13,0,e_1,773,799,840,27,1,1,5,5,0,1,26,41,67
p_144,6,0,e_0,815,836,856,6,0,0,0,3,0,0,21,20,41
p_150,3,0,e_3,860,861,894,6,1,1,3,5,0,1,1,33,34
p_147,6,0,e_3,849,872,894,6,0,0,0,3,0,0,23,22,45
p_154,4,0,e_3,874,880,894,2,1,0,6,4,1,0,6,14,20
p_146,10,0,e_2,846,864,900,10,0,0,15,3,0,0,18,36,54
p_153,6,0,e_2,872,878,900,30,1,1,8,4,1,1,6,22,28
p_152,2,0,e_2,868,892,900,5,2,1,9,4,1,0,24,8,32
p_149,6,0,e_0,859,880,940,3,1,0,0,3,0,0,21,60,81
p_151,12,0,e_0,863,900,940,9,2,0,0,5,0,1,37,40,77
p_156,12,0,e_0,884,900,940,21,1,1,7,5,1,1,16,40,56
p_157,7,0,e_0,889,917,940,24,1,1,9,5,1,1,28,23,51
p_159,8,0,e_3,893,920,946,22,1,1,0,4,1,0,27,26,53
p_148,15,0,e_1,849,897,948,15,0,0,0,3,0,0,48,51,99
p_155,11,0,e_1,884,911,948,22,1,1,11,5,0,1,27,37,64
p_158,7,0,e_1,892,925,948,23,1,1,14,5,0,2,33,23,56
p_3,4,0,e_2,25,39,87,4,0,0,0,3,0,0,14,48,62
p_4,5,0,e_2,34,44,87,5,0,0,2,5,0,1,10,43,53
p_5,9,0,e_2,41,58,87,9,0,0,4,5,1,1,17,29,46
p_6,9,0,e_2,45,58,87,9,0,0,5,5,1,1,13,29,42
p_2,11,0,e_1,19,55,90,11,0,0,0,3,0,0,36,35,71
p_1,13,0,e_0,13,54,95,13,0,0,0,3,0,0,41,41,82
p_12,0,8,e_2,86,87,113,21,4,4,0,4,1,0,1,26,27
p_16,4,0,e_1,101,115,129,13,3,1,0,3,0,0,14,14,28
p_15,5,0,e_0,99,116,133,13,4,2,0,3,0,0,17,17,34
p_19,0,7,e_1,125,129,152,11,2,0,1,4,1,1,4,23,27
p_13,8,0,e_2,87,113,155,13,4,2,0,5,1,0,26,42,68
p_17,10,0,e_2,112,121,155,5,2,0,8,5,1,0,9,34,43
p_20,3,0,e_2,142,144,155,2,2,1,4,4,1,0,2,11,13
p_7,2,0,e_3,55,63,159,2,0,0,0,3,0,0,8,96,104
p_10,9,0,e_3,77,86,159,15,3,2,6,5,1,2,9,73,82
p_9,10,0,e_3,67,91,159,17,2,1,3,5,1,1,24,68,92
p_14,13,0,e_3,87,102,159,8,4,1,9,5,1,3,15,57,72
p_8,15,0,e_3,62,110,159,13,1,0,2,5,0,1,48,49,97
p_11,4,0,e_3,84,145,159,17,4,2,9,5,1,3,61,14,75
p_21,0,10,e_0,142,143,181,5,2,0,0,3,0,0,1,38,39
p_27,5,0,e_3,180,197,214,5,0,0,0,3,0,0,17,17,34
p_22,6,0,e_0,146,165,215,28,1,1,0,5,1,0,19,50,69
p_25,9,0,e_0,163,176,215,9,0,0,5,5,1,1,13,39,52
p_30,2,0,e_0,200,207,215,2,1,0,4,4,1,0,7,8,15
p_24,14,0,e_1,157,175,229,16,1,1,8,5,0,1,18,54,72
p_18,15,0,e_1,120,180,229,27,2,2,3,4,1,0,60,49,109
p_23,15,0,e_1,150,180,229,18,1,1,7,5,1,1,30,49,79
p_31,5,0,e_1,203,212,229,29,1,1,8,4,1,0,9,17,26
p_32,0,10,e_3,209,214,248,1,1,0,1,4,1,0,5,34,39
p_35,0,6,e_1,222,229,249,19,2,2,2,4,1,0,7,20,27
p_26,6,0,e_2,169,189,263,6,0,0,0,3,0,0,20,74,94
p_28,7,0,e_2,184,194,263,6,1,0,5,5,0,1,10,69,79
p_29,14,0,e_2,192,217,263,11,1,0,6,5,1,1,25,46,71
p_36,1,0,e_2,225,258,263,17,2,1,12,4,1,0,33,5,38
p_41,7,0,e_1,257,263,288,11,3,2,6,3,0,0,6,25,31
p_42,4,0,e_1,269,274,288,11,1,0,5,4,1,0,5,14,19
p_43,4,0,e_1,270,274,288,11,1,0,5,4,1,1,4,14,18
p_44,4,0,e_2,275,290,304,10,1,0,0,3,0,0,15,14,29
p_34,11,0,e_0,217,253,316,10,2,0,0,3,0,0,36,63,99
p_37,15,0,e_0,228,267,316,12,2,0,3,5,0,1,39,49,88
p_47,3,0,e_0,293,305,316,4,1,0,7,4,1,0,12,11,23
p_49,3,0,e_0,298,305,316,3,1,0,5,4,1,1,7,11,18
p_33,1,0,e_3,213,219,316,1,0,0,0,3,1,0,6,97,103
p_38,12,0,e_3,240,256,316,4,2,0,8,5,2,0,16,60,76
p_39,13,0,e_3,247,261,316,3,2,0,10,2,2,1,14,55,69
p_40,15,0,e_3,255,269,316,3,3,0,12,5,1,2,14,47,61
p_51,0,4,e_2,309,310,326,2,1,0,0,3,0,0,1,16,17
p_57,1,0,e_0,327,333,338,1,0,0,0,3,0,0,6,5,11
p_58,0,6,e_3,330,331,353,0,0,0,0,3,0,0,1,22,23
p_60,2,0,e_0,338,347,357,9,1,1,0,3,0,0,9,10,19
p_62,1,0,e_0,345,352,357,8,1,1,1,5,0,1,7,5,12
p_54,7,0,e_2,313,337,370,24,1,1,0,5,1,1,24,33,57
p_53,8,0,e_2,313,342,370,23,1,1,0,5,1,0,29,28,57
p_56,8,0,e_2,324,342,370,8,0,0,4,5,1,2,18,28,46
p_59,3,0,e_2,335,359,370,9,1,1,6,5,0,2,24,11,35
p_63,3,0,e_0,364,375,386,3,0,0,0,3,0,0,11,11,22
p_46,8,0,e_1,291,316,386,30,1,1,0,5,0,1,25,70,95
p_48,9,0,e_1,294,321,386,28,1,1,1,5,0,2,27,65,92
p_45,11,0,e_1,290,329,386,28,1,1,0,3,0,0,39,57,96
p_50,11,0,e_1,299,329,386,24,1,1,2,5,0,3,30,57,87
p_52,14,0,e_1,312,340,386,17,1,1,7,5,0,3,28,46,74
p_55,14,0,e_1,314,340,386,16,1,1,8,5,0,4,26,46,72
p_61,12,0,e_1,341,348,386,10,1,0,14,4,1,0,7,38,45
p_65,0,7,e_2,369,370,393,6,0,0,0,4,1,0,1,23,24
p_68,2,0,e_0,389,397,405,13,2,2,0,3,0,0,8,8,16
p_69,2,0,e_1,391,400,416,12,2,2,0,3,0,0,9,16,25
p_70,3,0,e_1,398,405,416,9,2,0,1,5,0,1,7,11,18
p_64,0,15,e_2,365,370,419,6,0,0,2,4,1,0,5,49,54
p_66,11,0,e_3,376,394,441,5,0,0,6,3,0,0,18,47,65
p_67,12,0,e_3,377,399,441,6,1,1,6,3,0,1,22,42,64
p_71,7,0,e_3,403,416,441,4,1,0,11,4,1,0,13,25,38
p_72,6,0,e_3,417,421,441,1,1,0,7,4,1,0,4,20,24
p_73,3,0,e_0,423,434,445,3,1,0,0,3,0,0,11,11,22
p_75,3,0,e_1,438,449,460,28,1,1,0,3,0,0,11,11,22
p_74,10,0,e_2,424,442,476,26,1,1,15,3,0,0,18,34,52
p_76,10,0,e_2,440,442,476,10,0,0,11,4,0,1,2,34,36
p_77,4,0,e_2,455,462,476,4,0,0,6,4,1,0,7,14,21
p_81,1,0,e_1,493,498,503,7,1,0,0,3,0,0,5,5,10
p_79,9,0,e_3,457,487,516,9,0,0,0,3,0,0,30,29,59
p_82,0,12,e_2,494,495,535,7,1,0,0,3,0,0,1,40,41
p_78,12,0,e_0,455,493,539,12,0,0,0,3,0,0,38,46,84
p_80,13,0,e_0,474,498,539,8,1,0,6,5,0,1,24,41,65
p_83,0,12,e_1,501,503,543,5,1,0,1,4,1,0,2,40,42
p_87,3,0,e_3,528,540,569,3,0,0,0,3,0,0,12,29,41
p_89,5,0,e_3,535,548,569,4,1,0,1,5,0,1,13,21,34
p_94,3,0,e_3,546,556,569,3,3,1,4,5,1,2,10,13,23
p_90,1,0,e_3,538,564,569,7,2,2,2,5,0,2,26,5,31
p_88,10,0,e_1,531,535,585,10,1,0,9,5,1,0,4,50,54
p_92,10,0,e_1,540,551,585,7,2,0,11,5,2,0,11,34,45
p_95,10,0,e_1,547,551,585,9,3,0,11,4,1,1,4,34,38
p_96,7,0,e_1,551,562,585,27,3,3,10,1,1,0,11,23,34
p_84,12,0,e_2,504,535,589,22,1,1,2,5,1,0,31,54,85
p_85,14,0,e_2,517,543,589,14,0,0,6,5,1,0,26,46,72
p_86,14,0,e_2,518,543,589,14,0,0,7,5,1,1,25,46,71
p_91,14,0,e_2,539,543,589,11,3,0,13,5,1,1,4,46,50
p_99,9,0,e_2,556,560,589,24,2,2,10,4,1,0,4,29,33
p_107,3,0,e_3,584,595,634,3,1,1,0,3,0,1,11,39,50
p_106,5,0,e_3,583,603,634,5,0,0,0,3,0,0,20,31,51
p_108,7,0,e_3,584,611,634,7,2,2,0,3,0,2,27,23,50
p_93,4,0,e_0,543,558,646,2,3,1,0,3,0,0,15,88,103
p_97,5,0,e_0,552,563,646,29,3,3,2,5,0,1,11,83,94
p_98,6,0,e_0,555,568,646,27,2,2,3,5,0,2,13,78,91
p_101,9,0,e_0,566,579,646,22,1,1,6,5,1,2,13,67,80
p_100,10,0,e_0,557,584,646,23,2,2,4,5,0,3,27,62,89
p_105,12,0,e_0,582,592,646,12,0,0,9,5,1,2,10,54,64
p_110,12,0,e_0,590,592,646,11,3,0,11,5,1,2,2,54,56
p_102,14,0,e_0,568,600,646,14,0,0,6,5,1,2,32,46,78
p_103,14,0,e_0,577,600,646,14,0,0,9,5,1,3,23,46,69
p_104,14,0,e_0,581,600,646,14,0,0,9,5,1,2,19,46,65
p_109,10,0,e_0,590,614,646,8,3,0,12,5,1,2,24,32,56
p_117,0,2,e_3,636,637,647,0,0,0,0,3,0,0,1,10,11
p_123,0,2,e_0,661,662,672,3,1,1,0,3,0,0,1,10,11
p_121,3,0,e_3,656,662,673,1,0,0,2,3,0,0,6,11,17
p_125,2,0,e_0,668,672,680,30,1,1,1,5,1,0,4,8,12
p_126,1,0,e_0,681,687,692,1,0,0,0,3,0,0,6,5,11
p_116,7,0,e_2,633,657,692,7,0,0,0,3,0,0,24,35,59
p_122,7,0,e_2,657,657,692,5,1,1,7,2,0,1,0,35,35
p_118,8,0,e_2,649,664,692,6,0,0,4,5,0,1,15,28,43
p_119,8,0,e_2,650,664,692,6,0,0,5,5,0,2,14,28,42
p_124,7,0,e_2,664,669,692,26,1,1,8,4,1,0,5,23,28
p_111,2,0,e_1,607,615,695,6,2,1,0,3,0,0,8,80,88
p_113,9,0,e_1,629,638,695,23,1,1,6,5,1,1,9,57,66
p_115,9,0,e_1,632,638,695,21,1,1,7,5,1,2,6,57,63
p_112,11,0,e_1,613,646,695,26,1,1,1,5,0,1,33,49,82
p_114,13,0,e_1,632,654,695,17,1,1,7,5,1,2,22,41,63
p_120,13,0,e_1,653,654,695,11,0,0,13,5,1,1,1,41,42
p_128,0,15,e_2,705,705,754,0,0,0,0,3,0,0,0,49,49
p_129,5,0,e_1,705,723,756,5,0,0,0,3,0,0,18,33,51
p_131,7,0,e_1,722,731,756,7,0,0,5,5,0,1,9,25,34
p_133,6,0,e_1,734,736,756,6,1,0,7,4,1,0,2,20,22
p_132,4,0,e_3,730,745,759,4,0,0,0,3,0,0,15,14,29
p_127,7,0,e_0,701,724,799,7,0,0,0,3,0,0,23,75,98
p_130,11,0,e_0,705,738,799,11,0,0,1,5,0,1,33,61,94
p_135,11,0,e_0,739,740,799,9,1,0,11,5,1,1,1,59,60
p_134,14,0,e_0,734,751,799,14,1,0,10,5,1,1,17,48,65
p_136,14,0,e_0,749,751,799,19,1,1,13,5,1,1,2,48,50
p_138,12,0,e_0,756,759,799,19,1,1,13,4,1,0,3,40,43
p_140,5,0,e_0,768,782,799,5,0,0,9,4,1,0,14,17,31
p_143,5,0,e_0,780,782,799,18,2,2,6,4,1,1,2,17,19
p_137,13,0,e_2,755,764,805,18,1,1,15,3,0,0,9,41,50
p_139,0,15,e_1,758,759,808,0,1,0,0,3,0,0,1,49,50
p_145,1,0,e_2,820,826,831,10,1,0,0,3,0,0,6,5,11
p_141,12,0,e_3,770,808,854,12,0,0,0,3,0,0,38,46,84
p_142,13,0,e_3,773,813,854,13,1,0,0,5,0,1,40,41,81
p_144,6,0,e_0,815,835,855,7,1,0,0,3,0,0,20,20,40
p_150,3,0,e_3,860,871,884,3,0,0,0,3,0,0,11,13,24
p_152,2,0,e_3,868,876,884,2,1,1,2,5,0,1,8,8,16
p_146,10,0,e_1,846,863,899,23,1,1,15,3,0,0,17,36,53
p_147,6,0,e_1,849,877,899,26,1,1,14,4,0,1,28,22,50
p_153,6,0,e_1,872,877,899,27,2,2,7,4,1,1,5,22,27
p_154,4,0,e_1,874,885,899,29,2,2,7,4,1,1,11,14,25
p_149,6,0,e_0,859,879,939,6,0,0,0,3,0,0,20,60,80
p_155,11,0,e_0,884,896,939,11,0,0,7,5,1,1,12,43,55
p_151,12,0,e_0,863,901,939,11,1,0,1,5,0,1,38,38,76
p_156,12,0,e_0,884,901,939,12,0,0,7,5,1,1,17,38,55
p_148,15,0,e_2,849,896,943,17,1,1,0,3,0,0,47,47,94
p_157,7,0,e_3,889,913,944,7,0,0,0,3,0,0,24,31,55
p_158,7,0,e_3,892,913,944,7,1,0,0,5,0,1,21,31,52
p_159,8,0,e_3,893,918,944,7,1,0,1,5,0,1,25,26,51
p_3,4,0,e_2,25,40,62,4,0,0,0,3,0,0,15,22,37
p_4,5,0,e_2,34,45,62,5,0,0,2,5,0,1,11,17,28
p_5,9,0,e_1,41,48,91,9,0,0,7,5,0,1,7,43,50
p_6,9,0,e_1,45,48,91,9,0,0,8,5,0,2,3,43,46
p_2,11,0,e_1,19,56,91,11,0,0,0,3,0,0,37,35,72
p_1,13,0,e_0,13,54,95,13,0,0,0,3,0,0,41,41,82
p_12,0,8,e_1,86,91,117,21,2,2,2,4,1,0,5,26,31
p_16,4,0,e_0,101,113,135,13,2,1,0,5,0,1,12,22,34
p_15,5,0,e_0,99,118,135,12,2,1,0,3,0,0,19,17,36
p_13,8,0,e_2,87,93,137,13,3,2,6,5,0,3,6,44,50
p_10,9,0,e_2,77,98,137,15,2,1,3,5,0,1,21,39,60
p_9,10,0,e_2,67,103,137,17,2,1,0,3,0,0,36,34,70
p_11,4,0,e_2,84,123,137,18,2,1,5,5,0,2,39,14,53
p_7,2,0,e_3,55,64,156,2,0,0,0,3,0,0,9,92,101
p_14,13,0,e_3,87,99,156,8,2,1,9,5,1,1,12,57,69
p_8,15,0,e_3,62,107,156,13,1,0,2,5,0,1,45,49,94
p_20,3,0,e_3,142,145,156,1,1,0,4,4,1,0,3,11,14
p_19,0,7,e_0,125,135,160,10,1,0,3,4,1,0,10,25,35
p_21,0,10,e_2,142,143,177,4,1,0,0,3,0,0,1,34,35
p_17,10,0,e_1,112,125,189,4,1,0,6,5,1,0,13,64,77
p_18,15,0,e_1,120,142,189,26,1,1,9,5,0,1,22,47,69
p_30,2,0,e_1,200,209,217,16,3,1,0,3,0,0,9,8,17
p_24,14,0,e_2,157,191,237,14,0,0,3,5,1,0,34,46,80
p_33,1,0,e_2,213,232,237,13,2,0,7,4,1,0,19,5,24
p_22,6,0,e_0,146,155,237,27,1,1,3,5,1,0,9,82,91
p_23,15,0,e_0,150,186,237,17,1,1,4,5,1,1,36,51,87
p_31,5,0,e_0,203,218,237,12,3,1,10,4,1,0,15,19,34
p_36,1,0,e_0,225,232,237,10,2,1,3,4,1,0,7,5,12
p_32,0,10,e_1,209,217,249,15,3,3,2,2,0,0,8,32,40
p_35,0,6,e_0,222,237,257,12,3,0,4,4,1,0,15,20,35
p_26,6,0,e_3,169,183,261,10,1,1,2,5,0,1,14,78,92
p_28,7,0,e_3,184,188,261,5,3,1,6,5,1,2,4,73,77
p_25,9,0,e_3,163,196,261,9,0,0,0,3,0,0,33,65,98
p_29,14,0,e_3,192,213,261,6,3,0,8,5,1,2,21,48,69
p_34,11,0,e_3,217,224,261,2,2,0,13,4,1,1,7,37,44
p_27,5,0,e_3,180,244,261,8,2,2,5,5,0,2,64,17,81
p_41,7,0,e_0,257,263,288,24,1,1,6,3,0,0,6,25,31
p_42,4,0,e_0,269,274,288,4,0,0,6,4,1,0,5,14,19
p_43,4,0,e_0,270,274,288,4,0,0,5,4,1,1,4,14,18
p_39,13,0,e_1,247,260,317,22,1,1,9,5,1,1,13,57,70
p_37,15,0,e_1,228,268,317,25,2,2,3,5,1,0,40,49,89
p_40,15,0,e_1,255,268,317,17,1,1,12,5,0,2,13,49,62
p_47,3,0,e_1,293,306,317,15,2,1,7,4,1,0,13,11,24
p_38,12,0,e_2,240,279,319,24,2,2,0,3,0,0,39,40,79
p_49,3,0,e_2,298,308,319,13,2,1,6,4,1,0,10,11,21
p_51,0,4,e_1,309,317,331,12,2,2,2,4,1,0,8,14,22
p_57,1,0,e_2,327,333,338,12,1,0,0,3,0,0,6,5,11
p_59,3,0,e_1,335,341,356,8,1,0,4,3,0,0,6,15,21
p_60,2,0,e_1,338,346,356,8,1,0,4,4,0,1,8,10,18
p_62,1,0,e_1,345,351,356,6,1,0,2,1,1,0,6,5,11
p_54,7,0,e_0,313,315,356,10,2,1,7,5,0,2,2,41,43
p_46,8,0,e_0,291,320,356,10,2,1,0,3,0,0,29,36,65
p_53,8,0,e_0,313,320,356,9,2,1,6,5,0,2,7,36,43
p_48,9,0,e_0,294,325,356,8,2,1,0,5,0,1,31,31,62
p_56,8,0,e_0,324,330,356,6,1,0,9,5,1,1,6,26,32
p_58,0,6,e_2,330,338,358,13,1,0,0,5,0,1,8,20,28
p_44,4,0,e_3,275,290,368,4,0,0,0,3,0,0,15,78,93
p_45,11,0,e_3,290,313,368,7,0,0,4,3,0,0,23,55,78
p_50,11,0,e_3,299,313,368,5,2,0,6,5,1,1,14,55,69
p_52,14,0,e_3,312,324,368,3,2,0,11,5,1,1,12,44,56
p_55,14,0,e_3,314,324,368,3,2,0,11,5,1,1,10,44,54
p_63,3,0,e_0,364,376,387,28,1,1,0,3,0,0,12,11,23
p_65,0,7,e_3,369,369,394,0,0,0,0,3,0,0,0,25,25
p_68,2,0,e_0,389,398,406,6,1,1,0,3,0,0,9,8,17
p_69,2,0,e_0,391,398,406,6,1,1,0,5,0,1,7,8,15
p_64,0,15,e_1,365,366,415,1,1,0,0,3,0,0,1,49,50
p_61,12,0,e_2,341,378,418,27,1,1,1,5,1,0,37,40,77
p_67,12,0,e_2,377,378,418,10,1,0,12,5,0,2,1,40,41
p_66,11,0,e_2,376,383,418,10,1,0,11,5,0,1,7,35,42
p_70,3,0,e_3,398,412,423,4,0,0,7,3,0,0,14,11,25
p_73,3,0,e_2,423,435,446,3,0,0,0,3,0,0,12,11,23
p_72,6,0,e_0,417,437,457,26,1,1,0,3,0,0,20,20,40
p_74,10,0,e_1,424,432,466,10,0,0,13,4,0,1,8,34,42
p_71,7,0,e_1,403,443,466,26,1,1,11,5,1,0,40,23,63
p_77,4,0,e_2,455,470,484,16,3,2,0,3,0,0,15,14,29
p_81,1,0,e_1,493,499,504,10,1,0,0,3,0,0,6,5,11
p_79,9,0,e_0,457,486,515,10,3,2,0,3,1,0,29,29,58
p_75,3,0,e_3,438,450,527,3,0,0,0,3,0,0,12,77,89
p_76,10,0,e_3,440,473,527,10,1,0,0,5,0,1,33,54,87
p_78,12,0,e_3,455,481,527,8,2,0,4,5,1,1,26,46,72
p_80,13,0,e_3,474,486,527,3,2,0,10,5,1,1,12,41,53
p_82,0,12,e_2,494,495,535,11,1,0,0,3,0,0,1,40,41
p_83,0,12,e_1,501,504,544,9,1,0,1,4,1,0,3,40,43
p_90,1,0,e_3,538,543,548,1,0,0,0,3,0,0,5,5,10
p_87,3,0,e_0,528,540,569,3,0,0,0,3,0,0,12,29,41
p_93,4,0,e_0,543,545,569,27,1,1,3,5,1,1,2,24,26
p_89,5,0,e_0,535,550,569,5,0,0,2,5,0,1,15,19,34
p_94,3,0,e_0,546,558,569,27,1,1,4,5,1,1,12,11,23
p_88,10,0,e_1,531,536,588,10,0,0,9,5,1,0,5,52,57
p_92,10,0,e_1,540,552,588,10,1,0,11,5,2,0,12,36,48
p_96,7,0,e_1,551,563,588,7,0,0,10,4,1,1,12,25,37
p_98,6,0,e_1,555,568,588,6,1,0,10,4,1,1,13,20,33
p_84,12,0,e_2,504,535,591,26,1,1,2,5,1,0,31,56,87
p_85,14,0,e_2,517,543,591,19,1,1,6,5,1,0,26,48,74
p_86,14,0,e_2,518,543,591,19,1,1,6,5,1,1,25,48,73
p_91,14,0,e_2,539,543,591,14,1,0,13,5,1,1,4,48,52
p_95,10,0,e_2,547,557,591,20,1,1,13,4,1,0,10,34,44
p_99,9,0,e_2,556,562,591,9,1,0,10,4,1,1,6,29,35
p_111,2,0,e_2,607,616,624,12,3,2,0,3,0,0,9,8,17
p_109,10,0,e_1,590,622,654,8,5,2,0,3,0,0,32,32,64
p_97,5,0,e_3,552,570,655,5,0,0,0,3,0,0,18,85,103
p_101,9,0,e_3,566,584,655,7,2,1,4,5,0,2,18,71,89
p_100,10,0,e_3,557,589,655,9,1,0,1,5,0,1,32,66,98
p_110,12,0,e_3,590,597,655,6,4,1,10,5,1,3,7,58,65
p_102,14,0,e_3,568,605,655,10,3,0,4,5,0,3,37,50,87
p_103,14,0,e_3,577,605,655,7,4,0,7,5,1,3,28,50,78
p_104,14,0,e_3,581,605,655,6,4,0,8,5,1,3,24,50,74
p_112,11,0,e_3,613,616,655,1,3,0,12,4,1,2,3,39,42
p_106,5,0,e_3,583,636,655,14,3,2,9,2,1,2,53,19,72
p_107,3,0,e_3,584,644,655,16,4,2,9,2,1,3,60,11,71
p_117,0,2,e_1,636,654,662,5,2,0,6,4,1,0,18,8,26
p_108,7,0,e_0,584,605,664,12,5,2,0,5,0,1,21,59,80
p_105,12,0,e_0,582,622,664,7,4,1,0,3,0,0,40,42,82
p_113,9,0,e_0,629,633,664,28,3,3,10,4,1,0,4,31,35
p_116,7,0,e_0,633,641,664,29,3,3,9,1,1,0,8,23,31
p_123,0,2,e_0,661,664,672,5,1,1,1,4,1,0,3,8,11
p_121,3,0,e_3,656,668,679,3,0,0,0,3,0,0,12,11,23
p_125,2,0,e_0,668,672,680,5,0,0,1,5,1,0,4,8,12
p_126,1,0,e_0,681,686,691,1,0,0,0,3,0,0,5,5,10
p_122,7,0,e_1,657,679,702,7,1,0,0,5,1,0,22,23,45
p_124,7,0,e_1,664,679,702,5,1,0,2,5,0,1,15,23,38
p_118,8,0,e_2,649,658,718,24,1,1,5,5,0,2,9,60,69
p_119,8,0,e_2,650,658,718,23,1,1,6,5,0,3,8,60,68
p_115,9,0,e_2,632,663,718,27,3,3,0,3,0,0,31,55,86
p_114,13,0,e_2,632,677,718,23,3,3,0,3,0,1,45,41,86
p_120,13,0,e_2,653,677,718,17,1,1,7,5,0,3,24,41,65
p_129,5,0,e_0,705,719,752,25,2,1,1,5,0,1,14,33,47
p_127,7,0,e_0,701,727,752,7,0,0,0,3,0,0,26,25,51
p_131,7,0,e_0,722,727,752,19,1,1,6,5,1,1,5,25,30
p_132,4,0,e_0,730,738,752,19,1,1,6,4,1,0,8,14,22
p_128,0,15,e_3,705,705,756,0,0,0,0,3,0,0,0,51,51
p_133,6,0,e_2,734,755,775,16,1,1,0,3,0,0,21,20,41
p_130,11,0,e_1,705,740,803,11,0,0,0,3,0,0,35,63,98
p_135,11,0,e_1,739,740,803,9,1,1,11,2,0,1,1,63,64
p_134,14,0,e_1,734,753,803,8,1,1,9,5,0,1,19,50,69
p_137,13,0,e_1,755,758,803,28,1,0,14,4,1,0,3,45,48
p_138,12,0,e_1,756,763,803,27,1,0,14,4,1,1,7,40,47
p_140,5,0,e_1,768,786,803,7,1,0,11,4,1,0,18,17,35
p_136,14,0,e_3,749,751,805,2,1,1,14,5,1,0,2,54,56
p_143,5,0,e_3,780,788,805,2,1,0,7,4,1,0,8,17,25
p_139,0,15,e_0,758,759,812,15,1,0,0,3,0,0,1,53,54
p_145,1,0,e_2,820,826,831,1,0,0,0,3,0,0,6,5,11
p_144,6,0,e_1,815,835,855,6,0,0,0,3,0,0,20,20,40
p_141,12,0,e_0,770,799,859,29,1,1,3,5,1,0,29,60,89
p_142,13,0,e_0,773,804,859,27,1,1,4,5,1,1,31,55,86
p_150,3,0,e_0,860,872,883,6,1,1,0,3,0,0,12,11,23
p_152,2,0,e_1,868,876,928,16,1,1,0,3,0,0,8,52,60
p_154,4,0,e_1,874,884,928,13,2,1,2,5,0,2,10,44,54
p_153,6,0,e_1,872,892,928,12,2,1,1,5,0,1,20,36,56
p_157,7,0,e_1,889,897,928,6,2,1,5,5,1,1,8,31,39
p_158,7,0,e_1,892,897,928,5,1,0,6,5,1,1,5,31,36
p_159,8,0,e_1,893,902,928,4,1,0,6,5,1,1,9,26,35
p_147,6,0,e_3,849,869,929,6,0,0,0,3,0,0,20,60,80
p_149,6,0,e_3,859,869,929,3,1,0,3,5,0,1,10,60,70
p_155,11,0,e_3,884,886,929,3,2,1,10,5,1,1,2,43,45
p_151,12,0,e_3,863,891,929,8,1,0,4,5,0,1,28,38,66
p_156,12,0,e_3,884,891,929,2,3,0,10,5,1,2,7,38,45
p_146,10,0,e_2,846,878,942,10,0,0,0,3,0,0,32,64,96
p_148,15,0,e_2,849,895,942,15,1,1,0,5,0,1,46,47,93
p_3,4,0,e_2,25,39,87,4,0,0,0,3,0,0,14,48,62
p_4,5,0,e_2,34,44,87,5,0,0,3,5,0,1,10,43,53
p_5,9,0,e_2,41,58,87,9,0,0,4,5,1,1,17,29,46
p_6,9,0,e_2,45,58,87,9,0,0,5,5,1,1,13,29,42
p_2,11,0,e_1,19,54,89,11,0,0,0,3,0,0,35,35,70
p_1,13,0,e_0,13,54,95,13,0,0,0,3,0,0,41,41,82
p_12,0,8,e_2,86,87,115,21,4,4,0,3,1,0,1,28,29
p_16,4,0,e_1,101,116,130,13,3,1,0,3,0,0,15,14,29
p_15,5,0,e_0,99,117,134,13,4,2,0,3,0,0,18,17,35
p_19,0,7,e_1,125,130,155,10,2,0,2,4,1,0,5,25,30
p_7,2,0,e_3,55,63,161,2,0,0,0,3,0,0,8,98,106
p_10,9,0,e_3,77,86,161,15,3,2,6,5,1,2,9,75,84
p_9,10,0,e_3,67,91,161,17,2,1,3,5,1,1,24,70,94
p_14,13,0,e_3,87,102,161,8,4,1,9,5,1,3,15,59,74
p_8,15,0,e_3,62,110,161,13,1,0,2,5,0,1,48,51,99
p_11,4,0,e_3,84,145,161,18,4,3,8,5,1,3,61,16,77
p_20,3,0,e_3,142,150,161,2,2,1,5,4,1,1,8,11,19
p_21,0,10,e_0,142,142,176,5,2,0,0,3,0,0,0,34,34
p_13,8,0,e_2,87,115,187,13,4,2,0,3,1,0,28,72,100
p_17,10,0,e_2,112,123,187,5,2,0,7,5,1,0,11,64,75
p_18,15,0,e_2,120,140,187,27,2,2,9,5,1,1,20,47,67
p_22,6,0,e_1,146,150,232,28,2,2,5,5,1,0,4,82,86
p_23,15,0,e_1,150,181,232,18,1,1,6,5,2,0,31,51,82
p_28,7,0,e_1,184,207,232,6,3,1,14,4,1,0,23,25,48
p_33,1,0,e_1,213,227,232,15,1,0,5,4,1,0,14,5,19
p_30,2,0,e_2,200,208,236,16,2,1,0,3,0,0,8,28,36
p_31,5,0,e_2,203,219,236,12,2,1,1,5,0,1,16,17,33
p_24,14,0,e_0,157,190,236,17,1,1,4,5,1,0,33,46,79
p_36,1,0,e_0,225,231,236,10,1,0,3,4,1,0,6,5,11
p_35,0,6,e_1,222,232,252,12,2,0,2,4,1,1,10,20,30
p_27,5,0,e_3,180,181,260,8,2,2,5,5,0,2,1,79,80
p_26,6,0,e_3,169,186,260,11,1,1,1,5,0,1,17,74,91
p_25,9,0,e_3,163,197,260,9,0,0,0,3,0,0,34,63,97
p_29,14,0,e_3,192,214,260,6,2,0,8,5,1,1,22,46,68
p_34,11,0,e_3,217,225,260,2,1,0,13,4,1,0,8,35,43
p_32,0,10,e_1,209,232,266,16,2,2,7,4,1,0,23,34,57
p_42,4,0,e_3,269,283,297,4,0,0,0,3,0,0,14,14,28
p_43,4,0,e_3,270,283,297,4,1,0,0,5,0,1,13,14,27
p_44,4,0,e_3,275,283,297,2,1,0,2,5,0,1,8,14,22
p_41,7,0,e_2,257,281,306,24,1,1,0,3,0,0,24,25,49
p_47,3,0,e_2,293,295,306,28,1,1,4,4,1,0,2,11,13
p_51,0,4,e_2,309,309,325,19,2,2,0,3,0,0,0,16,16
p_38,12,0,e_0,240,278,328,25,1,1,0,3,0,0,38,50,88
p_39,13,0,e_0,247,283,328,21,1,1,2,5,0,1,36,45,81
p_48,9,0,e_0,294,297,328,22,1,1,10,4,1,1,3,31,34
p_46,8,0,e_0,291,302,328,24,1,1,11,4,1,0,11,26,37
p_37,15,0,e_1,228,283,334,26,1,1,1,4,1,0,55,51,106
p_40,15,0,e_1,255,283,334,17,1,1,6,5,1,1,28,51,79
p_45,11,0,e_1,290,297,334,21,1,1,13,4,1,0,7,37,44
p_57,1,0,e_1,327,329,334,19,3,2,2,4,1,0,2,5,7
p_58,0,6,e_0,330,331,353,19,3,3,0,3,0,0,1,22,23
p_60,2,0,e_1,338,343,361,15,2,1,0,5,0,1,5,18,23
p_59,3,0,e_1,335,348,361,14,3,1,0,3,0,0,13,13,26
p_62,1,0,e_1,345,356,361,14,3,1,2,5,1,1,11,5,16
p_54,7,0,e_2,313,336,367,17,3,2,0,5,1,0,23,31,54
p_53,8,0,e_2,313,341,367,16,3,2,0,5,1,1,28,26,54
p_56,8,0,e_2,324,341,367,13,3,2,4,5,1,2,17,26,43
p_63,3,0,e_0,364,375,386,6,1,0,6,3,0,0,11,11,22
p_49,3,0,e_3,298,310,393,3,0,0,0,3,0,0,12,83,95
p_50,11,0,e_3,299,336,393,11,1,1,0,3,0,1,37,57,94
p_52,14,0,e_3,312,347,393,11,2,0,3,5,1,1,35,46,81
p_55,14,0,e_3,314,347,393,10,3,0,4,5,1,2,33,46,79
p_61,12,0,e_3,341,355,393,4,2,1,12,5,1,1,14,38,52
p_65,0,7,e_2,369,370,395,8,1,0,0,3,0,0,1,25,26
p_68,2,0,e_0,389,397,405,29,1,1,0,3,0,0,8,8,16
p_69,2,0,e_0,391,397,405,29,1,1,0,5,0,1,6,8,14
p_64,0,15,e_1,365,365,414,9,1,0,0,3,0,0,0,49,49
p_73,3,0,e_0,423,434,445,5,2,1,0,3,0,0,11,11,22
p_66,11,0,e_2,376,409,454,24,1,1,1,5,1,0,33,45,78
p_67,12,0,e_2,377,414,454,23,1,1,1,5,1,1,37,40,77
p_75,3,0,e_2,438,443,454,7,1,0,5,4,1,0,5,11,16
p_70,3,0,e_3,398,409,468,3,0,0,0,3,0,0,11,59,70
p_72,6,0,e_3,417,420,468,3,2,1,5,5,1,1,3,48,51
p_71,7,0,e_3,403,425,468,6,1,0,1,5,0,1,22,43,65
p_74,10,0,e_3,424,436,468,3,2,0,7,5,1,1,12,32,44
p_77,4,0,e_2,455,469,483,30,1,1,0,3,0,0,14,14,28
p_76,10,0,e_1,440,458,492,29,1,1,15,3,0,0,18,34,52
p_79,9,0,e_1,457,463,492,24,1,1,10,4,0,1,6,29,35
p_81,1,0,e_1,493,499,504,1,0,0,0,3,0,0,6,5,11
p_82,0,12,e_2,494,494,534,0,0,0,0,3,0,0,0,40,40
p_78,12,0,e_0,455,493,541,22,1,1,0,3,0,0,38,48,86
p_80,13,0,e_0,474,498,541,13,0,0,6,5,0,1,24,43,67
p_87,3,0,e_0,528,530,541,13,1,1,4,4,1,0,2,11,13
p_83,0,12,e_3,501,501,543,0,0,0,0,3,0,0,0,42,42
p_90,1,0,e_1,538,541,572,13,2,1,0,5,0,1,3,31,34
p_89,5,0,e_1,535,555,572,9,2,1,0,3,0,0,20,17,37
p_97,5,0,e_1,552,555,572,5,2,1,4,5,1,1,3,17,20
p_88,10,0,e_3,531,535,585,5,1,1,9,5,1,0,4,50,54
p_92,10,0,e_3,540,551,585,3,2,1,11,5,2,0,11,34,45
p_95,10,0,e_3,547,551,585,1,2,0,11,4,1,1,4,34,38
p_96,7,0,e_3,551,562,585,3,1,0,10,1,1,0,11,23,34
p_84,12,0,e_2,504,534,588,12,1,0,2,5,1,0,30,54,84
p_85,14,0,e_2,517,542,588,10,1,0,6,5,1,0,25,46,71
p_86,14,0,e_2,518,542,588,10,1,0,7,5,1,1,24,46,70
p_91,14,0,e_2,539,542,588,3,2,0,13,5,1,1,3,46,49
p_99,9,0,e_2,556,559,588,30,2,2,10,4,1,0,3,29,32
p_111,2,0,e_2,607,616,624,6,2,1,0,3,0,0,9,8,17
p_107,3,0,e_3,584,596,633,3,1,1,0,3,1,1,12,37,49
p_108,7,0,e_3,584,610,633,7,0,0,0,3,1,0,26,23,49
p_94,3,0,e_0,546,555,644,8,2,1,0,5,0,1,9,89,98
p_93,4,0,e_0,543,560,644,8,2,1,0,3,0,0,17,84,101
p_98,6,0,e_0,555,568,644,3,2,1,3,2,0,1,13,76,89
p_101,9,0,e_0,566,579,644,27,1,1,5,5,1,2,13,65,78
p_100,10,0,e_0,557,584,644,29,2,2,3,5,1,2,27,60,87
p_105,12,0,e_0,582,592,644,19,1,1,10,5,1,2,10,52,62
p_110,12,0,e_0,590,592,644,11,2,0,11,5,1,2,2,52,54
p_102,14,0,e_0,568,600,644,22,1,1,6,2,1,2,32,44,76
p_103,14,0,e_0,577,600,644,19,1,1,8,5,1,3,23,44,67
p_104,14,0,e_0,581,600,644,17,1,1,9,5,1,2,19,44,63
p_117,0,2,e_0,636,644,652,26,1,1,3,4,1,0,8,8,16
p_106,5,0,e_1,583,601,660,26,1,1,0,3,0,0,18,59,77
p_109,10,0,e_1,590,618,660,9,2,0,2,5,0,1,28,42,70
p_112,11,0,e_1,613,623,660,25,1,1,9,5,1,1,10,37,47
p_116,7,0,e_1,633,637,660,19,1,1,8,4,1,0,4,23,27
p_123,0,2,e_1,661,662,672,17,1,1,0,3,0,0,1,10,11
p_125,2,0,e_1,668,672,680,13,1,1,1,5,1,0,4,8,12
p_126,1,0,e_1,681,686,691,10,1,0,0,3,0,0,5,5,10
p_121,3,0,e_0,656,661,698,16,1,1,2,3,0,0,5,37,42
p_122,7,0,e_0,657,675,698,12,1,1,2,5,0,1,18,23,41
p_124,7,0,e_0,664,675,698,9,1,1,3,5,1,1,11,23,34
p_114,13,0,e_3,632,674,715,13,0,0,0,3,1,0,42,41,83
p_118,8,0,e_2,649,655,715,13,1,1,6,5,0,1,6,60,66
p_119,8,0,e_2,650,655,715,13,1,1,7,5,0,2,5,60,65
p_113,9,0,e_2,629,660,715,22,1,1,0,3,0,0,31,55,86
p_115,9,0,e_2,632,660,715,9,1,1,1,5,0,1,28,55,83
p_120,13,0,e_2,653,674,715,7,1,0,8,5,0,2,21,41,62
p_128,0,15,e_1,705,706,759,3,1,0,0,3,0,1,1,53,54
p_132,4,0,e_3,730,745,759,4,0,0,0,3,0,0,15,14,29
p_127,7,0,e_0,701,724,795,27,1,1,0,3,0,0,23,71,94
p_130,11,0,e_0,705,738,795,22,1,1,1,5,0,1,33,57,90
p_134,14,0,e_0,734,749,795,14,1,0,10,5,1,1,15,46,61
p_140,5,0,e_0,768,778,795,23,1,1,8,4,1,0,10,17,27
p_133,6,0,e_2,734,742,806,6,1,0,4,5,0,1,8,64,72
p_131,7,0,e_2,722,747,806,7,0,0,0,3,0,0,25,59,84
p_135,11,0,e_2,739,761,806,9,1,0,5,5,0,2,22,45,67
p_138,12,0,e_2,756,766,806,19,1,1,10,5,1,1,10,40,50
p_143,5,0,e_2,780,789,806,19,3,3,8,4,1,0,9,17,26
p_129,5,0,e_1,705,725,808,28,1,1,0,3,0,0,20,83,103
p_136,14,0,e_1,749,754,808,19,1,1,12,5,2,0,5,54,59
p_137,13,0,e_1,755,767,808,18,1,1,14,5,2,0,12,41,53
p_139,0,15,e_3,758,759,812,0,0,0,0,3,1,0,1,53,54
p_145,1,0,e_1,820,825,830,12,1,0,0,3,0,0,5,5,10
p_144,6,0,e_0,815,835,855,9,1,0,0,3,0,0,20,20,40
p_141,12,0,e_3,770,799,859,16,1,1,2,5,1,0,29,60,89
p_142,13,0,e_3,773,804,859,13,2,1,4,5,1,1,31,55,86
p_152,2,0,e_3,868,869,885,2,1,1,2,5,0,1,1,16,17
p_150,3,0,e_3,860,874,885,3,0,0,0,3,0,0,14,11,25
p_149,6,0,e_0,859,880,902,6,0,0,0,3,0,0,21,22,43
p_153,6,0,e_0,872,880,902,3,2,0,4,5,0,1,8,22,30
p_154,4,0,e_0,874,888,902,7,1,0,4,5,0,1,14,14,28
p_147,6,0,e_1,849,866,932,27,1,1,1,5,0,1,17,66,83
p_146,10,0,e_1,846,880,932,24,1,1,0,3,0,0,34,52,86
p_155,11,0,e_1,884,885,932,19,1,1,11,5,1,1,1,47,48
p_151,12,0,e_1,863,890,932,12,1,0,5,5,0,2,27,42,69
p_156,12,0,e_1,884,890,932,18,1,1,11,5,1,2,6,42,48
p_159,8,0,e_1,893,904,932,8,0,0,11,4,1,1,11,28,39
p_157,7,0,e_1,889,909,932,7,0,0,12,5,1,1,20,23,43
p_158,7,0,e_1,892,909,932,7,0,0,12,4,1,1,17,23,40
p_148,15,0,e_2,849,896,943,18,1,1,0,3,0,0,47,47,94
p_3,4,0,e_2,25,40,88,4,0,0,0,3,0,0,15,48,63
p_4,5,0,e_2,34,45,88,5,0,0,2,5,0,1,11,43,54
p_5,9,0,e_2,41,59,88,9,0,0,4,5,1,1,18,29,47
p_6,9,0,e_2,45,59,88,9,0,0,5,2,1,1,14,29,43
p_2,11,0,e_1,19,54,89,11,0,0,0,3,0,0,35,35,70
p_1,13,0,e_0,13,54,95,13,0,0,0,3,0,0,41,41,82
p_12,0,8,e_1,86,89,115,21,5,5,1,4,1,0,3,26,29
p_16,4,0,e_0,101,114,136,14,4,2,0,5,0,1,13,22,35
p_15,5,0,e_0,99,119,136,13,4,2,0,3,0,0,20,17,37
p_13,8,0,e_2,87,114,156,13,5,3,0,3,1,0,27,42,69
p_17,10,0,e_2,112,122,156,5,2,0,8,5,0,1,10,34,44
p_20,3,0,e_2,142,145,156,2,2,1,4,4,1,0,3,11,14
p_7,2,0,e_3,55,64,160,2,0,0,0,3,0,0,9,96,105
p_10,9,0,e_3,77,87,160,15,3,2,6,5,1,2,10,73,83
p_9,10,0,e_3,67,92,160,18,2,1,2,5,1,1,25,68,93
p_14,13,0,e_3,87,103,160,8,4,1,9,2,1,3,16,57,73
p_8,15,0,e_3,62,111,160,14,1,0,1,5,0,1,49,49,98
p_11,4,0,e_3,84,146,160,18,4,3,8,5,1,3,62,14,76
p_19,0,7,e_0,125,136,161,11,2,0,3,4,1,0,11,25,36
p_21,0,10,e_2,142,156,188,5,2,0,4,4,1,0,14,32,46
p_18,15,0,e_1,120,143,192,28,2,2,8,3,0,0,23,49,72
p_26,6,0,e_1,169,172,192,11,1,1,7,4,1,0,3,20,23
p_25,9,0,e_3,163,193,224,9,0,0,0,3,0,0,30,31,61
p_30,2,0,e_3,200,216,224,5,1,0,7,4,1,0,16,8,24
p_28,7,0,e_2,184,199,226,5,1,1,9,5,1,1,15,27,42
p_27,5,0,e_2,180,207,226,8,1,1,8,5,1,0,27,19,46
p_31,5,0,e_2,203,207,226,1,2,0,6,4,1,1,4,19,23
p_33,1,0,e_2,213,221,226,2,2,1,4,4,1,0,8,5,13
p_22,6,0,e_0,146,156,238,28,1,1,3,5,1,0,10,82,92
p_24,14,0,e_0,157,184,238,17,1,1,6,5,2,1,27,54,81
p_23,15,0,e_0,150,189,238,18,1,1,4,5,1,1,39,49,88
p_36,1,0,e_0,225,233,238,19,1,1,4,4,1,0,8,5,13
p_35,0,6,e_2,222,226,246,1,1,0,1,4,1,0,4,20,24
p_32,0,10,e_3,209,224,256,4,2,0,4,4,1,1,15,32,47
p_41,7,0,e_3,257,269,294,3,0,0,10,3,0,0,12,25,37
p_42,4,0,e_3,269,280,294,3,1,0,7,4,1,0,11,14,25
p_34,11,0,e_1,217,228,297,21,1,1,7,5,0,1,11,69,80
p_29,14,0,e_1,192,239,297,23,0,0,0,3,0,0,47,58,105
p_37,15,0,e_1,228,244,297,14,1,0,11,2,0,1,16,53,69
p_39,13,0,e_1,247,252,297,6,1,0,15,4,1,1,5,45,50
p_38,12,0,e_1,240,257,297,7,1,0,14,5,1,1,17,40,57
p_44,4,0,e_1,275,283,297,2,2,0,6,4,1,0,8,14,22
p_43,4,0,e_0,270,284,298,3,2,0,0,3,0,0,14,14,28
p_49,3,0,e_0,298,310,321,3,0,0,0,3,0,0,12,11,23
p_51,0,4,e_3,309,310,326,0,0,0,0,3,0,0,1,16,17
p_57,1,0,e_0,327,332,337,11,1,1,0,3,0,0,5,5,10
p_40,15,0,e_2,255,285,342,25,0,0,6,3,0,0,30,57,87
p_45,11,0,e_2,290,299,342,20,1,1,14,4,1,0,9,43,52
p_48,9,0,e_2,294,307,342,9,0,0,12,4,1,3,13,35,48
p_46,8,0,e_2,291,312,342,23,1,1,13,4,1,1,21,30,51
p_54,7,0,e_2,313,317,342,7,1,0,8,4,1,1,4,25,29
p_47,3,0,e_2,293,331,342,27,1,1,13,4,1,2,38,11,49
p_60,2,0,e_0,338,346,356,6,2,0,0,3,0,0,8,10,18
p_62,1,0,e_0,345,351,356,6,2,1,2,5,0,1,6,5,11
p_58,0,6,e_2,330,342,362,11,1,1,3,4,1,1,12,20,32
p_53,8,0,e_3,313,340,368,8,1,0,0,5,1,0,27,28,55
p_56,8,0,e_3,324,340,368,4,2,0,4,5,1,1,16,28,44
p_59,3,0,e_3,335,357,368,6,1,1,7,5,0,1,22,11,33
p_63,3,0,e_0,364,376,387,28,1,1,0,3,0,0,12,11,23
p_50,11,0,e_1,299,334,391,11,0,0,0,3,0,0,35,57,92
p_52,14,0,e_1,312,345,391,14,1,0,4,5,0,1,33,46,79
p_55,14,0,e_1,314,345,391,14,2,0,5,5,0,2,31,46,77
p_61,12,0,e_1,341,353,391,26,2,2,13,5,1,1,12,38,50
p_68,2,0,e_0,389,398,406,21,3,3,0,3,0,0,9,8,17
p_65,0,7,e_2,369,389,412,30,1,1,6,3,0,0,20,23,43
p_69,2,0,e_1,391,400,416,21,3,3,0,3,0,0,9,16,25
p_70,3,0,e_1,398,405,416,17,3,3,2,5,0,1,7,11,18
p_64,0,15,e_3,365,368,419,1,1,0,1,4,1,0,3,51,54
p_71,7,0,e_2,403,412,437,12,3,2,4,5,1,0,9,25,34
p_73,3,0,e_2,423,426,437,11,1,0,4,4,1,0,3,11,14
p_72,6,0,e_0,417,438,458,9,2,0,0,3,0,0,21,20,41
p_75,3,0,e_1,438,450,461,7,1,0,0,3,0,0,12,11,23
p_66,11,0,e_3,376,403,468,17,1,1,2,5,1,0,27,65,92
p_67,12,0,e_3,377,408,468,15,2,1,3,5,1,1,31,60,91
p_74,10,0,e_3,424,436,468,4,1,0,14,4,1,0,12,32,44
p_81,1,0,e_1,493,498,503,1,0,0,0,3,0,0,5,5,10
p_79,9,0,e_0,457,487,516,24,1,1,0,3,1,0,30,29,59
p_76,10,0,e_2,440,472,528,29,1,1,0,3,0,0,32,56,88
p_78,12,0,e_2,455,480,528,22,1,1,5,5,0,2,25,48,73
p_80,13,0,e_2,474,485,528,13,0,0,10,5,1,2,11,43,54
p_77,4,0,e_2,455,514,528,30,1,1,5,5,0,1,59,14,73
p_82,0,12,e_3,494,494,534,0,0,0,0,3,0,0,0,40,40
p_83,0,12,e_1,501,503,543,23,1,1,1,4,1,0,2,40,42
p_87,3,0,e_0,528,539,564,15,2,2,0,3,0,0,11,25,36
p_89,5,0,e_0,535,547,564,11,2,1,2,5,0,1,12,17,29
p_90,1,0,e_2,538,544,571,14,2,1,0,3,0,0,6,27,33
p_94,3,0,e_2,546,552,571,10,1,0,1,5,1,1,6,19,25
p_93,4,0,e_2,543,557,571,10,1,0,1,5,0,1,14,14,28
p_88,10,0,e_1,531,535,585,7,2,2,9,5,1,0,4,50,54
p_92,10,0,e_1,540,551,585,5,2,1,11,5,2,0,11,34,45
p_95,10,0,e_1,547,551,585,3,1,0,11,4,1,1,4,34,38
p_96,7,0,e_1,551,562,585,4,1,0,10,4,1,0,11,23,34
p_84,12,0,e_3,504,534,590,10,1,0,2,5,1,0,30,56,86
p_85,14,0,e_3,517,542,590,8,1,0,6,5,1,0,25,48,73
p_86,14,0,e_3,518,542,590,7,2,0,7,5,1,1,24,48,72
p_91,14,0,e_3,539,542,590,1,2,0,13,5,1,1,3,48,51
p_99,9,0,e_3,556,559,590,1,2,0,10,4,1,1,3,31,34
p_98,6,0,e_3,555,570,590,4,1,0,10,4,1,0,15,20,35
p_111,2,0,e_3,607,616,624,2,0,0,0,3,0,0,9,8,17
p_109,10,0,e_1,590,622,654,10,0,0,0,3,0,0,32,32,64
p_97,5,0,e_2,552,588,657,6,1,0,3,2,1,1,36,69,105
p_106,5,0,e_2,583,588,657,27,1,1,4,5,0,3,5,69,74
p_108,7,0,e_2,584,596,657,25,1,1,4,5,0,4,12,61,73
p_100,10,0,e_2,557,607,657,30,3,3,4,3,1,1,50,50,100
p_105,12,0,e_2,582,615,657,20,1,1,3,5,0,2,33,42,75
p_110,12,0,e_2,590,615,657,12,0,0,5,5,1,4,25,42,67
p_112,11,0,e_2,613,620,657,10,1,0,12,5,1,2,7,37,44
p_107,3,0,e_2,584,646,657,29,1,1,4,5,0,3,62,11,73
p_101,9,0,e_0,566,596,659,28,2,2,0,3,0,0,30,63,93
p_102,14,0,e_0,568,613,659,22,2,2,0,5,0,1,45,46,91
p_103,14,0,e_0,577,613,659,20,1,1,3,5,0,2,36,46,82
p_104,14,0,e_0,581,613,659,19,1,1,4,5,0,2,32,46,78
p_116,7,0,e_0,633,636,659,18,2,2,8,4,1,0,3,23,26
p_117,0,2,e_1,636,654,662,24,2,2,6,4,1,0,18,8,26
p_123,0,2,e_0,661,661,671,17,2,2,0,3,0,0,0,10,10
p_125,2,0,e_0,668,671,679,13,2,1,1,5,1,0,3,8,11
p_126,1,0,e_0,681,687,692,10,1,0,0,3,0,0,6,5,11
p_122,7,0,e_2,657,681,704,11,3,2,0,3,0,0,24,23,47
p_121,3,0,e_1,656,667,704,15,3,2,0,5,1,0,11,37,48
p_124,7,0,e_1,664,681,704,9,2,1,2,5,0,1,17,23,40
p_118,8,0,e_3,649,655,715,12,2,2,6,5,0,2,6,60,66
p_119,8,0,e_3,650,655,715,12,3,2,6,5,0,3,5,60,65
p_113,9,0,e_3,629,660,715,9,0,0,0,3,0,0,31,55,86
p_115,9,0,e_3,632,660,715,8,1,0,1,5,0,1,28,55,83
p_114,13,0,e_3,632,674,715,12,1,0,1,5,0,1,42,41,83
p_120,13,0,e_3,653,674,715,6,3,0,7,5,0,3,21,41,62
p_129,5,0,e_1,705,722,739,28,1,1,0,3,0,0,17,17,34
p_127,7,0,e_0,701,725,750,27,1,1,0,3,0,0,24,25,49
p_131,7,0,e_0,722,725,750,7,0,0,6,5,0,1,3,25,28
p_132,4,0,e_0,730,736,750,4,0,0,6,4,1,0,6,14,20
p_128,0,15,e_2,705,706,759,3,1,0,0,3,0,1,1,53,54
p_140,5,0,e_1,768,786,803,9,3,2,0,3,0,0,18,17,35
p_143,5,0,e_1,780,786,803,8,2,0,3,5,0,1,6,17,23
p_139,0,15,e_0,758,758,807,17,3,3,0,3,0,0,0,49,49
p_130,11,0,e_2,705,743,810,22,1,1,0,3,0,0,38,67,105
p_134,14,0,e_2,734,754,810,14,1,1,8,5,1,1,20,56,76
p_136,14,0,e_2,749,754,810,9,2,0,13,5,2,1,5,56,61
p_137,13,0,e_2,755,767,810,7,2,0,14,5,2,0,12,43,55
p_141,12,0,e_2,770,772,810,1,3,0,13,4,1,0,2,38,40
p_133,6,0,e_3,734,754,822,6,0,0,0,3,0,0,20,68,88
p_135,11,0,e_3,739,771,822,10,1,0,1,5,0,1,32,51,83
p_138,12,0,e_3,756,776,822,6,2,0,6,5,1,1,20,46,66
p_142,13,0,e_3,773,781,822,2,2,0,11,5,1,1,8,41,49
p_145,1,0,e_2,820,825,830,30,1,1,0,3,0,0,5,5,10
p_144,6,0,e_1,815,836,856,26,1,1,0,3,0,0,21,20,41
p_150,3,0,e_1,860,872,885,6,1,1,0,3,0,0,12,13,25
p_152,2,0,e_1,868,877,885,16,2,1,2,5,0,1,9,8,17
p_146,10,0,e_0,846,864,900,10,0,0,15,3,0,0,18,36,54
p_153,6,0,e_0,872,878,900,12,2,1,8,4,1,0,6,22,28
p_154,4,0,e_0,874,886,900,13,2,1,7,4,1,1,12,14,26
p_147,6,0,e_3,849,870,932,6,0,0,0,3,0,0,21,62,83
p_149,6,0,e_3,859,870,932,4,1,0,2,5,0,1,11,62,73
p_155,11,0,e_3,884,887,932,3,2,1,10,5,1,1,3,45,48
p_151,12,0,e_3,863,892,932,8,1,0,4,5,0,1,29,40,69
p_156,12,0,e_3,884,892,932,2,2,0,10,5,1,1,8,40,48
p_159,8,0,e_3,893,906,932,4,1,0,12,4,1,0,13,26,39
p_157,7,0,e_1,889,913,936,6,2,1,0,3,0,0,24,23,47
p_158,7,0,e_1,892,913,936,19,1,0,0,5,0,1,21,23,44
p_148,15,0,e_2,849,896,943,15,0,0,0,3,0,0,47,47,94
p_3,4,0,e_2,25,39,87,4,0,0,0,3,0,0,14,48,62
p_4,5,0,e_2,34,44,87,5,0,0,2,5,0,1,10,43,53
p_5,9,0,e_2,41,58,87,9,0,0,4,5,1,1,17,29,46
p_6,9,0,e_2,45,58,87,9,0,0,5,5,1,1,13,29,42
p_2,11,0,e_1,19,54,89,11,0,0,0,3,0,0,35,35,70
p_1,13,0,e_0,13,54,95,13,0,0,0,3,0,0,41,41,82
p_12,0,8,e_2,86,87,115,21,4,4,0,3,1,0,1,28,29
p_16,4,0,e_1,101,115,129,13,3,1,0,3,0,0,14,14,28
p_15,5,0,e_0,99,117,134,13,4,2,0,3,0,0,18,17,35
p_19,0,7,e_1,125,129,154,10,2,0,1,4,1,0,4,25,29
p_7,2,0,e_3,55,63,161,2,0,0,0,3,0,0,8,98,106
p_10,9,0,e_3,77,86,161,15,3,2,6,5,1,2,9,75,84
p_9,10,0,e_3,67,91,161,17,2,1,3,5,1,1,24,70,94
p_14,13,0,e_3,87,102,161,8,4,1,9,5,1,3,15,59,74
p_8,15,0,e_3,62,110,161,13,1,0,2,5,0,1,48,51,99
p_11,4,0,e_3,84,145,161,18,4,3,8,5,1,3,61,16,77
p_20,3,0,e_3,142,150,161,2,2,1,5,4,1,1,8,11,19
p_21,0,10,e_0,142,142,178,5,2,0,0,3,0,0,0,36,36
p_13,8,0,e_2,87,115,187,13,4,2,0,3,1,0,28,72,100
p_17,10,0,e_2,112,123,187,5,2,0,7,5,1,0,11,64,75
p_18,15,0,e_2,120,140,187,27,2,2,9,5,1,1,20,47,67
p_27,5,0,e_3,180,187,212,4,1,1,3,5,0,1,7,25,32
p_26,6,0,e_3,169,192,212,6,0,0,0,3,0,0,23,20,43
p_25,9,0,e_0,163,173,214,9,0,0,6,5,1,0,10,41,51
p_28,7,0,e_0,184,189,214,3,2,0,8,4,1,0,5,25,30
p_30,2,0,e_0,200,206,214,2,1,0,4,4,1,0,6,8,14
p_22,6,0,e_1,146,149,233,28,2,2,5,5,1,0,3,84,87
p_24,14,0,e_1,157,177,233,17,1,1,8,5,1,1,20,56,76
p_23,15,0,e_1,150,182,233,18,1,1,6,5,2,0,32,51,83
p_31,5,0,e_1,203,214,233,28,1,1,9,4,1,0,11,19,30
p_33,1,0,e_1,213,228,233,19,1,1,5,4,1,1,15,5,20
p_36,1,0,e_1,225,228,233,15,1,1,2,4,1,1,3,5,8
p_32,0,10,e_3,209,212,244,1,1,0,1,4,1,0,3,32,35
p_35,0,6,e_0,222,223,245,17,1,1,0,3,0,0,1,22,23
p_38,12,0,e_3,240,252,292,3,1,0,9,5,1,0,12,40,52
p_42,4,0,e_3,269,278,292,3,1,0,7,4,1,0,9,14,23
p_44,4,0,e_3,275,278,292,1,2,0,5,4,1,1,3,14,17
p_34,11,0,e_2,217,227,296,10,1,0,8,5,0,1,10,69,79
p_29,14,0,e_2,192,238,296,22,1,1,0,3,0,0,46,58,104
p_37,15,0,e_2,228,243,296,10,1,0,11,5,1,1,15,53,68
p_39,13,0,e_2,247,251,296,2,1,0,14,4,1,0,4,45,49
p_41,7,0,e_2,257,271,296,4,1,0,11,4,1,0,14,25,39
p_43,4,0,e_2,270,282,296,3,2,0,7,4,1,1,12,14,26
p_51,0,4,e_2,309,309,325,0,0,0,0,3,0,0,0,16,16
p_40,15,0,e_0,255,285,342,26,1,1,6,3,0,0,30,57,87
p_45,11,0,e_0,290,299,342,20,1,1,14,4,1,0,9,43,52
p_48,9,0,e_0,294,307,342,9,0,0,12,4,1,2,13,35,48
p_46,8,0,e_0,291,312,342,8,0,0,14,4,1,1,21,30,51
p_54,7,0,e_0,313,317,342,7,0,0,8,4,1,0,4,25,29
p_57,1,0,e_0,327,337,342,11,1,1,4,4,1,0,10,5,15
p_58,0,6,e_0,330,342,362,11,1,1,3,4,1,1,12,20,32
p_53,8,0,e_3,313,340,368,8,0,0,0,3,0,0,27,28,55
p_60,2,0,e_3,338,360,368,6,1,0,8,5,0,1,22,8,30
p_56,8,0,e_2,324,339,369,5,1,0,4,5,1,0,15,30,45
p_59,3,0,e_2,335,356,369,6,1,1,7,5,0,1,21,13,34
p_62,1,0,e_2,345,364,369,6,2,1,7,4,1,1,19,5,24
p_63,3,0,e_0,364,375,386,28,1,1,6,3,0,0,11,11,22
p_47,3,0,e_1,293,304,387,3,0,0,0,3,0,0,11,83,94
p_49,3,0,e_1,298,304,387,3,0,0,1,5,0,1,6,83,89
p_50,11,0,e_1,299,330,387,11,0,0,1,5,0,1,31,57,88
p_52,14,0,e_1,312,341,387,14,0,0,5,5,1,1,29,46,75
p_55,14,0,e_1,314,341,387,14,1,1,6,5,1,2,27,46,73
p_61,12,0,e_1,341,349,387,26,2,2,14,4,1,0,8,38,46
p_65,0,7,e_3,369,370,395,0,0,0,0,3,0,0,1,25,26
p_68,2,0,e_0,389,398,406,17,3,3,0,3,0,0,9,8,17
p_64,0,15,e_2,365,369,416,1,1,0,1,4,1,0,4,47,51
p_69,2,0,e_1,391,400,444,16,3,3,0,3,0,0,9,44,53
p_70,3,0,e_1,398,405,444,14,2,2,1,5,0,1,7,39,46
p_71,7,0,e_1,403,419,444,8,2,2,2,5,1,1,16,25,41
p_72,6,0,e_1,417,424,444,5,1,0,7,5,1,1,7,20,27
p_73,3,0,e_0,423,435,446,6,1,0,0,3,0,0,12,11,23
p_66,11,0,e_3,376,409,454,10,1,0,1,5,1,0,33,45,78
p_67,12,0,e_3,377,414,454,11,2,0,1,5,1,1,37,40,77
p_75,3,0,e_3,438,443,454,1,1,0,4,4,1,0,5,11,16
p_74,10,0,e_2,424,441,475,29,1,1,15,3,0,0,17,34,51
p_76,10,0,e_2,440,441,475,24,2,2,10,4,0,1,1,34,35
p_77,4,0,e_2,455,461,475,4,0,0,6,4,1,0,6,14,20
p_81,1,0,e_2,493,499,504,1,0,0,0,3,0,0,6,5,11
p_79,9,0,e_1,457,487,516,9,0,0,0,3,0,0,30,29,59
p_82,0,12,e_3,494,494,534,0,0,0,0,3,0,0,0,40,40
p_78,12,0,e_0,455,494,542,12,0,0,0,3,0,0,39,48,87
p_80,13,0,e_0,474,499,542,13,0,0,6,5,0,1,25,43,68
p_87,3,0,e_0,528,531,542,15,2,2,4,4,1,0,3,11,14
p_83,0,12,e_2,501,504,544,23,1,1,1,4,1,0,3,40,43
p_90,1,0,e_1,538,540,571,14,2,1,1,5,0,1,2,31,33
p_89,5,0,e_1,535,554,571,11,2,1,0,3,0,0,19,17,36
p_97,5,0,e_1,552,554,571,6,1,0,5,5,1,1,2,17,19
p_94,3,0,e_0,546,554,573,10,1,0,1,5,0,1,8,19,27
p_93,4,0,e_0,543,559,573,10,1,0,0,3,0,0,16,14,30
p_88,10,0,e_2,531,536,586,7,2,2,9,5,1,0,5,50,55
p_92,10,0,e_2,540,552,586,5,2,1,11,5,2,0,12,34,46
p_95,10,0,e_2,547,552,586,3,1,0,11,4,1,1,5,34,39
p_96,7,0,e_2,551,563,586,5,1,0,10,1,1,0,12,23,35
p_84,12,0,e_3,504,534,588,10,1,0,2,5,1,0,30,54,84
p_85,14,0,e_3,517,542,588,7,1,0,7,5,1,0,25,46,71
p_86,14,0,e_3,518,542,588,7,2,0,7,5,1,1,24,46,70
p_91,14,0,e_3,539,542,588,1,2,0,13,5,1,1,3,46,49
p_99,9,0,e_3,556,559,588,1,1,0,10,4,1,0,3,29,32
p_109,10,0,e_2,590,622,666,10,0,0,0,3,0,0,32,44,76
p_112,11,0,e_2,613,627,666,6,1,1,7,5,0,2,14,39,53
p_113,9,0,e_2,629,635,666,3,1,0,11,4,1,1,6,31,37
p_115,9,0,e_2,632,635,666,2,1,0,10,4,1,3,3,31,34
p_111,2,0,e_2,607,658,666,17,1,1,5,5,0,1,51,8,59
p_98,6,0,e_0,555,593,667,4,1,0,3,5,1,1,38,74,112
p_100,10,0,e_0,557,607,667,30,2,2,3,5,1,2,50,60,110
p_103,14,0,e_0,577,621,667,19,1,1,1,5,0,2,44,46,90
p_107,3,0,e_0,584,656,667,28,1,1,3,5,0,3,72,11,83
p_110,12,0,e_3,590,629,667,12,0,0,0,3,0,0,39,38,77
p_106,5,0,e_1,583,588,671,26,1,1,4,5,0,3,5,83,88
p_108,7,0,e_1,584,596,671,24,1,1,4,5,0,4,12,75,87
p_101,9,0,e_1,566,604,671,28,1,1,2,4,1,0,38,67,105
p_105,12,0,e_1,582,615,671,20,1,1,3,5,0,2,33,56,89
p_102,14,0,e_1,568,623,671,23,1,1,1,4,1,1,55,48,103
p_104,14,0,e_1,581,623,671,18,1,1,3,5,0,2,42,48,90
p_116,7,0,e_1,633,646,671,4,1,0,11,4,1,0,13,25,38
p_121,3,0,e_1,656,660,671,1,2,0,4,4,1,1,4,11,15
p_117,0,2,e_0,636,667,675,10,1,0,9,4,1,1,31,8,39
p_123,0,2,e_0,661,667,675,2,2,0,2,4,1,1,6,8,14
p_125,2,0,e_0,668,675,723,24,1,1,0,5,1,1,7,48,55
p_118,8,0,e_0,649,695,723,28,1,1,5,4,1,1,46,28,74
p_126,1,0,e_0,681,718,723,21,1,1,4,5,1,1,37,5,42
p_119,8,0,e_1,650,697,725,28,1,1,6,4,1,0,47,28,75
p_129,5,0,e_1,705,708,725,9,2,1,6,4,1,0,3,17,20
p_120,13,0,e_3,653,708,751,21,1,1,4,4,1,0,55,43,98
p_127,7,0,e_3,701,728,751,8,1,1,11,5,0,1,27,23,50
p_131,7,0,e_3,722,728,751,2,2,0,9,4,1,1,6,23,29
p_122,7,0,e_2,657,689,754,26,2,2,2,1,1,1,32,65,97
p_124,7,0,e_2,664,689,754,24,2,2,0,4,1,2,25,65,90
p_114,13,0,e_2,632,709,754,29,1,1,10,4,1,2,77,45,122
p_130,11,0,e_2,705,717,754,3,2,1,12,5,1,1,12,37,49
p_132,4,0,e_2,730,740,754,3,1,0,7,4,1,0,10,14,24
p_128,0,15,e_0,705,723,772,14,2,2,5,4,1,1,18,49,67
p_140,5,0,e_3,768,785,802,5,0,0,0,3,0,0,17,17,34
p_143,5,0,e_3,780,785,802,2,1,0,3,5,0,1,5,17,22
p_139,0,15,e_2,758,758,807,0,0,0,0,3,0,0,0,49,49
p_133,6,0,e_1,734,754,822,30,1,1,0,3,0,0,20,68,88
p_135,11,0,e_1,739,771,822,23,1,1,1,5,0,1,32,51,83
p_138,12,0,e_1,756,776,822,12,0,0,6,5,1,2,20,46,66
p_137,13,0,e_1,755,781,822,13,0,0,6,5,1,1,26,41,67
p_134,14,0,e_0,734,767,823,21,1,1,3,5,1,0,33,56,89
p_136,14,0,e_0,749,767,823,17,1,1,8,5,1,1,18,56,74
p_142,13,0,e_0,773,780,823,12,1,0,15,4,1,1,7,43,50
p_141,12,0,e_0,770,785,823,12,1,0,15,5,2,0,15,38,53
p_144,6,0,e_3,815,836,858,6,0,0,0,3,0,0,21,22,43
p_145,1,0,e_3,820,853,858,10,1,1,1,5,0,1,33,5,38
p_150,3,0,e_3,860,871,884,3,0,0,0,3,0,0,11,13,24
p_152,2,0,e_3,868,876,884,2,1,1,2,5,0,1,8,8,16
p_146,10,0,e_2,846,863,899,23,2,2,15,3,0,0,17,36,53
p_153,6,0,e_2,872,877,899,27,2,2,8,4,1,0,5,22,27
p_154,4,0,e_2,874,885,899,28,2,2,7,4,1,1,11,14,25
p_147,6,0,e_1,849,870,932,26,2,2,0,3,0,0,21,62,83
p_149,6,0,e_1,859,870,932,6,0,0,2,5,0,1,11,62,73
p_155,11,0,e_1,884,887,932,11,0,0,10,5,1,1,3,45,48
p_151,12,0,e_1,863,892,932,11,1,0,4,5,0,1,29,40,69
p_156,12,0,e_1,884,892,932,12,0,0,10,5,1,2,8,40,48
p_159,8,0,e_1,893,906,932,7,1,0,12,4,1,0,13,26,39
p_157,7,0,e_3,889,912,935,7,0,0,0,3,0,0,23,23,46
p_158,7,0,e_3,892,912,935,7,1,0,0,5,0,1,20,23,43
p_148,15,0,e_0,849,896,943,17,2,2,0,3,0,0,47,47,94
p_3,4,0,e_2,25,40,54,4,0,0,0,3,0,0,15,14,29
p_2,11,0,e_1,19,54,89,11,0,0,0,3,0,0,35,35,70
p_4,5,0,e_3,34,51,94,5,0,0,0,3,0,0,17,43,60
p_5,9,0,e_3,41,65,94,7,1,0,2,5,0,1,24,29,53
p_6,9,0,e_3,45,65,94,6,2,0,3,5,0,2,20,29,49
p_1,13,0,e_0,13,54,95,13,0,0,0,3,0,0,41,41,82
p_12,0,8,e_3,86,94,120,3,1,0,3,4,1,0,8,26,34
p_11,4,0,e_0,84,109,131,29,1,1,3,4,1,0,25,22,47
p_15,5,0,e_0,99,114,131,20,2,2,1,5,0,1,15,17,32
p_19,0,7,e_0,125,131,154,21,2,2,2,4,1,0,6,23,29
p_7,2,0,e_2,55,64,156,10,2,1,0,3,0,0,9,92,101
p_10,9,0,e_2,77,87,156,26,1,1,6,5,1,1,10,69,79
p_8,15,0,e_2,62,107,156,7,2,0,1,5,0,1,45,49,94
p_13,8,0,e_2,87,130,156,24,1,1,9,5,1,1,43,26,69
p_16,4,0,e_1,101,103,157,20,2,2,3,5,0,1,2,54,56
p_9,10,0,e_1,67,123,157,29,1,1,7,4,1,0,56,34,90
p_17,10,0,e_1,112,123,157,11,2,1,6,5,1,1,11,34,45
p_20,3,0,e_1,142,146,157,13,2,1,4,4,1,0,4,11,15
p_21,0,10,e_2,142,156,188,16,2,2,5,4,1,0,14,32,46
p_14,13,0,e_3,87,137,196,19,1,1,2,4,1,0,50,59,109
p_18,15,0,e_3,120,145,196,7,1,0,8,5,0,1,25,51,76
p_25,9,0,e_3,163,165,196,1,2,0,10,4,1,1,2,31,33
p_22,6,0,e_3,146,176,196,9,1,0,15,4,1,0,30,20,50
p_26,6,0,e_3,169,176,196,2,2,0,8,4,1,1,7,20,27
p_23,15,0,e_0,150,180,233,29,2,2,6,5,1,0,30,53,83
p_28,7,0,e_0,184,206,233,27,1,1,14,4,1,1,22,27,49
p_27,5,0,e_0,180,214,233,30,1,1,15,2,0,0,34,19,53
p_33,1,0,e_0,213,228,233,6,2,1,5,1,1,0,15,5,20
p_24,14,0,e_1,157,202,248,27,2,2,0,3,0,0,45,46,91
p_36,1,0,e_1,225,243,248,15,2,1,7,4,1,0,18,5,23
p_29,14,0,e_2,192,206,250,17,1,1,10,3,0,0,14,44,58
p_35,0,6,e_1,222,248,268,17,2,2,8,4,1,0,26,20,46
p_32,0,10,e_1,209,248,282,8,1,1,12,4,1,0,39,34,73
p_30,2,0,e_3,200,209,307,2,0,0,0,3,0,0,9,98,107
p_31,5,0,e_3,203,220,307,5,1,0,0,5,0,1,17,87,104
p_34,11,0,e_3,217,240,307,7,2,0,4,5,1,1,23,67,90
p_37,15,0,e_3,228,254,307,8,2,0,7,5,1,1,26,53,79
p_41,7,0,e_3,257,280,307,8,1,0,15,4,1,0,23,27,50
p_43,4,0,e_3,270,291,307,6,2,1,10,4,1,1,21,16,37
p_47,3,0,e_3,293,296,307,1,1,0,4,4,1,0,3,11,14
p_42,4,0,e_1,269,302,318,7,2,1,6,5,1,0,33,16,49
p_44,4,0,e_1,275,302,318,5,3,1,8,5,1,1,27,16,43
p_49,3,0,e_1,298,307,318,30,1,1,5,4,0,1,9,11,20
p_51,0,4,e_3,309,310,326,0,0,0,0,3,0,0,1,16,17
p_38,12,0,e_0,240,279,331,7,2,1,0,3,0,0,39,52,91
p_39,13,0,e_0,247,284,331,4,2,1,2,5,0,1,37,47,84
p_45,11,0,e_0,290,292,331,23,2,2,12,4,1,0,2,39,41
p_48,9,0,e_0,294,300,331,24,2,2,11,4,1,1,6,31,37
p_46,8,0,e_0,291,305,331,26,1,1,11,4,1,1,14,26,40
p_58,0,6,e_0,330,331,355,23,1,1,0,3,1,0,1,24,25
p_40,15,0,e_2,255,302,357,30,1,1,0,3,0,0,47,55,102
p_50,11,0,e_2,299,316,357,21,1,1,14,5,0,1,17,41,58
p_53,8,0,e_2,313,327,357,20,2,1,12,4,1,1,14,30,44
p_59,3,0,e_2,335,344,357,19,1,1,6,4,1,1,9,13,22
p_57,1,0,e_2,327,352,357,23,1,1,8,4,1,0,25,5,30
p_62,1,0,e_2,345,352,357,17,1,1,3,4,1,1,7,5,12
p_60,2,0,e_0,338,341,375,19,1,1,1,5,1,0,3,34,37
p_65,0,7,e_0,369,375,398,11,1,0,2,4,1,0,6,23,29
p_54,7,0,e_1,313,341,400,21,2,1,1,4,1,0,28,59,87
p_56,8,0,e_1,324,346,400,17,2,1,1,5,0,1,22,54,76
p_61,12,0,e_1,341,360,400,7,1,1,7,2,0,1,19,40,59
p_68,2,0,e_1,389,392,400,2,1,0,3,4,1,0,3,8,11
p_52,14,0,e_3,312,358,404,14,1,0,0,5,1,0,46,46,92
p_55,14,0,e_3,314,358,404,14,2,0,0,5,1,1,44,46,90
p_69,2,0,e_3,391,396,404,2,1,0,4,4,1,0,5,8,13
p_64,0,15,e_0,365,375,424,12,1,0,3,4,1,0,10,49,59
p_63,3,0,e_2,364,376,447,9,1,0,0,3,0,0,12,71,83
p_66,11,0,e_2,376,402,447,27,1,1,3,2,0,0,26,45,71
p_67,12,0,e_2,377,407,447,26,1,1,3,5,1,1,30,40,70
p_73,3,0,e_2,423,436,447,8,1,1,7,4,1,0,13,11,24
p_72,6,0,e_3,417,438,460,6,0,0,0,3,0,0,21,22,43
p_75,3,0,e_3,438,449,460,3,1,0,6,4,1,0,11,11,22
p_71,7,0,e_1,403,426,469,7,0,0,0,3,0,0,23,43,66
p_74,10,0,e_1,424,437,469,8,1,0,7,5,0,1,13,32,45
p_77,4,0,e_0,455,459,475,28,1,1,5,4,0,1,4,16,20
p_70,3,0,e_0,398,464,475,29,1,1,7,5,1,0,66,11,77
p_81,1,0,e_1,493,498,503,7,1,0,0,3,0,0,5,5,10
p_79,9,0,e_3,457,489,518,22,1,1,1,4,1,0,32,29,61
p_76,10,0,e_2,440,479,525,26,2,2,2,4,1,0,39,46,85
p_78,12,0,e_2,455,487,525,20,1,1,2,5,0,1,32,38,70
p_83,0,12,e_1,501,503,541,6,1,0,1,4,1,0,2,38,40
p_82,0,12,e_3,494,518,556,8,1,0,8,4,1,0,24,38,62
p_80,13,0,e_0,474,516,565,9,1,0,0,3,1,0,42,49,91
p_89,5,0,e_0,535,542,565,18,2,2,7,4,1,0,7,23,30
p_93,4,0,e_0,543,547,565,16,2,2,5,4,1,1,4,18,22
p_94,3,0,e_0,546,552,565,16,2,2,4,4,1,2,6,13,19
p_90,1,0,e_0,538,560,565,21,2,2,6,4,1,1,22,5,27
p_87,3,0,e_2,528,539,598,22,2,2,0,3,0,0,11,59,70
p_96,7,0,e_2,551,553,598,11,2,2,7,5,1,1,2,45,47
p_88,10,0,e_2,531,564,598,14,2,2,0,5,0,1,33,34,67
p_92,10,0,e_2,540,564,598,11,2,2,3,5,1,1,24,34,58
p_98,6,0,e_2,555,578,598,10,2,1,7,5,1,1,23,20,43
p_84,12,0,e_1,504,541,599,22,1,1,0,5,1,0,37,58,95
p_86,14,0,e_1,518,549,599,14,1,1,4,5,1,0,31,50,81
p_91,14,0,e_1,539,549,599,8,2,0,12,5,1,1,10,50,60
p_95,10,0,e_1,547,563,599,9,2,2,14,5,1,1,16,36,52
p_100,10,0,e_1,557,563,599,6,2,1,12,4,1,2,6,36,42
p_97,5,0,e_1,552,580,599,12,2,2,13,4,1,1,28,19,47
p_107,3,0,e_1,584,588,599,5,3,2,4,4,1,0,4,11,15
p_85,14,0,e_3,517,564,614,14,0,0,0,3,1,0,47,50,97
p_99,9,0,e_3,556,581,614,7,1,1,12,2,1,1,25,33,58
p_108,7,0,e_3,584,589,614,1,2,0,8,4,1,1,5,25,30
p_106,5,0,e_3,583,597,614,4,1,0,9,4,1,0,14,17,31
p_101,9,0,e_0,566,595,662,5,2,0,0,3,0,0,29,67,96
p_105,12,0,e_0,582,606,662,27,1,1,5,5,0,2,24,56,80
p_102,14,0,e_0,568,614,662,29,2,2,0,5,0,1,46,48,94
p_103,14,0,e_0,577,614,662,26,2,2,3,5,0,2,37,48,85
p_104,14,0,e_0,581,614,662,25,1,1,4,5,0,2,33,48,81
p_112,11,0,e_0,613,625,662,19,1,1,14,5,1,1,12,37,49
p_116,7,0,e_0,633,639,662,11,1,1,9,4,1,0,6,23,29
p_109,10,0,e_1,590,631,665,27,2,2,3,4,1,0,41,34,75
p_111,2,0,e_1,607,657,665,30,1,1,2,5,0,1,50,8,58
p_117,0,2,e_0,636,662,672,17,1,1,8,4,1,1,26,10,36
p_123,0,2,e_0,661,662,672,17,2,2,0,3,1,0,1,10,11
p_125,2,0,e_1,668,676,684,13,2,1,0,3,0,0,8,8,16
p_110,12,0,e_2,590,636,690,25,2,2,3,4,1,0,46,54,100
p_114,13,0,e_2,632,641,690,13,1,0,11,5,0,1,9,49,58
p_118,8,0,e_2,649,658,690,4,1,1,11,4,1,0,9,32,41
p_119,8,0,e_2,650,658,690,4,1,1,11,4,1,1,8,32,40
p_122,7,0,e_2,657,663,690,11,2,2,8,4,1,2,6,27,33
p_121,3,0,e_2,656,677,690,15,2,2,9,4,1,1,21,13,34
p_126,1,0,e_2,681,685,690,10,1,0,2,4,1,0,4,5,9
p_124,7,0,e_0,664,689,712,9,2,1,0,2,1,0,25,23,48
p_113,9,0,e_3,629,659,714,9,0,0,0,3,0,0,30,55,85
p_115,9,0,e_3,632,659,714,9,1,0,0,5,0,1,27,55,82
p_120,13,0,e_3,653,673,714,6,1,0,7,5,0,1,20,41,61
p_129,5,0,e_2,705,723,740,28,1,1,0,3,0,0,18,17,35
p_128,0,15,e_0,705,712,759,3,1,0,2,4,1,0,7,47,54
p_132,4,0,e_3,730,737,773,8,1,1,2,5,0,1,7,36,43
p_133,6,0,e_3,734,745,773,5,2,1,3,5,0,2,11,28,39
p_131,7,0,e_3,722,750,773,7,0,0,0,3,0,0,28,23,51
p_127,7,0,e_1,701,725,798,27,1,1,0,3,0,0,24,73,97
p_130,11,0,e_1,705,739,798,22,1,1,0,5,0,1,34,59,93
p_134,14,0,e_1,734,750,798,11,2,0,9,5,1,1,16,48,64
p_138,12,0,e_1,756,758,798,24,1,1,13,4,1,0,2,40,42
p_140,5,0,e_1,768,781,798,26,1,1,9,4,1,0,13,17,30
p_137,13,0,e_0,755,767,812,23,1,1,14,5,1,0,12,45,57
p_141,12,0,e_0,770,772,812,19,1,1,13,4,1,0,2,40,42
p_143,5,0,e_0,780,795,812,23,1,1,10,4,1,0,15,17,32
p_139,0,15,e_3,758,773,820,5,1,0,5,4,1,0,15,47,62
p_145,1,0,e_1,820,826,831,14,0,0,0,3,0,0,6,5,11
p_135,11,0,e_2,739,775,832,7,3,0,0,3,1,0,36,57,93
p_142,13,0,e_2,773,783,832,17,1,1,10,5,0,2,10,49,59
p_136,14,0,e_2,749,788,832,21,1,0,3,5,0,1,39,44,83
p_144,6,0,e_0,815,836,856,10,1,1,0,3,0,0,21,20,41
p_146,10,0,e_3,846,864,900,5,0,0,15,3,0,0,18,36,54
p_153,6,0,e_3,872,878,900,2,2,0,8,4,1,1,6,22,28
p_152,2,0,e_3,868,892,900,7,1,0,9,4,1,0,24,8,32
p_150,3,0,e_0,860,871,904,8,1,1,0,3,0,1,11,33,44
p_154,4,0,e_0,874,876,904,3,3,1,4,5,1,1,2,28,30
p_149,6,0,e_0,859,884,904,6,1,1,0,3,0,0,25,20,45
p_147,6,0,e_2,849,870,932,9,1,1,0,3,0,0,21,62,83
p_151,12,0,e_2,863,890,932,18,1,1,4,5,0,1,27,42,69
p_156,12,0,e_2,884,890,932,23,2,2,10,5,1,1,6,42,48
p_159,8,0,e_2,893,904,932,24,1,1,12,4,1,1,11,28,39
p_157,7,0,e_2,889,909,932,26,2,2,12,2,1,0,20,23,43
p_158,7,0,e_2,892,909,932,25,1,1,12,4,1,1,17,23,40
p_148,15,0,e_1,849,896,945,20,1,1,0,3,0,0,47,49,96
p_155,11,0,e_1,884,910,945,23,2,2,11,5,0,1,26,35,61
p_3,4,0,e_2,25,39,87,4,0,0,0,3,0,0,14,48,62
p_4,5,0,e_2,34,44,87,5,0,0,2,5,0,1,10,43,53
p_5,9,0,e_2,41,58,87,9,0,0,4,5,1,1,17,29,46
p_6,9,0,e_2,45,58,87,9,0,0,5,5,1,1,13,29,42
p_2,11,0,e_1,19,54,89,11,0,0,0,3,0,0,35,35,70
p_1,13,0,e_0,13,54,95,13,0,0,0,3,0,0,41,41,82
p_12,0,8,e_2,86,87,115,21,4,4,0,3,1,0,1,28,29
p_16,4,0,e_1,101,116,130,13,3,1,0,3,0,0,15,14,29
p_15,5,0,e_0,99,117,134,13,4,2,0,3,0,0,18,17,35
p_19,0,7,e_1,125,130,155,11,2,0,1,4,1,0,5,25,30
p_7,2,0,e_3,55,63,159,2,0,0,0,3,0,0,8,96,104
p_10,9,0,e_3,77,86,159,15,3,2,6,5,1,2,9,73,82
p_9,10,0,e_3,67,91,159,17,2,1,3,5,1,1,24,68,92
p_14,13,0,e_3,87,102,159,8,4,1,9,5,1,3,15,57,72
p_8,15,0,e_3,62,110,159,13,1,0,2,5,0,1,48,49,97
p_11,4,0,e_3,84,145,159,17,4,2,9,5,1,3,61,14,75
p_21,0,10,e_0,142,142,180,5,2,0,0,3,0,1,0,38,38
p_13,8,0,e_2,87,115,187,13,5,3,0,5,1,1,28,72,100
p_17,10,0,e_2,112,123,187,5,2,0,7,5,1,0,11,64,75
p_18,15,0,e_2,120,140,187,27,2,2,9,5,1,1,20,47,67
p_26,6,0,e_3,169,190,212,6,0,0,0,3,0,0,21,22,43
p_30,2,0,e_3,200,204,212,1,1,0,3,4,1,0,4,8,12
p_20,3,0,e_0,142,155,216,2,2,1,0,3,0,0,13,61,74
p_25,9,0,e_0,163,175,216,9,0,0,5,5,2,0,12,41,53
p_28,7,0,e_0,184,191,216,3,1,0,9,4,1,1,7,25,32
p_27,5,0,e_0,180,199,216,4,1,1,10,4,1,0,19,17,36
p_22,6,0,e_1,146,150,234,28,1,1,5,5,1,0,4,84,88
p_24,14,0,e_1,157,178,234,16,1,1,7,5,1,1,21,56,77
p_23,15,0,e_1,150,183,234,18,1,1,6,2,1,0,33,51,84
p_31,5,0,e_1,203,215,234,27,2,2,9,4,1,0,12,19,31
p_33,1,0,e_1,213,229,234,19,1,1,5,4,1,1,16,5,21
p_36,1,0,e_1,225,229,234,17,2,2,2,4,1,1,4,5,9
p_32,0,10,e_3,209,212,244,1,1,0,1,4,1,0,3,32,35
p_35,0,6,e_0,222,222,244,19,2,2,0,3,0,0,0,22,22
p_34,11,0,e_3,217,249,294,10,1,0,1,5,1,0,32,45,77
p_38,12,0,e_3,240,254,294,3,2,0,9,5,1,1,14,40,54
p_43,4,0,e_3,270,280,294,3,1,0,7,4,1,0,10,14,24
p_29,14,0,e_2,192,237,295,22,1,1,0,3,0,0,45,58,103
p_37,15,0,e_2,228,242,295,10,2,0,11,5,0,1,14,53,67
p_39,13,0,e_2,247,250,295,2,2,0,14,4,1,0,3,45,48
p_41,7,0,e_2,257,270,295,4,1,0,11,4,1,0,13,25,38
p_42,4,0,e_2,269,281,295,3,1,0,7,1,1,0,12,14,26
p_44,4,0,e_2,275,281,295,2,2,0,6,4,1,1,6,14,20
p_51,0,4,e_2,309,309,325,0,0,0,0,3,0,0,0,16,16
p_40,15,0,e_0,255,285,342,27,1,1,6,3,0,0,30,57,87
p_45,11,0,e_0,290,299,342,20,1,1,14,4,1,0,9,43,52
p_48,9,0,e_0,294,307,342,9,0,0,12,4,1,2,13,35,48
p_46,8,0,e_0,291,312,342,23,1,1,13,4,1,1,21,30,51
p_54,7,0,e_0,313,317,342,7,0,0,8,4,1,0,4,25,29
p_57,1,0,e_0,327,337,342,11,1,1,4,4,1,0,10,5,15
p_58,0,6,e_0,330,342,362,11,1,1,3,4,1,1,12,20,32
p_53,8,0,e_3,313,340,368,8,0,0,0,3,0,0,27,28,55
p_62,1,0,e_3,345,363,368,6,1,0,7,4,1,0,18,5,23
p_56,8,0,e_2,324,339,369,5,1,0,4,3,1,0,15,30,45
p_59,3,0,e_2,335,356,369,7,1,1,7,5,0,1,21,13,34
p_60,2,0,e_2,338,361,369,7,1,1,8,5,0,2,23,8,31
p_63,3,0,e_0,364,375,386,28,1,1,6,3,0,0,11,11,22
p_47,3,0,e_1,293,304,387,27,1,1,0,3,0,0,11,83,94
p_49,3,0,e_1,298,304,387,3,0,0,1,5,0,1,6,83,89
p_50,11,0,e_1,299,330,387,11,0,0,2,5,0,1,31,57,88
p_52,14,0,e_1,312,341,387,14,0,0,5,5,1,1,29,46,75
p_55,14,0,e_1,314,341,387,14,1,0,6,5,1,2,27,46,73
p_61,12,0,e_1,341,349,387,26,1,1,14,4,1,0,8,38,46
p_65,0,7,e_2,369,369,394,0,0,0,0,3,1,0,0,25,25
p_68,2,0,e_0,389,398,406,18,2,2,0,3,0,0,9,8,17
p_64,0,15,e_2,365,369,420,1,1,0,1,4,1,0,4,51,55
p_69,2,0,e_1,391,399,443,17,2,2,0,3,0,0,8,44,52
p_70,3,0,e_1,398,404,443,14,2,2,2,5,0,1,6,39,45
p_71,7,0,e_1,403,418,443,9,2,2,3,5,1,1,15,25,40
p_72,6,0,e_1,417,423,443,6,1,0,7,5,1,1,6,20,26
p_73,3,0,e_0,423,435,446,7,1,0,0,3,0,0,12,11,23
p_66,11,0,e_3,376,411,456,11,0,0,0,3,0,0,35,45,80
p_67,12,0,e_3,377,416,456,12,1,0,0,5,0,1,39,40,79
p_75,3,0,e_3,438,445,456,2,1,0,5,4,1,0,7,11,18
p_74,10,0,e_2,424,442,476,30,1,1,15,3,0,0,18,34,52
p_76,10,0,e_2,440,442,476,25,2,2,11,4,0,1,2,34,36
p_77,4,0,e_2,455,462,476,26,1,1,6,4,1,0,7,14,21
p_81,1,0,e_2,493,499,504,1,0,0,0,3,0,0,6,5,11
p_79,9,0,e_1,457,487,516,9,0,0,0,3,0,0,30,29,59
p_82,0,12,e_3,494,495,535,0,0,0,0,3,0,0,1,40,41
p_78,12,0,e_0,455,493,541,18,1,1,0,3,0,0,38,48,86
p_80,13,0,e_0,474,498,541,13,0,0,6,5,0,1,24,43,67
p_87,3,0,e_0,528,530,541,15,2,2,4,4,1,0,2,11,13
p_83,0,12,e_2,501,504,544,23,1,1,1,4,1,0,3,40,43
p_94,3,0,e_0,546,554,581,10,1,0,1,5,0,1,8,27,35
p_93,4,0,e_0,543,559,581,18,1,0,0,3,0,0,16,22,38
p_97,5,0,e_0,552,564,581,6,1,0,3,5,0,2,12,17,29
p_88,10,0,e_2,531,536,586,7,2,2,9,5,1,0,5,50,55
p_92,10,0,e_2,540,552,586,5,2,1,11,5,2,0,12,34,46
p_95,10,0,e_2,547,552,586,3,1,0,11,4,1,1,5,34,39
p_98,6,0,e_2,555,566,586,4,1,0,9,4,1,0,11,20,31
p_84,12,0,e_3,504,535,589,10,1,0,2,5,1,0,31,54,85
p_85,14,0,e_3,517,543,589,8,1,0,6,5,1,0,26,46,72
p_86,14,0,e_3,518,543,589,7,2,0,7,5,1,1,25,46,71
p_91,14,0,e_3,539,543,589,1,2,0,13,5,1,1,4,46,50
p_99,9,0,e_3,556,560,589,1,1,0,10,4,1,0,4,29,33
p_107,3,0,e_0,584,595,634,28,1,1,0,3,0,2,11,39,50
p_106,5,0,e_0,583,603,634,27,1,1,0,3,0,0,20,31,51
p_108,7,0,e_0,584,611,634,24,1,1,0,3,0,1,27,23,50
p_90,1,0,e_1,538,540,639,15,2,1,1,5,0,1,2,99,101
p_89,5,0,e_1,535,554,639,11,1,1,0,3,0,0,19,85,104
p_96,7,0,e_1,551,562,639,5,1,0,4,5,1,1,11,77,88
p_101,9,0,e_1,566,570,639,28,1,1,8,5,1,1,4,69,73
p_100,10,0,e_1,557,575,639,30,2,2,5,5,1,1,18,64,82
p_105,12,0,e_1,582,583,639,20,1,1,12,5,1,1,1,56,57
p_102,14,0,e_1,568,591,639,23,1,1,9,5,1,2,23,48,71
p_103,14,0,e_1,577,591,639,20,1,1,10,5,1,1,14,48,62
p_104,14,0,e_1,581,591,639,19,1,1,11,5,1,1,10,48,58
p_110,12,0,e_1,590,599,639,12,0,0,14,5,1,2,9,40,49
p_109,10,0,e_1,590,607,639,10,0,0,14,5,1,1,17,32,49
p_117,0,2,e_0,636,637,647,17,2,2,0,3,0,0,1,10,11
p_121,3,0,e_1,656,668,681,8,2,1,0,3,0,0,12,13,25
p_125,2,0,e_1,668,673,681,6,2,1,3,2,0,1,5,8,13
p_123,0,2,e_1,661,681,689,10,3,3,1,5,0,1,20,8,28
p_116,7,0,e_3,633,656,695,11,1,1,0,5,0,1,23,39,62
p_115,9,0,e_3,632,664,695,9,0,0,0,3,0,0,32,31,63
p_122,7,0,e_3,657,672,695,4,2,1,7,5,1,1,15,23,38
p_124,7,0,e_3,664,672,695,2,2,0,9,4,1,1,8,23,31
p_111,2,0,e_2,607,615,695,2,0,0,0,3,0,0,8,80,88
p_113,9,0,e_2,629,638,695,9,0,0,6,5,1,1,9,57,66
p_112,11,0,e_2,613,646,695,11,0,0,2,5,0,1,33,49,82
p_114,13,0,e_2,632,654,695,13,0,0,7,5,1,2,22,41,63
p_120,13,0,e_2,653,654,695,7,2,0,13,5,1,1,1,41,42
p_118,8,0,e_0,649,669,697,5,2,1,2,3,0,0,20,28,48
p_119,8,0,e_0,650,669,697,5,2,1,2,5,0,1,19,28,47
p_126,1,0,e_0,681,692,697,3,1,0,4,4,1,0,11,5,16
p_129,5,0,e_0,705,723,740,5,0,0,0,3,0,0,18,17,35
p_128,0,15,e_2,705,706,757,0,0,0,0,3,0,0,1,51,52
p_127,7,0,e_1,701,719,770,7,0,0,2,3,0,0,18,51,69
p_130,11,0,e_1,705,733,770,11,0,0,2,5,0,1,28,37,65
p_133,6,0,e_1,734,750,770,5,2,1,11,4,1,0,16,20,36
p_132,4,0,e_3,730,737,799,8,1,1,2,5,0,1,7,62,69
p_131,7,0,e_3,722,748,799,7,0,0,0,3,0,0,26,51,77
p_135,11,0,e_3,739,762,799,7,2,0,4,5,1,1,23,37,60
p_140,5,0,e_3,768,782,799,4,1,0,9,4,1,0,14,17,31
p_143,5,0,e_3,780,782,799,1,2,0,6,4,1,1,2,17,19
p_134,14,0,e_2,734,752,808,11,2,0,8,5,1,0,18,56,74
p_136,14,0,e_2,749,752,808,7,2,0,13,5,1,1,3,56,59
p_137,13,0,e_2,755,765,808,4,2,0,15,5,2,0,10,43,53
p_138,12,0,e_2,756,770,808,3,2,0,15,2,2,1,14,38,52
p_139,0,15,e_0,758,759,808,12,2,2,0,3,0,0,1,49,50
p_145,1,0,e_3,820,826,831,1,0,0,0,3,0,0,6,5,11
p_144,6,0,e_2,815,835,855,6,0,0,0,3,0,0,20,20,40
p_141,12,0,e_1,770,809,855,27,2,2,0,3,0,0,39,46,85
p_142,13,0,e_1,773,814,855,25,2,2,0,5,0,1,41,41,82
p_150,3,0,e_2,860,871,884,24,2,2,0,3,0,0,11,13,24
p_152,2,0,e_2,868,876,884,22,1,1,2,5,0,1,8,8,16
p_146,10,0,e_0,846,864,900,10,0,0,15,3,0,0,18,36,54
p_153,6,0,e_0,872,878,900,17,2,1,8,4,1,0,6,22,28
p_154,4,0,e_0,874,886,900,19,2,1,7,4,1,1,12,14,26
p_149,6,0,e_1,859,879,939,21,2,1,0,3,0,0,20,60,80
p_155,11,0,e_1,884,896,939,8,2,1,7,5,1,1,12,43,55
p_151,12,0,e_1,863,901,939,14,2,1,1,5,0,1,38,38,76
p_156,12,0,e_1,884,901,939,7,2,1,7,5,1,2,17,38,55
p_157,7,0,e_2,889,912,943,11,2,1,0,3,0,0,23,31,54
p_158,7,0,e_2,892,912,943,10,2,1,1,5,0,1,20,31,51
p_159,8,0,e_2,893,917,943,9,2,1,1,5,0,1,24,26,50
p_147,6,0,e_3,849,869,945,6,0,0,0,3,0,0,20,76,96
p_148,15,0,e_3,849,898,945,15,1,1,0,3,0,1,49,47,96
p_3,4,0,e_2,25,40,88,4,0,0,0,3,0,0,15,48,63
p_4,5,0,e_2,34,45,88,5,0,0,2,5,0,1,11,43,54
p_5,9,0,e_2,41,59,88,9,0,0,4,5,1,1,18,29,47
p_6,9,0,e_2,45,59,88,9,0,0,5,5,1,1,14,29,43
p_2,11,0,e_1,19,54,89,11,0,0,0,3,0,0,35,35,70
p_1,13,0,e_0,13,54,95,13,0,0,0,3,0,0,41,41,82
p_12,0,8,e_1,86,89,115,21,4,4,1,4,1,0,3,26,29
p_16,4,0,e_0,101,114,136,13,4,1,0,5,0,1,13,22,35
p_15,5,0,e_0,99,119,136,13,4,2,0,3,0,0,20,17,37
p_19,0,7,e_0,125,136,159,10,2,0,4,4,1,0,11,23,34
p_7,2,0,e_3,55,63,161,2,0,0,0,3,0,0,8,98,106
p_10,9,0,e_3,77,86,161,15,3,2,6,5,1,2,9,75,84
p_9,10,0,e_3,67,91,161,17,2,1,3,5,1,1,24,70,94
p_14,13,0,e_3,87,102,161,8,4,1,9,5,1,3,15,59,74
p_8,15,0,e_3,62,110,161,17,0,0,2,2,0,0,48,51,99
p_11,4,0,e_3,84,145,161,18,4,3,8,5,1,3,61,16,77
p_20,3,0,e_3,142,150,161,2,2,1,5,4,1,1,8,11,19
p_22,6,0,e_1,146,154,174,28,2,2,8,3,0,0,8,20,28
p_13,8,0,e_2,87,114,186,13,5,3,0,3,1,0,27,72,99
p_17,10,0,e_2,112,122,186,5,2,0,8,5,0,1,10,64,74
p_18,15,0,e_2,120,139,186,27,2,2,9,5,1,1,19,47,66
p_21,0,10,e_3,142,161,197,5,2,0,5,4,1,1,19,36,55
p_30,2,0,e_2,200,209,217,16,2,1,0,3,0,0,9,8,17
p_27,5,0,e_1,180,197,232,9,3,2,0,3,0,0,17,35,52
p_28,7,0,e_1,184,205,232,7,3,2,1,5,0,1,21,27,48
p_31,5,0,e_1,203,213,232,11,2,1,7,5,1,1,10,19,29
p_33,1,0,e_1,213,227,232,13,1,0,5,4,1,0,14,5,19
p_36,1,0,e_1,225,227,232,9,1,0,2,4,1,1,2,5,7
p_24,14,0,e_0,157,182,234,17,1,1,7,5,1,1,25,52,77
p_23,15,0,e_0,150,187,234,18,1,1,4,5,1,0,37,47,84
p_32,0,10,e_2,209,217,249,14,2,2,2,4,1,0,8,32,40
p_35,0,6,e_1,222,232,252,11,1,0,2,4,1,1,10,20,30
p_26,6,0,e_3,169,181,257,12,2,2,2,5,1,1,12,76,88
p_25,9,0,e_3,163,192,257,11,1,1,0,5,1,0,29,65,94
p_29,14,0,e_3,192,211,257,5,2,0,9,5,2,0,19,46,65
p_34,11,0,e_3,217,222,257,1,1,0,12,4,1,0,5,35,40
p_42,4,0,e_3,269,283,297,4,0,0,0,3,0,0,14,14,28
p_43,4,0,e_3,270,283,297,4,1,0,0,5,0,1,13,14,27
p_44,4,0,e_3,275,283,297,3,1,0,1,5,0,1,8,14,22
p_41,7,0,e_0,257,281,304,7,0,0,0,3,0,0,24,23,47
p_38,12,0,e_1,240,272,312,23,1,1,2,5,1,0,32,40,72
p_47,3,0,e_1,293,301,312,28,3,3,5,4,1,0,8,11,19
p_49,3,0,e_1,298,301,312,19,3,3,4,4,1,1,3,11,14
p_39,13,0,e_2,247,260,315,20,1,1,9,5,1,1,13,55,68
p_37,15,0,e_2,228,268,315,25,1,1,3,5,1,0,40,47,87
p_40,15,0,e_2,255,268,315,15,1,1,11,5,0,2,13,47,60
p_51,0,4,e_0,309,309,325,19,3,3,0,3,0,0,0,16,16
p_57,1,0,e_2,327,332,337,18,4,2,0,3,0,0,5,5,10
p_58,0,6,e_2,330,337,357,19,3,3,0,5,0,1,7,20,27
p_54,7,0,e_1,313,336,363,16,4,4,0,3,0,0,23,27,50
p_60,2,0,e_1,338,353,363,15,2,1,7,4,1,0,15,10,25
p_62,1,0,e_1,345,358,363,14,3,1,4,4,1,1,13,5,18
p_53,8,0,e_0,313,339,367,15,4,3,0,5,1,0,26,28,54
p_56,8,0,e_0,324,339,367,12,4,3,4,5,1,1,15,28,43
p_59,3,0,e_0,335,356,367,14,3,1,7,5,0,1,21,11,32
p_63,3,0,e_1,364,375,386,7,1,0,0,3,0,0,11,11,22
p_46,8,0,e_3,291,323,393,24,2,2,2,4,1,1,32,70,102
p_48,9,0,e_3,294,328,393,22,3,3,1,4,1,2,34,65,99
p_45,11,0,e_3,290,336,393,21,1,1,2,4,1,0,46,57,103
p_50,11,0,e_3,299,336,393,11,3,0,0,5,0,3,37,57,94
p_52,14,0,e_3,312,347,393,10,3,0,4,5,0,3,35,46,81
p_55,14,0,e_3,314,347,393,9,4,0,5,5,0,4,33,46,79
p_61,12,0,e_3,341,355,393,4,2,1,12,5,1,1,14,38,52
p_65,0,7,e_1,369,386,411,8,1,0,1,5,0,1,17,25,42
p_64,0,15,e_0,365,367,414,9,1,0,1,4,1,0,2,47,49
p_70,3,0,e_3,398,409,420,3,0,0,0,3,0,0,11,11,22
p_68,2,0,e_1,389,394,434,29,1,1,1,5,1,0,5,40,45
p_69,2,0,e_1,391,394,434,29,1,1,1,5,1,1,3,40,43
p_71,7,0,e_1,403,411,434,6,1,0,4,5,2,0,8,23,31
p_66,11,0,e_2,376,394,439,24,1,1,6,3,0,0,18,45,63
p_67,12,0,e_2,377,399,439,23,1,1,6,3,0,1,22,40,62
p_73,3,0,e_2,423,428,439,3,0,0,4,4,1,0,5,11,16
p_75,3,0,e_1,438,449,460,3,0,0,0,3,0,0,11,11,22
p_74,10,0,e_0,424,434,468,10,0,0,13,4,0,1,10,34,44
p_72,6,0,e_0,417,448,468,25,1,1,15,3,0,0,31,20,51
p_81,1,0,e_0,493,498,503,6,1,0,0,3,0,0,5,5,10
p_77,4,0,e_3,455,469,515,4,0,0,0,3,0,0,14,46,60
p_79,9,0,e_3,457,486,515,9,1,0,0,5,0,1,29,29,58
p_76,10,0,e_2,440,472,526,10,0,0,0,3,0,0,32,54,86
p_78,12,0,e_2,455,480,526,12,1,0,5,5,0,1,25,46,71
p_80,13,0,e_2,474,485,526,8,2,0,10,5,1,1,11,41,52
p_82,0,12,e_1,494,495,535,7,1,0,0,3,0,0,1,40,41
p_83,0,12,e_0,501,503,543,4,1,0,0,4,1,0,2,40,42
p_90,1,0,e_3,538,544,549,1,0,0,0,3,0,0,6,5,11
p_87,3,0,e_2,528,539,568,3,0,0,0,3,0,0,11,29,40
p_93,4,0,e_2,543,544,568,3,1,0,4,5,1,1,1,24,25
p_89,5,0,e_2,535,549,568,5,0,0,2,5,0,1,14,19,33
p_94,3,0,e_2,546,557,568,28,1,1,4,5,1,1,11,11,22
p_88,10,0,e_0,531,535,587,10,0,0,9,5,1,0,4,52,56
p_92,10,0,e_0,540,551,587,10,1,0,11,5,2,0,11,36,47
p_95,10,0,e_0,547,551,587,21,1,1,11,4,1,1,4,36,40
p_96,7,0,e_0,551,562,587,7,0,0,10,1,1,0,11,25,36
p_98,6,0,e_0,555,567,587,6,1,0,9,4,1,1,12,20,32
p_84,12,0,e_1,504,535,589,22,1,1,2,5,1,0,31,54,85
p_85,14,0,e_1,517,543,589,14,0,0,6,5,1,0,26,46,72
p_86,14,0,e_1,518,543,589,14,0,0,6,5,1,1,25,46,71
p_91,14,0,e_1,539,543,589,14,1,1,13,5,1,1,4,46,50
p_99,9,0,e_1,556,560,589,9,1,0,10,4,1,0,4,29,33
p_111,2,0,e_0,607,616,624,12,1,0,0,3,0,0,9,8,17
p_97,5,0,e_3,552,570,651,5,0,0,0,3,0,0,18,81,99
p_101,9,0,e_3,566,584,651,7,2,1,4,5,0,2,18,67,85
p_100,10,0,e_3,557,589,651,9,1,0,1,5,0,1,32,62,94
p_105,12,0,e_3,582,597,651,8,4,1,8,5,1,3,15,54,69
p_110,12,0,e_3,590,597,651,6,3,1,10,5,1,2,7,54,61
p_102,14,0,e_3,568,605,651,10,3,0,4,5,0,3,37,46,83
p_103,14,0,e_3,577,605,651,7,4,0,7,5,1,3,28,46,74
p_104,14,0,e_3,581,605,651,6,4,0,8,5,1,3,24,46,70
p_112,11,0,e_3,613,616,651,1,1,0,12,4,1,0,3,35,38
p_107,3,0,e_2,584,594,653,16,4,3,0,5,0,1,10,59,69
p_106,5,0,e_2,583,602,653,14,4,3,0,3,0,0,19,51,70
p_108,7,0,e_2,584,610,653,12,4,3,0,5,0,2,26,43,69
p_109,10,0,e_2,590,621,653,8,3,2,2,5,0,3,31,32,63
p_117,0,2,e_2,636,653,661,5,1,0,5,4,1,0,17,8,25
p_123,0,2,e_3,661,662,672,0,0,0,0,3,0,0,1,10,11
p_125,2,0,e_3,668,672,680,1,1,0,1,5,1,0,4,8,12
p_126,1,0,e_3,681,686,691,1,0,0,0,3,0,0,5,5,10
p_121,3,0,e_2,656,666,703,3,0,0,1,5,1,0,10,37,47
p_122,7,0,e_2,657,680,703,7,0,0,1,5,1,1,23,23,46
p_124,7,0,e_2,664,680,703,7,1,0,2,5,0,2,16,23,39
p_118,8,0,e_0,649,656,716,23,1,1,6,5,0,1,7,60,67
p_119,8,0,e_0,650,656,716,8,0,0,6,5,0,2,6,60,66
p_113,9,0,e_0,629,661,716,28,1,1,0,3,0,0,32,55,87
p_115,9,0,e_0,632,661,716,27,1,1,0,5,0,1,29,55,84
p_120,13,0,e_0,653,675,716,13,0,0,7,5,0,2,22,41,63
p_116,7,0,e_1,633,656,717,29,1,1,0,3,0,1,23,61,84
p_114,13,0,e_1,632,676,717,23,1,1,0,3,0,0,44,41,85
p_129,5,0,e_2,705,722,739,9,1,1,0,3,0,0,17,17,34
p_128,0,15,e_0,705,716,763,13,1,1,3,4,1,0,11,47,58
p_132,4,0,e_1,730,736,772,10,2,1,2,5,0,1,6,36,42
p_133,6,0,e_1,734,744,772,7,2,1,3,5,0,2,10,28,38
p_131,7,0,e_1,722,749,772,9,2,1,0,3,0,0,27,23,50
p_127,7,0,e_3,701,725,802,7,0,0,0,3,0,0,24,77,101
p_130,11,0,e_3,705,739,802,10,1,0,1,5,0,1,34,63,97
p_135,11,0,e_3,739,741,802,6,2,1,11,5,1,1,2,61,63
p_134,14,0,e_3,734,752,802,5,2,0,9,5,1,1,18,50,68
p_136,14,0,e_3,749,752,802,1,2,0,13,5,1,1,3,50,53
p_137,13,0,e_3,755,757,802,1,1,0,14,4,1,0,2,45,47
p_138,12,0,e_3,756,762,802,1,2,0,13,4,1,1,6,40,46
p_140,5,0,e_3,768,785,802,6,1,0,11,4,1,0,17,17,34
p_143,5,0,e_3,780,785,802,2,2,0,7,4,1,1,5,17,22
p_139,0,15,e_2,758,758,807,13,2,0,0,3,0,0,0,49,49
p_142,13,0,e_0,773,778,821,26,2,2,15,4,0,1,5,43,48
p_141,12,0,e_0,770,783,821,28,2,2,15,3,0,0,13,38,51
p_145,1,0,e_3,820,826,831,1,0,0,0,3,0,0,6,5,11
p_144,6,0,e_1,815,836,856,6,0,0,0,3,0,0,21,20,41
p_150,3,0,e_1,860,871,884,6,1,1,0,3,0,0,11,13,24
p_152,2,0,e_1,868,876,884,17,2,2,2,5,0,1,8,8,16
p_146,10,0,e_2,846,863,899,10,0,0,15,3,0,0,17,36,53
p_153,6,0,e_2,872,877,899,12,2,1,8,4,1,0,5,22,27
p_154,4,0,e_2,874,885,899,13,2,1,7,4,1,1,11,14,25
p_147,6,0,e_3,849,870,932,6,0,0,0,3,0,0,21,62,83
p_149,6,0,e_3,859,870,932,3,1,0,3,5,0,1,11,62,73
p_155,11,0,e_3,884,887,932,3,2,1,10,5,1,1,3,45,48
p_151,12,0,e_3,863,892,932,8,1,0,4,5,0,1,29,40,69
p_156,12,0,e_3,884,892,932,2,3,0,10,5,1,2,8,40,48
p_159,8,0,e_3,893,906,932,4,1,0,12,4,1,0,13,26,39
p_157,7,0,e_1,889,912,935,6,2,1,0,3,0,0,23,23,46
p_158,7,0,e_1,892,912,935,19,1,0,0,5,0,1,20,23,43
p_148,15,0,e_0,849,897,944,15,0,0,0,3,0,0,48,47,95
p_3,4,0,e_2,25,39,53,4,0,0,0,3,0,0,14,14,28
p_2,11,0,e_1,19,54,89,11,0,0,0,3,0,0,35,35,70
p_4,5,0,e_3,34,51,94,5,0,0,0,3,0,0,17,43,60
p_5,9,0,e_3,41,65,94,7,1,0,2,5,0,1,24,29,53
p_6,9,0,e_3,45,65,94,6,2,0,3,5,0,2,20,29,49
p_1,13,0,e_0,13,54,95,13,0,0,0,3,0,0,41,41,82
p_12,0,8,e_1,86,89,115,2,2,0,1,4,1,1,3,26,29
p_11,4,0,e_3,84,108,130,29,1,1,3,4,1,0,24,22,46
p_15,5,0,e_3,99,113,130,4,1,0,1,5,0,1,14,17,31
p_19,0,7,e_3,125,130,153,1,1,0,1,4,1,0,5,23,28
p_7,2,0,e_2,55,63,155,10,2,1,0,3,0,0,8,92,100
p_14,13,0,e_2,87,98,155,19,2,2,9,5,1,1,11,57,68
p_8,15,0,e_2,62,106,155,7,2,0,2,5,0,1,44,49,93
p_17,10,0,e_2,112,123,155,15,1,0,13,4,1,0,11,32,43
p_16,4,0,e_0,101,109,157,4,2,1,1,5,0,1,8,48,56
p_10,9,0,e_0,77,126,157,27,1,1,6,4,1,0,49,31,80
p_20,3,0,e_0,142,146,157,7,1,1,4,4,1,0,4,11,15
p_21,0,10,e_2,142,155,189,10,1,1,4,4,1,0,13,34,47
p_13,8,0,e_1,87,115,189,24,2,2,0,4,1,1,28,74,102
p_9,10,0,e_1,67,123,189,29,1,1,7,4,1,0,56,66,122
p_18,15,0,e_1,120,140,189,18,1,1,9,5,1,1,20,49,69
p_22,6,0,e_1,146,169,189,3,1,1,14,4,1,0,23,20,43
p_25,9,0,e_2,163,184,225,11,1,1,2,5,1,0,21,41,62
p_31,5,0,e_2,203,206,225,3,3,2,6,4,1,1,3,19,22
p_30,2,0,e_2,200,217,225,6,3,2,7,4,1,0,17,8,25
p_23,15,0,e_3,150,179,232,9,1,0,6,5,1,0,29,53,82
p_28,7,0,e_3,184,205,232,7,2,0,14,4,1,1,21,27,48
p_26,6,0,e_3,169,210,232,12,1,1,12,5,0,1,41,22,63
p_33,1,0,e_3,213,227,232,4,1,0,5,4,1,0,14,5,19
p_35,0,6,e_2,222,225,245,3,2,0,1,4,1,0,3,20,23
p_24,14,0,e_0,157,201,249,8,1,1,0,3,1,0,44,48,92
p_27,5,0,e_0,180,230,249,10,2,1,7,5,0,1,50,19,69
p_36,1,0,e_0,225,244,249,30,2,2,7,4,1,1,19,5,24
p_32,0,10,e_2,209,225,259,6,2,0,5,4,1,1,16,34,50
p_34,11,0,e_1,217,227,294,23,2,2,8,5,0,1,10,67,77
p_29,14,0,e_1,192,238,294,27,3,3,0,3,0,0,46,56,102
p_37,15,0,e_1,228,243,294,16,1,1,11,5,1,1,15,51,66
p_39,13,0,e_1,247,251,294,11,1,0,14,4,1,0,4,43,47
p_43,4,0,e_1,270,280,294,11,1,1,7,4,1,0,10,14,24
p_44,4,0,e_1,275,280,294,9,1,1,5,4,1,1,5,14,19
p_41,7,0,e_2,257,270,295,12,1,1,10,5,1,0,13,25,38
p_42,4,0,e_2,269,281,295,11,1,1,7,1,0,0,12,14,26
p_38,12,0,e_3,240,278,318,12,0,0,0,3,0,0,38,40,78
p_47,3,0,e_3,293,307,318,5,1,0,8,4,1,0,14,11,25
p_51,0,4,e_3,309,318,332,3,1,0,3,4,1,0,9,14,23
p_40,15,0,e_0,255,302,359,11,1,0,0,3,0,0,47,57,104
p_45,11,0,e_0,290,316,359,28,1,1,11,5,0,1,26,43,69
p_56,8,0,e_0,324,327,359,6,2,0,9,4,1,1,3,32,35
p_54,7,0,e_0,313,332,359,24,2,2,12,4,1,1,19,27,46
p_59,3,0,e_0,335,346,359,9,1,1,6,4,1,1,11,13,24
p_57,1,0,e_0,327,354,359,12,2,2,8,4,1,1,27,5,32
p_53,8,0,e_3,313,346,376,24,1,1,2,4,1,0,33,30,63
p_60,2,0,e_3,338,366,376,9,1,1,5,5,0,1,28,10,38
p_62,1,0,e_3,345,371,376,7,1,0,8,2,0,1,26,5,31
p_58,0,6,e_0,330,359,379,12,2,2,7,4,1,2,29,20,49
p_46,8,0,e_1,291,320,390,30,1,1,1,4,1,0,29,70,99
p_48,9,0,e_1,294,325,390,28,2,2,0,5,0,1,31,65,96
p_52,14,0,e_1,312,342,390,18,1,1,5,5,0,2,30,48,78
p_61,12,0,e_1,341,350,390,6,2,0,14,5,1,1,9,40,49
p_63,3,0,e_1,364,379,390,30,3,3,8,4,1,0,15,11,26
p_49,3,0,e_2,298,309,390,3,2,0,0,3,0,0,11,81,92
p_50,11,0,e_2,299,335,390,25,2,2,0,5,0,1,36,55,91
p_55,14,0,e_2,314,346,390,17,2,2,4,5,1,1,32,44,76
p_68,2,0,e_1,389,398,406,16,1,1,0,3,1,0,9,8,17
p_69,2,0,e_1,391,398,406,16,1,1,0,5,0,1,7,8,15
p_65,0,7,e_2,369,390,413,2,2,0,7,4,1,0,21,23,44
p_64,0,15,e_2,365,390,439,2,2,0,8,4,1,0,25,49,74
p_67,12,0,e_0,377,399,441,12,1,1,5,5,1,0,22,42,64
p_71,7,0,e_0,403,416,441,7,1,1,11,4,1,1,13,25,38
p_70,3,0,e_0,398,430,441,12,1,1,12,2,0,0,32,11,43
p_66,11,0,e_3,376,412,449,11,0,0,0,3,0,0,36,37,73
p_73,3,0,e_3,423,438,449,5,1,0,8,4,1,0,15,11,26
p_72,6,0,e_1,417,438,484,4,1,0,0,3,0,0,21,46,67
p_74,10,0,e_1,424,452,484,28,2,2,1,5,0,1,28,32,60
p_76,10,0,e_2,440,456,490,23,1,1,15,4,0,1,16,34,50
p_75,3,0,e_2,438,479,490,30,1,1,15,5,1,0,41,11,52
p_81,1,0,e_1,493,498,503,13,2,1,0,3,0,0,5,5,10
p_77,4,0,e_0,455,470,516,4,0,0,0,3,0,0,15,46,61
p_79,9,0,e_0,457,487,516,15,1,1,0,5,0,1,30,29,59
p_82,0,12,e_2,494,495,535,14,2,2,0,3,0,0,1,40,41
p_78,12,0,e_3,455,494,542,12,0,0,0,3,0,0,39,48,87
p_80,13,0,e_3,474,499,542,7,1,0,6,5,0,1,25,43,68
p_87,3,0,e_3,528,531,542,1,1,0,4,4,1,0,3,11,14
p_83,0,12,e_1,501,503,543,13,1,0,1,4,1,0,2,40,42
p_88,10,0,e_1,531,535,587,23,1,1,9,5,1,0,4,52,56
p_95,10,0,e_1,547,551,587,9,2,0,11,4,1,1,4,36,40
p_96,7,0,e_1,551,562,587,11,2,1,10,1,1,1,11,25,36
p_89,5,0,e_1,535,570,587,27,1,1,10,2,1,0,35,17,52
p_84,12,0,e_2,504,535,593,30,1,1,2,5,1,0,31,58,89
p_86,14,0,e_2,518,543,593,23,1,1,7,5,1,0,25,50,75
p_91,14,0,e_2,539,543,593,17,1,1,13,5,1,1,4,50,54
p_98,6,0,e_2,555,569,593,11,2,1,11,4,1,2,14,24,38
p_97,5,0,e_2,552,574,593,12,1,1,11,4,1,1,22,19,41
p_93,4,0,e_2,543,579,593,16,1,1,14,2,1,0,36,14,50
p_85,14,0,e_0,517,562,614,23,1,1,0,3,0,0,45,52,97
p_99,9,0,e_0,556,579,614,7,2,1,12,5,0,2,23,35,58
p_101,9,0,e_0,566,579,614,4,2,1,13,4,1,2,13,35,48
p_108,7,0,e_0,584,587,614,9,2,1,8,4,1,2,3,27,30
p_106,5,0,e_0,583,595,614,11,2,1,8,4,1,1,12,19,31
p_90,1,0,e_0,538,609,614,30,1,1,6,5,0,1,71,5,76
p_107,3,0,e_2,584,604,617,13,2,1,3,4,1,0,20,13,33
p_111,2,0,e_2,607,609,617,7,1,0,3,4,1,0,2,8,10
p_94,3,0,e_3,546,553,636,16,1,1,1,5,0,1,7,83,90
p_92,10,0,e_3,540,576,636,21,1,1,1,4,1,0,36,60,96
p_100,10,0,e_3,557,576,636,6,2,0,4,5,1,1,19,60,79
p_102,14,0,e_3,568,590,636,6,2,0,8,5,1,1,22,46,68
p_103,14,0,e_3,577,590,636,4,2,0,10,5,1,1,13,46,59
p_104,14,0,e_3,581,590,636,3,2,0,11,5,1,1,9,46,55
p_110,12,0,e_3,590,598,636,2,1,0,14,4,1,0,8,38,46
p_117,0,2,e_3,636,636,646,0,0,0,0,3,1,0,0,10,10
p_109,10,0,e_1,590,619,669,4,2,1,1,5,0,1,29,50,79
p_105,12,0,e_1,582,627,669,5,2,1,1,4,1,0,45,42,87
p_115,9,0,e_1,632,638,669,22,1,1,11,4,1,0,6,31,37
p_121,3,0,e_1,656,658,669,20,2,2,4,4,1,0,2,11,13
p_123,0,2,e_1,661,669,677,21,2,2,2,4,1,0,8,8,16
p_126,1,0,e_1,681,686,691,14,2,1,2,3,0,0,5,5,10
p_116,7,0,e_2,633,652,693,24,1,1,1,5,0,1,19,41,60
p_113,9,0,e_2,629,660,693,23,1,1,0,3,0,0,31,33,64
p_124,7,0,e_2,664,668,693,13,2,2,8,4,1,0,4,25,29
p_125,2,0,e_2,668,685,693,17,2,2,7,1,1,0,17,8,25
p_112,11,0,e_0,613,649,700,26,1,1,0,4,1,0,36,51,87
p_114,13,0,e_0,632,657,700,18,1,1,5,5,0,1,25,43,68
p_122,7,0,e_0,657,677,700,15,2,2,13,4,1,0,20,23,43
p_118,8,0,e_3,649,670,730,6,0,0,2,3,0,0,21,60,81
p_119,8,0,e_3,650,670,730,6,1,1,2,3,0,1,20,60,80
p_120,13,0,e_3,653,687,730,10,1,0,3,5,0,1,34,43,77
p_129,5,0,e_3,705,713,730,2,1,0,7,4,1,0,8,17,25
p_127,7,0,e_0,701,724,747,2,1,0,0,3,0,0,23,23,46
p_131,7,0,e_0,722,724,747,26,1,1,6,5,0,1,2,23,25
p_128,0,15,e_2,705,705,754,8,1,0,0,3,0,0,0,49,49
p_130,11,0,e_1,705,740,799,27,1,1,0,3,0,0,35,59,94
p_134,14,0,e_1,734,751,799,14,1,0,9,5,0,1,17,48,65
p_138,12,0,e_1,756,759,799,5,2,0,13,4,1,0,3,40,43
p_140,5,0,e_1,768,782,799,6,2,0,9,4,1,0,14,17,31
p_137,13,0,e_2,755,764,805,7,2,0,15,3,0,0,9,41,50
p_132,4,0,e_3,730,745,807,4,0,0,0,3,0,0,15,62,77
p_133,6,0,e_3,734,753,807,5,1,0,1,5,0,1,19,54,73
p_135,11,0,e_3,739,770,807,9,2,0,2,5,0,2,31,37,68
p_143,5,0,e_3,780,790,807,3,1,0,8,4,1,0,10,17,27
p_145,1,0,e_3,820,826,831,1,0,0,0,3,0,0,6,5,11
p_141,12,0,e_0,770,787,839,29,1,1,6,5,0,1,17,52,69
p_136,14,0,e_0,749,795,839,9,3,0,0,3,0,0,46,44,90
p_139,0,15,e_2,758,805,854,15,2,2,15,4,0,1,47,49,96
p_144,6,0,e_1,815,835,855,6,0,0,0,3,0,0,20,20,40
p_142,13,0,e_2,773,846,905,28,1,1,11,4,1,0,73,59,132
p_153,6,0,e_2,872,883,905,17,2,1,9,4,1,1,11,22,33
p_150,3,0,e_2,860,894,905,24,1,1,14,4,1,0,34,11,45
p_147,6,0,e_0,849,867,917,24,1,1,0,5,0,1,18,50,68
p_146,10,0,e_0,846,881,917,10,0,0,0,3,0,0,35,36,71
p_157,7,0,e_0,889,892,917,10,2,1,8,4,1,1,3,25,28
p_154,4,0,e_0,874,903,917,18,2,1,8,5,1,1,29,14,43
p_149,6,0,e_1,859,879,939,21,1,1,0,3,0,0,20,60,80
p_155,11,0,e_1,884,896,939,8,2,1,7,5,1,1,12,43,55
p_151,12,0,e_1,863,901,939,14,1,1,1,5,0,1,38,38,76
p_156,12,0,e_1,884,901,939,7,2,1,7,5,1,1,17,38,55
p_148,15,0,e_3,849,896,947,15,0,0,0,3,0,0,47,51,98
p_158,7,0,e_3,892,922,947,9,2,1,14,5,0,2,30,25,55
p_152,2,0,e_3,868,939,947,22,1,1,6,5,0,1,71,8,79
p_159,8,0,e_2,893,931,957,8,3,1,3,1,1,0,38,26,64
p_3,4,0,e_2,25,39,53,4,0,0,0,3,0,0,14,14,28
p_6,9,0,e_1,45,48,91,6,2,0,8,5,0,1,3,43,46
p_2,11,0,e_1,19,56,91,11,0,0,0,3,0,0,37,35,72
p_4,5,0,e_3,34,52,95,5,0,0,0,3,0,0,18,43,61
p_5,9,0,e_3,41,66,95,8,1,0,1,5,0,1,25,29,54
p_1,13,0,e_0,13,54,95,13,0,0,0,3,0,0,41,41,82
p_12,0,8,e_1,86,91,117,3,2,0,1,4,1,1,5,26,31
p_11,4,0,e_3,84,109,131,30,1,1,4,4,1,0,25,22,47
p_15,5,0,e_3,99,114,131,4,1,0,1,5,0,1,15,17,32
p_19,0,7,e_3,125,131,154,2,1,0,2,4,1,0,6,23,29
p_7,2,0,e_2,55,63,155,10,2,1,0,3,0,0,8,92,100
p_14,13,0,e_2,87,98,155,19,2,2,10,5,1,2,11,57,68
p_8,15,0,e_2,62,106,155,7,2,0,2,2,0,0,44,49,93
p_13,8,0,e_2,87,129,155,24,2,2,10,5,1,1,42,26,68
p_16,4,0,e_0,101,109,157,5,2,1,1,5,0,1,8,48,56
p_10,9,0,e_0,77,126,157,27,1,1,6,4,1,0,49,31,80
p_20,3,0,e_0,142,146,157,8,1,1,4,4,1,0,4,11,15
p_9,10,0,e_1,67,125,191,29,1,1,8,4,1,0,58,66,124
p_17,10,0,e_1,112,125,191,6,2,0,6,5,1,1,13,66,79
p_18,15,0,e_1,120,142,191,18,1,1,8,5,0,1,22,49,71
p_22,6,0,e_1,146,171,191,3,1,1,14,4,1,0,25,20,45
p_26,6,0,e_1,169,171,191,13,1,1,7,4,1,1,2,20,22
p_21,0,10,e_0,142,157,191,11,1,1,4,4,1,0,15,34,49
p_25,9,0,e_0,163,186,227,11,1,1,2,5,1,0,23,41,64
p_31,5,0,e_0,203,208,227,3,2,0,6,4,1,1,5,19,24
p_30,2,0,e_0,200,219,227,7,2,1,8,4,1,0,19,8,27
p_23,15,0,e_3,150,180,231,9,1,0,6,5,1,0,30,51,81
p_27,5,0,e_3,180,212,231,10,1,0,15,4,1,0,32,19,51
p_33,1,0,e_3,213,226,231,4,1,0,5,4,1,0,13,5,18
p_35,0,6,e_0,222,227,247,2,2,0,2,4,1,0,5,20,25
p_24,14,0,e_2,157,202,250,8,1,1,0,3,0,0,45,48,93
p_28,7,0,e_2,184,225,250,7,2,0,8,5,0,1,41,25,66
p_36,1,0,e_2,225,245,250,30,1,1,7,4,1,0,20,5,25
p_32,0,10,e_0,209,227,261,6,2,0,5,4,1,1,18,34,52
p_34,11,0,e_1,217,227,296,23,2,2,8,5,0,1,10,69,79
p_29,14,0,e_1,192,238,296,28,2,2,0,3,0,0,46,58,104
p_37,15,0,e_1,228,243,296,16,1,1,11,5,1,1,15,53,68
p_39,13,0,e_1,247,251,296,11,1,0,14,4,1,0,4,45,49
p_41,7,0,e_1,257,271,296,12,1,1,11,4,1,0,14,25,39
p_44,4,0,e_1,275,282,296,9,1,1,6,4,1,0,7,14,21
p_42,4,0,e_0,269,289,303,11,1,1,10,3,0,0,20,14,34
p_43,4,0,e_0,270,289,303,11,1,1,10,4,0,1,19,14,33
p_38,12,0,e_3,240,278,318,12,0,0,0,3,0,0,38,40,78
p_47,3,0,e_3,293,307,318,5,1,0,8,4,1,0,14,11,25
p_49,3,0,e_3,298,307,318,3,2,0,6,4,1,1,9,11,20
p_51,0,4,e_0,309,309,325,3,1,0,0,3,0,0,0,16,16
p_45,11,0,e_2,290,291,358,27,1,1,11,5,0,1,1,67,68
p_40,15,0,e_2,255,305,358,10,1,0,0,3,0,0,50,53,103
p_46,8,0,e_2,291,328,358,30,1,1,11,2,0,1,37,30,67
p_53,8,0,e_2,313,328,358,23,1,1,13,4,1,1,15,30,45
p_59,3,0,e_2,335,345,358,8,2,2,6,4,1,1,10,13,23
p_57,1,0,e_2,327,353,358,13,2,2,8,1,1,0,26,5,31
p_58,0,6,e_2,330,358,378,13,2,2,8,4,1,1,28,20,48
p_48,9,0,e_1,294,325,390,28,2,2,0,4,1,0,31,65,96
p_50,11,0,e_1,299,333,390,24,2,2,0,5,0,1,34,57,91
p_55,14,0,e_1,314,344,390,17,2,2,6,5,0,2,30,46,76
p_62,1,0,e_1,345,385,390,15,3,1,14,4,1,0,40,5,45
p_54,7,0,e_3,313,341,402,24,1,1,1,4,1,0,28,61,89
p_56,8,0,e_3,324,346,402,6,1,0,2,5,0,1,22,56,78
p_61,12,0,e_3,341,360,402,5,1,0,7,2,0,1,19,42,61
p_63,3,0,e_3,364,389,402,8,1,0,11,4,1,0,25,13,38
p_69,2,0,e_3,391,394,402,1,1,0,3,4,1,0,3,8,11
p_52,14,0,e_0,312,357,403,18,1,1,0,5,1,0,45,46,91
p_60,2,0,e_0,338,395,403,8,2,2,8,5,0,1,57,8,65
p_65,0,7,e_1,369,390,415,10,2,0,6,4,1,1,21,25,46
p_70,3,0,e_0,398,414,425,28,1,1,1,4,1,0,16,11,27
p_68,2,0,e_1,389,398,440,1,1,0,0,3,1,0,9,42,51
p_72,6,0,e_1,417,420,440,4,1,1,7,4,1,0,3,20,23
p_66,11,0,e_2,376,395,440,26,2,2,6,5,1,1,19,45,64
p_67,12,0,e_2,377,400,440,25,2,2,6,2,1,2,23,40,63
p_73,3,0,e_2,423,429,440,5,1,1,5,4,1,0,6,11,17
p_71,7,0,e_3,403,426,449,7,0,0,0,3,0,0,23,23,46
p_64,0,15,e_2,365,440,489,11,2,0,2,5,1,0,75,49,124
p_74,10,0,e_0,424,457,491,4,1,0,0,3,1,0,33,34,67
p_75,3,0,e_0,438,480,491,30,1,1,4,5,0,1,42,11,53
p_81,1,0,e_0,493,498,503,7,1,0,0,3,0,0,5,5,10
p_77,4,0,e_3,455,470,516,4,0,0,0,3,0,0,15,46,61
p_79,9,0,e_3,457,487,516,9,1,0,0,5,0,1,30,29,59
p_76,10,0,e_1,440,472,518,23,1,1,0,3,1,0,32,46,78
p_78,12,0,e_1,455,480,518,12,1,1,5,5,0,1,25,38,63
p_80,13,0,e_2,474,481,536,8,2,0,11,5,1,0,7,55,62
p_83,0,12,e_0,501,503,541,5,1,0,0,4,1,0,2,38,40
p_82,0,12,e_3,494,516,554,7,1,0,7,4,1,0,22,38,60
p_95,10,0,e_3,547,562,598,4,2,1,10,5,1,1,15,36,51
p_98,6,0,e_3,555,576,598,6,2,1,12,4,0,2,21,22,43
p_87,3,0,e_3,528,587,598,17,1,1,4,5,1,0,59,11,70
p_94,3,0,e_3,546,587,598,12,2,1,9,5,1,1,41,11,52
p_84,12,0,e_0,504,541,601,22,1,1,0,5,1,0,37,60,97
p_85,14,0,e_0,517,549,601,14,1,0,4,5,1,0,32,52,84
p_91,14,0,e_0,539,549,601,7,2,0,12,5,1,1,10,52,62
p_100,10,0,e_0,557,563,601,2,3,0,12,4,1,2,6,38,44
p_96,7,0,e_0,551,574,601,6,3,1,14,4,1,1,23,27,50
p_93,4,0,e_0,543,585,601,12,2,1,12,5,1,1,42,16,58
p_107,3,0,e_0,584,590,601,1,2,0,4,1,1,0,6,11,17
p_88,10,0,e_1,531,551,615,9,2,1,3,5,0,1,20,64,84
p_86,14,0,e_1,518,565,615,14,1,0,0,3,0,0,47,50,97
p_101,9,0,e_1,566,582,615,30,3,3,14,4,1,1,16,33,49
p_108,7,0,e_1,584,590,615,27,2,2,9,4,1,1,6,25,31
p_97,5,0,e_1,552,598,615,7,3,0,10,5,1,1,46,17,63
p_106,5,0,e_1,583,598,615,29,2,2,9,4,1,1,15,17,32
p_111,2,0,e_0,607,615,623,16,1,1,0,3,0,0,8,8,16
p_90,1,0,e_2,538,541,634,16,2,1,0,5,0,1,3,93,96
p_89,5,0,e_2,535,555,634,13,2,1,0,4,1,0,20,79,99
p_99,9,0,e_2,556,569,634,3,3,1,5,5,1,1,13,65,78
p_92,10,0,e_2,540,574,634,6,2,1,1,2,0,1,34,60,94
p_102,14,0,e_2,568,588,634,24,3,3,9,5,1,2,20,46,66
p_103,14,0,e_2,577,588,634,22,2,2,11,5,1,1,11,46,57
p_104,14,0,e_2,581,588,634,21,2,2,12,5,1,1,7,46,53
p_105,12,0,e_2,582,596,634,23,2,2,12,5,1,1,14,38,52
p_110,12,0,e_2,590,596,634,20,2,2,14,4,1,1,6,38,44
p_117,0,2,e_2,636,637,647,11,1,0,0,3,0,0,1,10,11
p_109,10,0,e_3,590,630,672,22,1,1,2,4,1,0,40,42,82
p_112,11,0,e_3,613,635,672,6,1,0,5,5,0,1,22,37,59
p_121,3,0,e_3,656,661,672,2,1,0,5,4,1,0,5,11,16
p_123,0,2,e_3,661,672,680,3,1,0,3,1,1,0,11,8,19
p_116,7,0,e_0,633,653,692,5,2,1,0,5,0,1,20,39,59
p_113,9,0,e_0,629,661,692,3,2,1,0,3,0,0,32,31,63
p_115,9,0,e_0,632,661,692,3,2,1,0,5,0,1,29,31,60
p_124,7,0,e_0,664,669,692,26,1,1,9,4,1,0,5,23,28
p_126,1,0,e_3,681,687,692,1,0,0,2,3,0,0,6,5,11
p_122,7,0,e_2,657,666,697,27,2,2,4,5,0,1,9,31,40
p_118,8,0,e_2,649,671,697,29,1,1,2,3,0,0,22,26,48
p_119,8,0,e_2,650,671,697,28,1,1,2,5,0,1,21,26,47
p_114,13,0,e_1,632,673,716,3,2,0,0,3,0,0,41,43,84
p_120,13,0,e_1,653,673,716,22,1,1,6,5,0,1,20,43,63
p_125,2,0,e_1,668,708,716,29,1,1,12,5,0,1,40,8,48
p_129,5,0,e_3,705,722,739,5,0,0,0,3,0,0,17,17,34
p_128,0,15,e_2,705,705,756,0,0,0,0,3,0,0,0,51,51
p_132,4,0,e_1,730,737,771,29,1,1,2,5,0,1,7,34,41
p_131,7,0,e_1,722,748,771,28,1,1,0,3,0,0,26,23,49
p_127,7,0,e_0,701,724,773,7,0,0,0,3,0,0,23,49,72
p_130,11,0,e_0,705,738,773,11,1,0,1,5,0,1,33,35,68
p_134,14,0,e_2,734,751,809,18,1,1,8,5,1,0,17,58,75
p_137,13,0,e_2,755,764,809,10,3,1,15,5,2,0,9,45,54
p_138,12,0,e_2,756,769,809,11,3,1,15,2,2,1,13,40,53
p_140,5,0,e_2,768,792,809,15,3,2,12,1,1,0,24,17,41
p_143,5,0,e_2,780,792,809,11,2,1,9,4,1,1,12,17,29
p_139,0,15,e_1,758,771,820,22,3,3,4,4,1,0,13,49,62
p_133,6,0,e_3,734,759,833,25,1,1,1,4,1,0,25,74,99
p_135,11,0,e_3,739,776,833,11,1,0,0,5,0,1,37,57,94
p_136,14,0,e_3,749,787,833,11,2,0,3,5,0,2,38,46,84
p_145,1,0,e_3,820,828,833,2,1,0,3,4,1,0,8,5,13
p_142,13,0,e_0,773,814,855,5,3,1,0,3,1,0,41,41,82
p_144,6,0,e_2,815,836,856,29,1,1,0,3,0,0,21,20,41
p_141,12,0,e_1,770,809,867,7,3,1,0,3,1,0,39,58,97
p_150,3,0,e_2,860,870,903,13,2,2,0,5,0,1,10,33,43
p_154,4,0,e_2,874,875,903,8,2,1,4,5,1,1,1,28,29
p_149,6,0,e_2,859,883,903,10,2,1,0,3,0,0,24,20,44
p_147,6,0,e_3,849,866,916,14,1,1,0,5,0,1,17,50,67
p_146,10,0,e_3,846,880,916,10,0,0,0,3,0,0,34,36,70
p_157,7,0,e_3,889,891,916,30,1,1,7,4,1,0,2,25,27
p_158,7,0,e_3,892,893,916,30,1,1,7,4,1,0,1,23,24
p_152,2,0,e_1,868,876,942,12,2,1,0,3,0,0,8,66,74
p_153,6,0,e_1,872,890,942,6,2,1,1,5,0,1,18,52,70
p_155,11,0,e_1,884,907,942,28,1,1,4,5,1,1,23,35,58
p_151,12,0,e_0,863,893,953,7,2,0,2,5,0,1,30,60,90
p_148,15,0,e_0,849,904,953,15,2,0,2,4,1,0,55,49,104
p_159,8,0,e_0,893,927,953,29,1,1,12,2,0,1,34,26,60
p_156,12,0,e_2,884,941,979,27,1,1,6,4,1,0,57,38,95
p_3,4,0,e_2,25,39,87,4,0,0,0,3,0,0,14,48,62
p_4,5,0,e_2,34,44,87,5,0,0,3,5,0,1,10,43,53
p_5,9,0,e_2,41,58,87,9,0,0,4,5,1,1,17,29,46
p_6,9,0,e_2,45,58,87,9,0,0,5,5,1,1,13,29,42
p_2,11,0,e_1,19,55,90,11,0,0,0,3,0,0,36,35,71
p_1,13,0,e_0,13,55,96,13,0,0,0,3,0,0,42,41,83
p_12,0,8,e_2,86,87,113,21,5,5,0,4,1,0,1,26,27
p_16,4,0,e_1,101,115,129,13,4,1,0,3,0,0,14,14,28
p_19,0,7,e_1,125,129,154,10,3,0,1,4,1,0,4,25,29
p_7,2,0,e_3,55,64,162,2,0,0,0,3,0,0,9,98,107
p_10,9,0,e_3,77,87,162,15,3,2,6,5,1,2,10,75,85
p_9,10,0,e_3,67,92,162,18,2,1,2,5,1,1,25,70,95
p_8,15,0,e_3,62,109,162,14,1,0,1,5,0,1,47,53,100
p_13,8,0,e_3,87,132,162,13,4,2,9,5,1,3,45,30,75
p_11,4,0,e_3,84,146,162,18,4,3,8,5,1,3,62,16,78
p_20,3,0,e_3,142,151,162,2,2,1,5,4,1,1,9,11,20
p_15,5,0,e_0,99,116,165,13,4,1,0,3,0,0,17,49,66
p_17,10,0,e_0,112,133,165,5,3,0,4,5,0,1,21,32,53
p_14,13,0,e_2,87,130,185,8,4,1,0,3,1,0,43,55,98
p_18,15,0,e_2,120,138,185,27,3,3,10,5,0,1,18,47,65
p_21,0,10,e_3,142,162,196,5,3,0,5,4,1,2,20,34,54
p_30,2,0,e_2,200,208,216,15,2,1,0,3,0,0,8,8,16
p_27,5,0,e_0,180,186,221,10,2,2,3,5,0,1,6,35,41
p_26,6,0,e_0,169,191,221,12,2,2,0,3,0,0,22,30,52
p_28,7,0,e_0,184,196,221,6,2,2,4,5,0,2,12,25,37
p_33,1,0,e_0,213,216,221,13,1,0,2,4,1,0,3,5,8
p_22,6,0,e_1,146,149,233,28,2,2,5,5,1,0,3,84,87
p_24,14,0,e_1,157,177,233,17,1,1,8,5,1,1,20,56,76
p_23,15,0,e_1,150,182,233,18,2,2,6,5,2,0,32,51,83
p_31,5,0,e_1,203,214,233,11,2,1,8,4,1,0,11,19,30
p_36,1,0,e_1,225,228,233,9,1,0,2,4,1,0,3,5,8
p_35,0,6,e_0,222,223,245,11,1,0,0,3,0,0,1,22,23
p_32,0,10,e_2,209,216,248,14,1,1,2,4,1,0,7,32,39
p_25,9,0,e_3,163,191,256,11,1,1,0,5,1,0,28,65,93
p_29,14,0,e_3,192,210,256,5,2,0,9,5,2,0,18,46,64
p_34,11,0,e_3,217,221,256,1,1,0,12,4,1,0,4,35,39
p_42,4,0,e_3,269,283,297,4,0,0,0,3,0,0,14,14,28
p_43,4,0,e_3,270,283,297,4,1,0,0,5,0,1,13,14,27
p_44,4,0,e_3,275,283,297,3,1,0,1,5,0,1,8,14,22
p_41,7,0,e_1,257,281,306,7,0,0,0,3,0,0,24,25,49
p_47,3,0,e_1,293,295,306,28,2,2,4,4,1,1,2,11,13
p_37,15,0,e_2,228,265,312,24,1,1,4,5,1,0,37,47,84
p_40,15,0,e_2,255,265,312,15,1,1,12,5,0,1,10,47,57
p_38,12,0,e_0,240,265,313,23,1,1,4,5,1,0,25,48,73
p_39,13,0,e_0,247,270,313,20,1,1,6,5,0,1,23,43,66
p_49,3,0,e_0,298,302,313,19,2,2,4,4,1,0,4,11,15
p_51,0,4,e_0,309,313,327,18,2,2,1,4,1,0,4,14,18
p_57,1,0,e_0,327,338,343,18,3,2,4,3,1,0,11,5,16
p_54,7,0,e_2,313,336,361,16,3,3,0,3,0,0,23,25,48
p_59,3,0,e_2,335,350,361,14,2,1,7,5,0,1,15,11,26
p_46,8,0,e_1,291,332,362,24,2,2,4,4,1,0,41,30,71
p_53,8,0,e_1,313,332,362,15,3,3,2,5,0,1,19,30,49
p_56,8,0,e_1,324,332,362,12,3,3,6,5,0,1,8,30,38
p_60,2,0,e_1,338,352,362,14,2,1,6,4,1,0,14,10,24
p_62,1,0,e_1,345,357,362,13,2,1,4,4,1,1,12,5,17
p_58,0,6,e_0,330,343,363,18,3,3,4,4,0,1,13,20,33
p_63,3,0,e_0,364,376,387,6,1,0,6,3,0,0,12,11,23
p_48,9,0,e_3,294,326,391,22,2,2,1,4,1,1,32,65,97
p_45,11,0,e_3,290,334,391,21,1,1,2,4,1,0,44,57,101
p_50,11,0,e_3,299,334,391,11,2,0,0,5,0,2,35,57,92
p_52,14,0,e_3,312,345,391,10,2,0,4,5,0,2,33,46,79
p_55,14,0,e_3,314,345,391,9,3,0,5,5,0,3,31,46,77
p_61,12,0,e_3,341,353,391,3,2,1,13,5,1,1,12,38,50
p_65,0,7,e_2,369,369,394,7,1,0,0,3,0,0,0,25,25
p_68,2,0,e_0,389,397,405,29,1,1,0,3,0,0,8,8,16
p_64,0,15,e_1,365,366,415,9,1,0,0,3,0,0,1,49,50
p_69,2,0,e_3,391,399,443,2,0,0,0,3,1,0,8,44,52
p_70,3,0,e_3,398,404,443,1,1,0,2,5,0,1,6,39,45
p_71,7,0,e_3,403,418,443,4,2,0,3,5,1,1,15,25,40
p_73,3,0,e_3,423,432,443,3,1,0,6,4,1,0,9,11,20
p_66,11,0,e_2,376,408,453,24,1,1,1,5,1,0,32,45,77
p_67,12,0,e_2,377,413,453,23,1,1,2,5,1,1,36,40,76
p_75,3,0,e_2,438,442,453,28,1,1,4,4,1,0,4,11,15
p_72,6,0,e_0,417,438,458,13,1,0,0,3,0,0,21,20,41
p_74,10,0,e_1,424,442,476,25,2,2,15,3,0,0,18,34,52
p_76,10,0,e_1,440,442,476,21,1,1,11,4,0,1,2,34,36
p_77,4,0,e_1,455,462,476,4,0,0,6,4,1,0,7,14,21
p_81,1,0,e_1,493,498,503,1,0,0,0,3,0,0,5,5,10
p_79,9,0,e_0,457,487,516,9,0,0,0,3,1,0,30,29,59
p_82,0,12,e_3,494,495,535,0,0,0,0,3,0,0,1,40,41
p_78,12,0,e_2,455,493,541,12,0,0,0,3,0,0,38,48,86
p_80,13,0,e_2,474,498,541,13,0,0,6,5,0,1,24,43,67
p_87,3,0,e_2,528,530,541,15,2,2,4,4,1,0,2,11,13
p_83,0,12,e_1,501,503,543,23,1,1,0,4,1,0,2,40,42
p_90,1,0,e_0,538,541,572,15,2,1,0,5,0,1,3,31,34
p_89,5,0,e_0,535,555,572,11,1,1,0,3,0,0,20,17,37
p_97,5,0,e_0,552,555,572,7,1,0,4,5,1,1,3,17,20
p_94,3,0,e_2,546,554,573,10,1,0,1,5,0,1,8,19,27
p_93,4,0,e_2,543,559,573,18,1,0,0,3,0,0,16,14,30
p_88,10,0,e_1,531,535,585,7,2,2,9,5,1,0,4,50,54
p_92,10,0,e_1,540,551,585,5,2,1,11,5,2,0,11,34,45
p_95,10,0,e_1,547,551,585,3,1,0,11,4,1,1,4,34,38
p_96,7,0,e_1,551,562,585,5,1,0,10,1,1,0,11,23,34
p_84,12,0,e_3,504,535,591,10,1,0,2,5,1,0,31,56,87
p_85,14,0,e_3,517,543,591,8,1,0,6,5,1,0,26,48,74
p_86,14,0,e_3,518,543,591,7,2,0,7,5,1,1,25,48,73
p_91,14,0,e_3,539,543,591,1,2,0,13,5,1,1,4,48,52
p_99,9,0,e_3,556,560,591,1,2,0,10,4,1,1,4,31,35
p_98,6,0,e_3,555,571,591,4,1,0,10,4,1,0,16,20,36
p_107,3,0,e_1,584,596,663,29,1,1,0,3,1,0,12,67,79
p_109,10,0,e_1,590,619,663,10,1,1,1,5,0,1,29,44,73
p_112,11,0,e_1,613,624,663,6,1,1,8,5,1,2,11,39,50
p_116,7,0,e_1,633,638,663,4,1,0,8,4,1,1,5,25,30
p_111,2,0,e_1,607,655,663,17,1,1,6,5,1,1,48,8,56
p_101,9,0,e_0,566,601,666,28,2,2,2,4,1,0,35,65,100
p_105,12,0,e_0,582,612,666,21,1,1,3,5,0,2,30,54,84
p_102,14,0,e_0,568,620,666,23,2,2,1,4,1,1,52,46,98
p_104,14,0,e_0,581,620,666,19,1,1,2,5,0,2,39,46,85
p_113,9,0,e_0,629,637,666,21,0,0,11,4,1,0,8,29,37
p_115,9,0,e_0,632,637,666,3,1,0,10,4,1,1,5,29,34
p_110,12,0,e_3,590,629,667,12,0,0,0,3,1,0,39,38,77
p_106,5,0,e_2,583,590,669,28,1,1,3,5,0,2,7,79,86
p_108,7,0,e_2,584,598,669,25,1,1,3,5,0,3,14,71,85
p_100,10,0,e_2,557,609,669,30,3,3,4,5,1,1,52,60,112
p_103,14,0,e_2,577,623,669,20,1,1,1,5,0,1,46,46,92
p_121,3,0,e_2,656,658,669,1,2,0,4,4,1,1,2,11,13
p_117,0,2,e_0,636,666,674,10,1,0,9,1,1,0,30,8,38
p_123,0,2,e_0,661,666,674,2,2,0,2,4,1,1,5,8,13
p_125,2,0,e_3,668,675,721,14,1,1,0,5,0,1,7,46,53
p_119,8,0,e_3,650,695,721,27,1,1,5,4,1,0,45,26,71
p_118,8,0,e_0,649,694,722,28,1,1,6,4,1,0,45,28,73
p_126,1,0,e_0,681,717,722,11,2,1,4,5,0,1,36,5,41
p_122,7,0,e_1,657,686,751,26,2,2,2,4,1,1,29,65,94
p_124,7,0,e_1,664,686,751,24,2,2,0,5,0,2,22,65,87
p_120,13,0,e_1,653,706,751,21,2,2,3,4,1,1,53,45,98
p_131,7,0,e_1,722,726,751,23,1,1,8,4,1,1,4,25,29
p_129,5,0,e_1,705,734,751,30,1,1,13,5,1,1,29,17,46
p_114,13,0,e_2,632,710,757,29,1,1,11,4,1,0,78,47,125
p_130,11,0,e_2,705,718,757,24,1,1,11,5,0,2,13,39,52
p_127,7,0,e_2,701,732,757,30,1,1,10,5,0,1,31,25,56
p_133,6,0,e_2,734,737,757,20,1,1,7,4,1,0,3,20,23
p_128,0,15,e_3,705,721,774,5,1,0,5,4,1,0,16,53,69
p_140,5,0,e_2,768,785,802,11,3,1,0,3,0,0,17,17,34
p_143,5,0,e_2,780,785,802,8,1,0,4,5,0,1,5,17,22
p_139,0,15,e_1,758,759,808,19,4,4,0,3,0,0,1,49,50
p_135,11,0,e_3,739,756,821,13,1,1,6,5,1,0,17,65,82
p_137,13,0,e_3,755,764,821,6,2,2,11,2,1,1,9,57,66
p_136,14,0,e_3,749,769,821,7,2,1,9,5,1,1,20,52,72
p_132,4,0,e_0,730,744,828,24,1,1,0,3,0,0,14,84,98
p_138,12,0,e_0,756,770,828,7,3,3,8,5,1,1,14,58,72
p_141,12,0,e_0,770,770,828,4,2,1,12,2,1,1,0,58,58
p_142,13,0,e_0,773,777,828,28,1,0,12,5,1,1,4,51,55
p_134,14,0,e_0,734,782,828,12,1,1,1,5,0,1,48,46,94
p_145,1,0,e_0,820,823,828,29,1,1,2,4,1,0,3,5,8
p_144,6,0,e_2,815,835,855,26,1,1,0,3,0,0,20,20,40
p_150,3,0,e_2,860,872,885,24,1,1,0,3,0,0,12,13,25
p_152,2,0,e_2,868,877,885,22,1,1,2,5,0,1,9,8,17
p_146,10,0,e_1,846,863,899,10,0,0,15,3,0,0,17,36,53
p_153,6,0,e_1,872,877,899,17,1,1,8,4,1,0,5,22,27
p_154,4,0,e_1,874,885,899,18,1,1,7,4,1,1,11,14,25
p_147,6,0,e_0,849,869,933,6,0,0,0,3,0,0,20,64,84
p_149,6,0,e_0,859,869,933,21,1,1,3,5,0,1,10,64,74
p_155,11,0,e_0,884,886,933,8,1,1,11,5,1,1,2,47,49
p_151,12,0,e_0,863,891,933,14,1,1,4,5,0,1,28,42,70
p_156,12,0,e_0,884,891,933,7,1,1,10,5,1,1,7,42,49
p_159,8,0,e_0,893,905,933,8,1,1,12,4,1,1,12,28,40
p_158,7,0,e_0,892,910,933,9,1,1,12,4,1,0,18,23,41
p_157,7,0,e_2,889,912,935,10,1,1,0,3,0,0,23,23,46
p_148,15,0,e_3,849,896,943,15,0,0,0,3,0,0,47,47,94
p_3,4,0,e_2,25,40,88,4,0,0,0,3,0,0,15,48,63
p_4,5,0,e_2,34,45,88,5,0,0,2,5,0,1,11,43,54
p_5,9,0,e_2,41,59,88,9,0,0,4,5,1,1,18,29,47
p_6,9,0,e_2,45,59,88,9,0,0,5,2,1,1,14,29,43
p_2,11,0,e_1,19,54,89,11,0,0,0,3,0,0,35,35,70
p_1,13,0,e_0,13,55,96,13,0,0,0,3,0,0,42,41,83
p_12,0,8,e_1,86,89,115,21,5,5,1,4,1,0,3,26,29
p_16,4,0,e_0,101,114,136,13,4,1,0,5,0,1,13,22,35
p_15,5,0,e_0,99,119,136,13,4,2,0,3,0,0,20,17,37
p_13,8,0,e_2,87,114,140,13,5,3,0,3,1,0,27,26,53
p_7,2,0,e_3,55,64,160,2,0,0,0,3,0,0,9,96,105
p_10,9,0,e_3,77,87,160,15,3,2,6,5,1,2,10,73,83
p_9,10,0,e_3,67,92,160,17,2,1,3,5,1,1,25,68,93
p_14,13,0,e_3,87,103,160,8,4,1,9,2,1,3,16,57,73
p_8,15,0,e_3,62,111,160,13,1,0,2,5,0,1,49,49,98
p_11,4,0,e_3,84,146,160,18,4,3,8,5,1,3,62,14,76
p_19,0,7,e_0,125,136,161,11,2,0,4,4,1,0,11,25,36
p_21,0,10,e_2,142,143,181,5,2,0,0,3,0,1,1,38,39
p_17,10,0,e_1,112,123,187,5,2,0,7,5,1,0,11,64,75
p_18,15,0,e_1,120,140,187,27,2,2,9,5,0,1,20,47,67
p_20,3,0,e_2,142,156,213,2,2,1,0,3,0,0,14,57,71
p_25,9,0,e_2,163,176,213,9,0,0,5,5,2,0,13,37,50
p_30,2,0,e_1,200,209,237,18,2,1,0,3,0,0,9,28,37
p_31,5,0,e_1,203,220,237,14,2,1,0,5,0,1,17,17,34
p_22,6,0,e_0,146,156,238,28,1,1,3,5,1,0,10,82,92
p_24,14,0,e_0,157,184,238,17,1,1,6,5,2,1,27,54,81
p_23,15,0,e_0,150,189,238,18,1,1,4,5,1,1,39,49,88
p_36,1,0,e_0,225,233,238,11,2,1,4,4,1,0,8,5,13
p_32,0,10,e_2,209,213,247,17,2,2,1,4,1,0,4,34,38
p_35,0,6,e_0,222,238,258,13,2,0,5,4,1,0,16,20,36
p_27,5,0,e_3,180,186,265,4,1,1,3,5,0,1,6,79,85
p_26,6,0,e_3,169,191,265,6,0,0,0,3,0,0,22,74,96
p_28,7,0,e_3,184,196,265,2,2,0,5,5,0,2,12,69,81
p_29,14,0,e_3,192,219,265,8,2,0,6,5,1,1,27,46,73
p_34,11,0,e_3,217,230,265,4,2,1,13,5,1,1,13,35,48
p_41,7,0,e_0,257,263,288,26,1,1,6,5,1,0,6,25,31
p_42,4,0,e_0,269,274,288,4,0,0,5,4,1,0,5,14,19
p_43,4,0,e_0,270,274,288,4,0,0,5,4,1,1,4,14,18
p_44,4,0,e_1,275,289,303,4,0,0,0,3,0,0,14,14,28
p_33,1,0,e_2,213,218,317,15,2,1,0,3,1,0,5,99,104
p_38,12,0,e_2,240,255,317,26,1,1,8,5,2,1,15,62,77
p_39,13,0,e_2,247,260,317,23,1,1,10,5,1,2,13,57,70
p_37,15,0,e_2,228,268,317,27,2,2,4,5,2,0,40,49,89
p_40,15,0,e_2,255,268,317,18,1,1,12,5,1,2,13,49,62
p_47,3,0,e_2,293,306,317,13,1,1,7,4,1,0,13,11,24
p_49,3,0,e_2,298,306,317,13,2,2,5,4,1,1,8,11,19
p_51,0,4,e_1,309,310,326,12,2,2,0,3,0,0,1,16,17
p_57,1,0,e_2,327,332,337,7,2,1,0,3,0,0,5,5,10
p_46,8,0,e_3,291,317,355,8,0,0,0,3,0,0,26,38,64
p_53,8,0,e_3,313,317,355,3,2,1,7,5,0,2,4,38,42
p_48,9,0,e_3,294,322,355,8,1,0,1,5,0,1,28,33,61
p_56,8,0,e_3,324,327,355,1,2,0,9,4,1,1,3,28,31
p_54,7,0,e_3,313,332,355,4,2,2,7,5,0,2,19,23,42
p_59,3,0,e_1,335,340,355,4,1,0,4,3,0,0,5,15,20
p_60,2,0,e_1,338,345,355,4,1,0,3,4,0,1,7,10,17
p_62,1,0,e_1,345,350,355,2,1,0,2,4,1,0,5,5,10
p_58,0,6,e_2,330,337,357,8,2,0,0,5,0,1,7,20,27
p_45,11,0,e_0,290,326,383,11,0,0,0,3,0,0,36,57,93
p_50,11,0,e_0,299,326,383,9,2,0,2,5,0,1,27,57,84
p_52,14,0,e_0,312,337,383,8,2,0,6,5,0,1,25,46,71
p_55,14,0,e_0,314,337,383,7,3,0,7,5,0,2,23,46,69
p_61,12,0,e_0,341,345,383,22,1,1,13,4,1,0,4,38,42
p_63,3,0,e_1,364,376,387,3,0,0,0,3,0,0,12,11,23
p_65,0,7,e_0,369,383,406,30,1,1,4,4,1,0,14,23,37
p_68,2,0,e_1,389,398,414,21,1,1,0,3,0,0,9,16,25
p_69,2,0,e_1,391,398,414,21,1,1,0,5,0,1,7,16,23
p_70,3,0,e_1,398,403,414,18,1,1,2,2,0,0,5,11,16
p_64,0,15,e_3,365,366,415,0,0,0,0,3,0,0,1,49,50
p_71,7,0,e_0,403,406,429,12,1,1,6,5,1,0,3,23,26
p_66,11,0,e_2,376,394,441,17,1,1,6,3,0,0,18,47,65
p_67,12,0,e_2,377,399,441,15,1,1,6,5,0,1,22,42,64
p_72,6,0,e_2,417,419,441,9,0,0,7,4,1,0,2,22,24
p_73,3,0,e_2,423,430,441,12,0,0,5,4,1,0,7,11,18
p_75,3,0,e_0,438,449,460,8,1,1,0,3,0,0,11,11,22
p_74,10,0,e_3,424,441,475,5,0,0,15,3,0,0,17,34,51
p_77,4,0,e_3,455,461,475,2,1,0,6,4,1,0,6,14,20
p_81,1,0,e_0,493,498,503,1,0,0,0,3,0,0,5,5,10
p_79,9,0,e_2,457,487,516,26,2,2,0,3,0,0,30,29,59
p_76,10,0,e_1,440,473,527,30,0,0,0,3,0,0,33,54,87
p_78,12,0,e_1,455,481,527,24,1,1,4,5,0,1,26,46,72
p_80,13,0,e_1,474,486,527,17,1,1,10,5,1,1,12,41,53
p_82,0,12,e_3,494,495,535,0,0,0,0,3,0,0,1,40,41
p_83,0,12,e_0,501,503,543,23,1,1,1,4,1,0,2,40,42
p_90,1,0,e_2,538,544,549,15,2,1,0,3,0,0,6,5,11
p_87,3,0,e_1,528,540,569,15,2,2,0,3,0,0,12,29,41
p_93,4,0,e_1,543,545,569,10,1,0,4,5,1,1,2,24,26
p_89,5,0,e_1,535,550,569,11,2,1,2,5,0,1,15,19,34
p_94,3,0,e_1,546,558,569,11,1,0,4,5,1,1,12,11,23
p_88,10,0,e_0,531,535,587,7,2,2,9,5,1,0,4,52,56
p_92,10,0,e_0,540,551,587,5,2,1,11,5,2,0,11,36,47
p_95,10,0,e_0,547,551,587,3,1,0,11,4,1,1,4,36,40
p_96,7,0,e_0,551,562,587,5,1,0,10,4,1,0,11,25,36
p_98,6,0,e_0,555,567,587,5,1,0,9,4,1,1,12,20,32
p_84,12,0,e_3,504,535,589,10,1,0,2,5,1,0,31,54,85
p_85,14,0,e_3,517,543,589,8,1,0,6,5,1,0,26,46,72
p_86,14,0,e_3,518,543,589,8,2,0,6,5,1,1,25,46,71
p_91,14,0,e_3,539,543,589,1,2,0,13,5,1,1,4,46,50
p_99,9,0,e_3,556,560,589,1,1,0,10,4,1,0,4,29,33
p_111,2,0,e_0,607,615,623,2,0,0,0,3,0,0,8,8,16
p_97,5,0,e_2,552,570,651,7,1,0,0,3,0,0,18,81,99
p_101,9,0,e_2,566,584,651,29,1,1,4,5,0,2,18,67,85
p_100,10,0,e_2,557,589,651,30,2,2,1,5,0,1,32,62,94
p_105,12,0,e_2,582,597,651,20,1,1,9,5,1,3,15,54,69
p_110,12,0,e_2,590,597,651,12,0,0,10,5,1,2,7,54,61
p_102,14,0,e_2,568,605,651,23,1,1,5,5,0,3,37,46,83
p_103,14,0,e_2,577,605,651,20,1,1,7,5,1,3,28,46,74
p_104,14,0,e_2,581,605,651,19,1,1,8,5,1,3,24,46,70
p_112,11,0,e_2,613,616,651,11,0,0,12,4,1,0,3,35,38
p_107,3,0,e_1,584,595,654,29,1,1,0,3,0,1,11,59,70
p_106,5,0,e_1,583,603,654,27,1,1,0,3,0,0,20,51,71
p_108,7,0,e_1,584,611,654,24,1,1,0,3,0,2,27,43,70
p_109,10,0,e_1,590,622,654,10,0,0,2,5,0,3,32,32,64
p_117,0,2,e_2,636,651,659,17,2,2,5,4,1,0,15,8,23
p_123,0,2,e_1,661,662,672,10,3,3,0,3,0,0,1,10,11
p_121,3,0,e_2,656,664,675,8,3,2,1,5,1,0,8,11,19
p_125,2,0,e_1,668,672,680,7,2,1,1,5,1,0,4,8,12
p_126,1,0,e_1,681,687,692,4,1,0,0,3,0,0,6,5,11
p_116,7,0,e_3,633,655,696,11,1,1,0,5,0,1,22,41,63
p_118,8,0,e_3,649,660,696,5,2,1,5,5,0,2,11,36,47
p_119,8,0,e_3,650,660,696,4,3,1,6,5,0,3,10,36,46
p_115,9,0,e_3,632,665,696,9,0,0,0,3,0,0,33,31,64
p_122,7,0,e_3,657,673,696,4,3,2,7,5,1,2,16,23,39
p_124,7,0,e_3,664,673,696,2,2,0,9,2,1,1,9,23,32
p_113,9,0,e_0,629,658,713,9,0,0,0,3,0,0,29,55,84
p_114,13,0,e_0,632,672,713,13,1,0,1,5,0,1,40,41,81
p_120,13,0,e_0,653,672,713,6,3,0,8,5,0,2,19,41,60
p_129,5,0,e_3,705,722,739,5,0,0,0,3,0,0,17,17,34
p_128,0,15,e_2,705,705,754,0,0,0,0,3,0,0,0,49,49
p_132,4,0,e_0,730,737,773,29,1,1,2,5,0,1,7,36,43
p_133,6,0,e_0,734,745,773,26,1,1,3,5,0,2,11,28,39
p_131,7,0,e_0,722,750,773,12,0,0,0,3,0,0,28,23,51
p_127,7,0,e_1,701,725,802,7,0,0,0,3,0,0,24,77,101
p_130,11,0,e_1,705,739,802,11,1,0,0,5,0,1,34,63,97
p_135,11,0,e_1,739,741,802,11,0,0,11,5,1,1,2,61,63
p_134,14,0,e_1,734,752,802,18,1,1,9,5,1,1,18,50,68
p_136,14,0,e_1,749,752,802,14,0,0,13,5,1,1,3,50,53
p_137,13,0,e_1,755,757,802,13,0,0,14,4,1,0,2,45,47
p_138,12,0,e_1,756,762,802,12,0,0,13,1,1,0,6,40,46
p_140,5,0,e_1,768,785,802,23,1,1,11,4,1,0,17,17,34
p_143,5,0,e_1,780,785,802,19,1,1,6,4,1,1,5,17,22
p_139,0,15,e_3,758,758,807,0,0,0,0,3,0,0,0,49,49
p_142,13,0,e_2,773,778,821,13,1,1,15,4,0,1,5,43,48
p_141,12,0,e_2,770,783,821,15,1,1,15,3,0,0,13,38,51
p_145,1,0,e_1,820,825,830,14,0,0,0,3,0,0,5,5,10
p_144,6,0,e_0,815,836,856,9,0,0,0,3,0,0,21,20,41
p_150,3,0,e_0,860,871,884,8,1,1,0,3,0,0,11,13,24
p_152,2,0,e_0,868,876,884,7,1,0,2,5,0,1,8,8,16
p_146,10,0,e_3,846,863,899,5,0,0,15,3,0,0,17,36,53
p_153,6,0,e_3,872,877,899,1,1,0,7,4,1,0,5,22,27
p_154,4,0,e_3,874,885,899,3,2,1,7,4,1,1,11,14,25
p_147,6,0,e_1,849,870,932,9,1,1,0,3,0,0,21,62,83
p_149,6,0,e_1,859,870,932,5,1,1,3,5,0,1,11,62,73
p_155,11,0,e_1,884,887,932,23,2,2,10,5,1,1,3,45,48
p_151,12,0,e_1,863,892,932,28,0,0,4,5,0,1,29,40,69
p_156,12,0,e_1,884,892,932,22,2,2,10,5,1,2,8,40,48
p_159,8,0,e_1,893,906,932,24,1,1,12,4,1,0,13,26,39
p_157,7,0,e_0,889,912,935,26,1,1,0,3,0,0,23,23,46
p_158,7,0,e_0,892,912,935,25,1,1,0,5,0,1,20,23,43
p_148,15,0,e_2,849,897,944,19,1,1,0,3,0,0,48,47,95
p_3,4,0,e_2,25,39,87,4,0,0,0,3,0,0,14,48,62
p_4,5,0,e_2,34,44,87,5,0,0,3,5,0,1,10,43,53
p_5,9,0,e_2,41,58,87,9,0,0,4,5,1,1,17,29,46
p_6,9,0,e_2,45,58,87,9,0,0,5,5,1,1,13,29,42
p_2,11,0,e_1,19,54,89,11,0,0,0,3,0,0,35,35,70
p_1,13,0,e_0,13,54,95,13,0,0,0,3,0,0,41,41,82
p_12,0,8,e_2,86,87,115,21,5,5,0,3,1,0,1,28,29
p_16,4,0,e_1,101,116,130,14,4,2,0,3,0,0,15,14,29
p_15,5,0,e_0,99,116,133,13,4,2,0,3,0,0,17,17,34
p_19,0,7,e_1,125,130,155,11,2,0,1,4,1,0,5,25,30
p_7,2,0,e_3,55,64,162,2,0,0,0,3,0,0,9,98,107
p_10,9,0,e_3,77,87,162,15,3,2,6,5,1,2,10,75,85
p_9,10,0,e_3,67,92,162,17,2,1,3,5,1,1,25,70,95
p_14,13,0,e_3,87,103,162,8,4,1,9,2,1,3,16,59,75
p_8,15,0,e_3,62,111,162,14,1,0,1,5,0,1,49,51,100
p_11,4,0,e_3,84,146,162,18,4,3,8,5,1,3,62,16,78
p_20,3,0,e_3,142,151,162,2,2,1,5,4,1,1,9,11,20
p_21,0,10,e_0,142,143,177,5,2,0,0,3,0,0,1,34,35
p_13,8,0,e_2,87,115,187,13,4,2,0,3,1,0,28,72,100
p_17,10,0,e_2,112,123,187,5,2,0,7,5,1,0,11,64,75
p_18,15,0,e_2,120,140,187,27,2,2,9,5,1,1,20,47,67
p_30,2,0,e_2,200,208,216,16,2,1,0,3,0,0,8,8,16
p_22,6,0,e_1,146,150,232,28,2,2,5,5,1,0,4,82,86
p_23,15,0,e_1,150,181,232,18,1,1,6,5,2,0,31,51,82
p_27,5,0,e_1,180,213,232,8,2,2,15,5,1,1,33,19,52
p_31,5,0,e_1,203,213,232,12,2,1,8,4,1,1,10,19,29
p_33,1,0,e_1,213,227,232,13,1,0,5,4,1,0,14,5,19
p_24,14,0,e_0,157,191,237,18,1,1,4,5,1,0,34,46,80
p_36,1,0,e_0,225,232,237,10,1,0,3,4,1,0,7,5,12
p_32,0,10,e_2,209,216,248,15,2,2,2,4,1,0,7,32,39
p_35,0,6,e_1,222,232,252,12,2,0,3,4,1,1,10,20,30
p_26,6,0,e_3,169,183,259,11,1,1,1,5,0,1,14,76,90
p_28,7,0,e_3,184,188,259,5,2,1,6,5,1,1,4,71,75
p_25,9,0,e_3,163,196,259,9,0,0,0,3,0,0,33,63,96
p_29,14,0,e_3,192,213,259,6,2,0,8,5,1,1,21,46,67
p_34,11,0,e_3,217,224,259,2,1,0,13,4,1,0,7,35,42
p_42,4,0,e_3,269,284,298,4,0,0,0,3,0,0,15,14,29
p_43,4,0,e_3,270,284,298,4,1,1,0,3,0,1,14,14,28
p_44,4,0,e_3,275,284,298,3,1,0,1,5,0,1,9,14,23
p_41,7,0,e_0,257,281,306,23,1,1,0,3,0,0,24,25,49
p_47,3,0,e_0,293,295,306,29,3,3,4,4,1,0,2,11,13
p_38,12,0,e_1,240,272,312,24,1,1,2,5,1,0,32,40,72
p_49,3,0,e_1,298,301,312,19,2,2,4,4,1,0,3,11,14
p_39,13,0,e_2,247,259,314,21,1,1,10,5,1,1,12,55,67
p_37,15,0,e_2,228,267,314,25,1,1,3,5,1,0,39,47,86
p_40,15,0,e_2,255,267,314,16,1,1,12,5,0,2,12,47,59
p_51,0,4,e_1,309,312,326,19,2,2,1,4,1,0,3,14,17
p_48,9,0,e_0,294,335,368,22,3,3,3,1,1,0,41,33,74
p_60,2,0,e_0,338,358,368,14,2,1,8,4,1,1,20,10,30
p_57,1,0,e_0,327,363,368,18,3,2,6,5,0,1,36,5,41
p_53,8,0,e_1,313,340,368,15,3,2,0,5,1,0,27,28,55
p_59,3,0,e_1,335,357,368,14,2,1,6,5,0,2,22,11,33
p_54,7,0,e_2,313,337,370,16,3,3,0,3,1,0,24,33,57
p_56,8,0,e_2,324,342,370,12,3,2,3,5,0,1,18,28,46
p_62,1,0,e_2,345,365,370,13,2,0,7,4,1,0,20,5,25
p_58,0,6,e_1,330,368,388,18,3,3,5,5,0,1,38,20,58
p_46,8,0,e_3,291,324,394,24,2,2,2,4,1,1,33,70,103
p_45,11,0,e_3,290,335,394,22,1,1,3,4,1,0,45,59,104
p_50,11,0,e_3,299,335,394,11,2,0,0,5,0,2,36,59,95
p_52,14,0,e_3,312,346,394,10,2,0,4,5,0,2,34,48,82
p_55,14,0,e_3,314,346,394,9,3,0,5,5,0,3,32,48,80
p_61,12,0,e_3,341,354,394,4,2,1,12,5,1,1,13,40,53
p_63,3,0,e_3,364,383,394,6,1,0,9,4,1,0,19,11,30
p_65,0,7,e_2,369,370,395,7,2,0,0,3,1,0,1,25,26
p_64,0,15,e_0,365,368,415,9,2,0,1,4,1,0,3,47,50
p_68,2,0,e_2,389,412,420,30,1,1,5,5,1,0,23,8,31
p_69,2,0,e_2,391,412,420,29,1,1,6,5,1,1,21,8,29
p_73,3,0,e_2,423,435,446,4,2,0,0,3,0,0,12,11,23
p_70,3,0,e_3,398,410,447,3,0,0,0,3,0,0,12,37,49
p_71,7,0,e_3,403,424,447,6,1,0,1,5,0,1,21,23,44
p_66,11,0,e_1,376,405,452,24,2,2,2,5,1,0,29,47,76
p_67,12,0,e_1,377,410,452,23,2,2,3,5,1,1,33,42,75
p_72,6,0,e_1,417,430,452,3,2,1,10,4,1,0,13,22,35
p_75,3,0,e_1,438,441,452,30,1,1,4,4,1,0,3,11,14
p_74,10,0,e_0,424,442,476,27,1,1,15,3,0,0,18,34,52
p_76,10,0,e_0,440,442,476,22,1,1,11,4,0,1,2,34,36
p_77,4,0,e_0,455,462,476,4,0,0,6,4,1,0,7,14,21
p_81,1,0,e_0,493,498,503,1,0,0,0,3,0,0,5,5,10
p_79,9,0,e_2,457,486,515,9,0,0,0,3,0,0,29,29,58
p_82,0,12,e_3,494,494,534,0,0,0,0,3,0,0,0,40,40
p_78,12,0,e_1,455,493,541,12,0,0,0,3,0,0,38,48,86
p_80,13,0,e_1,474,498,541,13,0,0,6,5,0,1,24,43,67
p_87,3,0,e_1,528,530,541,15,2,2,4,4,1,0,2,11,13
p_83,0,12,e_0,501,503,543,23,1,1,1,4,1,0,2,40,42
p_90,1,0,e_2,538,540,571,14,2,1,0,5,0,1,2,31,33
p_89,5,0,e_2,535,554,571,11,2,1,0,3,0,0,19,17,36
p_97,5,0,e_2,552,554,571,6,1,0,5,5,1,1,2,17,19
p_94,3,0,e_1,546,555,574,10,1,0,0,5,0,1,9,19,28
p_93,4,0,e_1,543,560,574,10,1,0,0,3,0,0,17,14,31
p_88,10,0,e_0,531,535,585,7,2,2,9,5,1,0,4,50,54
p_92,10,0,e_0,540,551,585,5,2,1,11,5,2,0,11,34,45
p_95,10,0,e_0,547,551,585,3,1,0,11,4,1,1,4,34,38
p_96,7,0,e_0,551,562,585,5,1,0,10,1,1,0,11,23,34
p_84,12,0,e_3,504,534,588,10,1,0,2,5,1,0,30,54,84
p_85,14,0,e_3,517,542,588,7,1,0,7,5,1,0,25,46,71
p_86,14,0,e_3,518,542,588,7,2,0,7,5,1,1,24,46,70
p_91,14,0,e_3,539,542,588,1,2,0,13,5,1,1,3,46,49
p_99,9,0,e_3,556,559,588,1,1,0,10,4,1,0,3,29,32
p_111,2,0,e_3,607,616,624,2,0,0,0,3,0,0,9,8,17
p_106,5,0,e_1,583,591,662,27,1,1,2,5,0,3,8,71,79
p_98,6,0,e_1,555,596,662,4,1,0,3,5,1,1,41,66,107
p_108,7,0,e_1,584,601,662,24,1,1,3,5,0,4,17,61,78
p_100,10,0,e_1,557,612,662,30,2,2,3,5,1,2,55,50,105
p_105,12,0,e_1,582,620,662,20,1,1,2,5,0,2,38,42,80
p_110,12,0,e_1,590,620,662,12,0,0,5,2,0,4,30,42,72
p_113,9,0,e_1,629,631,662,9,0,0,10,4,1,0,2,31,33
p_116,7,0,e_1,633,639,662,19,1,1,9,4,1,0,6,23,29
p_101,9,0,e_2,566,600,663,28,1,1,1,4,1,0,34,63,97
p_102,14,0,e_2,568,617,663,22,1,1,1,4,1,1,49,46,95
p_103,14,0,e_2,577,617,663,19,1,1,2,5,0,2,40,46,86
p_104,14,0,e_2,581,617,663,18,1,1,3,5,0,2,36,46,82
p_107,3,0,e_2,584,652,663,28,1,1,4,5,0,2,68,11,79
p_109,10,0,e_0,590,622,664,10,0,0,0,3,0,0,32,42,74
p_112,11,0,e_0,613,627,664,10,1,0,7,5,0,1,14,37,51
p_115,9,0,e_0,632,635,664,9,0,0,10,4,1,0,3,29,32
p_117,0,2,e_1,636,662,672,25,1,1,8,4,1,1,26,10,36
p_123,0,2,e_1,661,662,672,18,4,4,0,3,1,0,1,10,11
p_125,2,0,e_1,668,672,680,13,4,1,1,5,1,0,4,8,12
p_126,1,0,e_1,681,687,692,10,3,2,0,3,0,0,6,5,11
p_124,7,0,e_0,664,687,710,10,4,1,0,3,1,0,23,23,46
p_118,8,0,e_3,649,658,720,13,1,1,5,5,0,1,9,62,71
p_119,8,0,e_3,650,658,720,12,2,1,6,5,0,2,8,62,70
p_114,13,0,e_3,632,675,720,13,0,0,0,3,0,0,43,45,88
p_120,13,0,e_3,653,675,720,6,2,0,7,5,0,2,22,45,67
p_122,7,0,e_3,657,695,720,11,2,1,8,2,0,2,38,25,63
p_121,3,0,e_3,656,709,720,15,2,1,8,5,0,2,53,11,64
p_128,0,15,e_2,705,706,757,4,2,0,0,3,0,0,1,51,52
p_132,4,0,e_3,730,745,759,4,0,0,0,3,0,0,15,14,29
p_127,7,0,e_1,701,725,796,28,2,2,0,3,0,0,24,71,95
p_130,11,0,e_1,705,739,796,23,2,2,1,5,0,1,34,57,91
p_134,14,0,e_1,734,750,796,14,1,0,9,5,1,1,16,46,62
p_136,14,0,e_1,749,750,796,19,1,1,14,5,1,1,1,46,47
p_140,5,0,e_1,768,779,796,22,1,1,9,4,1,0,11,17,28
p_129,5,0,e_2,705,725,806,29,2,2,0,3,0,1,20,81,101
p_137,13,0,e_2,755,765,806,18,1,1,15,5,2,0,10,41,51
p_133,6,0,e_0,734,742,806,6,1,0,4,5,0,1,8,64,72
p_131,7,0,e_0,722,747,806,7,0,0,0,3,0,0,25,59,84
p_135,11,0,e_0,739,761,806,9,1,0,5,5,0,2,22,45,67
p_138,12,0,e_0,756,766,806,19,1,1,10,5,1,1,10,40,50
p_143,5,0,e_0,780,789,806,18,3,3,8,4,1,0,9,17,26
p_139,0,15,e_3,758,759,810,0,1,0,0,4,1,0,1,51,52
p_145,1,0,e_1,820,825,830,11,1,0,0,3,0,0,5,5,10
p_144,6,0,e_0,815,835,855,8,1,0,0,3,0,0,20,20,40
p_141,12,0,e_3,770,797,857,15,1,1,3,5,1,0,27,60,87
p_142,13,0,e_3,773,802,857,13,2,1,4,5,1,1,29,55,84
p_150,3,0,e_3,860,872,885,3,0,0,0,3,0,0,12,13,25
p_152,2,0,e_3,868,877,885,2,1,1,2,5,0,1,9,8,17
p_149,6,0,e_0,859,879,901,6,0,0,0,3,0,0,20,22,42
p_153,6,0,e_0,872,879,901,5,1,0,4,5,0,1,7,22,29
p_154,4,0,e_0,874,887,901,29,2,2,5,5,0,1,13,14,27
p_147,6,0,e_1,849,866,932,26,1,1,1,5,0,1,17,66,83
p_146,10,0,e_1,846,880,932,24,1,1,0,3,0,0,34,52,86
p_155,11,0,e_1,884,885,932,19,1,1,11,5,1,1,1,47,48
p_151,12,0,e_1,863,890,932,12,1,0,5,5,0,2,27,42,69
p_156,12,0,e_1,884,890,932,18,1,1,11,5,1,1,6,42,48
p_159,8,0,e_1,893,904,932,8,0,0,11,4,1,1,11,28,39
p_157,7,0,e_1,889,909,932,7,0,0,12,5,1,1,20,23,43
p_158,7,0,e_1,892,909,932,7,0,0,12,4,1,1,17,23,40
p_148,15,0,e_2,849,896,943,18,1,1,0,3,0,0,47,47,94
p_3,4,0,e_2,25,40,88,4,0,0,0,3,0,0,15,48,63
p_4,5,0,e_2,34,45,88,5,0,0,2,5,0,1,11,43,54
p_5,9,0,e_2,41,59,88,9,0,0,4,5,1,1,18,29,47
p_6,9,0,e_2,45,59,88,9,0,0,5,5,1,1,14,29,43
p_2,11,0,e_1,19,54,89,11,0,0,0,3,0,0,35,35,70
p_1,13,0,e_0,13,55,96,13,0,0,0,3,0,0,42,41,83
p_12,0,8,e_1,86,89,115,21,4,4,1,4,1,0,3,26,29
p_16,4,0,e_0,101,113,135,13,3,1,0,5,0,1,12,22,34
p_15,5,0,e_0,99,118,135,13,4,2,0,3,0,0,19,17,36
p_13,8,0,e_2,87,114,148,13,5,3,0,3,1,1,27,34,61
p_10,9,0,e_2,77,119,148,15,3,2,3,4,1,0,42,29,71
p_19,0,7,e_0,125,135,158,10,2,0,3,4,1,0,10,23,33
p_7,2,0,e_3,55,64,160,2,0,0,0,3,0,0,9,96,105
p_9,10,0,e_3,67,90,160,17,2,1,3,5,1,1,23,70,93
p_14,13,0,e_3,87,101,160,8,4,1,9,5,1,3,14,59,73
p_8,15,0,e_3,62,109,160,14,1,0,1,5,0,1,47,51,98
p_11,4,0,e_3,84,144,160,18,3,2,8,5,1,2,60,16,76
p_20,3,0,e_3,142,149,160,1,2,0,4,4,1,1,7,11,18
p_21,0,10,e_2,142,148,180,4,2,0,2,4,1,0,6,32,38
p_17,10,0,e_1,112,123,189,5,2,0,7,5,1,0,11,66,77
p_18,15,0,e_1,120,140,189,27,2,2,9,5,0,1,20,49,69
p_22,6,0,e_1,146,169,189,28,2,2,14,4,1,0,23,20,43
p_30,2,0,e_1,200,208,216,6,1,0,0,3,0,0,8,8,16
p_26,6,0,e_3,169,184,228,11,1,1,1,5,0,1,15,44,59
p_25,9,0,e_3,163,195,228,9,0,0,0,3,0,0,32,33,65
p_31,5,0,e_3,203,209,228,2,1,0,7,4,1,0,6,19,25
p_33,1,0,e_3,213,223,228,3,1,0,4,4,1,0,10,5,15
p_23,15,0,e_0,150,184,237,18,1,1,5,5,1,0,34,53,87
p_28,7,0,e_0,184,210,237,5,2,1,15,4,1,1,26,27,53
p_27,5,0,e_0,180,218,237,8,2,2,14,5,0,1,38,19,57
p_36,1,0,e_0,225,232,237,30,1,1,3,4,1,0,7,5,12
p_24,14,0,e_2,157,194,238,17,1,1,2,5,1,0,37,44,81
p_29,14,0,e_2,192,194,238,6,2,0,13,5,0,1,2,44,46
p_32,0,10,e_1,209,216,248,5,1,0,2,4,1,0,7,32,39
p_35,0,6,e_3,222,228,248,1,1,0,1,1,1,0,6,20,26
p_42,4,0,e_2,269,283,297,10,2,1,0,3,0,0,14,14,28
p_43,4,0,e_2,270,283,297,10,2,1,0,5,0,1,13,14,27
p_44,4,0,e_2,275,283,297,9,1,0,1,5,0,1,8,14,22
p_41,7,0,e_0,257,280,303,11,2,2,0,3,0,0,23,23,46
p_38,12,0,e_3,240,268,314,8,1,0,4,5,1,0,28,46,74
p_39,13,0,e_3,247,273,314,7,1,0,6,2,1,1,26,41,67
p_34,11,0,e_1,217,253,316,22,2,2,0,5,1,0,36,63,99
p_37,15,0,e_1,228,267,316,15,1,0,3,5,1,1,39,49,88
p_40,15,0,e_1,255,267,316,7,2,0,11,5,1,1,12,49,61
p_47,3,0,e_1,293,305,316,4,1,0,7,4,1,0,12,11,23
p_49,3,0,e_1,298,305,316,2,2,0,5,4,1,1,7,11,18
p_51,0,4,e_1,309,316,330,1,2,0,2,4,1,0,7,14,21
p_57,1,0,e_1,327,341,346,13,1,1,3,5,1,0,14,5,19
p_54,7,0,e_0,313,326,361,7,1,1,3,5,0,1,13,35,48
p_46,8,0,e_0,291,331,361,30,1,1,4,4,1,0,40,30,70
p_53,8,0,e_0,313,331,361,8,1,1,3,5,0,1,18,30,48
p_56,8,0,e_0,324,331,361,7,1,1,7,5,0,2,7,30,37
p_59,3,0,e_0,335,348,361,9,1,1,7,4,1,0,13,13,26
p_60,2,0,e_0,338,353,361,9,1,1,6,4,1,1,15,8,23
p_58,0,6,e_1,330,346,368,13,1,1,4,3,1,1,16,22,38
p_63,3,0,e_0,364,376,387,6,1,0,0,3,0,0,12,11,23
p_45,11,0,e_2,290,332,387,27,1,1,2,4,1,0,42,55,97
p_50,11,0,e_2,299,332,387,24,2,2,0,5,0,1,33,55,88
p_52,14,0,e_2,312,343,387,16,2,2,5,5,0,1,31,44,75
p_55,14,0,e_2,314,343,387,14,1,1,5,5,0,2,29,44,73
p_62,1,0,e_1,345,351,388,14,2,1,0,3,1,0,6,37,43
p_48,9,0,e_3,294,343,392,28,1,1,7,4,1,0,49,49,98
p_61,12,0,e_3,341,354,392,3,1,0,9,5,0,1,13,38,51
p_65,0,7,e_1,369,388,413,7,1,0,6,4,1,0,19,25,44
p_69,2,0,e_3,391,400,416,2,0,0,0,3,1,0,9,16,25
p_70,3,0,e_3,398,405,416,1,1,0,2,5,0,1,7,11,18
p_64,0,15,e_2,365,387,436,9,1,0,7,4,1,0,22,49,71
p_68,2,0,e_1,389,396,438,29,1,1,0,5,1,0,7,42,49
p_71,7,0,e_1,403,413,438,4,2,0,4,5,2,0,10,25,35
p_73,3,0,e_1,423,427,438,8,1,1,4,4,1,0,4,11,15
p_72,6,0,e_3,417,438,458,6,0,0,0,3,0,0,21,20,41
p_66,11,0,e_0,376,422,459,24,1,1,3,4,1,0,46,37,83
p_74,10,0,e_0,424,427,459,9,1,0,11,4,1,0,3,32,35
p_75,3,0,e_1,438,450,461,3,1,0,0,3,0,0,12,11,23
p_67,12,0,e_2,377,425,487,23,1,1,3,4,1,0,48,62,110
p_76,10,0,e_2,440,453,487,26,1,1,14,4,1,0,13,34,47
p_77,4,0,e_2,455,473,487,27,1,1,10,4,1,0,18,14,32
p_81,1,0,e_1,493,498,503,6,1,0,0,3,0,0,5,5,10
p_79,9,0,e_3,457,487,516,21,1,1,0,4,1,0,30,29,59
p_82,0,12,e_2,494,494,534,7,1,0,0,3,0,0,0,40,40
p_83,0,12,e_1,501,503,541,5,1,0,1,4,1,0,2,38,40
p_78,12,0,e_0,455,497,547,19,1,1,1,4,1,0,42,50,92
p_80,13,0,e_0,474,502,547,8,1,0,5,5,0,1,28,45,73
p_84,12,0,e_0,504,507,547,22,1,1,13,4,1,0,3,40,43
p_90,1,0,e_0,538,542,547,17,2,2,2,4,1,0,4,5,9
p_95,10,0,e_1,547,549,585,5,2,0,11,4,0,2,2,36,38
p_89,5,0,e_1,535,566,585,13,2,1,10,5,1,0,31,19,50
p_97,5,0,e_1,552,566,585,9,2,1,10,4,1,2,14,19,33
p_93,4,0,e_1,543,571,585,13,2,1,12,4,0,1,28,14,42
p_85,14,0,e_2,517,542,592,14,0,0,7,5,1,0,25,50,75
p_86,14,0,e_2,518,542,592,14,0,0,7,5,1,1,24,50,74
p_91,14,0,e_2,539,542,592,11,2,0,13,5,0,1,3,50,53
p_92,10,0,e_2,540,556,592,7,2,0,14,5,0,1,16,36,52
p_99,9,0,e_2,556,561,592,3,2,1,10,4,1,1,5,31,36
p_98,6,0,e_2,555,572,592,6,2,1,10,1,1,0,17,20,37
p_87,3,0,e_3,528,540,595,3,0,0,0,3,0,0,12,55,67
p_88,10,0,e_3,531,563,595,10,1,0,0,5,0,1,32,32,64
p_100,10,0,e_3,557,563,595,2,2,0,8,5,1,1,6,32,38
p_111,2,0,e_2,607,616,624,2,0,0,0,3,0,0,9,8,17
p_94,3,0,e_0,546,558,647,13,2,1,0,3,1,0,12,89,101
p_96,7,0,e_0,551,572,647,7,2,1,1,5,0,1,21,75,96
p_101,9,0,e_0,566,580,647,30,1,1,5,5,1,1,14,67,81
p_105,12,0,e_0,582,591,647,22,1,1,9,5,1,1,9,56,65
p_102,14,0,e_0,568,599,647,25,1,1,6,5,1,2,31,48,79
p_103,14,0,e_0,577,599,647,22,1,1,8,5,1,2,22,48,70
p_104,14,0,e_0,581,599,647,21,1,1,9,5,1,1,18,48,66
p_108,7,0,e_0,584,622,647,26,1,1,10,5,1,3,38,25,63
p_106,5,0,e_0,583,630,647,29,1,1,10,5,1,2,47,17,64
p_117,0,2,e_0,636,647,655,19,2,2,3,4,1,0,11,8,19
p_107,3,0,e_1,584,596,667,30,1,1,0,4,1,0,12,71,83
p_109,10,0,e_1,590,619,667,21,1,1,1,5,0,1,29,48,77
p_110,12,0,e_1,590,627,667,19,1,1,1,5,0,2,37,40,77
p_113,9,0,e_1,629,638,667,9,1,1,12,4,1,0,9,29,38
p_115,9,0,e_1,632,638,667,11,2,2,11,4,1,1,6,29,35
p_123,0,2,e_1,661,667,675,12,1,0,2,4,1,0,6,8,14
p_125,2,0,e_1,668,675,683,8,1,0,0,5,1,0,7,8,15
p_116,7,0,e_2,633,656,691,13,2,2,0,3,0,0,23,35,58
p_118,8,0,e_2,649,661,691,7,2,1,5,5,0,1,12,30,42
p_119,8,0,e_2,650,661,691,7,2,1,5,5,0,2,11,30,41
p_124,7,0,e_2,664,666,691,4,1,0,8,4,1,0,2,25,27
p_126,1,0,e_2,681,686,691,5,1,0,3,4,1,0,5,5,10
p_121,3,0,e_0,656,661,698,16,1,0,2,3,0,0,5,37,42
p_122,7,0,e_0,657,675,698,6,1,0,2,5,0,1,18,23,41
p_112,11,0,e_3,613,649,698,11,0,0,0,3,0,0,36,49,85
p_114,13,0,e_3,632,657,698,7,1,0,6,5,0,1,25,41,66
p_120,13,0,e_3,653,657,698,1,2,0,12,5,1,1,4,41,45
p_129,5,0,e_1,705,722,739,5,0,0,0,3,0,0,17,17,34
p_127,7,0,e_0,701,725,750,7,0,0,0,3,0,0,24,25,49
p_131,7,0,e_0,722,725,750,19,1,1,6,5,0,1,3,25,28
p_132,4,0,e_0,730,736,750,19,1,1,6,4,1,0,6,14,20
p_128,0,15,e_3,705,706,755,0,0,0,0,3,0,0,1,49,50
p_130,11,0,e_2,705,740,799,11,0,0,0,3,0,0,35,59,94
p_134,14,0,e_2,734,751,799,8,1,1,9,5,0,1,17,48,65
p_136,14,0,e_2,749,751,799,3,2,1,14,5,1,1,2,48,50
p_138,12,0,e_2,756,759,799,3,2,1,13,4,1,0,3,40,43
p_140,5,0,e_2,768,782,799,7,2,1,10,4,1,0,14,17,31
p_143,5,0,e_2,780,782,799,3,2,1,6,4,1,1,2,17,19
p_137,13,0,e_3,755,763,806,2,1,0,15,4,0,1,8,43,51
p_133,6,0,e_3,734,786,806,16,1,1,8,5,1,0,52,20,72
p_139,0,15,e_0,758,758,807,14,2,0,0,3,0,0,0,49,49
p_135,11,0,e_1,739,775,826,9,2,1,0,3,0,0,36,51,87
p_141,12,0,e_1,770,780,826,29,2,2,9,5,0,1,10,46,56
p_142,13,0,e_1,773,785,826,27,2,2,10,5,0,2,12,41,53
p_145,1,0,e_3,820,826,831,1,0,0,0,3,0,0,6,5,11
p_144,6,0,e_2,815,835,855,6,0,0,0,3,0,0,20,20,40
p_150,3,0,e_2,860,871,882,24,1,1,0,3,0,0,11,11,22
p_146,10,0,e_0,846,863,901,10,0,0,15,3,0,0,17,38,55
p_153,6,0,e_0,872,877,901,17,1,1,7,4,1,1,5,24,29
p_154,4,0,e_0,874,885,901,18,1,1,7,4,1,2,11,16,27
p_152,2,0,e_0,868,893,901,22,1,1,9,4,1,0,25,8,33
p_147,6,0,e_1,849,870,932,6,0,0,0,3,0,0,21,62,83
p_149,6,0,e_1,859,870,932,21,1,1,2,5,0,1,11,62,73
p_151,12,0,e_1,863,890,932,14,1,1,4,5,0,1,27,42,69
p_156,12,0,e_1,884,890,932,7,1,1,10,5,1,1,6,42,48
p_159,8,0,e_1,893,904,932,8,2,1,12,4,1,1,11,28,39
p_158,7,0,e_1,892,909,932,9,2,1,12,4,1,0,17,23,40
p_148,15,0,e_3,849,896,945,15,0,0,0,3,0,0,47,49,96
p_157,7,0,e_3,889,922,945,10,1,1,13,5,0,1,33,23,56
p_155,11,0,e_2,884,920,955,8,1,1,0,3,0,0,36,35,71
p_3,4,0,e_2,25,40,88,4,0,0,0,3,0,0,15,48,63
p_4,5,0,e_2,34,45,88,5,0,0,2,5,0,1,11,43,54
p_5,9,0,e_2,41,59,88,9,0,0,4,5,1,1,18,29,47
p_6,9,0,e_2,45,59,88,9,0,0,5,2,1,1,14,29,43
p_2,11,0,e_1,19,55,90,11,0,0,0,3,0,0,36,35,71
p_1,13,0,e_0,13,55,96,13,0,0,0,3,0,0,42,41,83
p_12,0,8,e_1,86,90,116,21,4,4,1,4,1,0,4,26,30
p_16,4,0,e_2,101,115,129,13,4,1,0,3,0,0,14,14,28
p_15,5,0,e_0,99,116,133,13,5,2,0,3,0,0,17,17,34
p_19,0,7,e_2,125,129,154,10,3,0,1,4,1,0,4,25,29
p_7,2,0,e_3,55,63,161,2,0,0,0,3,0,0,8,98,106
p_10,9,0,e_3,77,86,161,15,3,2,6,5,1,2,9,75,84
p_9,10,0,e_3,67,91,161,17,2,1,3,5,1,1,24,70,94
p_14,13,0,e_3,87,102,161,8,4,1,9,5,1,3,15,59,74
p_8,15,0,e_3,62,110,161,17,0,0,2,2,0,0,48,51,99
p_13,8,0,e_3,87,133,161,13,5,3,9,5,1,4,46,28,74
p_11,4,0,e_3,84,147,161,17,4,2,9,5,1,3,63,14,77
p_21,0,10,e_0,142,143,181,5,2,0,0,3,0,1,1,38,39
p_17,10,0,e_1,112,124,188,5,3,0,7,5,1,0,12,64,76
p_18,15,0,e_1,120,141,188,27,3,3,9,5,0,1,21,47,68
p_20,3,0,e_0,142,156,213,2,2,1,0,3,0,0,14,57,71
p_25,9,0,e_0,163,176,213,9,0,0,5,5,2,0,13,37,50
p_30,2,0,e_1,200,208,216,18,2,1,0,3,0,0,8,8,16
p_22,6,0,e_2,146,149,233,28,2,2,5,5,1,0,3,84,87
p_24,14,0,e_2,157,177,233,17,1,1,7,5,1,1,20,56,76
p_23,15,0,e_2,150,182,233,19,1,1,6,5,2,0,32,51,83
p_31,5,0,e_2,203,214,233,14,2,1,8,4,1,0,11,19,30
p_33,1,0,e_2,213,228,233,15,2,1,5,4,1,1,15,5,20
p_36,1,0,e_2,225,228,233,12,2,1,2,4,1,1,3,5,8
p_35,0,6,e_1,222,223,245,13,2,0,0,3,0,0,1,22,23
p_32,0,10,e_0,209,213,245,17,2,2,1,4,1,0,4,32,36
p_27,5,0,e_3,180,186,265,4,1,1,3,5,0,1,6,79,85
p_26,6,0,e_3,169,191,265,6,0,0,0,3,0,0,22,74,96
p_28,7,0,e_3,184,196,265,2,2,0,5,5,0,2,12,69,81
p_29,14,0,e_3,192,219,265,8,2,0,6,5,1,1,27,46,73
p_34,11,0,e_3,217,230,265,4,2,1,13,5,1,1,13,35,48
p_42,4,0,e_3,269,284,298,4,0,0,0,3,0,0,15,14,29
p_43,4,0,e_3,270,284,298,4,1,0,0,5,0,1,14,14,28
p_44,4,0,e_3,275,284,298,3,1,0,1,5,0,1,9,14,23
p_41,7,0,e_2,257,280,303,25,1,1,0,3,0,0,23,23,46
p_37,15,0,e_0,228,262,311,26,2,2,5,5,1,0,34,49,83
p_40,15,0,e_0,255,262,311,18,1,1,13,5,0,1,7,49,56
p_47,3,0,e_0,293,300,311,29,3,3,5,4,1,0,7,11,18
p_38,12,0,e_1,240,265,313,26,1,1,5,5,1,0,25,48,73
p_39,13,0,e_1,247,270,313,23,1,1,6,5,0,1,23,43,66
p_49,3,0,e_1,298,302,313,19,3,3,4,4,1,0,4,11,15
p_51,0,4,e_2,309,310,326,19,3,3,0,3,0,0,1,16,17
p_54,7,0,e_0,313,337,364,16,4,4,0,3,0,0,24,27,51
p_59,3,0,e_0,335,351,364,15,3,2,6,5,0,3,16,13,29
p_57,1,0,e_0,327,359,364,19,4,3,4,5,0,1,32,5,37
p_62,1,0,e_0,345,359,364,14,3,1,5,4,1,2,14,5,19
p_53,8,0,e_1,313,339,365,15,4,3,0,3,1,0,26,26,52
p_56,8,0,e_2,324,340,368,12,4,3,4,5,1,0,16,28,44
p_60,2,0,e_2,338,360,368,15,2,1,8,5,0,1,22,8,30
p_58,0,6,e_0,330,364,386,19,3,3,5,5,0,2,34,22,56
p_65,0,7,e_2,369,369,394,8,1,0,0,3,0,0,0,25,25
p_46,8,0,e_3,291,324,394,24,2,2,2,4,1,1,33,70,103
p_48,9,0,e_3,294,329,394,22,3,3,1,4,1,2,35,65,100
p_45,11,0,e_3,290,337,394,22,1,1,3,4,1,0,47,57,104
p_50,11,0,e_3,299,337,394,11,3,0,0,5,0,3,38,57,95
p_52,14,0,e_3,312,348,394,10,3,0,4,5,0,3,36,46,82
p_55,14,0,e_3,314,348,394,9,4,0,5,5,0,4,34,46,80
p_61,12,0,e_3,341,356,394,4,2,1,12,5,1,1,15,38,53
p_64,0,15,e_1,365,366,415,10,1,0,0,3,0,0,1,49,50
p_68,2,0,e_2,389,411,419,30,1,1,6,5,1,0,22,8,30
p_69,2,0,e_2,391,411,419,29,1,1,6,5,1,1,20,8,28
p_73,3,0,e_2,423,434,445,4,2,0,0,3,0,0,11,11,22
p_70,3,0,e_3,398,410,447,3,0,0,0,3,0,0,12,37,49
p_71,7,0,e_3,403,424,447,6,1,0,1,5,0,1,21,23,44
p_63,3,0,e_0,364,375,448,7,1,0,0,3,1,0,11,73,84
p_66,11,0,e_0,376,403,448,25,1,1,3,5,2,0,27,45,72
p_67,12,0,e_0,377,408,448,23,1,1,3,5,2,1,31,40,71
p_72,6,0,e_0,417,428,448,3,2,1,9,4,1,0,11,20,31
p_74,10,0,e_1,424,442,478,27,1,1,15,3,0,0,18,36,54
p_76,10,0,e_1,440,442,478,22,1,1,11,4,0,2,2,36,38
p_77,4,0,e_1,455,462,478,4,0,0,6,4,1,1,7,16,23
p_75,3,0,e_1,438,467,478,30,1,1,11,4,0,1,29,11,40
p_81,1,0,e_1,493,498,503,1,0,0,0,3,0,0,5,5,10
p_79,9,0,e_2,457,487,516,9,0,0,0,3,0,0,30,29,59
p_82,0,12,e_3,494,495,535,0,0,0,0,3,0,0,1,40,41
p_78,12,0,e_0,455,494,542,12,0,0,0,3,0,0,39,48,87
p_80,13,0,e_0,474,499,542,13,0,0,6,5,0,1,25,43,68
p_87,3,0,e_0,528,531,542,15,2,2,4,4,1,0,3,11,14
p_83,0,12,e_1,501,503,543,23,1,1,0,4,1,0,2,40,42
p_90,1,0,e_2,538,541,572,14,2,1,0,5,0,1,3,31,34
p_89,5,0,e_2,535,555,572,11,2,1,0,3,0,0,20,17,37
p_97,5,0,e_2,552,555,572,6,1,0,4,5,1,1,3,17,20
p_94,3,0,e_0,546,555,574,10,1,0,0,5,0,1,9,19,28
p_93,4,0,e_0,543,560,574,18,1,0,0,3,0,0,17,14,31
p_88,10,0,e_1,531,535,585,7,2,2,9,5,1,0,4,50,54
p_92,10,0,e_1,540,551,585,5,2,1,11,5,2,0,11,34,45
p_95,10,0,e_1,547,551,585,3,1,0,11,4,1,1,4,34,38
p_96,7,0,e_1,551,562,585,5,1,0,10,1,1,0,11,23,34
p_84,12,0,e_3,504,535,589,10,1,0,2,5,1,0,31,54,85
p_85,14,0,e_3,517,543,589,8,1,0,6,5,1,0,26,46,72
p_86,14,0,e_3,518,543,589,8,2,0,6,5,1,1,25,46,71
p_91,14,0,e_3,539,543,589,1,2,0,13,5,1,1,4,46,50
p_99,9,0,e_3,556,560,589,1,1,0,10,4,1,0,4,29,33
p_111,2,0,e_3,607,616,624,2,0,0,0,3,0,0,9,8,17
p_101,9,0,e_2,566,601,664,28,1,1,2,4,1,0,35,63,98
p_105,12,0,e_2,582,612,664,20,1,1,3,5,0,2,30,52,82
p_110,12,0,e_2,590,612,664,12,0,0,6,5,0,3,22,52,74
p_102,14,0,e_2,568,620,664,23,1,1,1,4,1,1,52,44,96
p_104,14,0,e_2,581,620,664,18,1,1,2,5,0,2,39,44,83
p_107,3,0,e_1,584,596,665,28,1,1,0,3,1,0,12,69,81
p_108,7,0,e_1,584,610,665,24,1,1,0,3,1,1,26,55,81
p_109,10,0,e_1,590,621,665,10,0,0,1,5,0,2,31,44,75
p_112,11,0,e_1,613,626,665,10,1,0,8,5,1,1,13,39,52
p_113,9,0,e_1,629,634,665,9,0,0,11,4,1,0,5,31,36
p_115,9,0,e_1,632,634,665,9,0,0,10,4,1,1,2,31,33
p_116,7,0,e_1,633,642,665,19,1,1,9,4,1,1,9,23,32
p_106,5,0,e_0,583,591,670,27,1,1,3,5,0,3,8,79,87
p_98,6,0,e_0,555,596,670,5,1,0,3,5,1,1,41,74,115
p_100,10,0,e_0,557,610,670,30,2,2,3,5,1,2,53,60,113
p_103,14,0,e_0,577,624,670,20,1,1,1,5,0,2,47,46,93
p_121,3,0,e_0,656,659,670,16,2,2,4,4,1,0,3,11,14
p_117,0,2,e_2,636,664,672,26,1,1,9,4,1,0,28,8,36
p_123,0,2,e_1,661,665,673,18,3,3,1,4,1,0,4,8,12
p_125,2,0,e_1,668,673,681,14,3,1,0,5,1,0,5,8,13
p_126,1,0,e_0,681,686,691,11,2,1,0,3,0,0,5,5,10
p_124,7,0,e_2,664,689,712,10,3,1,0,3,1,0,25,23,48
p_118,8,0,e_3,649,659,719,13,1,1,5,5,0,1,10,60,70
p_119,8,0,e_3,650,659,719,13,2,1,5,5,0,2,9,60,69
p_114,13,0,e_3,632,676,719,13,0,0,0,3,0,0,44,43,87
p_120,13,0,e_3,653,676,719,7,2,0,6,5,0,2,23,43,66
p_122,7,0,e_3,657,696,719,12,2,2,7,5,0,2,39,23,62
p_129,5,0,e_1,705,722,739,30,1,1,0,3,0,0,17,17,34
p_128,0,15,e_2,705,712,759,4,1,0,2,4,1,0,7,47,54
p_132,4,0,e_3,730,737,773,8,1,1,2,5,0,1,7,36,43
p_133,6,0,e_3,734,745,773,5,2,1,3,5,0,2,11,28,39
p_131,7,0,e_3,722,750,773,7,0,0,0,3,0,0,28,23,51
p_127,7,0,e_0,701,725,802,29,1,1,0,3,0,0,24,77,101
p_130,11,0,e_0,705,739,802,24,1,1,1,5,0,1,34,63,97
p_135,11,0,e_0,739,741,802,7,3,0,11,5,1,1,2,61,63
p_134,14,0,e_0,734,752,802,11,3,0,9,5,1,1,18,50,68
p_136,14,0,e_0,749,752,802,21,1,0,13,5,1,1,3,50,53
p_137,13,0,e_0,755,757,802,23,1,1,14,4,1,0,2,45,47
p_138,12,0,e_0,756,762,802,23,1,1,13,1,1,0,6,40,46
p_140,5,0,e_0,768,785,802,26,1,1,10,4,1,0,17,17,34
p_143,5,0,e_0,780,785,802,5,0,0,7,4,1,1,5,17,22
p_139,0,15,e_1,758,759,808,5,1,0,0,3,0,0,1,49,50
p_142,13,0,e_2,773,778,821,13,0,0,14,4,0,1,5,43,48
p_141,12,0,e_2,770,783,821,19,1,1,15,3,0,0,13,38,51
p_145,1,0,e_2,820,826,831,1,0,0,0,3,1,0,6,5,11
p_144,6,0,e_0,815,836,856,6,0,0,0,3,0,0,21,20,41
p_150,3,0,e_0,860,871,884,6,1,1,0,3,0,0,11,13,24
p_152,2,0,e_0,868,876,884,16,2,1,2,5,0,1,8,8,16
p_146,10,0,e_1,846,863,899,10,0,0,15,3,0,0,17,36,53
p_153,6,0,e_1,872,877,899,12,2,1,8,4,1,0,5,22,27
p_154,4,0,e_1,874,885,899,13,2,1,7,4,1,1,11,14,25
p_147,6,0,e_3,849,870,932,6,0,0,0,3,0,0,21,62,83
p_149,6,0,e_3,859,870,932,4,1,0,2,5,0,1,11,62,73
p_155,11,0,e_3,884,887,932,3,2,1,10,5,1,1,3,45,48
p_151,12,0,e_3,863,892,932,8,1,0,4,5,0,1,29,40,69
p_156,12,0,e_3,884,892,932,2,3,0,10,5,1,2,8,40,48
p_159,8,0,e_3,893,906,932,4,1,0,12,4,1,0,13,26,39
p_157,7,0,e_0,889,913,936,6,2,1,0,3,0,0,24,23,47
p_158,7,0,e_0,892,913,936,19,1,0,0,5,0,1,21,23,44
p_148,15,0,e_2,849,897,944,15,0,0,0,3,0,0,48,47,95
p_3,4,0,e_2,25,39,53,4,0,0,0,3,0,0,14,14,28
p_7,2,0,e_2,55,63,71,10,2,1,0,3,0,0,8,8,16
p_6,9,0,e_1,45,48,91,6,2,0,8,5,0,1,3,43,46
p_2,11,0,e_1,19,56,91,11,0,0,0,3,0,0,37,35,72
p_1,13,0,e_0,13,55,96,13,0,0,0,3,0,0,42,41,83
p_12,0,8,e_1,86,91,117,15,2,2,1,4,1,0,5,26,31
p_15,5,0,e_0,99,117,134,7,1,0,0,3,0,0,18,17,35
p_4,5,0,e_3,34,52,137,5,0,0,0,3,0,0,18,85,103
p_5,9,0,e_3,41,66,137,7,1,0,2,5,0,1,25,71,96
p_9,10,0,e_3,67,71,137,11,2,1,9,5,1,1,4,66,70
p_8,15,0,e_3,62,88,137,7,2,0,8,5,1,1,26,49,75
p_16,4,0,e_3,101,123,137,7,1,0,11,4,1,0,22,14,36
p_19,0,7,e_0,125,134,159,4,1,0,3,4,1,0,9,25,34
p_11,4,0,e_2,84,92,166,12,2,1,2,5,0,1,8,74,82
p_13,8,0,e_2,87,106,166,23,1,0,3,5,0,2,19,60,79
p_10,9,0,e_2,77,111,166,10,2,1,0,3,0,0,34,55,89
p_14,13,0,e_2,87,125,166,28,1,0,3,5,0,3,38,41,79
p_21,0,10,e_3,142,143,179,0,0,0,0,3,0,0,1,36,37
p_17,10,0,e_1,112,125,189,27,2,2,7,5,1,0,13,64,77
p_18,15,0,e_1,120,142,189,20,2,2,8,5,0,1,22,47,69
p_27,5,0,e_2,180,187,224,13,2,1,3,5,0,1,7,37,44
p_26,6,0,e_2,169,192,224,15,3,2,0,3,0,0,23,32,55
p_28,7,0,e_2,184,197,224,10,2,1,4,5,0,2,13,27,40
p_30,2,0,e_2,200,214,224,10,1,0,6,4,1,0,14,10,24
p_33,1,0,e_2,213,219,224,7,1,0,2,4,1,1,6,5,11
p_20,3,0,e_3,142,156,237,3,1,1,0,3,0,1,14,81,95
p_24,14,0,e_3,157,193,237,11,2,0,3,5,2,0,36,44,80
p_22,6,0,e_0,146,154,238,14,2,1,3,5,1,0,8,84,92
p_25,9,0,e_0,163,167,238,14,3,2,8,5,1,1,4,71,75
p_23,15,0,e_0,150,187,238,14,2,0,5,5,1,1,37,51,88
p_31,5,0,e_0,203,219,238,6,1,0,10,4,1,0,16,19,35
p_36,1,0,e_0,225,233,238,3,1,0,3,4,1,0,8,5,13
p_35,0,6,e_2,222,224,244,5,1,0,0,4,1,0,2,20,22
p_32,0,10,e_2,209,224,258,9,1,0,4,4,1,1,15,34,49
p_34,11,0,e_1,217,227,294,25,1,1,8,5,0,1,10,67,77
p_29,14,0,e_1,192,238,294,28,1,0,0,3,0,0,46,56,102
p_37,15,0,e_1,228,243,294,18,1,1,11,5,1,1,15,51,66
p_39,13,0,e_1,247,251,294,13,0,0,14,4,1,0,4,43,47
p_42,4,0,e_1,269,280,294,7,1,1,7,4,1,0,11,14,25
p_43,4,0,e_1,270,280,294,7,1,1,7,4,1,1,10,14,24
p_44,4,0,e_1,275,280,294,5,1,1,5,4,1,1,5,14,19
p_41,7,0,e_3,257,281,304,7,0,0,0,3,0,0,24,23,47
p_38,12,0,e_0,240,279,321,12,0,0,0,3,0,0,39,42,81
p_46,8,0,e_0,291,293,321,26,1,1,9,4,1,0,2,28,30
p_49,3,0,e_0,298,310,321,29,1,1,7,4,1,0,12,11,23
p_40,15,0,e_2,255,275,322,15,0,0,9,5,1,0,20,47,67
p_51,0,4,e_3,309,309,325,0,0,0,0,3,0,0,0,16,16
p_57,1,0,e_2,327,333,338,23,1,1,0,3,0,0,6,5,11
p_58,0,6,e_2,330,338,358,23,1,1,0,5,0,1,8,20,28
p_47,3,0,e_1,293,305,374,30,1,1,0,3,1,1,12,69,81
p_54,7,0,e_1,313,319,374,21,2,1,5,5,1,2,6,55,61
p_53,8,0,e_1,313,324,374,20,2,1,5,5,1,3,11,50,61
p_48,9,0,e_1,294,329,374,24,1,1,0,5,0,2,35,45,80
p_45,11,0,e_1,290,337,374,23,1,1,1,4,1,0,47,37,84
p_50,11,0,e_1,299,337,374,20,1,1,1,5,0,3,38,37,75
p_60,2,0,e_1,338,366,374,18,1,1,11,4,1,0,28,8,36
p_56,8,0,e_0,324,351,379,4,1,1,0,3,0,0,27,28,55
p_59,3,0,e_0,335,368,379,18,1,1,3,5,0,1,33,11,44
p_63,3,0,e_2,364,369,382,10,1,0,5,4,0,1,5,13,18
p_62,1,0,e_2,345,377,382,17,2,2,2,5,1,0,32,5,37
p_65,0,7,e_1,369,374,397,11,1,0,1,4,1,0,5,23,28
p_61,12,0,e_3,341,351,405,7,1,1,9,5,0,1,10,54,64
p_52,14,0,e_3,312,359,405,14,1,0,0,5,1,0,47,46,93
p_55,14,0,e_3,314,359,405,14,2,0,0,5,1,1,45,46,91
p_68,2,0,e_3,389,397,405,3,1,0,5,4,1,0,8,8,16
p_69,2,0,e_3,391,397,405,2,2,0,4,4,1,1,6,8,14
p_64,0,15,e_1,365,374,423,12,1,0,2,1,1,0,9,49,58
p_66,11,0,e_0,376,414,453,28,1,1,1,4,1,0,38,39,77
p_71,7,0,e_0,403,428,453,23,1,1,8,5,0,2,25,25,50
p_70,3,0,e_0,398,442,453,29,1,1,6,5,0,1,44,11,55
p_72,6,0,e_3,417,438,460,6,0,0,0,3,0,0,21,22,43
p_75,3,0,e_3,438,449,460,3,1,0,6,4,1,0,11,11,22
p_67,12,0,e_2,377,420,460,26,1,1,1,1,1,0,43,40,83
p_74,10,0,e_2,424,428,460,9,1,0,11,4,1,0,4,32,36
p_73,3,0,e_1,423,462,473,8,1,1,15,3,0,0,39,11,50
p_81,1,0,e_1,493,498,503,1,0,0,0,3,0,0,5,5,10
p_82,0,12,e_3,494,495,535,0,0,0,0,3,0,0,1,40,41
p_77,4,0,e_0,455,469,535,28,1,1,0,3,0,0,14,66,80
p_79,9,0,e_0,457,486,535,22,1,1,0,5,0,2,29,49,78
p_78,12,0,e_0,455,497,535,20,1,1,0,5,0,1,42,38,80
p_83,0,12,e_1,501,503,541,23,1,1,0,4,1,0,2,38,40
p_76,10,0,e_2,440,492,550,26,2,2,6,4,1,0,52,58,110
p_80,13,0,e_2,474,503,550,13,0,0,4,5,0,1,29,47,76
p_84,12,0,e_2,504,508,550,10,1,0,13,4,1,0,4,42,46
p_87,3,0,e_2,528,537,550,15,2,2,6,4,1,0,9,13,22
p_90,1,0,e_2,538,545,550,14,2,1,3,4,1,0,7,5,12
p_85,14,0,e_3,517,543,595,8,1,0,6,5,1,0,26,52,78
p_91,14,0,e_3,539,543,595,1,2,0,13,5,0,2,4,52,56
p_88,10,0,e_3,531,557,595,7,2,2,11,5,1,1,26,38,64
p_99,9,0,e_3,556,562,595,1,3,0,10,1,1,2,6,33,39
p_98,6,0,e_3,555,573,595,4,3,0,10,4,1,2,18,22,40
p_93,4,0,e_3,543,581,595,10,1,0,14,2,0,1,38,14,52
p_86,14,0,e_1,518,549,597,8,2,0,5,5,1,0,31,48,79
p_95,10,0,e_1,547,563,597,3,3,0,13,5,0,2,16,34,50
p_94,3,0,e_1,546,586,597,10,3,2,13,5,0,1,40,11,51
p_97,5,0,e_2,552,569,602,6,3,1,0,5,0,1,17,33,50
p_96,7,0,e_2,551,577,602,5,3,1,0,3,0,0,26,25,51
p_107,3,0,e_2,584,591,602,30,1,1,5,4,1,0,7,11,18
p_111,2,0,e_1,607,616,624,18,1,1,0,3,0,0,9,8,17
p_89,5,0,e_0,535,553,638,11,2,1,0,3,0,0,18,85,103
p_92,10,0,e_0,540,570,638,5,2,1,1,5,0,1,30,68,98
p_100,10,0,e_0,557,570,638,30,4,4,6,5,1,1,13,68,81
p_102,14,0,e_0,568,584,638,23,3,3,10,5,1,2,16,54,70
p_103,14,0,e_0,577,584,638,21,2,2,12,5,1,2,7,54,61
p_104,14,0,e_0,581,584,638,20,1,1,13,5,1,2,3,54,57
p_105,12,0,e_0,582,592,638,22,1,1,13,5,1,2,10,46,56
p_109,10,0,e_0,590,600,638,22,1,1,12,4,1,4,10,38,48
p_101,9,0,e_0,566,605,638,29,3,3,9,5,1,1,39,33,72
p_108,7,0,e_0,584,613,638,26,1,1,14,4,1,3,29,25,54
p_106,5,0,e_0,583,621,638,29,1,1,14,2,1,2,38,17,55
p_117,0,2,e_0,636,638,646,13,3,3,1,4,1,0,2,8,10
p_110,12,0,e_3,590,633,683,19,1,1,1,4,1,0,43,50,93
p_114,13,0,e_3,632,638,683,1,2,0,12,5,0,2,6,45,51
p_115,9,0,e_3,632,652,683,3,1,0,12,5,0,1,20,31,51
p_121,3,0,e_3,656,672,683,5,1,0,8,4,1,0,16,11,27
p_123,0,2,e_3,661,683,691,7,2,0,7,4,1,1,22,8,30
p_116,7,0,e_2,633,636,691,7,2,1,6,5,0,1,3,55,58
p_112,11,0,e_2,613,650,691,8,1,1,0,3,0,0,37,41,78
p_122,7,0,e_2,657,664,691,1,2,0,9,4,1,0,7,27,34
p_125,2,0,e_2,668,681,691,2,2,1,6,4,1,0,13,10,23
p_126,1,0,e_2,681,686,691,30,1,1,2,4,1,0,5,5,10
p_124,7,0,e_0,664,666,697,28,2,2,7,5,0,1,2,31,33
p_118,8,0,e_0,649,671,697,2,2,1,2,3,0,0,22,26,48
p_119,8,0,e_1,650,655,715,2,2,1,6,5,0,1,5,60,65
p_113,9,0,e_1,629,660,715,4,1,1,0,3,0,0,31,55,86
p_120,13,0,e_1,653,674,715,26,1,1,8,5,0,2,21,41,62
p_129,5,0,e_0,705,722,739,7,1,1,0,3,0,0,17,17,34
p_128,0,15,e_2,705,706,757,12,1,1,0,3,0,0,1,51,52
p_127,7,0,e_3,701,719,770,5,0,0,2,3,0,0,18,51,69
p_130,11,0,e_3,705,733,770,8,1,0,3,5,0,1,28,37,65
p_133,6,0,e_3,734,750,770,5,1,0,11,4,1,0,16,20,36
p_132,4,0,e_1,730,737,771,8,2,1,2,5,0,1,7,34,41
p_131,7,0,e_1,722,748,771,7,2,1,0,3,0,0,26,23,49
p_134,14,0,e_2,734,752,810,27,2,2,8,5,1,0,18,58,76
p_136,14,0,e_2,749,752,810,22,1,1,13,5,1,1,3,58,61
p_137,13,0,e_2,755,765,810,22,1,1,14,5,2,0,10,45,55
p_138,12,0,e_2,756,770,810,23,1,1,15,2,2,1,14,40,54
p_143,5,0,e_2,780,793,810,19,1,1,9,4,1,0,13,17,30
p_139,0,15,e_1,758,771,818,4,1,0,4,4,1,0,13,47,60
p_135,11,0,e_0,739,775,820,28,2,2,0,3,0,0,36,45,81
p_141,12,0,e_0,770,780,820,12,0,0,10,5,0,2,10,40,50
p_140,5,0,e_0,768,803,820,26,1,1,9,5,0,1,35,17,52
p_145,1,0,e_0,820,826,831,10,1,0,0,3,0,0,6,5,11
p_142,13,0,e_3,773,814,855,13,0,0,0,3,0,0,41,41,82
p_144,6,0,e_2,815,836,856,7,1,0,0,3,0,0,21,20,41
p_152,2,0,e_3,868,869,885,2,1,1,2,5,0,1,1,16,17
p_150,3,0,e_3,860,874,885,3,0,0,0,3,0,0,14,11,25
p_146,10,0,e_1,846,863,899,23,1,1,15,3,0,0,17,36,53
p_153,6,0,e_1,872,877,899,3,2,0,7,4,1,0,5,22,27
p_154,4,0,e_1,874,885,899,29,1,1,7,4,1,1,11,14,25
p_149,6,0,e_2,859,879,939,6,0,0,0,3,0,0,20,60,80
p_155,11,0,e_2,884,896,939,19,1,1,7,5,1,1,12,43,55
p_151,12,0,e_2,863,901,939,12,1,0,1,5,0,1,38,38,76
p_157,7,0,e_3,889,913,944,7,0,0,0,3,0,0,24,31,55
p_158,7,0,e_3,892,913,944,7,1,0,0,5,0,1,21,31,52
p_159,8,0,e_3,893,918,944,8,1,0,0,5,0,1,25,26,51
p_147,6,0,e_0,849,869,947,26,1,1,0,3,0,0,20,78,98
p_156,12,0,e_0,884,889,947,18,1,1,11,5,1,1,5,58,63
p_148,15,0,e_0,849,900,947,17,1,1,0,3,0,1,51,47,98
p_3,4,0,e_2,25,39,87,4,0,0,0,3,0,0,14,48,62
p_4,5,0,e_2,34,44,87,5,0,0,3,5,0,1,10,43,53
p_5,9,0,e_2,41,58,87,9,0,0,4,5,1,1,17,29,46
p_6,9,0,e_2,45,58,87,9,0,0,5,5,1,1,13,29,42
p_2,11,0,e_1,19,54,89,11,0,0,0,3,0,0,35,35,70
p_1,13,0,e_0,13,55,96,13,0,0,0,3,0,0,42,41,83
p_12,0,8,e_2,86,87,113,21,5,5,0,4,1,0,1,26,27
p_16,4,0,e_1,101,116,130,13,4,1,0,3,0,0,15,14,29
p_15,5,0,e_0,99,117,134,13,4,2,0,3,0,0,18,17,35
p_13,8,0,e_2,87,113,139,13,4,2,0,3,1,0,26,26,52
p_19,0,7,e_1,125,130,153,11,3,0,2,4,1,1,5,23,28
p_7,2,0,e_3,55,64,162,2,0,0,0,3,0,0,9,98,107
p_10,9,0,e_3,77,87,162,15,3,2,6,5,1,2,10,75,85
p_9,10,0,e_3,67,92,162,18,2,1,2,5,1,1,25,70,95
p_14,13,0,e_3,87,103,162,8,4,1,9,5,1,3,16,59,75
p_8,15,0,e_3,62,111,162,14,1,0,1,5,0,1,49,51,100
p_17,10,0,e_3,112,128,162,5,2,0,15,4,1,1,16,34,50
p_11,4,0,e_3,84,148,162,18,4,3,8,5,1,3,64,14,78
p_21,0,10,e_2,142,143,179,6,2,0,0,3,0,0,1,36,37
p_20,3,0,e_0,142,153,184,3,2,1,0,3,0,0,11,31,42
p_22,6,0,e_0,146,164,184,29,2,2,1,5,0,1,18,20,38
p_27,5,0,e_3,180,187,212,4,1,1,3,5,0,1,7,25,32
p_26,6,0,e_3,169,192,212,6,0,0,0,3,0,0,23,20,43
p_25,9,0,e_2,163,174,215,9,0,0,6,5,1,0,11,41,52
p_28,7,0,e_2,184,190,215,3,2,0,9,4,1,0,6,25,31
p_30,2,0,e_2,200,207,215,2,1,0,4,4,1,0,7,8,15
p_24,14,0,e_1,157,176,232,18,1,1,8,5,0,1,19,56,75
p_18,15,0,e_1,120,181,232,28,3,3,3,4,1,0,61,51,112
p_23,15,0,e_1,150,181,232,19,1,1,6,5,1,1,31,51,82
p_31,5,0,e_1,203,213,232,28,1,1,8,4,1,0,10,19,29
p_33,1,0,e_1,213,227,232,19,1,1,5,1,1,0,14,5,19
p_32,0,10,e_3,209,212,244,1,1,0,1,4,1,0,3,32,35
p_35,0,6,e_2,222,222,246,19,2,2,0,3,0,0,0,24,24
p_36,1,0,e_2,225,229,266,17,2,2,0,5,1,0,4,37,41
p_34,11,0,e_3,217,249,294,10,1,0,1,5,1,0,32,45,77
p_38,12,0,e_3,240,254,294,3,2,0,9,5,1,1,14,40,54
p_43,4,0,e_3,270,280,294,3,1,0,7,4,1,0,10,14,24
p_44,4,0,e_3,275,280,294,1,2,0,5,4,1,1,5,14,19
p_29,14,0,e_0,192,237,295,22,1,1,0,3,0,0,45,58,103
p_37,15,0,e_0,228,242,295,10,2,0,11,5,0,1,14,53,67
p_39,13,0,e_0,247,250,295,3,2,0,14,4,1,0,3,45,48
p_41,7,0,e_0,257,270,295,4,1,0,11,4,1,0,13,25,38
p_42,4,0,e_0,269,281,295,3,1,0,7,1,1,0,12,14,26
p_47,3,0,e_3,293,305,316,3,0,0,0,3,1,0,12,11,23
p_49,3,0,e_3,298,305,316,2,1,0,1,5,0,1,7,11,18
p_51,0,4,e_3,309,316,330,2,1,0,2,4,1,0,7,14,21
p_57,1,0,e_3,327,341,346,4,1,1,3,5,1,0,14,5,19
p_40,15,0,e_1,255,303,356,27,1,1,0,3,0,0,48,53,101
p_45,11,0,e_1,290,317,356,20,1,1,11,5,0,1,27,39,66
p_50,11,0,e_1,299,317,356,10,1,0,14,5,0,2,18,39,57
p_54,7,0,e_1,313,331,356,24,1,1,12,4,1,1,18,25,43
p_59,3,0,e_1,335,345,356,30,2,2,6,4,1,0,10,11,21
p_53,8,0,e_0,313,321,359,23,1,1,6,5,0,1,8,38,46
p_48,9,0,e_0,294,326,359,9,1,0,0,3,1,0,32,33,65
p_56,8,0,e_0,324,331,359,6,1,0,9,5,1,1,7,28,35
p_60,2,0,e_0,338,351,359,30,2,2,6,4,1,0,13,8,21
p_58,0,6,e_3,330,346,368,4,1,1,4,3,1,1,16,22,38
p_46,8,0,e_2,291,317,383,23,1,1,0,3,0,0,26,66,92
p_52,14,0,e_2,312,337,383,17,1,1,6,5,0,1,25,46,71
p_55,14,0,e_2,314,337,383,17,1,1,7,5,0,2,23,46,69
p_61,12,0,e_2,341,345,383,19,1,1,13,4,1,0,4,38,42
p_63,3,0,e_0,364,375,386,4,2,1,0,3,0,0,11,11,22
p_62,1,0,e_3,345,351,388,1,0,0,0,3,1,0,6,37,43
p_68,2,0,e_0,389,397,405,2,0,0,0,3,0,0,8,8,16
p_65,0,7,e_2,369,383,406,6,1,0,5,4,1,0,14,23,37
p_69,2,0,e_3,391,400,416,2,0,0,0,3,0,0,9,16,25
p_70,3,0,e_3,398,405,416,2,1,0,1,5,0,1,7,11,18
p_64,0,15,e_1,365,365,418,7,2,2,0,3,0,0,0,53,53
p_71,7,0,e_2,403,406,429,5,2,0,6,5,1,0,3,23,26
p_73,3,0,e_3,423,434,445,3,0,0,0,3,0,0,11,11,22
p_72,6,0,e_0,417,438,458,6,0,0,0,3,0,0,21,20,41
p_66,11,0,e_1,376,402,467,23,1,1,3,5,1,0,26,65,91
p_67,12,0,e_1,377,407,467,22,1,1,3,5,1,1,30,60,90
p_74,10,0,e_1,424,435,467,10,1,0,13,4,1,0,11,32,43
p_77,4,0,e_3,455,469,483,4,0,0,0,3,0,0,14,14,28
p_81,1,0,e_1,493,499,504,1,0,0,0,3,0,0,6,5,11
p_79,9,0,e_0,457,487,516,9,1,0,0,3,1,0,30,29,59
p_75,3,0,e_2,438,450,527,29,1,1,0,3,0,0,12,77,89
p_76,10,0,e_2,440,473,527,21,1,1,0,5,0,1,33,54,87
p_78,12,0,e_2,455,481,527,12,1,0,4,5,1,1,26,46,72
p_80,13,0,e_2,474,486,527,20,1,1,10,5,1,1,12,41,53
p_82,0,12,e_3,494,495,535,0,0,0,0,3,0,0,1,40,41
p_83,0,12,e_1,501,504,544,23,1,1,1,4,1,0,3,40,43
p_87,3,0,e_0,528,540,567,15,2,2,0,3,0,0,12,27,39
p_89,5,0,e_0,535,548,567,11,1,1,1,5,0,1,13,19,32
p_94,3,0,e_0,546,556,567,10,1,0,5,5,1,1,10,11,21
p_90,1,0,e_2,538,544,569,15,2,1,0,3,0,0,6,25,31
p_93,4,0,e_2,543,555,569,10,1,0,1,5,0,1,12,14,26
p_88,10,0,e_1,531,536,586,7,2,2,9,5,1,0,5,50,55
p_92,10,0,e_1,540,552,586,5,2,1,11,5,2,0,12,34,46
p_95,10,0,e_1,547,552,586,3,1,0,11,4,1,1,5,34,39
p_96,7,0,e_1,551,563,586,5,1,0,10,1,1,0,12,23,35
p_84,12,0,e_3,504,535,591,10,1,0,2,5,1,0,31,56,87
p_85,14,0,e_3,517,543,591,8,1,0,6,5,1,0,26,48,74
p_86,14,0,e_3,518,543,591,7,2,0,7,5,1,1,25,48,73
p_91,14,0,e_3,539,543,591,1,2,0,13,5,1,1,4,48,52
p_99,9,0,e_3,556,560,591,1,2,0,10,4,1,1,4,31,35
p_98,6,0,e_3,555,571,591,5,1,0,11,4,1,0,16,20,36
p_101,9,0,e_0,566,596,663,28,2,2,0,4,1,1,30,67,97
p_100,10,0,e_0,557,601,663,30,3,3,3,4,1,0,44,62,106
p_105,12,0,e_0,582,609,663,21,1,1,5,5,0,3,27,54,81
p_103,14,0,e_0,577,617,663,21,1,1,3,5,0,2,40,46,86
p_104,14,0,e_0,581,617,663,19,1,1,4,5,0,3,36,46,82
p_113,9,0,e_0,629,634,663,3,1,0,10,4,1,0,5,29,34
p_97,5,0,e_2,552,586,665,7,1,0,3,5,1,1,34,79,113
p_106,5,0,e_2,583,586,665,27,1,1,4,5,0,2,3,79,82
p_108,7,0,e_2,584,594,665,25,1,1,5,5,0,2,10,71,81
p_102,14,0,e_2,568,617,665,23,2,2,0,3,1,1,49,48,97
p_116,7,0,e_2,633,640,665,4,1,0,9,4,1,1,7,25,32
p_107,3,0,e_2,584,654,665,29,1,1,5,5,0,3,70,11,81
p_109,10,0,e_1,590,623,667,20,1,1,0,3,0,0,33,44,77
p_112,11,0,e_1,613,628,667,6,1,1,7,5,0,2,15,39,54
p_115,9,0,e_1,632,636,667,2,1,0,10,4,1,1,4,31,35
p_111,2,0,e_1,607,659,667,17,1,1,5,5,0,1,52,8,60
p_110,12,0,e_3,590,629,667,12,0,0,0,3,1,0,39,38,77
p_123,0,2,e_0,661,663,671,2,2,0,1,4,1,2,2,8,10
p_117,0,2,e_2,636,665,673,10,1,0,8,4,1,2,29,8,37
p_125,2,0,e_1,668,675,693,14,1,1,0,5,0,1,7,18,25
p_121,3,0,e_1,656,680,693,30,2,2,3,4,1,1,24,13,37
p_126,1,0,e_1,681,688,693,11,1,1,3,4,1,0,7,5,12
p_119,8,0,e_3,650,693,719,27,1,1,5,4,1,0,43,26,69
p_129,5,0,e_1,705,718,751,29,1,1,1,5,0,1,13,33,46
p_127,7,0,e_1,701,726,751,29,1,1,0,3,0,0,25,25,50
p_131,7,0,e_1,722,726,751,22,1,1,6,5,1,1,4,25,29
p_132,4,0,e_1,730,737,751,23,1,1,6,4,1,0,7,14,21
p_122,7,0,e_2,657,690,751,26,2,2,3,4,1,1,33,61,94
p_120,13,0,e_2,653,710,751,22,2,2,3,4,1,1,57,41,98
p_124,7,0,e_0,664,688,753,24,2,2,0,5,1,2,24,65,89
p_118,8,0,e_0,649,693,753,28,1,1,4,4,1,1,44,60,104
p_114,13,0,e_0,632,710,753,28,1,1,9,4,1,1,78,43,121
p_130,11,0,e_0,705,718,753,24,1,1,11,5,1,1,13,35,48
p_128,0,15,e_3,705,719,776,4,1,0,4,4,1,0,14,57,71
p_140,5,0,e_1,768,785,802,12,3,2,0,3,0,0,17,17,34
p_143,5,0,e_1,780,785,802,9,3,2,3,5,0,1,5,17,22
p_139,0,15,e_0,758,758,807,19,5,5,0,3,0,0,0,49,49
p_133,6,0,e_3,734,739,827,20,1,1,4,5,1,0,5,88,93
p_135,11,0,e_3,739,756,827,13,3,2,6,5,2,1,17,71,88
p_138,12,0,e_3,756,761,827,7,4,3,11,5,2,2,5,66,71
p_137,13,0,e_3,755,766,827,6,4,2,11,5,2,2,11,61,72
p_134,14,0,e_3,734,771,827,11,2,1,5,5,1,1,37,56,93
p_136,14,0,e_3,749,771,827,7,4,1,9,5,2,2,22,56,78
p_142,13,0,e_3,773,784,827,3,3,1,14,5,2,1,11,43,54
p_141,12,0,e_3,770,789,827,4,2,1,14,2,2,0,19,38,57
p_145,1,0,e_2,820,825,830,1,1,0,0,3,0,0,5,5,10
p_144,6,0,e_1,815,835,855,28,1,1,0,3,0,0,20,20,40
p_150,3,0,e_1,860,872,885,6,1,1,0,3,0,0,12,13,25
p_152,2,0,e_1,868,877,885,17,2,2,2,5,0,1,9,8,17
p_146,10,0,e_0,846,863,899,10,0,0,15,3,0,0,17,36,53
p_153,6,0,e_0,872,877,899,12,2,1,8,4,1,0,5,22,27
p_154,4,0,e_0,874,885,899,13,2,1,7,4,1,1,11,14,25
p_147,6,0,e_3,849,870,932,6,0,0,0,3,0,0,21,62,83
p_149,6,0,e_3,859,870,932,3,1,0,3,5,0,1,11,62,73
p_155,11,0,e_3,884,887,932,3,2,1,10,5,1,1,3,45,48
p_151,12,0,e_3,863,892,932,8,1,0,4,5,0,1,29,40,69
p_156,12,0,e_3,884,892,932,2,2,0,10,5,1,1,8,40,48
p_159,8,0,e_3,893,906,932,4,1,0,12,4,1,0,13,26,39
p_157,7,0,e_1,889,912,935,6,2,1,0,3,0,0,23,23,46
p_158,7,0,e_1,892,912,935,19,1,0,1,5,0,1,20,23,43
p_148,15,0,e_2,849,897,944,15,0,0,0,3,0,0,48,47,95
p_3,4,0,e_2,25,40,88,4,0,0,0,3,0,0,15,48,63
p_4,5,0,e_2,34,45,88,5,0,0,2,5,0,1,11,43,54
p_5,9,0,e_2,41,59,88,9,0,0,4,5,1,1,18,29,47
p_6,9,0,e_2,45,59,88,9,0,0,5,2,1,1,14,29,43
p_2,11,0,e_1,19,54,89,11,0,0,0,3,0,0,35,35,70
p_1,13,0,e_0,13,54,95,13,0,0,0,3,0,0,41,41,82
p_12,0,8,e_2,86,88,114,21,4,4,0,4,1,0,2,26,28
p_16,4,0,e_1,101,115,129,13,4,1,0,3,0,0,14,14,28
p_15,5,0,e_0,99,116,133,13,4,2,0,3,0,0,17,17,34
p_19,0,7,e_1,125,129,154,11,2,0,1,4,1,0,4,25,29
p_7,2,0,e_3,55,64,160,2,0,0,0,3,0,0,9,96,105
p_10,9,0,e_3,77,87,160,15,3,2,6,5,1,2,10,73,83
p_9,10,0,e_3,67,92,160,18,2,1,2,5,1,1,25,68,93
p_14,13,0,e_3,87,103,160,8,4,1,9,5,1,3,16,57,73
p_8,15,0,e_3,62,111,160,14,1,0,1,5,0,1,49,49,98
p_11,4,0,e_3,84,146,160,18,4,3,8,5,1,3,62,14,76
p_21,0,10,e_0,142,143,181,5,2,0,0,3,0,1,1,38,39
p_13,8,0,e_2,87,114,186,13,4,2,0,3,1,0,27,72,99
p_17,10,0,e_2,112,122,186,5,2,0,7,5,1,0,10,64,74
p_18,15,0,e_2,120,139,186,28,2,2,9,5,1,1,19,47,66
p_20,3,0,e_0,142,156,213,2,2,1,0,3,0,0,14,57,71
p_25,9,0,e_0,163,176,213,9,0,0,5,5,2,0,13,37,50
p_30,2,0,e_2,200,209,217,18,2,1,0,3,0,0,9,8,17
p_22,6,0,e_1,146,149,233,28,1,1,5,5,1,0,3,84,87
p_24,14,0,e_1,157,177,233,17,1,1,7,5,1,1,20,56,76
p_23,15,0,e_1,150,182,233,18,1,1,6,5,2,0,32,51,83
p_31,5,0,e_1,203,214,233,14,2,1,9,4,1,0,11,19,30
p_33,1,0,e_1,213,228,233,15,2,1,5,4,1,1,15,5,20
p_36,1,0,e_1,225,228,233,12,2,1,2,4,1,1,3,5,8
p_35,0,6,e_2,222,223,245,14,2,0,0,3,0,0,1,22,23
p_32,0,10,e_0,209,213,245,17,2,2,1,4,1,0,4,32,36
p_27,5,0,e_3,180,186,265,4,1,1,3,5,0,1,6,79,85
p_26,6,0,e_3,169,191,265,6,0,0,0,3,0,0,22,74,96
p_28,7,0,e_3,184,196,265,2,2,0,5,5,0,2,12,69,81
p_29,14,0,e_3,192,219,265,8,2,0,6,5,1,1,27,46,73
p_34,11,0,e_3,217,230,265,3,2,0,14,5,1,1,13,35,48
p_42,4,0,e_3,269,284,298,4,0,0,0,3,0,0,15,14,29
p_43,4,0,e_3,270,284,298,4,1,1,0,3,0,1,14,14,28
p_44,4,0,e_3,275,284,298,3,1,0,1,5,0,1,9,14,23
p_41,7,0,e_1,257,281,304,26,1,1,0,3,0,0,24,23,47
p_37,15,0,e_0,228,262,311,27,2,2,4,5,1,0,34,49,83
p_40,15,0,e_0,255,262,311,18,1,1,13,5,0,1,7,49,56
p_47,3,0,e_0,293,300,311,28,3,3,5,4,1,0,7,11,18
p_38,12,0,e_2,240,265,313,26,1,1,5,5,1,0,25,48,73
p_39,13,0,e_2,247,270,313,23,1,1,6,5,0,1,23,43,66
p_49,3,0,e_2,298,302,313,3,2,2,4,4,1,0,4,11,15
p_51,0,4,e_0,309,311,325,19,2,2,1,4,1,0,2,14,16
p_54,7,0,e_2,313,336,363,17,3,3,0,3,1,0,23,27,50
p_59,3,0,e_2,335,350,363,14,2,1,7,5,0,3,15,13,28
p_57,1,0,e_2,327,358,363,18,3,2,4,5,0,1,31,5,36
p_62,1,0,e_2,345,358,363,13,3,0,5,4,1,2,13,5,18
p_56,8,0,e_0,324,339,365,12,2,2,4,3,1,0,15,26,41
p_53,8,0,e_1,313,330,366,15,3,2,3,5,0,1,17,36,53
p_48,9,0,e_1,294,335,366,22,3,3,3,4,1,0,41,31,72
p_60,2,0,e_1,338,358,366,14,2,1,8,4,1,0,20,8,28
p_58,0,6,e_2,330,363,383,18,3,3,5,5,0,2,33,20,53
p_65,0,7,e_1,369,369,394,8,2,0,0,3,0,0,0,25,25
p_46,8,0,e_3,291,324,394,24,2,2,2,4,1,1,33,70,103
p_45,11,0,e_3,290,335,394,22,1,1,3,4,1,0,45,59,104
p_50,11,0,e_3,299,335,394,11,2,0,0,5,0,2,36,59,95
p_52,14,0,e_3,312,346,394,10,2,0,4,5,0,2,34,48,82
p_55,14,0,e_3,314,346,394,9,3,0,5,5,0,3,32,48,80
p_61,12,0,e_3,341,354,394,3,2,1,13,5,1,1,13,40,53
p_63,3,0,e_3,364,383,394,6,1,0,9,4,1,0,19,11,30
p_64,0,15,e_0,365,365,414,9,2,0,0,3,1,0,0,49,49
p_68,2,0,e_1,389,411,419,29,1,1,6,5,1,0,22,8,30
p_69,2,0,e_1,391,411,419,29,1,1,6,5,1,1,20,8,28
p_70,3,0,e_3,398,409,420,3,0,0,0,3,0,0,11,11,22
p_73,3,0,e_1,423,435,446,3,0,0,0,3,0,0,12,11,23
p_66,11,0,e_2,376,400,447,24,2,2,4,5,1,0,24,47,71
p_67,12,0,e_2,377,405,447,23,2,2,4,5,1,1,28,42,70
p_71,7,0,e_2,403,422,447,6,1,0,12,5,1,1,19,25,44
p_72,6,0,e_2,417,427,447,25,1,1,8,4,1,1,10,20,30
p_74,10,0,e_0,424,441,475,10,0,0,15,3,0,0,17,34,51
p_77,4,0,e_0,455,461,475,11,2,1,6,4,1,0,6,14,20
p_81,1,0,e_0,493,499,504,10,1,0,0,3,0,0,6,5,11
p_79,9,0,e_1,457,487,516,10,3,2,0,3,0,0,30,29,59
p_75,3,0,e_3,438,449,526,3,0,0,0,3,0,0,11,77,88
p_76,10,0,e_3,440,472,526,10,1,0,0,5,0,1,32,54,86
p_78,12,0,e_3,455,480,526,7,2,0,5,5,1,1,25,46,71
p_80,13,0,e_3,474,485,526,3,2,0,10,5,1,1,11,41,52
p_82,0,12,e_2,494,494,534,10,1,0,0,3,0,0,0,40,40
p_83,0,12,e_0,501,504,544,8,1,0,1,4,1,0,3,40,43
p_87,3,0,e_1,528,540,567,3,0,0,0,3,0,0,12,27,39
p_89,5,0,e_1,535,548,567,5,0,0,1,5,0,1,13,19,32
p_94,3,0,e_1,546,556,567,4,2,1,4,5,1,1,10,11,21
p_90,1,0,e_3,538,544,569,1,0,0,0,3,0,0,6,25,31
p_93,4,0,e_3,543,555,569,3,1,0,1,5,0,1,12,14,26
p_88,10,0,e_0,531,536,586,10,0,0,9,5,1,0,5,50,55
p_92,10,0,e_0,540,552,586,10,1,0,11,5,2,0,12,34,46
p_95,10,0,e_0,547,552,586,9,2,0,12,4,1,1,5,34,39
p_96,7,0,e_0,551,563,586,4,2,0,10,4,1,1,12,23,35
p_84,12,0,e_2,504,534,588,25,1,1,2,5,1,0,30,54,84
p_85,14,0,e_2,517,542,588,19,1,1,7,5,1,0,25,46,71
p_86,14,0,e_2,518,542,588,19,1,1,7,5,1,1,24,46,70
p_91,14,0,e_2,539,542,588,14,1,0,13,5,1,1,3,46,49
p_99,9,0,e_2,556,559,588,25,3,3,10,4,1,0,3,29,32
p_97,5,0,e_3,552,586,665,2,2,0,3,5,1,1,34,79,113
p_106,5,0,e_3,583,586,665,19,3,2,4,5,0,3,3,79,82
p_98,6,0,e_3,555,591,665,2,2,2,4,3,1,1,36,74,110
p_108,7,0,e_3,584,596,665,16,3,1,5,5,0,3,12,69,81
p_104,14,0,e_3,581,619,665,10,2,0,4,5,0,2,38,46,84
p_107,3,0,e_3,584,654,665,20,4,3,5,5,0,4,70,11,81
p_101,9,0,e_1,566,596,665,22,3,3,0,4,1,1,30,69,99
p_100,10,0,e_1,557,601,665,24,3,3,3,4,1,0,44,64,108
p_105,12,0,e_1,582,609,665,12,3,1,5,5,0,3,27,56,83
p_102,14,0,e_1,568,617,665,14,2,2,0,5,0,2,49,48,97
p_103,14,0,e_1,577,617,665,12,2,0,3,5,0,3,40,48,88
p_113,9,0,e_1,629,634,665,2,2,0,10,4,1,0,5,31,36
p_116,7,0,e_1,633,642,665,3,2,0,9,4,1,2,9,23,32
p_109,10,0,e_0,590,622,666,12,4,1,0,3,0,0,32,44,76
p_112,11,0,e_0,613,627,666,5,3,1,7,5,0,2,14,39,53
p_115,9,0,e_0,632,635,666,1,2,0,10,4,1,1,3,31,34
p_111,2,0,e_0,607,658,666,16,3,1,5,5,0,1,51,8,59
p_110,12,0,e_2,590,629,669,10,4,1,0,3,0,0,39,40,79
p_121,3,0,e_2,656,658,669,30,2,2,4,4,1,1,2,11,13
p_123,0,2,e_3,661,665,673,1,2,0,1,4,1,1,4,8,12
p_117,0,2,e_0,636,666,674,9,2,0,9,4,1,1,30,8,38
p_124,7,0,e_3,664,690,721,23,2,2,0,4,1,1,26,31,57
p_118,8,0,e_3,649,695,721,26,2,2,4,4,1,1,46,26,72
p_125,2,0,e_0,668,674,722,14,3,2,0,5,1,1,6,48,54
p_119,8,0,e_0,650,694,722,26,3,3,4,4,1,1,44,28,72
p_126,1,0,e_0,681,717,722,11,2,2,4,5,1,1,36,5,41
p_122,7,0,e_1,657,688,753,26,2,2,2,4,1,1,31,65,96
p_114,13,0,e_1,632,708,753,27,2,2,10,4,1,1,76,45,121
p_127,7,0,e_1,701,728,753,29,1,1,11,5,1,1,27,25,52
p_131,7,0,e_1,722,728,753,23,1,1,9,4,1,1,6,25,31
p_132,4,0,e_1,730,739,753,24,1,1,7,4,1,0,9,14,23
p_120,13,0,e_2,653,710,755,20,2,2,4,4,1,0,57,45,102
p_130,11,0,e_2,705,718,755,24,1,1,12,5,0,2,13,37,50
p_129,5,0,e_2,705,738,755,30,1,1,12,5,0,1,33,17,50
p_128,0,15,e_3,705,721,772,5,1,0,5,4,1,0,16,51,67
p_140,5,0,e_2,768,785,802,11,2,1,0,3,0,0,17,17,34
p_143,5,0,e_2,780,785,802,8,2,1,4,5,0,1,5,17,22
p_139,0,15,e_1,758,758,807,18,2,2,0,3,0,0,0,49,49
p_138,12,0,e_3,756,759,821,7,2,2,11,5,1,1,3,62,65
p_134,14,0,e_3,734,767,821,12,1,1,4,5,1,0,33,54,87
p_136,14,0,e_3,749,767,821,7,2,1,9,5,1,1,18,54,72
p_141,12,0,e_3,770,783,821,3,2,0,15,5,2,0,13,38,51
p_133,6,0,e_0,734,755,821,20,2,2,0,3,0,0,21,66,87
p_135,11,0,e_0,739,772,821,13,2,2,1,5,0,1,33,49,82
p_137,13,0,e_0,755,780,821,6,2,2,6,5,1,1,25,41,66
p_142,13,0,e_0,773,780,821,2,2,0,11,5,1,1,7,41,48
p_145,1,0,e_3,820,826,831,1,0,0,0,3,1,0,6,5,11
p_144,6,0,e_2,815,836,856,26,1,1,0,3,0,0,21,20,41
p_150,3,0,e_2,860,872,885,24,1,1,0,3,0,0,12,13,25
p_152,2,0,e_2,868,877,885,22,1,1,2,5,0,1,9,8,17
p_146,10,0,e_1,846,864,900,10,0,0,15,3,0,0,18,36,54
p_153,6,0,e_1,872,878,900,17,1,1,8,4,1,0,6,22,28
p_154,4,0,e_1,874,886,900,18,1,1,7,4,1,1,12,14,26
p_147,6,0,e_0,849,870,934,6,0,0,0,3,0,0,21,64,85
p_149,6,0,e_0,859,870,934,22,1,1,2,5,0,1,11,64,75
p_155,11,0,e_0,884,887,934,8,1,1,10,5,1,1,3,47,50
p_151,12,0,e_0,863,892,934,14,1,1,4,5,0,1,29,42,71
p_156,12,0,e_0,884,892,934,7,1,1,10,5,1,2,8,42,50
p_159,8,0,e_0,893,906,934,8,1,1,12,4,1,1,13,28,41
p_158,7,0,e_0,892,911,934,9,1,1,12,4,1,0,19,23,42
p_157,7,0,e_2,889,912,935,11,1,1,0,3,0,0,23,23,46
p_148,15,0,e_3,849,897,944,15,0,0,0,3,0,0,48,47,95
p_3,4,0,e_2,25,40,54,4,0,0,0,3,0,0,15,14,29
p_7,2,0,e_2,55,63,71,10,2,1,0,3,0,0,8,8,16
p_6,9,0,e_1,45,48,91,6,2,0,8,5,0,1,3,43,46
p_2,11,0,e_1,19,56,91,11,0,0,0,3,0,0,37,35,72
p_1,13,0,e_0,13,55,96,13,0,0,0,3,0,0,42,41,83
p_12,0,8,e_1,86,91,117,15,2,2,2,4,1,0,5,26,31
p_16,4,0,e_0,101,113,135,7,2,1,0,5,0,1,12,22,34
p_15,5,0,e_0,99,118,135,7,2,1,0,3,0,0,19,17,36
p_4,5,0,e_3,34,51,136,5,0,0,0,3,0,0,17,85,102
p_5,9,0,e_3,41,65,136,7,1,0,2,5,0,1,24,71,95
p_9,10,0,e_3,67,70,136,11,2,1,9,5,1,1,3,66,69
p_8,15,0,e_3,62,87,136,7,2,0,8,5,1,1,25,49,74
p_13,8,0,e_3,87,110,136,23,1,0,15,2,1,0,23,26,49
p_19,0,7,e_0,125,135,158,4,1,0,3,4,1,0,10,23,33
p_11,4,0,e_2,84,92,164,12,2,1,1,5,0,1,8,72,80
p_10,9,0,e_2,77,109,164,9,2,1,0,3,0,0,32,55,87
p_14,13,0,e_2,87,123,164,28,1,0,3,5,0,2,36,41,77
p_17,10,0,e_1,112,125,191,28,1,1,7,5,1,0,13,66,79
p_18,15,0,e_1,120,142,191,20,1,1,8,5,0,1,22,49,71
p_26,6,0,e_1,169,171,191,15,2,1,7,4,1,0,2,20,22
p_21,0,10,e_2,142,164,198,6,1,1,7,4,1,0,22,34,56
p_20,3,0,e_3,142,153,236,3,0,0,0,3,0,0,11,83,94
p_22,6,0,e_3,146,164,236,5,1,0,1,5,0,1,18,72,90
p_24,14,0,e_3,157,190,236,10,2,0,4,5,1,1,33,46,79
p_33,1,0,e_3,213,231,236,6,1,0,7,4,1,0,18,5,23
p_23,15,0,e_0,150,184,237,13,2,0,4,5,1,0,34,53,87
p_28,7,0,e_0,184,210,237,9,2,1,15,4,1,1,26,27,53
p_27,5,0,e_0,180,218,237,12,2,1,14,5,0,1,38,19,57
p_36,1,0,e_0,225,232,237,2,2,0,3,4,1,0,7,5,12
p_30,2,0,e_1,200,209,237,9,1,0,0,3,0,0,9,28,37
p_31,5,0,e_1,203,220,237,5,1,0,0,5,0,1,17,17,34
p_35,0,6,e_0,222,237,257,4,2,0,4,4,1,0,15,20,35
p_25,9,0,e_2,163,193,258,13,2,1,0,3,1,0,30,65,95
p_29,14,0,e_2,192,212,258,30,1,1,9,5,1,1,20,46,66
p_34,11,0,e_2,217,223,258,24,2,2,13,4,1,0,6,35,41
p_32,0,10,e_3,209,236,268,8,1,0,8,4,1,0,27,32,59
p_42,4,0,e_2,269,272,308,10,1,1,3,5,0,1,3,36,39
p_41,7,0,e_2,257,283,308,10,2,2,0,3,1,0,26,25,51
p_47,3,0,e_2,293,297,308,4,2,1,4,4,1,0,4,11,15
p_38,12,0,e_3,240,276,318,11,1,0,1,5,1,0,36,42,78
p_43,4,0,e_3,270,302,318,10,1,1,10,5,0,1,32,16,48
p_49,3,0,e_3,298,307,318,2,2,1,5,4,1,1,9,11,20
p_39,13,0,e_0,247,280,325,10,2,0,3,5,1,0,33,45,78
p_46,8,0,e_0,291,297,325,30,2,2,10,4,1,1,6,28,34
p_44,4,0,e_0,275,311,325,8,2,0,12,5,0,1,36,14,50
p_51,0,4,e_3,309,318,332,3,1,0,3,4,1,0,9,14,23
p_37,15,0,e_1,228,284,335,17,2,2,3,4,1,0,56,51,107
p_40,15,0,e_1,255,284,335,9,2,0,6,5,0,1,29,51,80
p_45,11,0,e_1,290,298,335,27,2,2,13,4,1,0,8,37,45
p_48,9,0,e_1,294,306,335,27,2,2,12,4,1,1,12,29,41
p_57,1,0,e_0,327,333,338,12,2,2,0,3,0,0,6,5,11
p_58,0,6,e_1,330,335,357,12,2,2,1,4,1,0,5,22,27
p_60,2,0,e_0,338,347,357,8,1,1,0,3,0,0,9,10,19
p_62,1,0,e_0,345,352,357,15,1,1,2,5,0,1,7,5,12
p_59,3,0,e_1,335,346,377,9,1,1,0,3,1,0,11,31,42
p_53,8,0,e_3,313,346,398,24,1,1,2,4,1,0,33,52,85
p_56,8,0,e_3,324,346,398,7,2,0,1,5,1,1,22,52,74
p_61,12,0,e_3,341,360,398,6,1,0,6,5,0,1,19,38,57
p_65,0,7,e_1,369,377,400,9,1,0,3,4,1,0,8,23,31
p_54,7,0,e_2,313,331,402,24,2,2,1,5,0,2,18,71,89
p_50,11,0,e_2,299,345,402,24,3,3,3,4,1,0,46,57,103
p_52,14,0,e_2,312,356,402,18,1,1,1,5,0,1,44,46,90
p_55,14,0,e_2,314,356,402,17,2,2,2,5,0,3,42,46,88
p_68,2,0,e_2,389,394,402,1,1,0,3,4,1,0,5,8,13
p_69,2,0,e_2,391,394,402,30,1,1,3,4,1,1,3,8,11
p_70,3,0,e_3,398,409,420,3,0,0,0,3,1,0,11,11,22
p_64,0,15,e_1,365,377,428,11,1,0,4,4,1,0,12,51,63
p_63,3,0,e_0,364,376,437,8,1,0,0,3,0,0,12,61,73
p_66,11,0,e_0,376,402,437,26,1,1,3,2,0,0,26,35,61
p_73,3,0,e_3,423,434,445,3,0,0,0,3,0,0,11,11,22
p_75,3,0,e_0,438,449,460,29,1,1,0,3,0,0,11,11,22
p_72,6,0,e_2,417,424,472,25,1,1,4,5,0,1,7,48,55
p_71,7,0,e_2,403,429,472,6,1,0,0,3,0,0,26,43,69
p_74,10,0,e_2,424,440,472,10,1,0,6,2,0,1,16,32,48
p_67,12,0,e_1,377,417,477,25,1,1,0,3,1,0,40,60,100
p_76,10,0,e_1,440,445,477,22,1,1,12,4,1,0,5,32,37
p_81,1,0,e_1,493,499,504,12,2,1,0,3,0,0,6,5,11
p_82,0,12,e_2,494,494,534,13,2,2,0,3,0,0,0,40,40
p_77,4,0,e_3,455,470,536,4,0,0,0,3,0,0,15,66,81
p_79,9,0,e_3,457,487,536,15,2,1,0,5,0,2,30,49,79
p_78,12,0,e_3,455,498,536,12,1,1,0,3,0,1,43,38,81
p_83,0,12,e_1,501,504,542,12,1,0,1,4,1,0,3,38,41
p_84,12,0,e_0,504,512,562,29,1,1,9,5,0,1,8,50,58
p_80,13,0,e_0,474,517,562,8,3,0,0,3,0,0,43,45,88
p_93,4,0,e_0,543,546,562,15,3,2,5,4,1,1,3,16,19
p_87,3,0,e_0,528,551,562,29,1,1,10,4,1,0,23,11,34
p_94,3,0,e_0,546,551,562,15,3,2,4,4,1,1,5,11,16
p_85,14,0,e_2,517,542,594,22,1,1,6,5,1,0,25,52,77
p_91,14,0,e_2,539,542,594,13,2,0,13,5,0,2,3,52,55
p_88,10,0,e_2,531,556,594,21,1,1,11,5,1,1,25,38,63
p_99,9,0,e_2,556,561,594,6,2,1,10,1,1,2,5,33,38
p_96,7,0,e_2,551,569,594,9,3,1,12,4,1,1,18,25,43
p_98,6,0,e_2,555,574,594,9,2,1,10,1,1,1,19,20,39
p_86,14,0,e_1,518,550,600,22,1,1,4,5,1,0,32,50,82
p_95,10,0,e_1,547,564,600,8,3,0,13,5,0,1,17,36,53
p_97,5,0,e_1,552,581,600,11,3,1,14,4,1,1,29,19,48
p_107,3,0,e_1,584,589,600,12,4,1,4,4,1,0,5,11,16
p_111,2,0,e_1,607,616,624,6,3,2,0,3,0,0,9,8,17
p_90,1,0,e_3,538,541,636,9,1,1,0,5,0,1,3,95,98
p_89,5,0,e_3,535,555,636,5,0,0,0,3,1,0,20,81,101
p_92,10,0,e_3,540,572,636,9,1,0,1,2,0,1,32,64,96
p_100,10,0,e_3,557,572,636,5,2,0,5,5,1,1,15,64,79
p_102,14,0,e_3,568,586,636,5,2,0,9,5,1,1,18,50,68
p_103,14,0,e_3,577,586,636,3,2,0,11,5,1,1,9,50,59
p_104,14,0,e_3,581,586,636,2,2,0,12,5,1,1,5,50,55
p_109,10,0,e_3,590,600,636,3,3,0,13,4,1,2,10,36,46
p_108,7,0,e_3,584,611,636,8,3,1,13,5,1,2,27,25,52
p_106,5,0,e_3,583,619,636,10,2,1,13,5,1,1,36,17,53
p_101,9,0,e_0,566,595,644,3,2,1,0,3,0,0,29,49,78
p_105,12,0,e_0,582,606,644,3,2,1,5,5,0,1,24,38,62
p_110,12,0,e_0,590,606,644,1,4,0,8,5,0,2,16,38,54
p_117,0,2,e_3,636,636,646,0,0,0,0,3,1,0,0,10,10
p_116,7,0,e_1,633,652,693,24,1,1,1,5,0,1,19,41,60
p_113,9,0,e_1,629,660,693,23,1,1,0,3,0,0,31,33,64
p_115,9,0,e_1,632,660,693,22,1,1,0,5,0,1,28,33,61
p_124,7,0,e_1,664,668,693,3,2,1,8,4,1,0,4,25,29
p_125,2,0,e_1,668,685,693,6,2,0,7,4,1,0,17,8,25
p_118,8,0,e_3,649,670,698,6,0,0,2,3,0,0,21,28,49
p_121,3,0,e_3,656,687,698,9,1,1,4,5,0,1,31,11,42
p_123,0,2,e_1,661,693,701,11,2,2,9,4,1,0,32,8,40
p_112,11,0,e_2,613,649,702,26,2,2,0,3,0,0,36,53,89
p_114,13,0,e_2,632,657,702,18,1,1,5,5,0,1,25,45,70
p_120,13,0,e_2,653,657,702,11,1,0,12,5,1,1,4,45,49
p_122,7,0,e_2,657,677,702,5,2,1,13,4,1,0,20,25,45
p_126,1,0,e_2,681,697,702,4,2,1,6,4,1,0,16,5,21
p_119,8,0,e_0,650,676,702,6,1,0,0,3,0,0,26,26,52
p_127,7,0,e_1,701,719,742,7,0,0,2,3,0,0,18,23,41
p_128,0,15,e_2,705,706,757,0,0,0,0,3,0,0,1,51,52
p_129,5,0,e_0,705,723,758,5,0,0,0,3,0,0,18,35,53
p_131,7,0,e_0,722,731,758,10,1,1,5,2,0,0,9,27,36
p_133,6,0,e_0,734,736,758,7,1,1,7,4,1,1,2,22,24
p_132,4,0,e_0,730,744,758,11,1,1,7,5,1,1,14,14,28
p_130,11,0,e_3,705,741,802,11,0,0,0,3,0,0,36,61,97
p_134,14,0,e_3,734,752,802,5,1,0,9,5,0,1,18,50,68
p_136,14,0,e_3,749,752,802,1,2,0,13,5,1,1,3,50,53
p_137,13,0,e_3,755,757,802,1,1,0,14,4,1,0,2,45,47
p_138,12,0,e_3,756,762,802,1,1,0,13,1,1,0,6,40,46
p_143,5,0,e_3,780,785,802,1,1,0,6,4,1,0,5,17,22
p_135,11,0,e_2,739,743,804,6,2,1,10,5,1,0,4,61,65
p_139,0,15,e_0,758,759,810,13,2,0,0,3,0,0,1,51,52
p_145,1,0,e_3,820,826,831,1,0,0,0,3,0,0,6,5,11
p_140,5,0,e_1,768,786,847,5,1,0,0,3,0,0,18,61,79
p_141,12,0,e_1,770,809,847,28,1,1,0,5,0,1,39,38,77
p_144,6,0,e_2,815,836,856,6,0,0,0,3,0,0,21,20,41
p_142,13,0,e_0,773,802,857,26,1,1,3,5,1,0,29,55,84
p_150,3,0,e_2,860,871,884,24,1,1,0,3,0,0,11,13,24
p_152,2,0,e_2,868,876,884,22,1,1,2,5,0,1,8,8,16
p_149,6,0,e_0,859,880,902,21,1,1,0,3,0,0,21,22,43
p_153,6,0,e_0,872,880,902,17,1,1,4,5,0,1,8,22,30
p_154,4,0,e_0,874,888,902,18,1,1,4,5,0,1,14,14,28
p_147,6,0,e_1,849,867,931,24,1,1,0,5,0,1,18,64,82
p_146,10,0,e_1,846,881,931,10,0,0,0,3,1,0,35,50,85
p_151,12,0,e_1,863,889,931,14,1,1,5,5,0,2,26,42,68
p_156,12,0,e_1,884,889,931,7,1,1,11,5,1,1,5,42,47
p_159,8,0,e_1,893,903,931,8,1,1,11,4,1,1,10,28,38
p_157,7,0,e_1,889,908,931,10,1,1,12,4,1,0,19,23,42
p_158,7,0,e_1,892,908,931,9,1,1,12,4,1,1,16,23,39
p_148,15,0,e_3,849,896,943,15,0,0,0,3,0,0,47,47,94
p_155,11,0,e_2,884,919,954,8,1,1,0,3,1,0,35,35,70
p_3,4,0,e_2,25,40,88,4,0,0,0,3,0,0,15,48,63
p_4,5,0,e_2,34,45,88,5,0,0,2,5,0,1,11,43,54
p_5,9,0,e_2,41,59,88,9,0,0,4,5,1,1,18,29,47
p_6,9,0,e_2,45,59,88,9,0,0,5,5,1,1,14,29,43
p_2,11,0,e_1,19,55,90,11,0,0,0,3,0,0,36,35,71
p_1,13,0,e_0,13,54,95,13,0,0,0,3,0,0,41,41,82
p_12,0,8,e_1,86,90,116,21,5,5,1,4,1,0,4,26,30
p_16,4,0,e_2,101,115,129,13,5,1,0,3,0,0,14,14,28
p_15,5,0,e_0,99,116,133,13,5,2,0,3,0,0,17,17,34
p_19,0,7,e_2,125,129,154,11,3,0,1,4,1,0,4,25,29
p_7,2,0,e_3,55,64,162,2,0,0,0,3,0,0,9,98,107
p_10,9,0,e_3,77,87,162,15,3,2,6,5,1,2,10,75,85
p_9,10,0,e_3,67,92,162,17,2,1,3,5,1,1,25,70,95
p_14,13,0,e_3,87,103,162,8,4,1,9,2,1,3,16,59,75
p_8,15,0,e_3,62,111,162,13,1,0,2,5,0,1,49,51,100
p_13,8,0,e_3,87,134,162,13,5,3,9,2,1,4,47,28,75
p_11,4,0,e_3,84,148,162,18,4,3,8,5,1,3,64,14,78
p_21,0,10,e_0,142,143,179,6,2,0,0,3,0,0,1,36,37
p_17,10,0,e_1,112,124,188,5,3,0,7,5,1,0,12,64,76
p_18,15,0,e_1,120,141,188,27,3,3,9,5,0,1,21,47,68
p_20,3,0,e_0,142,156,221,3,2,1,0,3,0,1,14,65,79
p_28,7,0,e_0,184,190,221,5,1,1,9,4,1,2,6,31,37
p_26,6,0,e_0,169,195,221,10,1,1,7,5,2,0,26,26,52
p_27,5,0,e_0,180,200,221,8,1,1,10,4,1,1,20,21,41
p_30,2,0,e_0,200,211,221,5,1,0,5,4,1,0,11,10,21
p_33,1,0,e_0,213,216,221,2,1,0,2,4,1,0,3,5,8
p_25,9,0,e_3,163,192,223,9,0,0,0,3,0,0,29,31,60
p_31,5,0,e_3,203,206,223,1,1,0,6,4,1,0,3,17,20
p_22,6,0,e_2,146,149,229,29,2,2,5,5,1,0,3,80,83
p_24,14,0,e_2,157,177,229,18,1,1,8,5,1,1,20,52,72
p_23,15,0,e_2,150,182,229,19,1,1,6,5,2,0,32,47,79
p_35,0,6,e_3,222,223,247,0,0,0,0,3,1,0,1,24,25
p_32,0,10,e_0,209,221,253,4,1,0,2,4,1,1,12,32,44
p_36,1,0,e_3,225,230,267,11,1,1,0,2,1,0,5,37,42
p_34,11,0,e_1,217,227,296,21,1,1,8,5,0,1,10,69,79
p_29,14,0,e_1,192,238,296,23,0,0,0,3,0,0,46,58,104
p_37,15,0,e_1,228,243,296,15,2,0,11,5,1,1,15,53,68
p_39,13,0,e_1,247,251,296,19,1,0,14,4,1,0,4,45,49
p_41,7,0,e_1,257,271,296,26,1,1,11,4,1,0,14,25,39
p_44,4,0,e_1,275,282,296,3,1,0,6,4,1,0,7,14,21
p_42,4,0,e_2,269,283,297,4,0,0,0,3,0,0,14,14,28
p_43,4,0,e_3,270,284,298,4,0,0,0,3,0,0,14,14,28
p_49,3,0,e_3,298,309,320,3,0,0,0,3,1,0,11,11,22
p_38,12,0,e_0,240,261,323,8,2,0,6,5,1,0,21,62,83
p_40,15,0,e_0,255,272,323,19,1,1,10,5,0,1,17,51,68
p_46,8,0,e_0,291,295,323,24,1,1,9,4,1,0,4,28,32
p_47,3,0,e_0,293,312,323,28,1,1,8,4,1,1,19,11,30
p_51,0,4,e_3,309,320,334,3,1,0,3,4,1,0,11,14,25
p_57,1,0,e_0,327,332,337,5,1,1,0,3,0,0,5,5,10
p_59,3,0,e_3,335,341,356,1,0,0,4,3,0,0,6,15,21
p_60,2,0,e_3,338,346,356,2,1,1,4,4,0,1,8,10,18
p_62,1,0,e_3,345,351,356,1,2,0,2,4,1,1,6,5,11
p_58,0,6,e_0,330,337,357,5,1,1,1,5,0,1,7,20,27
p_54,7,0,e_2,313,320,359,25,1,1,5,5,0,2,7,39,46
p_53,8,0,e_2,313,325,359,24,1,1,5,5,0,1,12,34,46
p_56,8,0,e_2,324,325,359,7,1,0,8,5,1,2,1,34,35
p_48,9,0,e_2,294,330,359,22,1,1,1,4,1,0,36,29,65
p_45,11,0,e_1,290,331,386,22,1,1,2,4,1,0,41,55,96
p_50,11,0,e_1,299,331,386,11,1,0,0,5,0,1,32,55,87
p_52,14,0,e_1,312,342,386,19,1,1,5,5,0,1,30,44,74
p_55,14,0,e_1,314,342,386,18,1,1,6,5,0,2,28,44,72
p_63,3,0,e_2,364,376,387,3,0,0,0,3,0,0,12,11,23
p_68,2,0,e_2,389,397,405,21,3,3,0,3,0,0,8,8,16
p_69,2,0,e_2,391,397,405,20,3,3,0,5,0,1,6,8,14
p_65,0,7,e_1,369,386,409,30,1,1,5,4,1,0,17,23,40
p_61,12,0,e_0,341,377,417,21,2,2,1,5,1,0,36,40,76
p_70,3,0,e_0,398,406,417,17,3,3,6,4,1,0,8,11,19
p_64,0,15,e_3,365,365,418,0,0,0,0,3,0,0,0,53,53
p_71,7,0,e_1,403,409,432,12,3,2,5,5,1,0,6,23,29
p_73,3,0,e_2,423,434,445,11,1,0,0,3,0,0,11,11,22
p_72,6,0,e_0,417,438,458,21,1,0,0,3,0,0,21,20,41
p_66,11,0,e_3,376,402,467,16,1,1,3,5,1,0,26,65,91
p_67,12,0,e_3,377,407,467,15,2,1,3,5,1,1,30,60,90
p_74,10,0,e_3,424,435,467,4,1,0,14,4,1,0,11,32,43
p_77,4,0,e_2,455,470,484,30,1,1,0,3,0,0,15,14,29
p_81,1,0,e_2,493,499,504,1,0,0,0,3,0,0,6,5,11
p_79,9,0,e_0,457,487,516,24,1,1,0,3,1,0,30,29,59
p_75,3,0,e_1,438,449,526,7,1,0,0,3,0,0,11,77,88
p_76,10,0,e_1,440,472,526,29,1,1,0,5,0,1,32,54,86
p_78,12,0,e_1,455,480,526,22,1,1,4,5,1,1,25,46,71
p_80,13,0,e_1,474,485,526,13,0,0,10,5,1,1,11,41,52
p_82,0,12,e_3,494,495,535,0,0,0,0,3,0,0,1,40,41
p_83,0,12,e_2,501,504,544,23,1,1,1,4,1,0,3,40,43
p_87,3,0,e_0,528,540,553,15,2,2,0,3,0,0,12,13,25
p_90,1,0,e_0,538,548,553,14,2,1,3,5,0,1,10,5,15
p_93,4,0,e_1,543,549,573,18,1,0,2,5,0,1,6,24,30
p_89,5,0,e_1,535,554,573,11,2,1,0,3,0,0,19,19,38
p_97,5,0,e_1,552,554,573,7,1,0,4,5,1,2,2,19,21
p_94,3,0,e_1,546,562,573,11,1,0,3,5,0,2,16,11,27
p_88,10,0,e_2,531,536,586,7,2,2,8,5,1,0,5,50,55
p_92,10,0,e_2,540,552,586,5,2,1,11,5,2,0,12,34,46
p_95,10,0,e_2,547,552,586,3,1,0,11,4,1,1,5,34,39
p_96,7,0,e_2,551,563,586,5,1,0,10,1,1,0,12,23,35
p_84,12,0,e_3,504,535,589,10,1,0,2,5,1,0,31,54,85
p_85,14,0,e_3,517,543,589,8,1,0,6,5,1,0,26,46,72
p_86,14,0,e_3,518,543,589,8,2,0,6,5,1,1,25,46,71
p_91,14,0,e_3,539,543,589,1,2,0,13,5,1,1,4,46,50
p_99,9,0,e_3,556,560,589,1,1,0,10,4,1,0,4,29,33
p_111,2,0,e_3,607,615,623,2,0,0,0,3,0,0,8,8,16
p_109,10,0,e_2,590,623,655,10,0,0,0,3,0,0,33,32,65
p_98,6,0,e_0,555,575,655,5,1,0,0,3,0,0,20,80,100
p_101,9,0,e_0,566,586,655,28,1,1,3,5,0,2,20,69,89
p_100,10,0,e_0,557,591,655,30,2,2,0,5,0,1,34,64,98
p_110,12,0,e_0,590,599,655,12,0,0,10,2,1,2,9,56,65
p_102,14,0,e_0,568,607,655,23,1,1,4,5,0,3,39,48,87
p_103,14,0,e_0,577,607,655,20,1,1,6,5,1,3,30,48,78
p_104,14,0,e_0,581,607,655,19,1,1,8,5,1,3,26,48,74
p_112,11,0,e_0,613,618,655,10,1,0,13,4,1,1,5,37,42
p_107,3,0,e_0,584,644,655,28,1,1,8,5,1,3,60,11,71
p_117,0,2,e_2,636,655,663,25,1,1,6,4,1,0,19,8,27
p_106,5,0,e_1,583,599,666,27,1,1,0,5,0,1,16,67,83
p_108,7,0,e_1,584,607,666,25,1,1,0,5,0,2,23,59,82
p_105,12,0,e_1,582,624,666,20,1,1,0,3,0,0,42,42,84
p_113,9,0,e_1,629,635,666,9,0,0,11,4,1,0,6,31,37
p_115,9,0,e_1,632,635,666,17,1,1,10,4,1,1,3,31,34
p_116,7,0,e_1,633,643,666,19,1,1,10,4,1,1,10,23,33
p_123,0,2,e_1,661,666,674,18,2,2,2,4,1,0,5,8,13
p_125,2,0,e_1,668,674,682,13,2,1,0,5,1,0,6,8,14
p_126,1,0,e_1,681,687,692,11,1,0,0,3,1,0,6,5,11
p_124,7,0,e_2,664,681,704,10,2,1,2,3,0,0,17,23,40
p_121,3,0,e_0,656,668,705,16,2,2,0,3,0,0,12,37,49
p_122,7,0,e_0,657,682,705,11,1,1,0,5,0,1,25,23,48
p_118,8,0,e_3,649,658,716,13,1,1,5,5,0,1,9,58,67
p_119,8,0,e_3,650,658,716,13,2,1,5,5,0,2,8,58,66
p_114,13,0,e_3,632,675,716,13,0,0,0,3,0,0,43,41,84
p_120,13,0,e_3,653,675,716,6,2,0,7,5,0,2,22,41,63
p_129,5,0,e_2,705,722,739,29,1,1,0,3,0,0,17,17,34
p_127,7,0,e_1,701,724,749,28,1,1,0,3,0,0,23,25,48
p_131,7,0,e_1,722,724,749,22,1,1,7,5,0,1,2,25,27
p_132,4,0,e_1,730,735,749,22,1,1,5,4,1,0,5,14,19
p_128,0,15,e_3,705,716,765,4,1,0,4,4,1,0,11,49,60
p_130,11,0,e_0,705,740,801,23,1,1,0,3,1,0,35,61,96
p_135,11,0,e_0,739,740,801,12,1,1,11,5,0,3,1,61,62
p_134,14,0,e_0,734,751,801,10,1,1,9,5,0,1,17,50,67
p_136,14,0,e_0,749,751,801,5,1,1,13,5,1,2,2,50,52
p_138,12,0,e_0,756,759,801,5,1,1,13,4,1,1,3,42,45
p_133,6,0,e_0,734,779,801,18,1,1,9,5,0,2,45,22,67
p_143,5,0,e_0,780,784,801,6,1,0,6,4,1,0,4,17,21
p_139,0,15,e_1,758,758,807,17,2,2,0,3,0,0,0,49,49
p_137,13,0,e_3,755,757,814,5,1,1,12,5,1,0,2,57,59
p_141,12,0,e_3,770,776,814,2,1,0,14,4,1,0,6,38,44
p_145,1,0,e_3,820,825,830,1,0,0,0,3,0,0,5,5,10
p_140,5,0,e_2,768,786,853,10,1,0,0,3,0,0,18,67,85
p_142,13,0,e_2,773,812,853,30,2,2,1,5,0,1,39,41,80
p_144,6,0,e_0,815,835,855,6,0,0,0,3,0,0,20,20,40
p_152,2,0,e_2,868,869,885,22,1,1,2,5,0,1,1,16,17
p_150,3,0,e_2,860,874,885,24,1,1,0,3,0,0,14,11,25
p_146,10,0,e_1,846,863,899,10,0,0,15,3,0,0,17,36,53
p_147,6,0,e_1,849,877,899,24,1,1,14,4,0,1,28,22,50
p_153,6,0,e_1,872,877,899,17,1,1,8,4,1,1,5,22,27
p_154,4,0,e_1,874,885,899,18,1,1,7,4,1,1,11,14,25
p_149,6,0,e_0,859,880,940,21,1,1,0,3,0,0,21,60,81
p_155,11,0,e_0,884,897,940,8,1,1,7,5,1,1,13,43,56
p_151,12,0,e_0,863,902,940,14,1,1,1,5,0,1,39,38,77
p_156,12,0,e_0,884,902,940,7,1,1,7,5,1,1,18,38,56
p_157,7,0,e_2,889,912,943,10,1,1,0,3,0,0,23,31,54
p_158,7,0,e_2,892,912,943,9,1,1,0,5,0,1,20,31,51
p_159,8,0,e_2,893,917,943,8,1,1,1,5,0,1,24,26,50
p_148,15,0,e_3,849,896,943,15,0,0,0,3,0,0,47,47,94
p_3,4,0,e_2,25,40,54,4,0,0,0,3,0,0,15,14,29
p_7,2,0,e_2,55,64,72,10,2,1,0,3,0,0,9,8,17
p_6,9,0,e_1,45,49,92,6,2,0,8,5,0,1,4,43,47
p_2,11,0,e_1,19,57,92,11,0,0,0,3,0,0,38,35,73
p_1,13,0,e_0,13,55,96,13,0,0,0,3,0,0,42,41,83
p_12,0,8,e_1,86,92,118,15,1,1,2,4,1,0,6,26,32
p_16,4,0,e_0,101,113,135,7,2,1,0,5,0,1,12,22,34
p_15,5,0,e_0,99,118,135,6,2,1,0,3,0,0,19,17,36
p_4,5,0,e_3,34,51,136,5,0,0,0,3,0,0,17,85,102
p_5,9,0,e_3,41,65,136,7,1,0,2,5,0,1,24,71,95
p_9,10,0,e_3,67,70,136,11,2,1,9,5,1,1,3,66,69
p_8,15,0,e_3,62,87,136,7,2,0,8,5,1,1,25,49,74
p_13,8,0,e_3,87,110,136,7,1,0,15,4,1,0,23,26,49
p_19,0,7,e_0,125,135,158,4,1,0,3,4,1,0,10,23,33
p_17,10,0,e_1,112,126,158,28,1,1,6,5,1,0,14,32,46
p_20,3,0,e_3,142,153,164,3,0,0,0,3,0,0,11,11,22
p_11,4,0,e_2,84,91,179,12,2,1,2,5,0,1,7,88,95
p_10,9,0,e_2,77,108,179,9,2,1,0,3,0,0,31,71,102
p_14,13,0,e_2,87,122,179,28,1,0,3,5,0,2,35,57,92
p_18,15,0,e_2,120,130,179,20,1,1,13,5,1,1,10,49,59
p_22,6,0,e_2,146,159,179,5,1,0,10,4,1,0,13,20,33
p_21,0,10,e_1,142,158,192,6,1,1,5,4,1,0,16,34,50
p_27,5,0,e_2,180,198,217,4,1,1,0,3,0,0,18,19,37
p_30,2,0,e_2,200,209,217,18,2,1,5,4,1,0,9,8,17
p_25,9,0,e_1,163,187,228,21,1,1,1,5,1,0,24,41,65
p_31,5,0,e_1,203,209,228,14,2,1,7,4,1,0,6,19,25
p_33,1,0,e_1,213,223,228,14,2,1,4,4,1,0,10,5,15
p_24,14,0,e_0,157,181,235,18,1,1,7,5,1,1,24,54,78
p_23,15,0,e_0,150,186,235,13,1,0,5,5,1,0,36,49,85
p_36,1,0,e_0,225,230,235,11,1,0,2,4,1,0,5,5,10
p_35,0,6,e_1,222,228,248,13,1,0,1,4,1,1,6,20,26
p_32,0,10,e_2,209,217,249,17,2,2,2,1,1,0,8,32,40
p_26,6,0,e_3,169,190,262,6,0,0,0,3,0,0,21,72,93
p_28,7,0,e_3,184,195,262,3,1,0,4,5,0,1,11,67,78
p_29,14,0,e_3,192,218,262,8,2,0,6,5,1,1,26,44,70
p_42,4,0,e_3,269,283,297,4,0,0,0,3,0,0,14,14,28
p_43,4,0,e_3,270,283,297,4,1,0,0,5,0,1,13,14,27
p_44,4,0,e_3,275,283,297,2,1,0,2,5,0,1,8,14,22
p_41,7,0,e_0,257,280,303,25,1,1,0,3,0,0,23,23,46
p_38,12,0,e_1,240,268,316,25,1,1,3,5,1,0,28,48,76
p_39,13,0,e_1,247,273,316,22,1,1,6,2,1,1,26,43,69
p_47,3,0,e_1,293,305,316,28,2,2,7,4,1,0,12,11,23
p_34,11,0,e_2,217,254,317,25,1,0,0,5,1,0,37,63,100
p_37,15,0,e_2,228,268,317,26,1,1,3,5,1,1,40,49,89
p_40,15,0,e_2,255,268,317,17,1,1,11,5,1,1,13,49,62
p_49,3,0,e_2,298,306,317,19,2,2,5,4,1,0,8,11,19
p_51,0,4,e_1,309,316,330,18,2,2,2,4,1,0,7,14,21
p_57,1,0,e_1,327,341,346,13,3,2,3,5,1,0,14,5,19
p_58,0,6,e_1,330,346,368,13,2,2,4,4,0,1,16,22,38
p_54,7,0,e_3,313,320,375,10,2,2,5,5,0,2,7,55,62
p_53,8,0,e_3,313,325,375,9,3,2,5,5,0,3,12,50,62
p_48,9,0,e_3,294,330,375,22,2,2,1,4,1,1,36,45,81
p_45,11,0,e_3,290,338,375,21,1,1,2,4,1,0,48,37,85
p_50,11,0,e_3,299,338,375,11,2,0,0,5,0,2,39,37,76
p_60,2,0,e_3,338,367,375,9,1,0,11,4,1,0,29,8,37
p_62,1,0,e_1,345,351,388,8,2,1,0,3,1,0,6,37,43
p_46,8,0,e_0,291,329,395,24,2,2,4,4,1,0,38,66,104
p_52,14,0,e_0,312,349,395,9,2,0,3,5,0,1,37,46,83
p_55,14,0,e_0,314,349,395,9,4,0,3,5,0,2,35,46,81
p_63,3,0,e_0,364,384,395,30,2,2,10,4,1,0,20,11,31
p_65,0,7,e_3,369,375,398,2,1,0,2,4,1,0,6,23,29
p_56,8,0,e_2,324,350,406,6,4,2,0,3,0,0,26,56,82
p_61,12,0,e_2,341,364,406,29,2,2,5,5,0,2,23,42,65
p_59,3,0,e_2,335,393,406,9,2,1,3,5,0,1,58,13,71
p_68,2,0,e_2,389,398,406,24,3,3,4,4,1,1,9,8,17
p_69,2,0,e_2,391,398,406,23,3,3,4,4,1,2,7,8,15
p_64,0,15,e_3,365,375,426,2,2,0,2,4,1,1,10,51,61
p_70,3,0,e_0,398,410,449,20,2,2,0,3,0,0,12,39,51
p_71,7,0,e_0,403,424,449,15,2,2,1,5,0,1,21,25,46
p_73,3,0,e_0,423,438,449,13,2,1,7,5,1,1,15,11,26
p_72,6,0,e_2,417,437,459,12,2,1,0,3,0,0,20,22,42
p_75,3,0,e_2,438,448,459,9,1,0,6,4,1,0,10,11,21
p_67,12,0,e_1,377,426,466,18,3,1,4,4,1,0,49,40,89
p_74,10,0,e_1,424,434,466,5,2,0,12,5,0,1,10,32,42
p_66,11,0,e_3,376,412,477,19,2,1,0,5,2,0,36,65,101
p_76,10,0,e_3,440,443,477,1,1,0,11,4,1,0,3,34,37
p_77,4,0,e_3,455,463,477,3,1,0,7,4,1,0,8,14,22
p_81,1,0,e_1,493,498,503,1,0,0,0,3,0,0,5,5,10
p_82,0,12,e_2,494,495,535,0,0,0,0,3,0,0,1,40,41
p_83,0,12,e_3,501,501,543,0,0,0,0,3,0,0,0,42,42
p_79,9,0,e_0,457,485,546,27,2,2,0,5,0,1,28,61,89
p_78,12,0,e_0,455,496,546,25,1,1,0,3,0,0,41,50,91
p_80,13,0,e_0,474,501,546,18,1,1,5,5,0,2,27,45,72
p_87,3,0,e_0,528,533,546,13,1,1,4,4,1,0,5,13,18
p_90,1,0,e_0,538,541,546,12,3,1,2,4,1,0,3,5,8
p_88,10,0,e_3,531,535,587,5,1,1,9,5,1,0,4,52,56
p_95,10,0,e_3,547,551,587,1,2,0,11,4,1,1,4,36,40
p_96,7,0,e_3,551,562,587,3,2,0,10,4,1,1,11,25,36
p_89,5,0,e_3,535,570,587,9,1,1,10,2,1,0,35,17,52
p_85,14,0,e_2,517,543,593,10,1,0,6,5,1,0,26,50,76
p_91,14,0,e_2,539,543,593,3,3,0,13,5,0,1,4,50,54
p_92,10,0,e_2,540,557,593,3,3,1,13,5,0,1,17,36,53
p_99,9,0,e_2,556,562,593,30,3,3,10,1,1,1,6,31,37
p_93,4,0,e_2,543,579,593,8,2,0,14,2,0,1,36,14,50
p_84,12,0,e_1,504,543,601,12,1,0,0,3,0,0,39,58,97
p_86,14,0,e_1,518,551,601,10,1,0,4,5,0,1,33,50,83
p_100,10,0,e_1,557,565,601,28,3,3,13,4,1,0,8,36,44
p_101,9,0,e_1,566,570,601,27,2,2,10,4,1,0,4,31,35
p_107,3,0,e_1,584,590,601,28,1,1,5,4,1,0,6,11,17
p_111,2,0,e_1,607,616,624,17,2,2,0,3,0,0,9,8,17
p_94,3,0,e_0,546,558,647,8,2,1,0,3,0,0,12,89,101
p_97,5,0,e_0,552,566,647,5,3,1,1,5,0,1,14,81,95
p_98,6,0,e_0,555,571,647,3,3,1,2,5,0,2,16,76,92
p_105,12,0,e_0,582,591,647,20,1,1,9,5,1,1,9,56,65
p_102,14,0,e_0,568,599,647,21,2,2,5,5,1,1,31,48,79
p_103,14,0,e_0,577,599,647,19,1,1,8,5,1,1,22,48,70
p_104,14,0,e_0,581,599,647,18,1,1,9,5,1,1,18,48,66
p_108,7,0,e_0,584,622,647,24,1,1,10,5,1,3,38,25,63
p_106,5,0,e_0,583,630,647,26,1,1,10,5,1,2,47,17,64
p_117,0,2,e_0,636,647,655,11,3,0,4,4,1,0,11,8,19
p_109,10,0,e_3,590,622,674,10,0,0,0,3,0,0,32,52,84
p_110,12,0,e_3,590,630,674,12,1,1,0,3,0,1,40,44,84
p_115,9,0,e_3,632,641,674,3,1,0,12,4,1,0,9,33,42
p_116,7,0,e_3,633,649,674,4,2,1,11,4,1,1,16,25,41
p_121,3,0,e_3,656,663,674,2,1,0,5,4,1,0,7,11,18
p_123,0,2,e_3,661,674,682,3,2,0,3,4,1,1,13,8,21
p_126,1,0,e_3,681,687,692,3,0,0,2,2,1,0,6,5,11
p_118,8,0,e_1,649,655,693,29,1,1,6,5,0,1,6,38,44
p_113,9,0,e_1,629,660,693,21,1,0,0,3,0,0,31,33,64
p_122,7,0,e_1,657,668,693,28,2,2,8,5,1,1,11,25,36
p_124,7,0,e_1,664,668,693,26,1,1,8,4,1,1,4,25,29
p_125,2,0,e_1,668,685,693,30,1,1,7,1,1,0,17,8,25
p_112,11,0,e_2,613,649,698,6,2,1,0,3,0,0,36,49,85
p_114,13,0,e_2,632,657,698,29,2,2,5,5,0,1,25,41,66
p_120,13,0,e_2,653,657,698,23,1,1,12,5,1,1,4,41,45
p_119,8,0,e_0,650,675,701,29,1,1,0,5,1,0,25,26,51
p_129,5,0,e_1,705,723,740,5,0,0,0,3,0,0,18,17,35
p_127,7,0,e_0,701,725,750,7,0,0,0,3,0,0,24,25,49
p_131,7,0,e_0,722,725,750,10,1,1,6,5,0,1,3,25,28
p_132,4,0,e_0,730,736,750,11,1,1,6,4,1,0,6,14,20
p_128,0,15,e_2,705,706,755,0,0,0,0,3,0,0,1,49,50
p_130,11,0,e_3,705,741,800,11,0,0,0,3,0,0,36,59,95
p_134,14,0,e_3,734,752,800,5,1,0,9,5,0,1,18,48,66
p_136,14,0,e_3,749,752,800,1,2,0,13,5,1,1,3,48,51
p_138,12,0,e_3,756,760,800,1,1,0,13,4,1,0,4,40,44
p_140,5,0,e_3,768,783,800,5,1,0,10,4,1,0,15,17,32
p_143,5,0,e_3,780,783,800,1,2,0,6,4,1,1,3,17,20
p_137,13,0,e_2,755,763,806,30,1,1,15,4,0,1,8,43,51
p_133,6,0,e_2,734,786,806,13,2,2,8,5,1,0,52,20,72
p_139,0,15,e_0,758,759,808,12,2,0,0,3,0,0,1,49,50
p_135,11,0,e_1,739,775,826,6,2,1,0,3,1,0,36,51,87
p_141,12,0,e_1,770,780,826,27,2,2,10,5,0,1,10,46,56
p_142,13,0,e_1,773,785,826,25,2,2,11,5,0,2,12,41,53
p_145,1,0,e_3,820,826,831,1,0,0,0,3,0,0,6,5,11
p_144,6,0,e_2,815,835,855,6,0,0,0,3,0,0,20,20,40
p_150,3,0,e_2,860,871,884,24,1,1,0,3,0,0,11,13,24
p_152,2,0,e_2,868,876,884,22,1,1,2,5,0,1,8,8,16
p_146,10,0,e_0,846,864,900,10,0,0,15,3,0,0,18,36,54
p_153,6,0,e_0,872,878,900,17,1,1,8,4,1,0,6,22,28
p_154,4,0,e_0,874,886,900,18,1,1,7,4,1,1,12,14,26
p_147,6,0,e_1,849,869,933,6,0,0,0,3,0,0,20,64,84
p_149,6,0,e_1,859,869,933,21,1,1,3,5,0,1,10,64,74
p_155,11,0,e_1,884,886,933,8,1,1,11,5,1,1,2,47,49
p_151,12,0,e_1,863,891,933,14,1,1,4,5,0,1,28,42,70
p_156,12,0,e_1,884,891,933,7,1,1,11,5,1,1,7,42,49
p_159,8,0,e_1,893,905,933,8,1,1,12,4,1,1,12,28,40
p_158,7,0,e_1,892,910,933,9,1,1,12,4,1,0,18,23,41
p_157,7,0,e_2,889,912,935,10,1,1,0,3,0,0,23,23,46
p_148,15,0,e_3,849,896,943,15,0,0,0,3,0,0,47,47,94
p_3,4,0,e_2,25,39,87,4,0,0,0,3,0,0,14,48,62
p_4,5,0,e_2,34,44,87,5,0,0,3,5,0,1,10,43,53
p_5,9,0,e_2,41,58,87,9,0,0,4,5,1,1,17,29,46
p_6,9,0,e_2,45,58,87,9,0,0,5,5,1,1,13,29,42
p_2,11,0,e_1,19,55,90,11,0,0,0,3,0,0,36,35,71
p_1,13,0,e_0,13,54,95,13,0,0,0,3,0,0,41,41,82
p_12,0,8,e_2,86,87,113,21,4,4,0,4,1,0,1,26,27
p_16,4,0,e_1,101,116,130,13,3,1,0,3,0,0,15,14,29
p_15,5,0,e_0,99,117,134,13,3,1,0,3,0,0,18,17,35
p_19,0,7,e_1,125,130,155,10,2,0,1,4,1,0,5,25,30
p_7,2,0,e_3,55,63,159,2,0,0,0,3,0,0,8,96,104
p_10,9,0,e_3,77,86,159,15,3,2,6,5,1,2,9,73,82
p_9,10,0,e_3,67,91,159,17,2,1,3,5,1,1,24,68,92
p_8,15,0,e_3,62,108,159,17,0,0,2,2,0,0,46,51,97
p_17,10,0,e_3,112,125,159,4,2,0,14,4,1,1,13,34,47
p_11,4,0,e_3,84,145,159,17,4,2,9,5,1,3,61,14,75
p_21,0,10,e_0,142,143,179,5,2,0,0,3,0,1,1,36,37
p_13,8,0,e_2,87,113,185,13,4,2,0,3,1,1,26,72,98
p_14,13,0,e_2,87,130,185,8,4,1,0,3,1,0,43,55,98
p_18,15,0,e_2,120,138,185,27,3,3,10,5,1,1,18,47,65
p_30,2,0,e_2,200,209,217,15,2,1,0,3,0,0,9,8,17
p_20,3,0,e_0,142,156,217,2,2,1,0,3,0,0,14,61,75
p_28,7,0,e_0,184,190,217,5,1,1,9,4,1,2,6,27,33
p_26,6,0,e_0,169,195,217,11,1,1,7,5,2,0,26,22,48
p_27,5,0,e_0,180,200,217,8,1,1,10,4,1,1,20,17,37
p_22,6,0,e_1,146,150,234,28,1,1,5,5,1,0,4,84,88
p_24,14,0,e_1,157,178,234,16,1,1,7,5,1,1,21,56,77
p_23,15,0,e_1,150,183,234,18,1,1,6,2,1,0,33,51,84
p_31,5,0,e_1,203,215,234,11,2,1,9,4,1,0,12,19,31
p_33,1,0,e_1,213,229,234,12,1,0,5,4,1,1,16,5,21
p_36,1,0,e_1,225,229,234,9,1,0,2,4,1,1,4,5,9
p_35,0,6,e_2,222,223,245,11,1,0,0,3,0,0,1,22,23
p_32,0,10,e_0,209,217,249,14,1,1,2,4,1,0,8,32,40
p_25,9,0,e_3,163,193,256,9,0,0,0,3,0,0,30,63,93
p_29,14,0,e_3,192,210,256,5,1,0,9,5,0,1,18,46,64
p_34,11,0,e_3,217,221,256,1,1,0,12,4,1,0,4,35,39
p_42,4,0,e_3,269,284,298,4,0,0,0,3,0,0,15,14,29
p_43,4,0,e_3,270,284,298,4,1,0,0,5,0,1,14,14,28
p_44,4,0,e_3,275,284,298,3,1,0,1,5,0,1,9,14,23
p_41,7,0,e_1,257,281,306,7,0,0,0,3,0,0,24,25,49
p_47,3,0,e_1,293,295,306,29,2,2,4,4,1,1,2,11,13
p_38,12,0,e_2,240,265,313,23,1,1,4,5,1,0,25,48,73
p_39,13,0,e_2,247,270,313,20,1,1,6,5,0,1,23,43,66
p_49,3,0,e_2,298,302,313,3,2,2,4,4,1,0,4,11,15
p_37,15,0,e_0,228,266,313,24,1,1,3,5,1,0,38,47,85
p_40,15,0,e_0,255,266,313,15,0,0,12,5,0,1,11,47,58
p_51,0,4,e_0,309,313,327,19,2,2,1,4,1,0,4,14,18
p_57,1,0,e_0,327,338,343,18,2,2,4,3,1,0,11,5,16
p_54,7,0,e_2,313,337,362,17,3,3,0,3,0,0,24,25,49
p_60,2,0,e_2,338,354,362,14,2,1,7,4,1,0,16,8,24
p_46,8,0,e_1,291,332,362,24,2,2,4,4,1,0,41,30,71
p_53,8,0,e_1,313,332,362,15,3,3,2,5,0,1,19,30,49
p_56,8,0,e_1,324,332,362,12,3,3,5,5,0,1,8,30,38
p_59,3,0,e_1,335,349,362,14,2,1,8,4,1,0,14,13,27
p_62,1,0,e_1,345,357,362,13,3,0,4,4,1,1,12,5,17
p_58,0,6,e_0,330,343,363,19,3,3,4,4,0,1,13,20,33
p_63,3,0,e_0,364,376,387,6,1,0,6,3,0,0,12,11,23
p_48,9,0,e_3,294,327,392,22,2,2,1,4,1,1,33,65,98
p_45,11,0,e_3,290,335,392,22,1,1,3,4,1,0,45,57,102
p_50,11,0,e_3,299,335,392,11,2,0,0,5,0,2,36,57,93
p_52,14,0,e_3,312,346,392,10,2,0,4,5,0,2,34,46,80
p_55,14,0,e_3,314,346,392,9,3,0,5,5,0,3,32,46,78
p_61,12,0,e_3,341,354,392,4,2,1,12,5,1,1,13,38,51
p_65,0,7,e_2,369,370,395,8,1,0,0,3,0,0,1,25,26
p_68,2,0,e_0,389,397,405,29,1,1,0,3,0,0,8,8,16
p_69,2,0,e_0,391,397,405,28,1,1,0,5,0,1,6,8,14
p_64,0,15,e_1,365,365,414,9,1,0,0,3,0,0,0,49,49
p_70,3,0,e_3,398,410,449,3,0,0,0,3,0,0,12,39,51
p_71,7,0,e_3,403,424,449,6,1,0,1,5,0,1,21,25,46
p_73,3,0,e_3,423,438,449,4,2,0,7,5,1,1,15,11,26
p_66,11,0,e_2,376,409,454,24,1,1,1,5,1,0,33,45,78
p_67,12,0,e_2,377,414,454,23,1,1,1,5,1,1,37,40,77
p_75,3,0,e_2,438,443,454,30,1,1,4,4,1,0,5,11,16
p_72,6,0,e_0,417,437,457,3,2,1,0,3,0,0,20,20,40
p_74,10,0,e_1,424,441,475,11,2,0,15,3,0,0,17,34,51
p_76,10,0,e_1,440,441,475,23,1,1,10,4,0,1,1,34,35
p_77,4,0,e_1,455,461,475,4,0,0,6,4,1,0,6,14,20
p_81,1,0,e_1,493,499,504,1,0,0,0,3,0,0,6,5,11
p_79,9,0,e_0,457,486,515,9,0,0,0,3,1,0,29,29,58
p_82,0,12,e_3,494,495,535,0,0,0,0,3,0,0,1,40,41
p_78,12,0,e_2,455,494,542,12,0,0,0,3,0,0,39,48,87
p_80,13,0,e_2,474,499,542,13,0,0,6,5,0,1,25,43,68
p_87,3,0,e_2,528,531,542,15,2,2,4,4,1,0,3,11,14
p_83,0,12,e_1,501,504,544,23,1,1,1,4,1,0,3,40,43
p_90,1,0,e_0,538,541,572,14,2,1,0,5,0,1,3,31,34
p_89,5,0,e_0,535,555,572,11,2,1,0,3,0,0,20,17,37
p_97,5,0,e_0,552,555,572,7,1,0,4,5,1,1,3,17,20
p_94,3,0,e_2,546,555,574,11,1,0,0,5,0,1,9,19,28
p_93,4,0,e_2,543,560,574,10,1,0,0,3,0,0,17,14,31
p_88,10,0,e_1,531,536,586,7,2,2,8,5,1,0,5,50,55
p_92,10,0,e_1,540,552,586,5,2,1,11,5,2,0,12,34,46
p_95,10,0,e_1,547,552,586,3,1,0,11,4,1,1,5,34,39
p_96,7,0,e_1,551,563,586,5,1,0,10,1,1,0,12,23,35
p_84,12,0,e_3,504,535,591,10,1,0,2,5,1,0,31,56,87
p_85,14,0,e_3,517,543,591,8,1,0,6,5,1,0,26,48,74
p_86,14,0,e_3,518,543,591,7,2,0,7,5,1,1,25,48,73
p_91,14,0,e_3,539,543,591,1,2,0,13,5,1,1,4,48,52
p_99,9,0,e_3,556,560,591,1,2,0,10,4,1,1,4,31,35
p_98,6,0,e_3,555,571,591,4,1,0,10,4,1,0,16,20,36
p_111,2,0,e_3,607,616,624,2,0,0,0,3,0,0,9,8,17
p_101,9,0,e_0,566,601,668,29,2,2,2,4,1,0,35,67,102
p_105,12,0,e_0,582,612,668,21,1,1,3,5,0,2,30,56,86
p_102,14,0,e_0,568,620,668,23,2,2,1,4,1,1,52,48,100
p_104,14,0,e_0,581,620,668,19,1,1,3,5,0,2,39,48,87
p_115,9,0,e_0,632,637,668,17,1,1,10,4,1,1,5,31,36
p_107,3,0,e_0,584,657,668,29,1,1,4,5,0,3,73,11,84
p_109,10,0,e_1,590,622,672,20,1,1,0,3,0,1,32,50,82
p_112,11,0,e_1,613,627,672,10,1,0,7,5,0,2,14,45,59
p_110,12,0,e_1,590,632,672,18,1,1,0,3,0,0,42,40,82
p_116,7,0,e_1,633,649,672,19,1,1,12,4,1,0,16,23,39
p_106,5,0,e_2,583,591,672,27,1,1,3,5,0,2,8,81,89
p_108,7,0,e_2,584,599,672,25,1,1,3,5,0,3,15,73,88
p_100,10,0,e_2,557,610,672,30,3,3,3,5,1,1,53,62,115
p_103,14,0,e_2,577,624,672,20,1,1,1,5,0,1,47,48,95
p_113,9,0,e_2,629,641,672,9,0,0,13,4,1,0,12,31,43
p_121,3,0,e_2,656,661,672,16,2,2,4,4,1,0,5,11,16
p_117,0,2,e_0,636,668,676,25,1,1,9,1,1,1,32,8,40
p_123,0,2,e_0,661,668,676,17,3,3,2,4,1,0,7,8,15
p_125,2,0,e_0,668,676,684,13,3,1,0,5,1,0,8,8,16
p_126,1,0,e_1,681,686,691,10,2,1,0,3,0,0,5,5,10
p_118,8,0,e_3,649,658,718,13,1,1,5,5,0,1,9,60,69
p_119,8,0,e_3,650,658,718,13,2,1,5,5,0,2,8,60,68
p_114,13,0,e_3,632,675,718,13,0,0,0,3,0,0,43,43,86
p_120,13,0,e_3,653,675,718,7,2,0,6,5,0,2,22,43,65
p_122,7,0,e_3,657,695,718,11,1,1,8,2,0,1,38,23,61
p_124,7,0,e_3,664,695,718,9,3,1,10,5,1,2,31,23,54
p_127,7,0,e_0,701,724,749,29,1,1,0,3,0,0,23,25,48
p_131,7,0,e_0,722,724,749,7,0,0,7,5,0,1,2,25,27
p_132,4,0,e_0,730,735,749,4,0,0,5,4,1,0,5,14,19
p_128,0,15,e_2,705,705,754,4,1,0,0,3,0,0,0,49,49
p_129,5,0,e_1,705,722,801,29,1,1,0,3,0,1,17,79,96
p_130,11,0,e_1,705,742,801,23,1,1,0,3,0,0,37,59,96
p_134,14,0,e_1,734,753,801,14,1,1,8,5,1,1,19,48,67
p_136,14,0,e_1,749,753,801,10,2,0,13,5,1,1,4,48,52
p_138,12,0,e_1,756,761,801,6,2,0,13,4,1,0,5,40,45
p_140,5,0,e_1,768,784,801,7,2,1,10,4,1,0,16,17,33
p_143,5,0,e_1,780,784,801,9,2,1,6,4,1,1,4,17,21
p_137,13,0,e_2,755,764,805,7,2,0,15,3,0,0,9,41,50
p_139,0,15,e_0,758,758,807,15,2,2,0,3,0,0,0,49,49
p_133,6,0,e_3,734,755,823,6,0,0,0,3,0,0,21,68,89
p_135,11,0,e_3,739,772,823,10,1,0,1,5,0,1,33,51,84
p_141,12,0,e_3,770,777,823,1,2,0,11,5,1,1,7,46,53
p_142,13,0,e_3,773,782,823,2,2,0,11,5,1,1,9,41,50
p_145,1,0,e_2,820,825,830,30,1,1,0,3,0,0,5,5,10
p_144,6,0,e_1,815,836,856,26,1,1,0,3,0,0,21,20,41
p_150,3,0,e_1,860,871,884,24,1,1,0,3,0,0,11,13,24
p_152,2,0,e_1,868,876,884,23,1,1,2,5,0,1,8,8,16
p_146,10,0,e_0,846,863,899,10,0,0,15,3,0,0,17,36,53
p_153,6,0,e_0,872,877,899,17,1,1,8,4,1,0,5,22,27
p_154,4,0,e_0,874,885,899,18,1,1,7,4,1,1,11,14,25
p_147,6,0,e_2,849,870,934,6,0,0,0,3,0,0,21,64,85
p_149,6,0,e_2,859,870,934,21,1,1,2,5,0,1,11,64,75
p_155,11,0,e_2,884,887,934,8,1,1,10,5,1,1,3,47,50
p_151,12,0,e_2,863,892,934,14,1,1,4,5,0,1,29,42,71
p_156,12,0,e_2,884,892,934,7,1,1,10,5,1,2,8,42,50
p_159,8,0,e_2,893,906,934,8,1,1,12,4,1,1,13,28,41
p_158,7,0,e_2,892,911,934,9,1,1,12,4,1,0,19,23,42
p_157,7,0,e_1,889,912,935,11,1,1,0,3,0,0,23,23,46
p_148,15,0,e_3,849,897,944,15,0,0,0,3,0,0,48,47,95
p_3,4,0,e_2,25,39,87,4,0,0,0,3,0,0,14,48,62
p_4,5,0,e_2,34,44,87,5,0,0,2,5,0,1,10,43,53
p_5,9,0,e_2,41,58,87,9,0,0,4,5,1,1,17,29,46
p_6,9,0,e_2,45,58,87,9,0,0,5,5,1,1,13,29,42
p_2,11,0,e_1,19,55,90,11,0,0,0,3,0,0,36,35,71
p_1,13,0,e_0,13,55,96,13,0,0,0,3,0,0,42,41,83
p_12,0,8,e_2,86,87,113,21,5,5,0,4,1,0,1,26,27
p_16,4,0,e_1,101,116,130,14,3,1,0,3,0,0,15,14,29
p_15,5,0,e_0,99,117,134,13,3,1,0,3,0,0,18,17,35
p_19,0,7,e_1,125,130,155,10,2,0,2,4,1,0,5,25,30
p_7,2,0,e_3,55,64,160,2,0,0,0,3,0,0,9,96,105
p_10,9,0,e_3,77,87,160,15,3,2,6,5,1,2,10,73,83
p_9,10,0,e_3,67,92,160,18,2,1,2,5,1,1,25,68,93
p_8,15,0,e_3,62,109,160,14,1,0,1,5,0,1,47,51,98
p_17,10,0,e_3,112,126,160,4,2,0,14,4,1,1,14,34,48
p_11,4,0,e_3,84,146,160,18,4,3,8,5,1,3,62,14,76
p_21,0,10,e_0,142,142,178,5,2,0,0,3,0,1,0,36,36
p_13,8,0,e_2,87,113,185,13,4,2,0,3,1,0,26,72,98
p_14,13,0,e_2,87,130,185,8,4,1,0,3,1,1,43,55,98
p_18,15,0,e_2,120,138,185,27,3,3,10,5,1,1,18,47,65
p_20,3,0,e_0,142,155,218,2,2,1,0,3,0,0,13,63,76
p_28,7,0,e_0,184,189,218,5,1,1,9,4,1,2,5,29,34
p_26,6,0,e_0,169,194,218,11,1,1,7,5,2,0,25,24,49
p_27,5,0,e_0,180,199,218,8,1,1,10,4,1,1,19,19,38
p_30,2,0,e_0,200,210,218,5,1,0,5,4,1,0,10,8,18
p_25,9,0,e_3,163,193,226,9,0,0,0,3,0,0,30,33,63
p_31,5,0,e_3,203,207,226,1,1,0,6,4,1,0,4,19,23
p_33,1,0,e_3,213,221,226,2,1,0,3,4,1,0,8,5,13
p_22,6,0,e_1,146,150,230,28,1,1,5,5,1,0,4,80,84
p_24,14,0,e_1,157,178,230,17,1,1,7,5,1,1,21,52,73
p_23,15,0,e_1,150,183,230,18,1,1,6,2,1,0,33,47,80
p_35,0,6,e_3,222,226,248,1,1,0,1,4,1,0,4,22,26
p_32,0,10,e_0,209,218,250,5,1,0,2,1,1,0,9,32,41
p_36,1,0,e_3,225,231,268,1,0,0,0,3,1,0,6,37,43
p_34,11,0,e_2,217,227,296,21,2,2,8,5,0,1,10,69,79
p_29,14,0,e_2,192,238,296,23,0,0,0,3,0,0,46,58,104
p_37,15,0,e_2,228,243,296,15,2,0,11,5,1,1,15,53,68
p_39,13,0,e_2,247,251,296,19,1,0,14,4,1,0,4,45,49
p_41,7,0,e_2,257,271,296,27,1,1,12,4,1,0,14,25,39
p_44,4,0,e_2,275,282,296,3,1,0,6,4,1,0,7,14,21
p_42,4,0,e_1,269,284,298,4,0,0,0,3,0,0,15,14,29
p_43,4,0,e_3,270,285,299,4,0,0,0,3,0,0,15,14,29
p_38,12,0,e_0,240,258,318,8,2,0,7,5,1,0,18,60,78
p_40,15,0,e_0,255,269,318,19,1,1,11,5,0,1,14,49,63
p_47,3,0,e_0,293,307,318,29,1,1,8,4,1,0,14,11,25
p_51,0,4,e_0,309,318,332,15,1,1,3,4,1,0,9,14,23
p_57,1,0,e_0,327,343,348,18,1,1,3,5,1,0,16,5,21
p_49,3,0,e_1,298,309,360,27,2,2,0,3,1,1,11,51,62
p_54,7,0,e_1,313,323,360,7,1,1,4,5,1,1,10,37,47
p_46,8,0,e_1,291,328,360,25,1,1,2,4,1,0,37,32,69
p_53,8,0,e_1,313,328,360,6,1,1,4,5,1,1,15,32,47
p_56,8,0,e_1,324,328,360,12,2,2,7,5,1,1,4,32,36
p_59,3,0,e_1,335,345,360,14,2,1,6,4,1,0,10,15,25
p_60,2,0,e_1,338,350,360,14,2,1,5,4,1,1,12,10,22
p_62,1,0,e_1,345,355,360,13,2,0,3,1,1,1,10,5,15
p_58,0,6,e_1,330,360,380,19,2,2,8,4,1,0,30,20,50
p_45,11,0,e_2,290,331,386,22,1,1,2,4,1,0,41,55,96
p_50,11,0,e_2,299,331,386,11,1,0,1,5,0,1,32,55,87
p_52,14,0,e_2,312,342,386,10,1,0,5,5,0,1,30,44,74
p_48,9,0,e_3,294,328,391,22,1,1,1,4,1,0,34,63,97
p_55,14,0,e_3,314,345,391,10,1,0,4,5,0,1,31,46,77
p_61,12,0,e_3,341,353,391,3,2,1,13,5,1,1,12,38,50
p_65,0,7,e_2,369,386,411,7,1,0,6,4,1,0,17,25,42
p_69,2,0,e_3,391,400,416,2,0,0,0,3,0,0,9,16,25
p_70,3,0,e_3,398,405,416,1,1,0,2,5,0,1,7,11,18
p_64,0,15,e_0,365,365,416,9,1,0,0,3,0,1,0,51,51
p_68,2,0,e_2,389,394,434,28,1,1,1,5,1,0,5,40,45
p_71,7,0,e_2,403,411,434,4,2,0,4,5,2,0,8,23,31
p_66,11,0,e_1,376,397,442,24,1,1,5,5,1,0,21,45,66
p_67,12,0,e_1,377,402,442,23,1,1,5,5,1,1,25,40,65
p_72,6,0,e_1,417,422,442,6,0,0,7,4,1,0,5,20,25
p_73,3,0,e_3,423,435,446,3,0,0,0,3,0,0,12,11,23
p_63,3,0,e_0,364,378,465,6,1,0,0,3,0,0,14,87,101
p_74,10,0,e_0,424,433,465,10,1,0,13,4,1,0,9,32,41
p_77,4,0,e_1,455,470,484,4,0,0,0,3,0,0,15,14,29
p_81,1,0,e_0,493,499,504,6,1,0,0,3,0,0,6,5,11
p_79,9,0,e_3,457,486,515,9,0,0,0,3,0,0,29,29,58
p_75,3,0,e_2,438,450,527,29,1,1,0,3,0,0,12,77,89
p_76,10,0,e_2,440,473,527,22,1,1,0,5,0,1,33,54,87
p_78,12,0,e_2,455,481,527,12,0,0,4,5,1,1,26,46,72
p_80,13,0,e_2,474,486,527,8,1,0,10,5,1,1,12,41,53
p_82,0,12,e_1,494,495,535,7,1,0,0,3,0,0,1,40,41
p_83,0,12,e_0,501,504,544,5,1,0,1,4,1,0,3,40,43
p_87,3,0,e_2,528,539,566,3,0,0,0,3,0,0,11,27,38
p_89,5,0,e_2,535,547,566,5,0,0,2,5,0,1,12,19,31
p_94,3,0,e_2,546,555,566,4,2,1,5,5,1,1,9,11,20
p_90,1,0,e_3,538,543,568,1,0,0,0,3,0,0,5,25,30
p_93,4,0,e_3,543,554,568,5,0,0,1,2,0,0,11,14,25
p_88,10,0,e_0,531,536,586,10,0,0,8,5,1,0,5,50,55
p_92,10,0,e_0,540,552,586,10,1,0,11,5,2,0,12,34,46
p_95,10,0,e_0,547,552,586,8,2,0,11,4,1,1,5,34,39
p_96,7,0,e_0,551,563,586,4,2,0,10,1,1,0,12,23,35
p_84,12,0,e_1,504,535,591,21,1,1,2,5,1,0,31,56,87
p_85,14,0,e_1,517,543,591,14,0,0,6,5,1,0,26,48,74
p_86,14,0,e_1,518,543,591,14,0,0,7,5,1,1,25,48,73
p_91,14,0,e_1,539,543,591,14,1,0,13,5,1,1,4,48,52
p_99,9,0,e_1,556,560,591,25,2,2,10,4,1,1,4,31,35
p_98,6,0,e_1,555,571,591,28,2,2,11,4,1,0,16,20,36
p_111,2,0,e_1,607,615,623,14,3,1,0,3,0,0,8,8,16
p_108,7,0,e_2,584,589,664,16,4,2,5,5,0,3,5,75,80
p_101,9,0,e_2,566,597,664,21,2,2,0,5,0,1,31,67,98
p_100,10,0,e_2,557,602,664,24,2,2,3,4,1,0,45,62,107
p_103,14,0,e_2,577,616,664,12,2,0,3,5,0,2,39,48,87
p_112,11,0,e_2,613,627,664,4,3,1,13,5,1,1,14,37,51
p_113,9,0,e_2,629,635,664,1,2,0,11,4,1,0,6,29,35
p_115,9,0,e_2,632,635,664,30,2,2,10,4,1,1,3,29,32
p_97,5,0,e_3,552,585,664,2,2,0,3,5,1,1,33,79,112
p_106,5,0,e_3,583,585,664,18,3,2,5,5,0,3,2,79,81
p_105,12,0,e_3,582,608,664,12,2,1,4,5,0,2,26,56,82
p_102,14,0,e_3,568,616,664,14,1,0,0,5,0,1,48,48,96
p_104,14,0,e_3,581,616,664,10,2,0,4,5,0,2,35,48,83
p_116,7,0,e_3,633,639,664,2,2,0,9,4,1,1,6,25,31
p_107,3,0,e_3,584,653,664,20,3,2,5,5,0,3,69,11,80
p_109,10,0,e_0,590,623,671,12,4,2,0,3,0,0,33,48,81
p_110,12,0,e_0,590,631,671,10,4,1,0,3,0,1,41,40,81
p_121,3,0,e_0,656,660,671,29,1,1,4,4,1,0,4,11,15
p_117,0,2,e_2,636,664,672,8,3,0,9,4,1,0,28,8,36
p_123,0,2,e_2,661,664,672,1,1,0,1,4,1,0,3,8,11
p_125,2,0,e_3,668,676,684,2,0,0,0,3,0,0,8,8,16
p_126,1,0,e_0,681,686,691,30,1,1,0,3,0,0,5,5,10
p_124,7,0,e_2,664,689,712,7,0,0,0,3,1,0,25,23,48
p_118,8,0,e_1,649,659,719,26,2,2,5,5,0,1,10,60,70
p_119,8,0,e_1,650,659,719,26,2,2,5,5,0,2,9,60,69
p_114,13,0,e_1,632,676,719,26,2,2,0,3,0,0,44,43,87
p_120,13,0,e_1,653,676,719,20,1,1,6,5,0,2,23,43,66
p_122,7,0,e_1,657,696,719,25,1,1,7,5,0,2,39,23,62
p_128,0,15,e_3,705,705,758,0,1,1,0,3,0,1,0,53,53
p_132,4,0,e_2,730,744,772,20,2,1,0,3,0,0,14,28,42
p_133,6,0,e_2,734,752,772,16,2,1,1,5,0,1,18,20,38
p_127,7,0,e_0,701,724,795,7,0,0,0,3,0,0,23,71,94
p_130,11,0,e_0,705,738,795,11,2,2,1,5,0,1,33,57,90
p_134,14,0,e_0,734,749,795,8,2,1,10,5,1,1,15,46,61
p_140,5,0,e_0,768,778,795,7,2,0,8,4,1,0,10,17,27
p_129,5,0,e_3,705,724,807,5,0,0,0,3,0,0,19,83,102
p_136,14,0,e_3,749,753,807,3,2,1,13,5,2,0,4,54,58
p_138,12,0,e_3,756,769,807,3,2,0,15,5,2,0,13,38,51
p_131,7,0,e_1,722,745,810,19,2,1,0,3,0,0,23,65,88
p_135,11,0,e_1,739,759,810,10,2,1,5,5,0,1,20,51,71
p_137,13,0,e_1,755,767,810,3,2,1,10,5,1,1,12,43,55
p_143,5,0,e_1,780,793,810,4,1,0,9,4,1,0,13,17,30
p_139,0,15,e_2,758,772,823,15,2,0,4,4,1,0,14,51,65
p_145,1,0,e_1,820,826,831,1,0,0,0,3,0,0,6,5,11
p_144,6,0,e_0,815,835,855,6,0,0,0,3,0,0,20,20,40
p_141,12,0,e_2,770,810,874,30,1,1,0,4,1,0,40,64,104
p_142,13,0,e_2,773,815,874,28,1,1,0,5,1,1,42,59,101
p_147,6,0,e_2,849,852,874,6,1,1,7,4,1,0,3,22,25
p_150,3,0,e_2,860,863,874,24,1,1,4,4,1,0,3,11,14
p_149,6,0,e_0,859,880,902,21,1,1,0,3,0,0,21,22,43
p_153,6,0,e_0,872,880,902,17,1,1,3,5,0,2,8,22,30
p_152,2,0,e_0,868,894,902,22,1,1,2,5,0,1,26,8,34
p_154,4,0,e_2,874,888,902,18,1,1,0,3,1,0,14,14,28
p_146,10,0,e_1,846,879,931,10,0,0,0,3,0,0,33,52,85
p_151,12,0,e_1,863,887,931,14,1,1,5,5,0,1,24,44,68
p_156,12,0,e_1,884,887,931,7,1,1,11,5,1,1,3,44,47
p_155,11,0,e_1,884,892,931,8,1,1,11,5,1,1,8,39,47
p_159,8,0,e_1,893,903,931,8,1,1,11,4,1,1,10,28,38
p_157,7,0,e_1,889,908,931,10,1,1,12,4,1,1,19,23,42
p_158,7,0,e_1,892,908,931,9,1,1,11,4,1,1,16,23,39
p_148,15,0,e_3,849,896,943,15,0,0,0,3,0,0,47,47,94
p_3,4,0,e_2,25,40,88,4,0,0,0,3,0,0,15,48,63
p_4,5,0,e_2,34,45,88,5,0,0,2,5,0,1,11,43,54
p_5,9,0,e_2,41,59,88,9,0,0,4,5,1,1,18,29,47
p_6,9,0,e_2,45,59,88,9,0,0,5,2,1,1,14,29,43
p_2,11,0,e_1,19,54,89,11,0,0,0,3,0,0,35,35,70
p_1,13,0,e_0,13,55,96,13,0,0,0,3,0,0,42,41,83
p_12,0,8,e_1,86,89,115,21,4,4,1,4,1,0,3,26,29
p_16,4,0,e_2,101,116,130,13,4,1,0,3,0,0,15,14,29
p_15,5,0,e_0,99,116,133,13,5,2,0,3,0,0,17,17,34
p_19,0,7,e_2,125,130,155,10,3,0,1,4,1,0,5,25,30
p_7,2,0,e_3,55,63,161,2,0,0,0,3,0,0,8,98,106
p_10,9,0,e_3,77,86,161,15,3,2,6,5,1,2,9,75,84
p_9,10,0,e_3,67,91,161,17,2,1,3,5,1,1,24,70,94
p_14,13,0,e_3,87,102,161,8,4,1,9,5,1,3,15,59,74
p_8,15,0,e_3,62,110,161,13,1,0,2,5,0,1,48,51,99
p_13,8,0,e_3,87,133,161,13,5,3,9,5,1,4,46,28,74
p_11,4,0,e_3,84,147,161,17,4,2,9,5,1,3,63,14,77
p_20,3,0,e_0,142,153,164,2,2,1,0,3,0,0,11,11,22
p_17,10,0,e_1,112,123,187,5,3,0,7,5,1,0,11,64,75
p_18,15,0,e_1,120,140,187,27,3,3,9,5,0,1,20,47,67
p_21,0,10,e_3,142,161,193,5,2,0,5,4,1,1,19,32,51
p_30,2,0,e_1,200,208,216,6,1,1,0,3,0,0,8,8,16
p_27,5,0,e_3,180,210,229,9,1,1,6,5,1,0,30,19,49
p_31,5,0,e_3,203,210,229,2,1,0,7,4,0,1,7,19,26
p_33,1,0,e_3,213,224,229,4,1,0,5,4,1,0,11,5,16
p_22,6,0,e_2,146,150,230,28,1,1,5,5,1,0,4,80,84
p_24,14,0,e_2,157,178,230,17,1,1,7,5,1,1,21,52,73
p_23,15,0,e_2,150,183,230,18,1,1,6,5,2,0,33,47,80
p_32,0,10,e_1,209,216,248,5,1,0,2,4,1,0,7,32,39
p_35,0,6,e_3,222,229,249,1,2,0,1,4,1,1,7,20,27
p_26,6,0,e_0,169,184,262,12,1,1,1,5,0,1,15,78,93
p_28,7,0,e_0,184,189,262,6,2,1,6,2,0,1,5,73,78
p_25,9,0,e_0,163,197,262,11,1,1,0,3,1,0,34,65,99
p_29,14,0,e_0,192,214,262,14,1,0,8,5,1,1,22,48,70
p_34,11,0,e_0,217,225,262,22,2,2,13,4,1,0,8,37,45
p_36,1,0,e_0,225,257,262,30,1,1,11,4,1,0,32,5,37
p_42,4,0,e_0,269,283,297,10,2,1,0,3,0,0,14,14,28
p_43,4,0,e_0,270,283,297,10,2,1,0,5,0,1,13,14,27
p_44,4,0,e_0,275,283,297,9,1,0,2,5,0,1,8,14,22
p_41,7,0,e_2,257,280,303,11,2,2,0,3,0,0,23,23,46
p_37,15,0,e_1,228,265,314,15,0,0,3,5,1,0,37,49,86
p_40,15,0,e_1,255,265,314,8,2,0,12,5,0,1,10,49,59
p_47,3,0,e_1,293,303,314,4,1,0,6,4,1,0,10,11,21
p_49,3,0,e_1,298,303,314,3,1,0,5,4,1,1,5,11,16
p_38,12,0,e_3,240,269,315,9,1,0,3,5,1,0,29,46,75
p_39,13,0,e_3,247,274,315,7,2,0,6,5,1,1,27,41,68
p_51,0,4,e_1,309,314,328,2,1,0,2,4,1,0,5,14,19
p_57,1,0,e_3,327,333,338,1,0,0,0,3,0,0,6,5,11
p_58,0,6,e_3,330,338,358,2,1,1,0,5,0,1,8,20,28
p_54,7,0,e_1,313,339,364,24,1,1,0,3,1,0,26,25,51
p_62,1,0,e_1,345,359,364,9,1,1,6,4,1,0,14,5,19
p_53,8,0,e_2,313,329,367,23,1,1,3,5,0,1,16,38,54
p_56,8,0,e_2,324,329,367,8,0,0,7,5,0,2,5,38,43
p_48,9,0,e_2,294,334,367,28,1,1,3,4,1,0,40,33,73
p_59,3,0,e_2,335,354,367,28,1,1,9,4,1,0,19,13,32
p_60,2,0,e_2,338,359,367,10,1,1,8,4,1,1,21,8,29
p_46,8,0,e_0,291,323,391,30,1,1,2,4,1,1,32,68,100
p_45,11,0,e_0,290,334,391,27,1,1,2,4,1,0,44,57,101
p_50,11,0,e_0,299,334,391,24,1,1,0,5,0,2,35,57,92
p_52,14,0,e_0,312,345,391,17,1,1,5,5,0,2,33,46,79
p_55,14,0,e_0,314,345,391,16,1,1,5,5,0,3,31,46,77
p_61,12,0,e_0,341,353,391,12,1,0,13,5,1,1,12,38,50
p_65,0,7,e_3,369,389,414,6,0,0,6,3,0,0,20,25,45
p_64,0,15,e_2,365,367,414,6,0,0,1,4,1,0,2,47,49
p_68,2,0,e_3,389,397,439,2,0,0,0,3,0,0,8,42,50
p_73,3,0,e_3,423,428,439,2,1,0,5,4,1,0,5,11,16
p_69,2,0,e_0,391,400,444,12,2,1,0,3,0,0,9,44,53
p_70,3,0,e_0,398,405,444,9,2,1,2,5,0,1,7,39,46
p_71,7,0,e_0,403,419,444,4,2,0,3,5,1,1,16,25,41
p_72,6,0,e_0,417,424,444,30,1,1,7,5,1,1,7,20,27
p_63,3,0,e_1,364,376,445,3,0,0,0,3,0,0,12,69,81
p_66,11,0,e_1,376,402,445,23,1,1,3,2,0,0,26,43,69
p_67,12,0,e_1,377,407,445,22,1,1,3,5,1,1,30,38,68
p_74,10,0,e_2,424,441,477,24,2,2,15,3,0,0,17,36,53
p_77,4,0,e_2,455,461,477,11,1,1,6,4,1,1,6,16,22
p_75,3,0,e_2,438,466,477,27,1,1,11,4,0,1,28,11,39
p_81,1,0,e_1,493,498,503,10,1,0,0,3,0,0,5,5,10
p_79,9,0,e_0,457,486,515,10,2,2,0,3,0,0,29,29,58
p_76,10,0,e_3,440,472,526,10,0,0,0,3,0,0,32,54,86
p_78,12,0,e_3,455,480,526,7,1,0,5,5,0,1,25,46,71
p_80,13,0,e_3,474,485,526,3,2,0,10,5,1,1,11,41,52
p_82,0,12,e_2,494,494,534,11,1,0,0,3,0,0,0,40,40
p_83,0,12,e_1,501,503,543,8,1,0,1,4,1,0,2,40,42
p_90,1,0,e_3,538,543,548,1,0,0,0,3,0,0,5,5,10
p_87,3,0,e_0,528,540,569,3,0,0,0,3,0,0,12,29,41
p_93,4,0,e_0,543,545,569,5,0,0,3,5,1,1,2,24,26
p_89,5,0,e_0,535,550,569,5,0,0,1,5,0,1,15,19,34
p_94,3,0,e_0,546,558,569,28,1,1,4,5,1,1,12,11,23
p_88,10,0,e_1,531,535,585,10,0,0,9,5,1,0,4,50,54
p_95,10,0,e_1,547,551,585,20,1,1,11,4,1,0,4,34,38
p_96,7,0,e_1,551,562,585,7,0,0,10,4,1,0,11,23,34
p_84,12,0,e_2,504,534,592,25,1,1,2,5,1,0,30,58,88
p_85,14,0,e_2,517,542,592,19,1,1,7,5,1,0,25,50,75
p_86,14,0,e_2,518,542,592,18,1,1,7,5,1,1,24,50,74
p_91,14,0,e_2,539,542,592,14,1,0,13,5,1,1,3,50,53
p_92,10,0,e_2,540,556,592,10,1,0,14,5,1,1,16,36,52
p_99,9,0,e_2,556,561,592,9,1,0,10,1,1,1,5,31,36
p_98,6,0,e_2,555,572,592,6,1,0,10,4,1,1,17,20,37
p_111,2,0,e_2,607,615,623,12,1,0,0,3,0,0,8,8,16
p_107,3,0,e_1,584,596,633,16,4,3,0,3,1,1,12,37,49
p_108,7,0,e_1,584,610,633,12,4,3,0,3,1,0,26,23,49
p_106,5,0,e_0,583,601,650,14,4,3,0,3,0,0,18,49,67
p_109,10,0,e_0,590,618,650,8,3,2,1,5,0,1,28,32,60
p_97,5,0,e_3,552,570,651,5,0,0,0,3,0,0,18,81,99
p_101,9,0,e_3,566,584,651,7,2,1,4,5,0,2,18,67,85
p_100,10,0,e_3,557,589,651,9,1,0,1,5,0,1,32,62,94
p_105,12,0,e_3,582,597,651,8,4,1,8,5,1,3,15,54,69
p_110,12,0,e_3,590,597,651,6,3,1,10,5,1,2,7,54,61
p_102,14,0,e_3,568,605,651,9,3,0,5,5,0,3,37,46,83
p_103,14,0,e_3,577,605,651,7,4,0,7,5,1,3,28,46,74
p_104,14,0,e_3,581,605,651,6,4,0,8,5,1,3,24,46,70
p_112,11,0,e_3,613,616,651,1,1,0,12,4,1,0,3,35,38
p_117,0,2,e_0,636,650,658,5,1,0,5,4,1,0,14,8,22
p_123,0,2,e_3,661,661,671,0,0,0,0,3,0,0,0,10,10
p_125,2,0,e_3,668,671,679,1,1,0,1,5,1,0,3,8,11
p_126,1,0,e_3,681,686,691,1,0,0,0,3,0,0,5,5,10
p_116,7,0,e_1,633,656,697,29,1,1,0,3,1,1,23,41,64
p_118,8,0,e_1,649,661,697,22,1,1,5,5,0,2,12,36,48
p_119,8,0,e_1,650,661,697,8,0,0,5,5,0,3,11,36,47
p_115,9,0,e_1,632,666,697,27,1,1,0,3,1,0,34,31,65
p_124,7,0,e_1,664,674,697,7,1,0,9,5,1,1,10,23,33
p_121,3,0,e_0,656,663,700,3,0,0,1,5,1,0,7,37,44
p_122,7,0,e_0,657,677,700,7,0,0,2,2,1,1,20,23,43
p_113,9,0,e_2,629,658,713,28,1,1,0,3,0,0,29,55,84
p_114,13,0,e_2,632,672,713,23,1,1,1,5,0,1,40,41,81
p_120,13,0,e_2,653,672,713,13,0,0,7,5,0,2,19,41,60
p_129,5,0,e_1,705,722,739,5,0,0,0,3,0,0,17,17,34
p_128,0,15,e_3,705,706,757,0,0,0,0,3,0,0,1,51,52
p_127,7,0,e_0,701,724,795,7,0,0,0,3,0,0,23,71,94
p_130,11,0,e_0,705,738,795,11,0,0,1,5,0,1,33,57,90
p_134,14,0,e_0,734,749,795,8,1,1,10,5,1,1,15,46,61
p_140,5,0,e_0,768,778,795,8,1,0,8,4,1,0,10,17,27
p_136,14,0,e_3,749,752,806,3,1,1,13,5,1,0,3,54,57
p_137,13,0,e_3,755,765,806,3,2,1,14,5,2,0,10,41,51
p_132,4,0,e_2,730,736,808,19,1,1,2,5,0,1,6,72,78
p_133,6,0,e_2,734,744,808,16,1,1,3,5,0,2,10,64,74
p_131,7,0,e_2,722,749,808,19,1,1,0,3,0,0,27,59,86
p_135,11,0,e_2,739,763,808,9,1,1,5,5,1,2,24,45,69
p_138,12,0,e_2,756,768,808,3,3,0,9,5,1,1,12,40,52
p_143,5,0,e_2,780,791,808,4,1,0,9,4,1,0,11,17,28
p_139,0,15,e_1,758,759,812,15,2,0,0,3,0,0,1,53,54
p_145,1,0,e_2,820,825,830,1,0,0,0,3,0,0,5,5,10
p_144,6,0,e_0,815,835,855,6,0,0,0,3,0,0,20,20,40
p_141,12,0,e_1,770,799,859,30,1,1,2,5,1,0,29,60,89
p_142,13,0,e_1,773,804,859,28,1,1,4,5,1,1,31,55,86
p_150,3,0,e_1,860,871,884,24,2,2,0,3,0,0,11,13,24
p_152,2,0,e_1,868,876,884,22,1,1,2,5,0,1,8,8,16
p_149,6,0,e_0,859,880,902,21,2,1,0,3,0,0,21,22,43
p_153,6,0,e_0,872,880,902,17,2,1,3,5,0,1,8,22,30
p_154,4,0,e_0,874,888,902,19,2,1,4,5,0,1,14,14,28
p_146,10,0,e_2,846,879,931,10,0,0,0,3,0,0,33,52,85
p_151,12,0,e_2,863,887,931,14,2,1,5,5,0,1,24,44,68
p_156,12,0,e_2,884,887,931,7,2,1,11,5,1,2,3,44,47
p_155,11,0,e_2,884,892,931,9,2,1,11,5,1,1,8,39,47
p_159,8,0,e_2,893,903,931,9,2,1,11,4,1,1,10,28,38
p_157,7,0,e_2,889,908,931,11,2,1,12,4,1,1,19,23,42
p_158,7,0,e_2,892,908,931,10,2,1,11,4,1,1,16,23,39
p_147,6,0,e_3,849,869,945,6,1,1,0,3,0,1,20,76,96
p_148,15,0,e_3,849,898,945,15,0,0,0,3,0,0,49,47,96
p_3,4,0,e_2,25,39,87,4,0,0,0,3,0,0,14,48,62
p_4,5,0,e_2,34,44,87,5,0,0,3,5,0,1,10,43,53
p_5,9,0,e_2,41,58,87,9,0,0,4,5,1,1,17,29,46
p_6,9,0,e_1,45,49,92,9,0,0,8,5,0,1,4,43,47
p_2,11,0,e_1,19,57,92,11,0,0,0,3,0,0,38,35,73
p_1,13,0,e_0,13,55,96,13,0,0,0,3,0,0,42,41,83
p_12,0,8,e_2,86,87,113,21,4,4,0,4,1,0,1,26,27
p_16,4,0,e_1,101,116,130,13,4,1,0,3,0,0,15,14,29
p_19,0,7,e_1,125,130,155,10,3,0,1,4,1,0,5,25,30
p_7,2,0,e_3,55,63,161,2,0,0,0,3,0,0,8,98,106
p_10,9,0,e_3,77,86,161,15,3,2,6,5,1,2,9,75,84
p_9,10,0,e_3,67,91,161,17,2,1,3,5,1,1,24,70,94
p_8,15,0,e_3,62,108,161,13,1,0,2,5,0,1,46,53,99
p_13,8,0,e_3,87,131,161,13,4,2,9,5,1,3,44,30,74
p_11,4,0,e_3,84,145,161,18,4,3,8,5,1,3,61,16,77
p_20,3,0,e_3,142,150,161,2,2,1,5,4,1,1,8,11,19
p_15,5,0,e_0,99,117,166,13,4,1,0,3,0,0,18,49,67
p_17,10,0,e_0,112,134,166,4,3,0,4,5,0,1,22,32,54
p_14,13,0,e_2,87,130,185,8,4,1,0,3,1,0,43,55,98
p_18,15,0,e_2,120,138,185,26,3,3,10,5,0,1,18,47,65
p_21,0,10,e_0,142,166,198,5,3,0,8,4,1,0,24,32,56
p_26,6,0,e_3,169,184,228,11,1,1,1,5,0,1,15,44,59
p_25,9,0,e_3,163,195,228,9,0,0,0,3,0,0,32,33,65
p_27,5,0,e_3,180,209,228,8,2,2,5,5,0,2,29,19,48
p_31,5,0,e_3,203,209,228,2,2,0,7,4,1,1,6,19,25
p_33,1,0,e_3,213,223,228,3,1,0,4,4,1,0,10,5,15
p_28,7,0,e_2,184,208,231,5,2,1,0,3,1,0,24,23,47
p_22,6,0,e_1,146,150,234,28,2,2,5,5,1,0,4,84,88
p_24,14,0,e_1,157,178,234,17,1,1,7,5,1,1,21,56,77
p_23,15,0,e_1,150,183,234,18,1,1,6,2,1,0,33,51,84
p_30,2,0,e_1,200,224,234,6,2,1,10,4,1,0,24,10,34
p_36,1,0,e_1,225,229,234,30,1,1,2,4,1,0,4,5,9
p_35,0,6,e_3,222,228,248,1,2,0,1,4,1,1,6,20,26
p_29,14,0,e_0,192,212,258,6,3,0,8,5,1,0,20,46,66
p_34,11,0,e_0,217,223,258,22,2,2,13,4,1,0,6,35,41
p_32,0,10,e_3,209,228,262,5,1,0,5,4,1,0,19,34,53
p_42,4,0,e_0,269,284,298,10,1,1,0,3,0,0,15,14,29
p_43,4,0,e_0,270,284,298,10,1,1,0,5,0,1,14,14,28
p_44,4,0,e_0,275,284,298,9,1,0,1,5,0,1,9,14,23
p_39,13,0,e_3,247,273,316,7,1,0,6,2,2,0,26,43,69
p_47,3,0,e_3,293,305,316,4,1,0,7,4,1,0,12,11,23
p_41,7,0,e_2,257,263,320,10,2,2,5,5,0,1,6,57,63
p_38,12,0,e_2,240,280,320,9,2,0,0,3,0,0,40,40,80
p_46,8,0,e_2,291,294,320,29,1,1,9,4,1,0,3,26,29
p_51,0,4,e_3,309,316,330,2,1,0,2,4,1,0,7,14,21
p_37,15,0,e_1,228,281,334,15,2,0,1,1,1,0,53,53,106
p_40,15,0,e_1,255,281,334,7,2,0,7,5,0,1,26,53,79
p_45,11,0,e_1,290,295,334,27,1,1,13,4,1,0,5,39,44
p_48,9,0,e_1,294,303,334,28,2,2,11,4,1,1,9,31,40
p_57,1,0,e_1,327,329,334,10,2,2,2,4,1,0,2,5,7
p_58,0,6,e_1,330,334,354,10,1,1,1,4,1,0,4,20,24
p_54,7,0,e_3,313,341,368,24,1,1,1,4,1,0,28,27,55
p_59,3,0,e_3,335,355,368,6,1,1,5,5,0,1,20,13,33
p_60,2,0,e_3,338,360,368,6,2,1,6,5,0,2,22,8,30
p_62,1,0,e_1,345,371,376,5,3,2,3,5,1,0,26,5,31
p_56,8,0,e_2,324,350,378,6,2,0,0,3,0,0,26,28,54
p_63,3,0,e_2,364,367,378,28,1,1,4,4,1,0,3,11,14
p_49,3,0,e_0,298,309,394,2,2,0,0,3,1,0,11,85,96
p_53,8,0,e_0,313,326,394,23,1,1,4,5,1,2,13,68,81
p_50,11,0,e_0,299,337,394,24,2,2,0,5,0,1,38,57,95
p_52,14,0,e_0,312,348,394,17,1,1,4,5,1,1,36,46,82
p_55,14,0,e_0,314,348,394,17,2,2,4,5,1,3,34,46,80
p_61,12,0,e_0,341,356,394,13,2,0,12,5,1,1,15,38,53
p_65,0,7,e_1,369,376,399,30,1,1,2,4,0,1,7,23,30
p_68,2,0,e_2,389,397,405,22,1,1,0,3,0,0,8,8,16
p_69,2,0,e_2,391,397,405,21,1,1,0,5,0,1,6,8,14
p_64,0,15,e_3,365,368,415,1,1,0,1,4,1,0,3,47,50
p_70,3,0,e_0,398,409,446,18,1,1,0,3,0,0,11,37,48
p_71,7,0,e_0,403,423,446,12,1,1,1,5,0,1,20,23,43
p_72,6,0,e_2,417,438,458,9,0,0,0,3,0,0,21,20,41
p_66,11,0,e_1,376,413,458,17,1,1,0,5,1,0,37,45,82
p_67,12,0,e_1,377,418,458,16,1,1,0,5,1,1,41,40,81
p_73,3,0,e_1,423,447,458,12,0,0,11,4,1,0,24,11,35
p_75,3,0,e_1,438,447,458,8,1,1,6,4,1,1,9,11,20
p_74,10,0,e_3,424,441,475,5,0,0,15,3,0,0,17,34,51
p_77,4,0,e_3,455,461,475,2,1,0,6,4,1,0,6,14,20
p_81,1,0,e_1,493,499,504,1,0,0,0,3,0,0,6,5,11
p_82,0,12,e_2,494,494,534,0,0,0,0,3,0,0,0,40,40
p_79,9,0,e_0,457,475,534,26,2,2,3,5,0,2,18,59,77
p_76,10,0,e_0,440,480,534,30,0,0,2,4,1,0,40,54,94
p_78,12,0,e_0,455,488,534,24,2,2,2,5,0,1,33,46,79
p_80,13,0,e_0,474,493,534,17,1,1,9,5,0,3,19,41,60
p_83,0,12,e_3,501,502,544,0,0,0,0,3,0,0,1,42,43
p_87,3,0,e_1,528,540,553,14,1,1,0,3,0,0,12,13,25
p_90,1,0,e_1,538,548,553,13,2,1,3,5,0,1,10,5,15
p_93,4,0,e_0,543,549,573,8,2,0,2,5,0,1,6,24,30
p_89,5,0,e_0,535,554,573,9,2,1,0,3,0,0,19,19,38
p_94,3,0,e_0,546,562,573,9,2,1,3,5,0,2,16,11,27
p_88,10,0,e_3,531,536,586,6,1,1,8,5,1,0,5,50,55
p_92,10,0,e_3,540,552,586,3,2,1,11,5,2,0,12,34,46
p_96,7,0,e_3,551,563,586,3,2,0,10,4,1,1,12,23,35
p_84,12,0,e_2,504,534,592,12,1,0,2,5,1,0,30,58,88
p_85,14,0,e_2,517,542,592,10,1,0,7,5,1,0,25,50,75
p_86,14,0,e_2,518,542,592,10,1,0,7,5,1,1,24,50,74
p_91,14,0,e_2,539,542,592,3,2,0,13,5,1,1,3,50,53
p_95,10,0,e_2,547,556,592,2,2,0,13,4,1,0,9,36,45
p_99,9,0,e_2,556,561,592,30,2,2,10,4,1,1,5,31,36
p_98,6,0,e_2,555,572,592,4,2,1,10,1,1,0,17,20,37
p_111,2,0,e_2,607,616,624,17,2,2,0,3,0,0,9,8,17
p_97,5,0,e_1,552,570,655,5,2,1,0,3,1,0,18,85,103
p_101,9,0,e_1,566,584,655,28,1,1,4,5,0,2,18,71,89
p_100,10,0,e_1,557,589,655,29,2,2,1,5,0,1,32,66,98
p_105,12,0,e_1,582,597,655,19,1,1,9,5,1,3,15,58,73
p_102,14,0,e_1,568,605,655,22,1,1,5,5,0,3,37,50,87
p_104,14,0,e_1,581,605,655,17,1,1,8,5,1,3,24,50,74
p_112,11,0,e_1,613,616,655,6,2,1,12,4,1,2,3,39,42
p_108,7,0,e_1,584,630,655,24,1,1,9,2,1,3,46,25,71
p_107,3,0,e_1,584,644,655,28,1,1,9,2,1,4,60,11,71
p_117,0,2,e_1,636,655,663,10,2,0,5,4,1,1,19,8,27
p_106,5,0,e_0,583,594,671,26,1,1,1,5,0,1,11,77,88
p_103,14,0,e_0,577,623,671,19,1,1,0,3,0,0,46,48,94
p_113,9,0,e_0,629,640,671,3,2,0,12,4,1,0,11,31,42
p_116,7,0,e_0,633,648,671,5,2,1,11,4,1,1,15,23,38
p_109,10,0,e_3,590,622,672,14,1,1,0,5,0,1,32,50,82
p_110,12,0,e_3,590,630,672,12,0,0,0,3,0,0,40,42,82
p_115,9,0,e_3,632,641,672,3,1,0,12,4,1,0,9,31,40
p_121,3,0,e_3,656,661,672,1,1,0,4,4,1,0,5,11,16
p_123,0,2,e_0,661,671,679,3,1,0,3,4,1,0,10,8,18
p_126,1,0,e_0,681,687,692,1,0,0,2,3,0,0,6,5,11
p_122,7,0,e_1,657,680,705,27,2,2,0,5,1,0,23,25,48
p_124,7,0,e_1,664,680,705,25,1,1,2,5,0,1,16,25,41
p_125,2,0,e_1,668,697,705,29,1,1,3,5,0,1,29,8,37
p_118,8,0,e_2,649,658,716,29,1,1,5,5,0,1,9,58,67
p_119,8,0,e_2,650,658,716,29,1,1,5,5,0,2,8,58,66
p_114,13,0,e_2,632,675,716,29,1,1,0,3,0,0,43,41,84
p_120,13,0,e_2,653,675,716,22,1,1,7,5,0,2,22,41,63
p_127,7,0,e_0,701,725,750,7,0,0,0,3,0,0,24,25,49
p_131,7,0,e_0,722,725,750,10,1,1,6,5,0,1,3,25,28
p_132,4,0,e_0,730,736,750,10,1,1,6,4,1,0,6,14,20
p_128,0,15,e_1,705,706,757,22,1,1,0,3,0,1,1,51,52
p_133,6,0,e_2,734,755,775,13,2,2,0,3,0,0,21,20,41
p_130,11,0,e_3,705,740,799,11,0,0,0,3,0,0,35,59,94
p_135,11,0,e_3,739,740,799,6,2,1,11,5,0,2,1,59,60
p_134,14,0,e_3,734,751,799,5,1,0,9,5,0,1,17,48,65
p_136,14,0,e_3,749,751,799,0,2,0,14,5,1,1,2,48,50
p_138,12,0,e_3,756,759,799,1,1,0,13,4,1,0,3,40,43
p_140,5,0,e_3,768,782,799,4,1,0,9,4,1,0,14,17,31
p_129,5,0,e_1,705,725,808,5,0,0,0,3,0,0,20,83,103
p_137,13,0,e_1,755,765,808,30,1,1,14,5,2,0,10,43,53
p_143,5,0,e_1,780,791,808,30,2,2,8,4,1,0,11,17,28
p_139,0,15,e_0,758,759,812,12,1,0,0,3,0,0,1,53,54
p_145,1,0,e_2,820,826,831,1,0,0,0,3,0,0,6,5,11
p_144,6,0,e_1,815,836,856,6,0,0,0,3,0,0,21,20,41
p_141,12,0,e_0,770,799,859,27,2,2,2,5,1,0,29,60,89
p_142,13,0,e_0,773,804,859,25,2,2,3,5,1,1,31,55,86
p_150,3,0,e_1,860,871,884,24,2,2,0,3,0,0,11,13,24
p_152,2,0,e_1,868,876,884,22,2,1,2,5,0,1,8,8,16
p_149,6,0,e_0,859,879,901,22,2,1,0,3,1,0,20,22,42
p_153,6,0,e_0,872,879,901,18,2,1,4,5,0,1,7,22,29
p_154,4,0,e_0,874,887,901,19,2,1,5,5,0,1,13,14,27
p_146,10,0,e_2,846,879,931,10,0,0,0,3,0,0,33,52,85
p_151,12,0,e_2,863,887,931,14,2,1,5,5,0,1,24,44,68
p_156,12,0,e_2,884,887,931,8,2,1,11,5,1,2,3,44,47
p_155,11,0,e_2,884,892,931,9,2,1,11,5,1,1,8,39,47
p_159,8,0,e_2,893,903,931,9,2,1,11,4,1,1,10,28,38
p_158,7,0,e_2,892,908,931,10,2,1,11,1,1,0,16,23,39
p_157,7,0,e_1,889,913,936,11,2,1,0,3,0,0,24,23,47
p_147,6,0,e_3,849,870,946,6,1,1,0,3,0,1,21,76,97
p_148,15,0,e_3,849,899,946,15,0,0,0,3,0,0,50,47,97
p_3,4,0,e_2,25,40,88,4,0,0,0,3,0,0,15,48,63
p_4,5,0,e_2,34,45,88,5,0,0,2,5,0,1,11,43,54
p_5,9,0,e_2,41,59,88,9,0,0,4,5,1,1,18,29,47
p_6,9,0,e_2,45,59,88,9,0,0,5,2,1,1,14,29,43
p_2,11,0,e_1,19,55,90,11,0,0,0,3,0,0,36,35,71
p_1,13,0,e_0,13,54,95,13,0,0,0,3,0,0,41,41,82
p_12,0,8,e_1,86,90,116,21,4,4,1,4,1,0,4,26,30
p_16,4,0,e_0,101,114,136,13,4,1,0,5,0,1,13,22,35
p_15,5,0,e_0,99,119,136,13,4,1,0,3,0,0,20,17,37
p_17,10,0,e_1,112,124,158,4,3,0,7,5,1,0,12,34,46
p_20,3,0,e_1,142,147,158,2,2,1,5,4,1,0,5,11,16
p_7,2,0,e_3,55,63,159,2,0,0,0,3,0,0,8,96,104
p_10,9,0,e_3,77,86,159,15,3,2,6,5,1,2,9,73,82
p_9,10,0,e_3,67,91,159,17,2,1,3,5,1,1,24,68,92
p_8,15,0,e_3,62,108,159,13,1,0,2,5,0,1,46,51,97
p_13,8,0,e_3,87,131,159,13,4,2,9,5,1,3,44,28,72
p_11,4,0,e_3,84,145,159,18,4,3,8,5,1,3,61,14,75
p_19,0,7,e_0,125,136,161,10,3,0,3,4,1,0,11,25,36
p_14,13,0,e_2,87,129,184,8,5,1,0,3,1,0,42,55,97
p_18,15,0,e_2,120,137,184,26,3,3,10,5,0,1,17,47,64
p_21,0,10,e_1,142,158,190,5,2,0,5,4,1,1,16,32,48
p_26,6,0,e_3,169,183,229,11,1,1,1,5,0,1,14,46,60
p_25,9,0,e_3,163,194,229,9,0,0,0,3,0,0,31,35,66
p_27,5,0,e_3,180,208,229,8,2,2,5,5,0,2,28,21,49
p_30,2,0,e_3,200,219,229,5,2,1,7,4,1,1,19,10,29
p_33,1,0,e_3,213,224,229,3,2,1,4,4,1,1,11,5,16
p_28,7,0,e_2,184,208,233,5,3,1,0,3,0,0,24,25,49
p_31,5,0,e_2,203,216,233,2,3,0,5,5,0,1,13,17,30
p_22,6,0,e_0,146,156,236,28,1,1,3,5,1,0,10,80,90
p_23,15,0,e_0,150,187,236,18,1,1,4,5,1,1,37,49,86
p_36,1,0,e_0,225,231,236,30,1,1,3,4,1,0,6,5,11
p_24,14,0,e_1,157,204,248,16,1,1,0,3,1,0,47,44,91
p_29,14,0,e_1,192,204,248,5,3,0,10,5,0,1,12,44,56
p_35,0,6,e_3,222,229,249,2,2,0,2,4,1,1,7,20,27
p_32,0,10,e_3,209,229,263,5,2,0,5,4,1,1,20,34,54
p_42,4,0,e_1,269,283,297,15,1,1,0,3,0,0,14,14,28
p_43,4,0,e_1,270,283,297,14,1,1,0,5,0,1,13,14,27
p_44,4,0,e_1,275,283,297,12,1,1,1,5,0,1,8,14,22
p_41,7,0,e_0,257,280,303,15,2,2,0,3,0,0,23,23,46
p_34,11,0,e_2,217,268,323,21,3,3,5,4,1,0,51,55,106
p_38,12,0,e_2,240,273,323,15,3,1,2,5,0,1,33,50,83
p_39,13,0,e_2,247,278,323,11,3,1,4,5,0,2,31,45,76
p_46,8,0,e_2,291,295,323,4,2,1,9,4,1,0,4,28,32
p_47,3,0,e_2,293,312,323,8,1,0,9,4,1,1,19,11,30
p_51,0,4,e_0,309,310,326,7,1,0,0,3,0,0,1,16,17
p_37,15,0,e_3,228,280,331,15,0,0,0,3,1,0,52,51,103
p_40,15,0,e_3,255,280,331,7,2,0,8,5,1,1,25,51,76
p_45,11,0,e_3,290,294,331,1,1,0,12,4,1,0,4,37,41
p_48,9,0,e_3,294,302,331,2,1,0,11,1,1,0,8,29,37
p_58,0,6,e_3,330,331,353,0,1,0,0,4,1,0,1,22,23
p_54,7,0,e_0,313,337,372,29,1,1,0,5,1,0,24,35,59
p_53,8,0,e_0,313,342,372,28,1,1,0,5,1,1,29,30,59
p_60,2,0,e_0,338,362,372,8,2,2,7,5,1,2,24,10,34
p_57,1,0,e_0,327,367,372,30,1,1,4,5,0,2,40,5,45
p_59,3,0,e_3,335,342,373,8,1,1,1,5,1,0,7,31,38
p_56,8,0,e_2,324,350,380,24,1,1,0,3,0,0,26,30,56
p_63,3,0,e_2,364,367,380,30,1,1,4,4,1,1,3,13,16
p_62,1,0,e_2,345,375,380,7,2,1,7,5,0,1,30,5,35
p_49,3,0,e_1,298,310,393,7,2,1,0,3,0,0,12,83,95
p_50,11,0,e_1,299,336,393,29,2,2,0,3,0,1,37,57,94
p_52,14,0,e_1,312,347,393,22,1,1,3,5,1,1,35,46,81
p_55,14,0,e_1,314,347,393,22,1,1,4,5,1,2,33,46,79
p_61,12,0,e_1,341,355,393,9,1,0,12,5,1,1,14,38,52
p_65,0,7,e_0,369,372,395,1,1,0,1,4,1,0,3,23,26
p_68,2,0,e_2,389,397,405,23,1,1,0,3,0,0,8,8,16
p_69,2,0,e_2,391,397,405,23,1,1,0,5,0,1,6,8,14
p_64,0,15,e_3,365,373,420,2,1,0,2,4,1,0,8,47,55
p_70,3,0,e_1,398,410,447,19,1,1,0,3,0,0,12,37,49
p_71,7,0,e_1,403,424,447,13,1,1,1,5,0,1,21,23,44
p_66,11,0,e_0,376,409,454,18,1,1,1,5,1,0,33,45,78
p_67,12,0,e_0,377,414,454,17,1,1,1,5,1,1,37,40,77
p_73,3,0,e_0,423,443,454,12,0,0,10,4,1,0,20,11,31
p_72,6,0,e_2,417,437,459,10,1,1,0,3,0,0,20,22,42
p_75,3,0,e_2,438,448,459,8,1,1,6,4,1,0,10,11,21
p_74,10,0,e_3,424,441,475,5,0,0,15,3,0,0,17,34,51
p_76,10,0,e_3,440,441,475,20,1,1,10,4,0,1,1,34,35
p_77,4,0,e_3,455,461,475,2,1,0,6,4,1,0,6,14,20
p_81,1,0,e_2,493,499,504,1,0,0,0,3,0,0,6,5,11
p_79,9,0,e_1,457,487,516,26,2,2,0,3,0,0,30,29,59
p_82,0,12,e_3,494,494,534,0,0,0,0,3,0,0,0,40,40
p_78,12,0,e_0,455,493,539,24,1,1,0,3,0,0,38,46,84
p_80,13,0,e_0,474,498,539,17,1,1,6,5,0,1,24,41,65
p_83,0,12,e_2,501,504,544,23,1,1,1,4,1,0,3,40,43
p_87,3,0,e_1,528,539,566,15,2,2,0,3,0,0,11,27,38
p_89,5,0,e_1,535,547,566,11,2,1,2,5,0,1,12,19,31
p_90,1,0,e_1,538,561,566,14,2,1,3,5,0,2,23,5,28
p_88,10,0,e_2,531,536,586,7,2,2,8,5,1,0,5,50,55
p_92,10,0,e_2,540,552,586,4,2,0,11,5,2,0,12,34,46
p_96,7,0,e_2,551,563,586,5,2,1,10,1,1,0,12,23,35
p_84,12,0,e_3,504,534,592,10,1,0,2,5,1,0,30,58,88
p_85,14,0,e_3,517,542,592,8,1,0,6,5,1,0,25,50,75
p_86,14,0,e_3,518,542,592,7,2,0,7,5,1,1,24,50,74
p_91,14,0,e_3,539,542,592,1,2,0,13,5,1,1,3,50,53
p_95,10,0,e_3,547,556,592,3,1,0,13,4,1,0,9,36,45
p_99,9,0,e_3,556,561,592,1,2,0,10,1,1,1,5,31,36
p_98,6,0,e_3,555,572,592,4,1,0,10,1,1,0,17,20,37
p_111,2,0,e_3,607,615,623,2,0,0,0,3,0,0,8,8,16
p_94,3,0,e_0,546,555,644,10,1,0,0,5,0,1,9,89,98
p_93,4,0,e_0,543,560,644,10,1,0,0,3,0,0,17,84,101
p_97,5,0,e_0,552,565,644,6,2,1,2,5,0,2,13,79,92
p_100,10,0,e_0,557,582,644,30,3,3,3,5,1,2,25,62,87
p_102,14,0,e_0,568,596,644,23,2,2,5,5,1,1,28,48,76
p_103,14,0,e_0,577,596,644,21,1,1,8,5,1,2,19,48,67
p_104,14,0,e_0,581,596,644,19,1,1,10,5,1,2,15,48,63
p_106,5,0,e_0,583,625,644,28,1,1,10,5,1,1,42,19,61
p_107,3,0,e_0,584,633,644,30,1,1,10,5,1,2,49,11,60
p_108,7,0,e_1,584,589,646,25,1,1,5,5,0,2,5,57,62
p_101,9,0,e_1,566,597,646,29,2,2,0,3,1,0,31,49,80
p_105,12,0,e_1,582,608,646,21,1,1,5,5,0,1,26,38,64
p_110,12,0,e_1,590,608,646,18,1,1,7,5,1,2,18,38,56
p_117,0,2,e_0,636,644,652,25,1,1,3,4,1,0,8,8,16
p_109,10,0,e_2,590,622,666,20,1,1,0,3,0,0,32,44,76
p_112,11,0,e_2,613,627,666,9,1,0,7,5,0,1,14,39,53
p_113,9,0,e_2,629,635,666,9,0,0,11,4,1,0,6,31,37
p_115,9,0,e_2,632,635,666,9,1,1,10,4,1,1,3,31,34
p_116,7,0,e_2,633,643,666,19,1,1,9,4,1,1,10,23,33
p_123,0,2,e_2,661,666,674,17,1,1,1,4,1,0,5,8,13
p_125,2,0,e_2,668,674,682,13,1,1,0,5,1,0,6,8,14
p_121,3,0,e_0,656,657,704,16,1,1,3,5,0,1,1,47,48
p_124,7,0,e_0,664,671,704,9,1,1,5,5,1,1,7,33,40
p_119,8,0,e_0,650,676,704,12,1,1,2,5,1,0,26,28,54
p_126,1,0,e_0,681,699,704,10,1,0,7,4,1,0,18,5,23
p_122,7,0,e_1,657,673,704,11,1,1,2,5,0,1,16,31,47
p_118,8,0,e_1,649,678,704,13,1,1,0,3,0,0,29,26,55
p_114,13,0,e_3,632,673,714,13,0,0,0,3,0,0,41,41,82
p_120,13,0,e_3,653,673,714,7,1,0,6,5,0,1,20,41,61
p_127,7,0,e_2,701,725,750,27,1,1,0,3,0,0,24,25,49
p_131,7,0,e_2,722,725,750,7,0,0,6,5,0,1,3,25,28
p_132,4,0,e_2,730,736,750,4,0,0,6,4,1,0,6,14,20
p_128,0,15,e_0,705,705,756,3,1,0,0,3,0,1,0,51,51
p_133,6,0,e_3,734,755,775,6,0,0,0,3,0,0,21,20,41
p_130,11,0,e_1,705,741,802,22,1,1,0,3,0,0,36,61,97
p_135,11,0,e_1,739,741,802,10,1,0,10,5,0,2,2,61,63
p_134,14,0,e_1,734,752,802,14,1,1,9,5,0,1,18,50,68
p_136,14,0,e_1,749,752,802,10,1,0,13,5,1,1,3,50,53
p_137,13,0,e_1,755,757,802,19,0,0,14,4,1,0,2,45,47
p_138,12,0,e_1,756,762,802,24,1,1,13,4,1,1,6,40,46
p_140,5,0,e_1,768,785,802,27,1,1,10,4,1,0,17,17,34
p_129,5,0,e_0,705,724,805,28,1,1,0,3,0,0,19,81,100
p_143,5,0,e_0,780,788,805,5,0,0,7,4,1,0,8,17,25
p_139,0,15,e_2,758,758,811,6,1,0,0,3,0,0,0,53,53
p_145,1,0,e_1,820,826,831,1,0,0,0,3,0,0,6,5,11
p_144,6,0,e_0,815,835,855,6,0,0,0,3,0,0,20,20,40
p_141,12,0,e_2,770,798,858,20,1,1,3,5,1,0,28,60,88
p_142,13,0,e_2,773,803,858,17,1,1,4,5,1,1,30,55,85
p_152,2,0,e_2,868,869,885,22,2,1,2,5,0,1,1,16,17
p_150,3,0,e_2,860,874,885,24,2,2,0,3,0,0,14,11,25
p_149,6,0,e_0,859,880,902,21,2,1,0,3,0,0,21,22,43
p_153,6,0,e_0,872,880,902,18,2,1,4,5,0,1,8,22,30
p_154,4,0,e_0,874,888,902,19,2,1,4,5,0,1,14,14,28
p_146,10,0,e_1,846,879,931,10,0,0,0,3,0,0,33,52,85
p_151,12,0,e_1,863,887,931,14,2,1,5,5,0,1,24,44,68
p_156,12,0,e_1,884,887,931,8,2,1,11,5,1,2,3,44,47
p_155,11,0,e_1,884,892,931,9,2,1,11,5,1,1,8,39,47
p_159,8,0,e_1,893,903,931,9,2,1,11,4,1,1,10,28,38
p_158,7,0,e_1,892,908,931,10,2,1,11,4,1,0,16,23,39
p_157,7,0,e_2,889,913,936,11,2,1,0,3,0,0,24,23,47
p_147,6,0,e_3,849,870,946,6,1,1,0,3,0,1,21,76,97
p_148,15,0,e_3,849,899,946,15,0,0,0,3,0,0,50,47,97
p_3,4,0,e_2,25,39,87,4,0,0,0,3,0,0,14,48,62
p_4,5,0,e_2,34,44,87,5,0,0,2,5,0,1,10,43,53
p_5,9,0,e_2,41,58,87,9,0,0,4,5,1,1,17,29,46
p_6,9,0,e_2,45,58,87,9,0,0,5,5,1,1,13,29,42
p_2,11,0,e_1,19,55,90,11,0,0,0,3,0,0,36,35,71
p_1,13,0,e_0,13,55,96,13,0,0,0,3,0,0,42,41,83
p_12,0,8,e_2,86,87,113,21,5,5,0,4,1,0,1,26,27
p_16,4,0,e_1,101,115,129,13,4,1,0,3,0,0,14,14,28
p_15,5,0,e_0,99,116,133,13,4,2,0,3,0,0,17,17,34
p_13,8,0,e_2,87,113,139,13,5,3,0,5,1,0,26,26,52
p_19,0,7,e_1,125,129,152,11,3,0,1,4,1,1,4,23,27
p_7,2,0,e_3,55,64,162,2,0,0,0,3,0,0,9,98,107
p_10,9,0,e_3,77,87,162,15,3,2,6,5,1,2,10,75,85
p_9,10,0,e_3,67,92,162,17,2,1,3,5,1,1,25,70,95
p_14,13,0,e_3,87,103,162,8,4,1,9,5,1,3,16,59,75
p_8,15,0,e_3,62,111,162,13,1,0,2,5,0,1,49,51,100
p_17,10,0,e_3,112,128,162,5,2,0,15,4,1,1,16,34,50
p_11,4,0,e_3,84,148,162,18,4,3,8,5,1,3,64,14,78
p_21,0,10,e_2,142,143,177,6,2,0,0,3,0,0,1,34,35
p_20,3,0,e_0,142,154,207,3,2,1,0,3,0,0,12,53,65
p_22,6,0,e_0,146,165,207,29,2,2,0,5,0,1,19,42,61
p_25,9,0,e_0,163,176,207,9,0,0,6,5,1,1,13,31,44
p_27,5,0,e_0,180,190,207,4,1,1,8,4,1,0,10,17,27
p_26,6,0,e_3,169,190,212,6,0,0,0,3,0,0,21,22,43
p_30,2,0,e_3,200,204,212,1,1,0,3,4,1,0,4,8,12
p_28,7,0,e_2,184,196,219,3,1,0,10,3,0,0,12,23,35
p_33,1,0,e_3,213,219,224,1,0,0,0,3,0,0,6,5,11
p_24,14,0,e_1,157,175,229,17,1,1,8,5,0,1,18,54,72
p_18,15,0,e_1,120,180,229,27,3,3,3,4,1,0,60,49,109
p_23,15,0,e_1,150,180,229,19,1,1,7,5,1,1,30,49,79
p_31,5,0,e_1,203,212,229,27,2,2,8,4,1,0,9,17,26
p_32,0,10,e_0,209,210,244,1,1,0,0,3,0,0,1,34,35
p_35,0,6,e_3,222,224,246,0,1,0,0,4,1,0,2,22,24
p_43,4,0,e_1,270,271,305,7,2,0,4,5,0,1,1,34,35
p_41,7,0,e_1,257,282,305,8,2,1,0,3,0,0,25,23,48
p_36,1,0,e_3,225,229,308,11,1,1,0,5,1,0,4,79,83
p_38,12,0,e_3,240,266,308,8,2,0,4,5,2,0,26,42,68
p_42,4,0,e_3,269,292,308,7,1,0,11,4,1,0,23,16,39
p_44,4,0,e_3,275,292,308,5,2,0,9,4,1,1,17,16,33
p_47,3,0,e_3,293,297,308,1,1,0,4,4,1,0,4,11,15
p_39,13,0,e_2,247,260,309,7,2,0,9,5,0,1,13,49,62
p_29,14,0,e_2,192,265,309,22,1,1,8,4,0,1,73,44,117
p_34,11,0,e_0,217,249,312,11,1,0,1,5,1,0,32,63,95
p_37,15,0,e_0,228,263,312,14,1,0,5,5,1,1,35,49,84
p_40,15,0,e_0,255,263,312,7,2,0,12,5,1,1,8,49,57
p_49,3,0,e_0,298,301,312,30,1,1,4,4,1,1,3,11,14
p_51,0,4,e_3,309,309,325,0,0,0,0,3,0,0,0,16,16
p_48,9,0,e_0,294,341,372,25,2,2,5,4,1,0,47,31,78
p_62,1,0,e_0,345,367,372,6,4,2,8,4,1,0,22,5,27
p_54,7,0,e_3,313,336,373,7,1,0,0,5,1,0,23,37,60
p_53,8,0,e_3,313,341,373,8,2,0,0,5,1,1,28,32,60
p_56,8,0,e_3,324,341,373,4,2,2,4,3,1,2,17,32,49
p_59,3,0,e_3,335,358,373,6,3,1,7,5,0,3,23,15,38
p_60,2,0,e_3,338,363,373,7,4,1,7,5,1,3,25,10,35
p_57,1,0,e_3,327,368,373,11,2,2,4,5,0,2,41,5,46
p_50,11,0,e_2,299,344,389,22,1,1,3,4,1,0,45,45,90
p_61,12,0,e_2,341,349,389,14,4,0,10,5,0,1,8,40,48
p_63,3,0,e_2,364,378,389,29,2,2,8,4,1,0,14,11,25
p_58,0,6,e_0,330,372,392,11,3,3,5,5,0,1,42,20,62
p_46,8,0,e_1,291,331,397,26,2,2,4,4,1,1,40,66,106
p_45,11,0,e_1,290,342,397,24,2,2,5,4,1,0,52,55,107
p_52,14,0,e_1,312,353,397,14,1,0,2,5,0,2,41,44,85
p_55,14,0,e_1,314,353,397,13,3,0,2,5,0,3,39,44,83
p_65,0,7,e_0,369,372,397,1,1,0,1,4,1,0,3,25,28
p_68,2,0,e_2,389,397,405,18,2,2,0,3,1,0,8,8,16
p_69,2,0,e_2,391,397,405,18,2,2,0,5,0,1,6,8,14
p_64,0,15,e_0,365,372,423,2,2,0,1,4,1,1,7,51,58
p_73,3,0,e_2,423,435,446,7,1,0,0,3,0,0,12,11,23
p_66,11,0,e_3,376,411,456,11,0,0,0,3,0,0,35,45,80
p_67,12,0,e_3,377,416,456,12,1,0,0,5,0,1,39,40,79
p_75,3,0,e_3,438,445,456,2,1,0,5,4,1,0,7,11,18
p_70,3,0,e_1,398,410,469,14,2,2,0,3,0,0,12,59,71
p_72,6,0,e_1,417,421,469,6,1,0,5,5,1,1,4,48,52
p_71,7,0,e_1,403,426,469,9,2,2,1,5,0,1,23,43,66
p_74,10,0,e_1,424,437,469,30,1,1,7,5,1,1,13,32,45
p_77,4,0,e_3,455,470,484,4,0,0,0,3,1,0,15,14,29
p_76,10,0,e_0,440,457,491,25,2,2,15,3,0,0,17,34,51
p_79,9,0,e_0,457,462,491,9,1,0,10,4,1,0,5,29,34
p_81,1,0,e_0,493,498,503,1,0,0,0,3,0,0,5,5,10
p_82,0,12,e_1,494,494,534,0,0,0,0,3,0,0,0,40,40
p_78,12,0,e_2,455,493,539,18,1,1,0,3,0,0,38,46,84
p_80,13,0,e_2,474,498,539,20,1,1,6,5,0,1,24,41,65
p_83,0,12,e_3,501,501,543,0,0,0,0,3,0,0,0,42,42
p_87,3,0,e_0,528,540,567,13,1,1,0,3,0,0,12,27,39
p_89,5,0,e_0,535,548,567,9,1,1,1,5,0,1,13,19,32
p_94,3,0,e_0,546,556,567,9,1,0,4,5,1,1,10,11,21
p_90,1,0,e_2,538,544,569,12,2,1,0,3,1,0,6,25,31
p_93,4,0,e_2,543,555,569,16,1,0,1,5,0,1,12,14,26
p_88,10,0,e_3,531,535,585,5,1,1,9,5,1,0,4,50,54
p_95,10,0,e_3,547,551,585,1,1,0,11,4,1,0,4,34,38
p_96,7,0,e_3,551,562,585,3,1,0,10,1,1,0,11,23,34
p_84,12,0,e_1,504,534,592,12,1,0,2,5,1,0,30,58,88
p_85,14,0,e_1,517,542,592,10,1,0,6,5,1,0,25,50,75
p_86,14,0,e_1,518,542,592,10,1,0,7,5,1,1,24,50,74
p_91,14,0,e_1,539,542,592,3,2,0,13,5,1,1,3,50,53
p_92,10,0,e_1,540,556,592,3,2,1,14,5,1,1,16,36,52
p_99,9,0,e_1,556,561,592,30,2,2,10,4,1,1,5,31,36
p_98,6,0,e_1,555,572,592,3,2,1,10,1,1,0,17,20,37
p_111,2,0,e_1,607,615,623,12,3,2,0,3,0,0,8,8,16
p_97,5,0,e_2,552,586,647,5,2,1,3,5,1,1,34,61,95
p_106,5,0,e_2,583,586,647,26,1,1,4,5,0,2,3,61,64
p_105,12,0,e_2,582,609,647,19,1,1,4,5,0,1,27,38,65
p_110,12,0,e_2,590,609,647,11,2,0,6,5,1,1,19,38,57
p_107,3,0,e_3,584,596,653,3,0,0,0,3,1,0,12,57,69
p_108,7,0,e_3,584,610,653,7,1,1,0,3,1,1,26,43,69
p_109,10,0,e_3,590,621,653,9,2,0,1,5,0,2,31,32,63
p_117,0,2,e_2,636,647,655,5,1,0,3,4,1,0,11,8,19
p_101,9,0,e_0,566,596,665,27,1,1,0,4,1,1,30,69,99
p_100,10,0,e_0,557,601,665,29,2,2,3,4,1,0,44,64,108
p_102,14,0,e_0,568,615,665,21,1,1,0,5,0,2,47,50,97
p_103,14,0,e_0,577,615,665,18,1,1,3,5,0,3,38,50,88
p_104,14,0,e_0,581,615,665,17,1,1,4,5,0,3,34,50,84
p_112,11,0,e_0,613,626,665,4,2,0,14,5,1,1,13,39,52
p_113,9,0,e_0,629,634,665,29,1,1,10,4,1,0,5,31,36
p_115,9,0,e_0,632,634,665,28,1,1,10,4,1,1,2,31,33
p_116,7,0,e_0,633,642,665,29,1,1,9,1,1,0,9,23,32
p_123,0,2,e_0,661,665,673,13,2,2,1,4,1,0,4,8,12
p_125,2,0,e_0,668,673,681,9,2,1,1,5,1,0,5,8,13
p_126,1,0,e_0,681,686,691,8,1,0,0,3,1,0,5,5,10
p_118,8,0,e_2,649,675,701,23,1,1,0,5,1,0,26,26,52
p_119,8,0,e_2,650,675,701,23,1,1,0,5,1,1,25,26,51
p_121,3,0,e_3,656,667,704,3,0,0,0,3,0,0,11,37,48
p_122,7,0,e_3,657,681,704,7,1,0,0,5,0,1,24,23,47
p_124,7,0,e_3,664,681,704,5,2,0,2,5,0,2,17,23,40
p_114,13,0,e_1,632,674,715,24,1,1,0,3,0,0,42,41,83
p_120,13,0,e_1,653,674,715,13,0,0,6,5,0,1,21,41,62
p_129,5,0,e_2,705,722,739,5,0,0,0,3,0,0,17,17,34
p_127,7,0,e_0,701,725,750,24,1,1,0,3,0,0,24,25,49
p_131,7,0,e_0,722,725,750,19,2,2,6,5,0,1,3,25,28
p_132,4,0,e_0,730,736,750,19,2,2,6,4,1,0,6,14,20
p_128,0,15,e_3,705,706,759,0,1,1,0,3,0,1,1,53,54
p_139,0,15,e_0,758,758,807,15,4,4,0,3,0,0,0,49,49
p_133,6,0,e_1,734,755,809,16,3,3,0,3,0,0,21,54,75
p_135,11,0,e_1,739,772,809,9,3,2,1,5,0,1,33,37,70
p_143,5,0,e_1,780,792,809,5,1,0,9,4,1,0,12,17,29
p_130,11,0,e_3,705,743,810,11,0,0,0,3,0,0,38,67,105
p_134,14,0,e_3,734,754,810,8,2,1,8,5,1,1,20,56,76
p_136,14,0,e_3,749,754,810,3,3,1,13,5,2,1,5,56,61
p_137,13,0,e_3,755,767,810,3,2,1,14,5,2,0,12,43,55
p_138,12,0,e_3,756,772,810,4,3,1,14,5,2,1,16,38,54
p_141,12,0,e_3,770,772,810,1,2,0,13,4,1,1,2,38,40
p_145,1,0,e_3,820,826,831,1,0,0,0,3,0,0,6,5,11
p_140,5,0,e_2,768,786,853,8,2,1,0,3,0,0,18,67,85
p_142,13,0,e_2,773,812,853,29,1,1,1,5,0,1,39,41,80
p_144,6,0,e_1,815,835,855,6,0,0,0,3,0,0,20,20,40
p_152,2,0,e_2,868,869,885,22,2,1,2,5,0,1,1,16,17
p_150,3,0,e_2,860,874,885,24,2,2,0,3,0,0,14,11,25
p_146,10,0,e_0,846,864,900,10,0,0,15,3,0,0,18,36,54
p_153,6,0,e_0,872,878,900,18,2,1,8,4,1,0,6,22,28
p_154,4,0,e_0,874,886,900,19,2,1,7,4,1,1,12,14,26
p_149,6,0,e_1,859,879,939,22,2,1,0,3,0,0,20,60,80
p_155,11,0,e_1,884,896,939,9,2,1,7,5,1,1,12,43,55
p_151,12,0,e_1,863,901,939,14,2,1,1,5,0,1,38,38,76
p_156,12,0,e_1,884,901,939,8,2,1,7,5,1,1,17,38,55
p_157,7,0,e_2,889,913,944,11,2,1,0,3,0,0,24,31,55
p_158,7,0,e_2,892,913,944,10,2,1,0,5,0,1,21,31,52
p_159,8,0,e_2,893,918,944,9,2,1,1,5,0,1,25,26,51
p_147,6,0,e_3,849,870,946,6,1,1,0,3,0,1,21,76,97
p_148,15,0,e_3,849,899,946,15,0,0,0,3,0,0,50,47,97
p_3,4,0,e_2,25,39,87,4,0,0,0,3,0,0,14,48,62
p_4,5,0,e_2,34,44,87,5,0,0,3,5,0,1,10,43,53
p_5,9,0,e_2,41,58,87,9,0,0,4,5,1,1,17,29,46
p_6,9,0,e_2,45,58,87,9,0,0,5,5,1,1,13,29,42
p_2,11,0,e_1,19,55,90,11,0,0,0,3,0,0,36,35,71
p_1,13,0,e_0,13,55,96,13,0,0,0,3,0,0,42,41,83
p_12,0,8,e_2,86,87,115,21,4,4,0,3,1,0,1,28,29
p_16,4,0,e_1,101,115,129,13,4,1,0,3,0,0,14,14,28
p_15,5,0,e_0,99,116,133,13,4,2,0,3,0,0,17,17,34
p_19,0,7,e_1,125,129,154,10,2,0,1,4,1,0,4,25,29
p_7,2,0,e_3,55,63,161,2,0,0,0,3,0,0,8,98,106
p_10,9,0,e_3,77,86,161,15,3,2,6,5,1,2,9,75,84
p_9,10,0,e_3,67,91,161,17,2,1,3,5,1,1,24,70,94
p_14,13,0,e_3,87,102,161,8,4,1,9,5,1,3,15,59,74
p_8,15,0,e_3,62,110,161,17,0,0,2,2,0,0,48,51,99
p_11,4,0,e_3,84,145,161,18,4,3,8,5,1,3,61,16,77
p_20,3,0,e_3,142,150,161,2,2,1,5,4,1,1,8,11,19
p_21,0,10,e_0,142,143,179,5,2,0,0,3,0,0,1,36,37
p_13,8,0,e_2,87,115,187,13,5,3,0,5,1,1,28,72,100
p_17,10,0,e_2,112,123,187,5,2,0,7,5,1,0,11,64,75
p_18,15,0,e_2,120,140,187,27,2,2,9,5,1,1,20,47,67
p_27,5,0,e_3,180,187,212,4,1,1,3,5,0,1,7,25,32
p_26,6,0,e_3,169,192,212,6,0,0,0,3,0,0,23,20,43
p_25,9,0,e_0,163,174,215,9,0,0,5,5,1,0,11,41,52
p_28,7,0,e_0,184,190,215,3,2,0,9,4,1,0,6,25,31
p_30,2,0,e_0,200,207,215,2,1,0,4,4,1,0,7,8,15
p_22,6,0,e_1,146,149,233,28,2,2,5,5,1,0,3,84,87
p_24,14,0,e_1,157,177,233,17,1,1,7,5,1,1,20,56,76
p_23,15,0,e_1,150,182,233,18,1,1,6,5,2,0,32,51,83
p_31,5,0,e_1,203,214,233,28,1,1,8,4,1,0,11,19,30
p_33,1,0,e_1,213,228,233,19,1,1,5,4,1,1,15,5,20
p_36,1,0,e_1,225,228,233,15,1,1,2,4,1,1,3,5,8
p_35,0,6,e_0,222,222,244,17,1,1,0,3,0,0,0,22,22
p_32,0,10,e_3,209,212,244,1,1,0,1,4,1,0,3,32,35
p_38,12,0,e_3,240,252,292,3,1,0,9,5,1,0,12,40,52
p_42,4,0,e_3,269,278,292,3,1,0,7,4,1,0,9,14,23
p_44,4,0,e_3,275,278,292,1,2,0,5,4,1,1,3,14,17
p_34,11,0,e_2,217,227,296,10,1,0,8,5,0,1,10,69,79
p_29,14,0,e_2,192,238,296,20,1,0,0,3,0,0,46,58,104
p_37,15,0,e_2,228,243,296,10,1,0,11,5,1,1,15,53,68
p_39,13,0,e_2,247,251,296,2,1,0,14,4,1,0,4,45,49
p_41,7,0,e_2,257,271,296,4,1,0,11,4,1,0,14,25,39
p_43,4,0,e_2,270,282,296,3,2,0,7,1,1,0,12,14,26
p_51,0,4,e_2,309,310,326,0,0,0,0,3,0,0,1,16,17
p_40,15,0,e_0,255,285,342,27,1,1,6,3,0,0,30,57,87
p_45,11,0,e_0,290,299,342,19,1,1,14,4,1,0,9,43,52
p_48,9,0,e_0,294,307,342,9,0,0,13,4,1,2,13,35,48
p_46,8,0,e_0,291,312,342,8,0,0,13,4,1,1,21,30,51
p_54,7,0,e_0,313,317,342,7,1,1,8,4,1,0,4,25,29
p_57,1,0,e_0,327,337,342,11,1,1,4,4,1,0,10,5,15
p_58,0,6,e_0,330,342,362,11,1,1,3,4,1,1,12,20,32
p_53,8,0,e_3,313,340,368,8,0,0,0,3,0,0,27,28,55
p_60,2,0,e_3,338,360,368,7,1,1,7,5,0,1,22,8,30
p_56,8,0,e_2,324,340,370,5,1,0,3,5,1,0,16,30,46
p_59,3,0,e_2,335,357,370,7,1,1,6,5,0,1,22,13,35
p_62,1,0,e_2,345,365,370,6,2,1,7,4,1,1,20,5,25
p_47,3,0,e_1,293,304,387,3,0,0,0,3,0,0,11,83,94
p_49,3,0,e_1,298,304,387,3,0,0,1,5,0,1,6,83,89
p_50,11,0,e_1,299,330,387,11,0,0,1,5,0,1,31,57,88
p_52,14,0,e_1,312,341,387,14,0,0,5,5,1,1,29,46,75
p_55,14,0,e_1,314,341,387,14,1,0,6,5,1,2,27,46,73
p_61,12,0,e_1,341,349,387,26,2,2,14,4,1,0,8,38,46
p_63,3,0,e_0,364,376,387,28,1,1,6,3,0,0,12,11,23
p_65,0,7,e_3,369,369,394,0,0,0,0,3,0,0,0,25,25
p_68,2,0,e_0,389,398,406,16,3,3,0,3,0,0,9,8,17
p_64,0,15,e_2,365,370,417,1,1,0,1,1,1,0,5,47,52
p_69,2,0,e_1,391,400,444,16,3,3,0,3,0,0,9,44,53
p_70,3,0,e_1,398,405,444,13,2,2,1,5,0,1,7,39,46
p_71,7,0,e_1,403,419,444,8,2,2,2,5,1,1,16,25,41
p_72,6,0,e_1,417,424,444,5,1,0,7,5,1,1,7,20,27
p_73,3,0,e_0,423,434,445,6,1,0,0,3,0,0,11,11,22
p_66,11,0,e_3,376,408,453,10,1,0,1,5,1,0,32,45,77
p_67,12,0,e_3,377,413,453,10,2,0,2,5,1,1,36,40,76
p_75,3,0,e_3,438,442,453,1,1,0,4,4,1,0,4,11,15
p_74,10,0,e_2,424,442,476,29,1,1,15,3,0,0,18,34,52
p_76,10,0,e_2,440,442,476,24,2,2,11,4,0,1,2,34,36
p_77,4,0,e_2,455,462,476,4,0,0,6,4,1,0,7,14,21
p_81,1,0,e_2,493,499,504,1,0,0,0,3,0,0,6,5,11
p_79,9,0,e_1,457,486,515,9,0,0,0,3,0,0,29,29,58
p_82,0,12,e_3,494,495,535,0,0,0,0,3,0,0,1,40,41
p_78,12,0,e_0,455,493,539,12,0,0,0,3,0,0,38,46,84
p_80,13,0,e_0,474,498,539,13,0,0,6,5,0,1,24,41,65
p_83,0,12,e_2,501,504,544,23,1,1,1,4,1,0,3,40,43
p_87,3,0,e_1,528,540,569,15,2,2,0,3,0,0,12,29,41
p_93,4,0,e_1,543,545,569,18,1,0,4,5,1,2,2,24,26
p_89,5,0,e_1,535,550,569,11,1,1,1,5,0,1,15,19,34
p_90,1,0,e_1,538,564,569,14,2,1,3,5,0,2,26,5,31
p_88,10,0,e_2,531,536,588,7,2,2,9,5,1,0,5,52,57
p_92,10,0,e_2,540,552,588,5,2,1,11,5,2,0,12,36,48
p_95,10,0,e_2,547,552,588,3,1,0,12,4,1,1,5,36,41
p_96,7,0,e_2,551,563,588,5,1,0,10,4,1,1,12,25,37
p_98,6,0,e_2,555,568,588,4,1,0,9,4,1,1,13,20,33
p_84,12,0,e_3,504,535,589,10,1,0,2,5,1,0,31,54,85
p_85,14,0,e_3,517,543,589,8,1,0,6,5,1,0,26,46,72
p_86,14,0,e_3,518,543,589,7,2,0,7,5,1,1,25,46,71
p_91,14,0,e_3,539,543,589,1,2,0,13,5,1,1,4,46,50
p_99,9,0,e_3,556,560,589,1,1,0,10,4,1,0,4,29,33
p_107,3,0,e_1,584,594,633,29,1,1,0,5,0,1,10,39,49
p_106,5,0,e_1,583,602,633,27,1,1,0,3,0,0,19,31,50
p_108,7,0,e_1,584,610,633,24,1,1,0,5,0,2,26,23,49
p_94,3,0,e_0,546,557,646,10,1,0,0,3,0,0,11,89,100
p_97,5,0,e_0,552,565,646,7,1,0,2,5,0,1,13,81,94
p_101,9,0,e_0,566,579,646,28,1,1,5,5,1,1,13,67,80
p_100,10,0,e_0,557,584,646,30,2,2,3,5,1,1,27,62,89
p_105,12,0,e_0,582,592,646,20,1,1,9,5,1,2,10,54,64
p_110,12,0,e_0,590,592,646,12,0,0,12,5,1,3,2,54,56
p_102,14,0,e_0,568,600,646,23,1,1,6,5,1,2,32,46,78
p_103,14,0,e_0,577,600,646,20,1,1,9,5,1,3,23,46,69
p_104,14,0,e_0,581,600,646,18,1,1,9,5,1,2,19,46,65
p_109,10,0,e_0,590,614,646,10,0,0,11,5,1,2,24,32,56
p_117,0,2,e_3,636,637,647,0,0,0,0,3,0,0,1,10,11
p_123,0,2,e_0,661,662,672,3,0,0,0,3,0,0,1,10,11
p_121,3,0,e_3,656,662,673,1,0,0,2,3,0,0,6,11,17
p_125,2,0,e_0,668,672,680,30,1,1,1,5,1,0,4,8,12
p_116,7,0,e_1,633,656,691,7,0,0,0,3,1,0,23,35,58
p_122,7,0,e_1,657,658,691,5,1,0,7,5,1,1,1,33,34
p_118,8,0,e_1,649,663,691,6,0,0,5,5,0,1,14,28,42
p_119,8,0,e_1,650,663,691,6,0,0,5,5,0,2,13,28,41
p_124,7,0,e_1,664,668,691,26,1,1,8,4,1,0,4,23,27
p_126,1,0,e_0,681,686,691,1,0,0,0,3,0,0,5,5,10
p_111,2,0,e_2,607,616,696,2,0,0,0,3,0,0,9,80,89
p_113,9,0,e_2,629,639,696,9,0,0,6,5,1,1,10,57,67
p_115,9,0,e_2,632,639,696,9,0,0,7,5,1,2,7,57,64
p_112,11,0,e_2,613,647,696,11,0,0,1,5,0,1,34,49,83
p_114,13,0,e_2,632,655,696,13,0,0,7,5,1,2,23,41,64
p_120,13,0,e_2,653,655,696,11,0,0,13,5,1,1,2,41,43
p_128,0,15,e_2,705,706,755,0,0,0,0,3,0,0,1,49,50
p_129,5,0,e_1,705,723,758,5,0,0,0,3,0,0,18,35,53
p_131,7,0,e_1,722,731,758,7,0,0,5,5,0,1,9,27,36
p_133,6,0,e_1,734,736,758,6,0,0,7,4,1,1,2,22,24
p_132,4,0,e_1,730,744,758,4,0,0,7,5,1,1,14,14,28
p_127,7,0,e_0,701,724,799,7,0,0,0,3,0,0,23,75,98
p_130,11,0,e_0,705,738,799,11,0,0,1,5,0,1,33,61,94
p_135,11,0,e_0,739,740,799,11,0,0,11,5,1,1,1,59,60
p_134,14,0,e_0,734,751,799,14,0,0,10,5,1,1,17,48,65
p_136,14,0,e_0,749,751,799,14,0,0,14,5,1,1,2,48,50
p_138,12,0,e_0,756,759,799,14,1,1,13,4,1,0,3,40,43
p_140,5,0,e_0,768,782,799,17,1,1,9,4,1,0,14,17,31
p_143,5,0,e_0,780,782,799,13,1,1,6,4,1,1,2,17,19
p_139,0,15,e_1,758,759,808,25,1,1,0,3,0,0,1,49,50
p_142,13,0,e_2,773,778,821,7,1,0,15,4,0,1,5,43,48
p_141,12,0,e_2,770,783,821,10,1,1,15,3,0,0,13,38,51
p_145,1,0,e_0,820,826,831,5,1,0,0,3,0,0,6,5,11
p_137,13,0,e_3,755,796,839,13,0,0,0,3,0,0,41,43,84
p_144,6,0,e_3,815,819,839,1,1,0,7,4,1,0,4,20,24
p_152,2,0,e_3,868,869,885,2,1,1,2,5,0,1,1,16,17
p_150,3,0,e_3,860,874,885,3,0,0,0,3,0,0,14,11,25
p_146,10,0,e_1,846,863,899,10,0,0,15,3,0,0,17,36,53
p_153,6,0,e_1,872,877,899,3,2,0,7,4,1,0,5,22,27
p_154,4,0,e_1,874,885,899,29,1,1,7,4,1,1,11,14,25
p_147,6,0,e_0,849,869,933,6,0,0,0,3,0,0,20,64,84
p_149,6,0,e_0,859,869,933,6,0,0,3,5,0,1,10,64,74
p_155,11,0,e_0,884,886,933,19,1,1,10,5,1,1,2,47,49
p_151,12,0,e_0,863,891,933,12,1,0,4,5,0,1,28,42,70
p_156,12,0,e_0,884,891,933,18,1,1,10,5,1,2,7,42,49
p_159,8,0,e_0,893,905,933,8,0,0,12,4,1,1,12,28,40
p_157,7,0,e_0,889,910,933,7,0,0,11,5,1,1,21,23,44
p_158,7,0,e_0,892,910,933,7,0,0,12,4,1,1,18,23,41
p_148,15,0,e_2,849,897,944,15,0,0,0,3,0,0,48,47,95
p_3,4,0,e_2,25,40,88,4,0,0,0,3,0,0,15,48,63
p_4,5,0,e_2,34,45,88,5,0,0,2,5,0,1,11,43,54
p_5,9,0,e_2,41,59,88,9,0,0,4,5,1,1,18,29,47
p_6,9,0,e_2,45,59,88,9,0,0,5,5,1,1,14,29,43
p_2,11,0,e_1,19,55,90,11,0,0,0,3,0,0,36,35,71
p_1,13,0,e_0,13,55,96,13,0,0,0,3,0,0,42,41,83
p_12,0,8,e_1,86,90,116,21,5,5,1,4,1,0,4,26,30
p_16,4,0,e_2,101,115,129,13,5,1,0,3,0,0,14,14,28
p_15,5,0,e_0,99,117,134,13,5,2,0,3,0,0,18,17,35
p_19,0,7,e_2,125,129,154,11,3,0,1,4,1,0,4,25,29
p_7,2,0,e_3,55,64,162,2,0,0,0,3,0,0,9,98,107
p_10,9,0,e_3,77,87,162,15,3,2,6,5,1,2,10,75,85
p_9,10,0,e_3,67,92,162,17,2,1,3,5,1,1,25,70,95
p_14,13,0,e_3,87,103,162,8,5,1,9,5,1,4,16,59,75
p_8,15,0,e_3,62,111,162,13,1,0,2,5,0,1,49,51,100
p_13,8,0,e_3,87,134,162,13,4,2,9,2,1,3,47,28,75
p_11,4,0,e_3,84,148,162,18,4,3,8,5,1,3,64,14,78
p_21,0,10,e_0,142,142,180,6,2,0,0,3,0,1,0,38,38
p_17,10,0,e_1,112,124,188,5,3,0,7,5,1,0,12,64,76
p_18,15,0,e_1,120,141,188,28,3,3,9,5,0,1,21,47,68
p_27,5,0,e_3,180,186,213,4,1,1,3,5,0,1,6,27,33
p_26,6,0,e_3,169,191,213,6,0,0,0,3,0,0,22,22,44
p_30,2,0,e_3,200,205,213,1,1,0,3,4,1,0,5,8,13
p_20,3,0,e_0,142,155,214,3,2,1,0,3,0,0,13,59,72
p_25,9,0,e_0,163,175,214,9,0,0,5,5,2,0,12,39,51
p_28,7,0,e_0,184,191,214,2,2,0,9,4,1,0,7,23,30
p_22,6,0,e_2,146,149,233,28,2,2,5,5,1,0,3,84,87
p_24,14,0,e_2,157,177,233,17,1,1,8,5,1,1,20,56,76
p_23,15,0,e_2,150,182,233,19,1,1,6,5,2,0,32,51,83
p_31,5,0,e_2,203,214,233,28,2,2,8,4,1,0,11,19,30
p_36,1,0,e_2,225,228,233,11,1,1,2,4,1,0,3,5,8
p_35,0,6,e_3,222,223,245,0,0,0,0,3,0,0,1,22,23
p_32,0,10,e_0,209,214,248,1,1,0,1,4,1,0,5,34,39
p_41,7,0,e_3,257,263,288,1,0,0,6,3,0,0,6,25,31
p_42,4,0,e_3,269,274,288,2,1,0,6,4,1,0,5,14,19
p_43,4,0,e_3,270,274,288,1,2,0,5,4,1,1,4,14,18
p_34,11,0,e_1,217,227,294,11,0,0,8,5,0,1,10,67,77
p_29,14,0,e_1,192,238,294,22,1,1,0,3,0,0,46,56,102
p_37,15,0,e_1,228,243,294,14,1,0,11,5,1,1,15,51,66
p_39,13,0,e_1,247,251,294,7,0,0,14,4,1,0,4,43,47
p_44,4,0,e_1,275,280,294,30,1,1,6,4,1,0,5,14,19
p_33,1,0,e_0,213,219,316,1,0,0,0,3,1,0,6,97,103
p_38,12,0,e_0,240,256,316,7,1,0,8,5,2,0,16,60,76
p_40,15,0,e_0,255,267,316,9,0,0,12,5,1,1,12,49,61
p_49,3,0,e_0,298,305,316,11,1,1,5,4,1,0,7,11,18
p_51,0,4,e_0,309,316,330,11,1,1,2,4,1,0,7,14,21
p_57,1,0,e_0,327,341,346,5,1,0,3,5,1,0,14,5,19
p_54,7,0,e_3,313,315,348,2,1,1,7,5,0,1,2,33,35
p_46,8,0,e_3,291,320,348,8,0,0,0,3,0,0,29,28,57
p_53,8,0,e_3,313,320,348,2,1,0,6,5,0,1,7,28,35
p_60,2,0,e_3,338,340,348,1,1,0,3,4,1,0,2,8,10
p_47,3,0,e_1,293,305,360,13,1,1,0,3,1,0,12,55,67
p_48,9,0,e_1,294,325,360,9,1,0,0,5,0,1,31,35,66
p_56,8,0,e_1,324,330,360,29,1,1,9,5,1,1,6,30,36
p_59,3,0,e_1,335,347,360,30,1,1,7,4,1,0,12,13,25
p_62,1,0,e_1,345,355,360,30,1,1,4,4,1,1,10,5,15
p_58,0,6,e_0,330,346,366,5,1,0,4,4,0,1,16,20,36
p_45,11,0,e_2,290,326,383,11,0,0,0,3,0,0,36,57,93
p_50,11,0,e_2,299,326,383,9,1,0,2,5,0,1,27,57,84
p_52,14,0,e_2,312,337,383,8,1,0,7,5,0,1,25,46,71
p_55,14,0,e_2,314,337,383,7,2,0,7,5,0,2,23,46,69
p_61,12,0,e_2,341,345,383,20,1,1,13,4,1,0,4,38,42
p_63,3,0,e_1,364,376,387,3,0,0,0,3,0,0,12,11,23
p_65,0,7,e_2,369,383,406,30,1,1,4,4,1,0,14,23,37
p_68,2,0,e_1,389,398,406,22,1,1,0,3,0,0,9,8,17
p_69,2,0,e_1,391,398,406,21,1,1,0,5,0,1,7,8,15
p_64,0,15,e_3,365,366,415,0,0,0,0,3,0,0,1,49,50
p_71,7,0,e_2,403,406,431,12,1,1,6,5,1,1,3,25,28
p_70,3,0,e_2,398,420,431,17,1,1,5,5,1,0,22,11,33
p_66,11,0,e_0,376,393,438,17,1,1,6,3,0,0,17,45,62
p_67,12,0,e_0,377,398,438,16,1,1,6,5,0,1,21,40,61
p_73,3,0,e_0,423,427,438,12,0,0,4,4,1,0,4,11,15
p_72,6,0,e_1,417,438,458,9,0,0,0,3,0,0,21,20,41
p_75,3,0,e_0,438,450,461,8,1,1,0,3,0,0,12,11,23
p_74,10,0,e_3,424,442,476,5,0,0,15,3,0,0,18,34,52
p_77,4,0,e_3,455,462,476,2,1,0,6,4,1,0,7,14,21
p_81,1,0,e_0,493,498,503,1,0,0,0,3,0,0,5,5,10
p_79,9,0,e_2,457,470,529,26,2,2,5,5,0,2,13,59,72
p_76,10,0,e_2,440,475,529,20,1,1,0,3,0,0,35,54,89
p_78,12,0,e_2,455,483,529,24,2,2,4,5,0,1,28,46,74
p_80,13,0,e_2,474,488,529,18,1,1,10,5,1,2,14,41,55
p_82,0,12,e_1,494,495,535,0,0,0,0,3,0,0,1,40,41
p_83,0,12,e_3,501,502,544,0,0,0,0,3,0,0,1,42,43
p_90,1,0,e_2,538,544,549,13,2,1,0,3,0,0,6,5,11
p_87,3,0,e_0,528,539,568,14,1,1,0,3,0,0,11,29,40
p_89,5,0,e_0,535,547,568,9,1,1,2,5,0,1,12,21,33
p_93,4,0,e_0,543,552,568,8,2,0,4,5,1,1,9,16,25
p_94,3,0,e_0,546,557,568,9,2,1,5,5,1,2,11,11,22
p_88,10,0,e_3,531,536,588,6,1,1,8,5,1,0,5,52,57
p_92,10,0,e_3,540,552,588,3,2,1,11,5,2,0,12,36,48
p_95,10,0,e_3,547,552,588,1,2,0,11,4,1,1,5,36,41
p_96,7,0,e_3,551,563,588,3,1,0,10,1,1,0,12,25,37
p_98,6,0,e_3,555,568,588,4,2,1,10,4,1,1,13,20,33
p_84,12,0,e_1,504,535,589,12,1,0,2,5,1,0,31,54,85
p_85,14,0,e_1,517,543,589,10,1,0,6,5,1,0,26,46,72
p_86,14,0,e_1,518,543,589,10,1,0,7,5,1,1,25,46,71
p_91,14,0,e_1,539,543,589,4,2,0,13,5,1,1,4,46,50
p_99,9,0,e_1,556,560,589,30,3,3,10,4,1,0,4,29,33
p_111,2,0,e_1,607,616,624,2,0,0,0,3,0,0,9,8,17
p_97,5,0,e_2,552,570,651,5,2,1,0,3,0,0,18,81,99
p_101,9,0,e_2,566,584,651,27,2,2,4,5,0,2,18,67,85
p_100,10,0,e_2,557,589,651,29,3,3,1,5,0,1,32,62,94
p_105,12,0,e_2,582,597,651,20,1,1,9,5,1,3,15,54,69
p_110,12,0,e_2,590,597,651,12,0,0,10,5,1,2,7,54,61
p_102,14,0,e_2,568,605,651,22,1,1,4,5,0,3,37,46,83
p_103,14,0,e_2,577,605,651,19,1,1,7,5,1,3,28,46,74
p_104,14,0,e_2,581,605,651,18,1,1,8,5,1,3,24,46,70
p_112,11,0,e_2,613,616,651,11,0,0,12,4,1,0,3,35,38
p_107,3,0,e_0,584,595,654,28,1,1,0,3,0,2,11,59,70
p_106,5,0,e_0,583,603,654,27,1,1,0,3,0,0,20,51,71
p_108,7,0,e_0,584,611,654,24,1,1,0,3,0,1,27,43,70
p_109,10,0,e_0,590,622,654,10,0,0,2,5,0,3,32,32,64
p_117,0,2,e_2,636,651,659,25,1,1,5,4,1,0,15,8,23
p_123,0,2,e_0,661,661,671,17,1,1,0,3,0,0,0,10,10
p_125,2,0,e_0,668,671,679,13,1,1,1,5,1,0,3,8,11
p_126,1,0,e_0,681,687,692,10,1,0,0,3,0,0,6,5,11
p_121,3,0,e_2,656,664,701,15,1,1,1,5,1,0,8,37,45
p_122,7,0,e_2,657,678,701,11,1,1,1,5,1,1,21,23,44
p_124,7,0,e_2,664,678,701,9,1,1,3,5,1,1,14,23,37
p_114,13,0,e_3,632,673,714,13,0,0,0,3,0,0,41,41,82
p_116,7,0,e_1,633,652,717,19,1,1,1,5,0,1,19,65,84
p_118,8,0,e_1,649,657,717,13,1,1,6,5,0,2,8,60,68
p_119,8,0,e_1,650,657,717,13,1,1,6,5,0,3,7,60,67
p_113,9,0,e_1,629,662,717,9,0,0,0,3,0,0,33,55,88
p_115,9,0,e_1,632,662,717,9,1,1,1,5,0,1,30,55,85
p_120,13,0,e_1,653,676,717,7,1,0,7,5,1,2,23,41,64
p_132,4,0,e_3,730,745,759,4,0,0,0,3,0,0,15,14,29
p_128,0,15,e_2,705,706,759,3,1,0,0,3,0,1,1,53,54
p_127,7,0,e_0,701,724,795,27,1,1,0,3,0,0,23,71,94
p_130,11,0,e_0,705,738,795,22,1,1,1,5,0,1,33,57,90
p_134,14,0,e_0,734,749,795,14,1,0,10,5,1,1,15,46,61
p_140,5,0,e_0,768,778,795,23,1,1,8,4,1,0,10,17,27
p_133,6,0,e_1,734,743,807,6,1,0,3,5,0,1,9,64,73
p_131,7,0,e_1,722,748,807,7,0,0,0,3,0,0,26,59,85
p_135,11,0,e_1,739,762,807,9,1,0,5,5,0,2,23,45,68
p_138,12,0,e_1,756,767,807,19,1,1,9,5,1,1,11,40,51
p_143,5,0,e_1,780,790,807,19,3,3,8,4,1,0,10,17,27
p_129,5,0,e_2,705,725,808,28,1,1,0,3,0,0,20,83,103
p_136,14,0,e_2,749,754,808,19,1,1,12,5,2,0,5,54,59
p_137,13,0,e_2,755,767,808,18,1,1,14,5,2,0,12,41,53
p_139,0,15,e_3,758,759,812,0,0,0,0,3,1,0,1,53,54
p_145,1,0,e_1,820,825,830,12,1,0,0,3,0,0,5,5,10
p_144,6,0,e_0,815,835,855,9,1,0,0,3,0,0,20,20,40
p_141,12,0,e_3,770,799,859,16,1,1,2,5,1,0,29,60,89
p_142,13,0,e_3,773,804,859,14,2,1,3,5,1,1,31,55,86
p_150,3,0,e_0,860,871,882,3,0,0,0,3,0,0,11,11,22
p_152,2,0,e_3,868,876,928,2,0,0,0,3,0,0,8,52,60
p_154,4,0,e_3,874,884,928,6,2,1,2,5,0,2,10,44,54
p_153,6,0,e_3,872,892,928,5,1,0,1,5,0,1,20,36,56
p_157,7,0,e_3,889,897,928,2,2,0,5,5,1,1,8,31,39
p_158,7,0,e_3,892,897,928,1,2,0,6,2,1,1,5,31,36
p_159,8,0,e_3,893,902,928,2,2,0,6,5,1,1,9,26,35
p_147,6,0,e_2,849,869,929,27,1,1,0,3,0,0,20,60,80
p_149,6,0,e_2,859,869,929,6,0,0,3,5,0,1,10,60,70
p_155,11,0,e_2,884,886,929,7,2,2,10,5,1,1,2,43,45
p_151,12,0,e_2,863,891,929,12,0,0,4,5,0,1,28,38,66
p_156,12,0,e_2,884,891,929,8,2,0,11,5,1,2,7,38,45
p_146,10,0,e_1,846,879,943,24,1,1,0,3,0,0,33,64,97
p_148,15,0,e_1,849,896,943,18,1,1,0,5,0,1,47,47,94
p_3,4,0,e_2,25,39,87,4,0,0,0,3,0,0,14,48,62
p_4,5,0,e_2,34,44,87,5,0,0,3,5,0,1,10,43,53
p_5,9,0,e_2,41,58,87,9,0,0,4,5,1,1,17,29,46
p_6,9,0,e_2,45,58,87,9,0,0,5,5,1,1,13,29,42
p_2,11,0,e_1,19,55,90,11,0,0,0,3,0,0,36,35,71
p_1,13,0,e_0,13,55,96,13,0,0,0,3,0,0,42,41,83
p_12,0,8,e_2,86,87,115,21,4,4,0,3,1,0,1,28,29
p_16,4,0,e_1,101,115,129,13,4,1,0,3,0,0,14,14,28
p_15,5,0,e_0,99,116,133,13,4,2,0,3,0,0,17,17,34
p_19,0,7,e_1,125,129,154,11,2,0,1,4,1,0,4,25,29
p_7,2,0,e_3,55,63,161,2,0,0,0,3,0,0,8,98,106
p_10,9,0,e_3,77,86,161,15,3,2,6,5,1,2,9,75,84
p_9,10,0,e_3,67,91,161,17,2,1,3,5,1,1,24,70,94
p_14,13,0,e_3,87,102,161,8,4,1,9,5,1,3,15,59,74
p_8,15,0,e_3,62,110,161,17,0,0,2,2,0,0,48,51,99
p_11,4,0,e_3,84,145,161,18,4,3,8,5,1,3,61,16,77
p_20,3,0,e_3,142,150,161,2,2,1,5,4,1,1,8,11,19
p_21,0,10,e_0,142,143,179,5,2,0,0,3,0,0,1,36,37
p_13,8,0,e_2,87,115,187,13,5,3,0,5,1,1,28,72,100
p_17,10,0,e_2,112,123,187,5,2,0,7,5,1,0,11,64,75
p_18,15,0,e_2,120,140,187,27,2,2,9,5,1,1,20,47,67
p_25,9,0,e_0,163,174,213,9,0,0,5,5,1,0,11,39,50
p_27,5,0,e_0,180,196,213,4,1,1,10,4,1,0,16,17,33
p_30,2,0,e_2,200,209,217,17,2,1,0,3,0,0,9,8,17
p_22,6,0,e_1,146,149,233,28,2,2,5,5,1,0,3,84,87
p_24,14,0,e_1,157,177,233,17,1,1,8,5,1,1,20,56,76
p_23,15,0,e_1,150,182,233,18,1,1,6,5,2,0,32,51,83
p_31,5,0,e_1,203,214,233,14,2,1,9,4,1,0,11,19,30
p_33,1,0,e_1,213,228,233,14,2,1,5,1,1,0,15,5,20
p_36,1,0,e_1,225,228,233,11,2,1,2,4,1,1,3,5,8
p_35,0,6,e_2,222,222,244,13,2,0,0,3,0,0,0,22,22
p_32,0,10,e_0,209,213,245,16,2,2,1,4,1,0,4,32,36
p_26,6,0,e_3,169,189,263,6,0,0,0,3,0,0,20,74,94
p_28,7,0,e_3,184,194,263,2,1,0,5,5,0,1,10,69,79
p_29,14,0,e_3,192,217,263,8,2,0,6,5,1,1,25,46,71
p_34,11,0,e_3,217,228,263,3,1,0,14,4,1,0,11,35,46
p_42,4,0,e_3,269,283,297,4,0,0,0,3,0,0,14,14,28
p_43,4,0,e_3,270,283,297,4,1,0,0,5,0,1,13,14,27
p_44,4,0,e_3,275,283,297,3,1,0,1,5,0,1,8,14,22
p_41,7,0,e_1,257,281,304,25,1,1,0,3,0,0,24,23,47
p_37,15,0,e_0,228,262,311,26,1,1,4,5,1,0,34,49,83
p_40,15,0,e_0,255,262,311,18,1,1,13,5,0,1,7,49,56
p_47,3,0,e_0,293,300,311,28,3,3,5,4,1,0,7,11,18
p_38,12,0,e_2,240,264,312,26,1,1,5,5,1,0,24,48,72
p_39,13,0,e_2,247,269,312,22,1,1,6,5,0,1,22,43,65
p_49,3,0,e_2,298,301,312,19,2,2,4,4,1,0,3,11,14
p_51,0,4,e_0,309,311,325,18,2,2,0,4,1,0,2,14,16
p_54,7,0,e_0,313,336,363,16,3,3,0,5,1,0,23,27,50
p_60,2,0,e_0,338,353,363,14,2,1,7,4,1,1,15,10,25
p_57,1,0,e_0,327,358,363,18,3,2,4,5,0,1,31,5,36
p_62,1,0,e_0,345,358,363,13,2,1,4,4,1,2,13,5,18
p_48,9,0,e_1,294,333,364,22,3,3,3,4,1,0,39,31,70
p_59,3,0,e_1,335,353,364,14,2,1,9,4,1,0,18,11,29
p_53,8,0,e_2,313,340,366,15,3,2,0,3,0,0,27,26,53
p_56,8,0,e_2,324,340,366,12,3,2,3,5,0,1,16,26,42
p_58,0,6,e_1,330,364,384,18,3,3,8,5,0,1,34,20,54
p_63,3,0,e_0,364,375,386,6,1,0,0,3,0,0,11,11,22
p_46,8,0,e_3,291,323,391,24,2,2,2,4,1,1,32,68,100
p_45,11,0,e_3,290,334,391,21,1,1,2,4,1,0,44,57,101
p_50,11,0,e_3,299,334,391,11,2,0,0,5,0,2,35,57,92
p_52,14,0,e_3,312,345,391,9,2,0,5,5,0,2,33,46,79
p_55,14,0,e_3,314,345,391,9,3,0,5,5,0,3,31,46,77
p_61,12,0,e_3,341,353,391,3,2,1,13,5,1,1,12,38,50
p_65,0,7,e_0,369,386,411,7,1,0,1,5,0,1,17,25,42
p_64,0,15,e_2,365,366,415,8,1,0,0,3,1,0,1,49,50
p_69,2,0,e_3,391,400,416,2,0,0,0,3,0,0,9,16,25
p_70,3,0,e_3,398,405,416,1,1,0,2,5,0,1,7,11,18
p_68,2,0,e_0,389,394,434,28,1,1,1,5,1,0,5,40,45
p_71,7,0,e_0,403,411,434,4,2,0,4,5,2,0,8,23,31
p_73,3,0,e_3,423,435,446,3,0,0,0,3,0,0,12,11,23
p_66,11,0,e_1,376,401,446,24,1,1,4,5,1,0,25,45,70
p_67,12,0,e_1,377,406,446,22,1,1,4,5,1,1,29,40,69
p_72,6,0,e_1,417,426,446,6,0,0,9,4,1,0,9,20,29
p_75,3,0,e_0,438,450,461,30,1,1,0,3,0,0,12,11,23
p_74,10,0,e_2,424,442,476,10,1,1,15,3,0,0,18,34,52
p_76,10,0,e_2,440,442,476,22,1,1,11,4,0,1,2,34,36
p_77,4,0,e_2,455,462,476,4,0,0,6,4,1,0,7,14,21
p_81,1,0,e_0,493,498,503,6,1,0,0,3,0,0,5,5,10
p_79,9,0,e_3,457,486,515,9,0,0,0,3,0,0,29,29,58
p_82,0,12,e_2,494,494,534,7,1,0,0,3,0,0,0,40,40
p_78,12,0,e_1,455,494,542,12,0,0,0,3,0,0,39,48,87
p_80,13,0,e_1,474,499,542,8,1,0,6,5,0,1,25,43,68
p_87,3,0,e_1,528,531,542,3,0,0,4,4,1,0,3,11,14
p_83,0,12,e_0,501,503,543,4,1,0,0,4,1,0,2,40,42
p_90,1,0,e_3,538,541,572,9,1,1,0,5,0,1,3,31,34
p_89,5,0,e_3,535,555,572,5,0,0,0,3,0,0,20,17,37
p_97,5,0,e_3,552,555,572,1,2,0,4,5,1,1,3,17,20
p_88,10,0,e_0,531,535,585,10,0,0,9,5,1,0,4,50,54
p_92,10,0,e_0,540,551,585,9,2,0,11,5,2,0,11,34,45
p_95,10,0,e_0,547,551,585,7,2,0,11,4,1,1,4,34,38
p_96,7,0,e_0,551,562,585,3,2,0,10,1,1,0,11,23,34
p_84,12,0,e_2,504,534,588,22,1,1,2,5,1,0,30,54,84
p_85,14,0,e_2,517,542,588,14,0,0,6,5,1,0,25,46,71
p_86,14,0,e_2,518,542,588,14,0,0,7,5,1,1,24,46,70
p_91,14,0,e_2,539,542,588,14,2,0,13,5,1,1,3,46,49
p_99,9,0,e_2,556,559,588,26,1,1,10,4,1,0,3,29,32
p_111,2,0,e_0,607,615,623,12,3,2,0,3,0,0,8,8,16
p_94,3,0,e_1,546,555,644,5,2,1,0,5,0,1,9,89,98
p_93,4,0,e_1,543,560,644,5,2,1,0,3,0,0,17,84,101
p_98,6,0,e_1,555,568,644,29,1,1,3,2,0,1,13,76,89
p_101,9,0,e_1,566,579,644,23,1,1,5,5,1,2,13,65,78
p_100,10,0,e_1,557,584,644,25,1,1,3,5,1,2,27,60,87
p_105,12,0,e_1,582,592,644,12,0,0,10,5,1,2,10,52,62
p_110,12,0,e_1,590,592,644,10,4,0,12,5,1,2,2,52,54
p_102,14,0,e_1,568,600,644,17,1,1,6,5,1,2,32,44,76
p_103,14,0,e_1,577,600,644,14,0,0,8,5,1,3,23,44,67
p_104,14,0,e_1,581,600,644,14,0,0,9,5,1,2,19,44,63
p_117,0,2,e_2,636,636,646,9,2,0,0,3,0,0,0,10,10
p_107,3,0,e_3,584,595,666,3,1,1,0,3,0,1,11,71,82
p_106,5,0,e_3,583,603,666,5,0,0,0,3,0,0,20,63,83
p_108,7,0,e_3,584,611,666,7,2,2,0,3,0,2,27,55,82
p_109,10,0,e_3,590,622,666,8,3,0,2,5,0,3,32,44,76
p_112,11,0,e_3,613,627,666,4,2,0,7,5,1,1,14,39,53
p_113,9,0,e_3,629,635,666,2,1,0,11,4,1,0,6,31,37
p_115,9,0,e_3,632,635,666,1,2,0,10,4,1,1,3,31,34
p_116,7,0,e_3,633,643,666,3,2,1,10,4,1,1,10,23,33
p_123,0,2,e_3,661,666,674,1,1,0,1,4,1,0,5,8,13
p_121,3,0,e_1,656,667,680,30,1,1,0,3,0,0,11,13,24
p_125,2,0,e_1,668,672,680,2,1,0,3,4,1,0,4,8,12
p_126,1,0,e_1,681,686,691,1,0,0,0,3,0,0,5,5,10
p_122,7,0,e_2,657,666,697,26,1,1,4,5,0,1,9,31,40
p_124,7,0,e_2,664,666,697,23,1,1,6,5,0,2,2,31,33
p_118,8,0,e_2,649,671,697,28,1,1,2,3,0,0,22,26,48
p_119,8,0,e_2,650,671,697,27,1,1,2,5,0,1,21,26,47
p_114,13,0,e_0,632,673,714,27,2,2,0,3,0,0,41,41,82
p_120,13,0,e_0,653,673,714,21,1,1,7,5,0,1,20,41,61
p_129,5,0,e_1,705,722,739,6,1,1,0,3,0,0,17,17,34
p_128,0,15,e_2,705,706,757,19,2,2,0,3,0,0,1,51,52
p_127,7,0,e_3,701,718,771,5,0,0,2,3,0,0,17,53,70
p_130,11,0,e_3,705,732,771,8,1,0,3,5,0,1,27,39,66
p_133,6,0,e_3,734,749,771,5,2,0,11,4,1,1,15,22,37
p_132,4,0,e_3,730,757,771,7,2,0,11,5,1,1,27,14,41
p_134,14,0,e_2,734,752,806,27,3,3,8,5,1,0,18,54,72
p_136,14,0,e_2,749,752,806,22,2,2,13,5,1,1,3,54,57
p_140,5,0,e_2,768,789,806,26,1,1,12,4,1,0,21,17,38
p_143,5,0,e_2,780,789,806,19,1,1,8,4,1,1,9,17,26
p_139,0,15,e_1,758,759,810,4,1,0,0,3,0,0,1,51,52
p_131,7,0,e_0,722,746,811,7,2,1,0,3,0,0,24,65,89
p_135,11,0,e_0,739,760,811,28,3,3,5,5,0,1,21,51,72
p_138,12,0,e_0,756,765,811,22,2,2,10,5,1,2,9,46,55
p_137,13,0,e_0,755,770,811,22,2,2,9,5,1,1,15,41,56
p_145,1,0,e_2,820,825,830,10,1,0,0,3,0,0,5,5,10
p_142,13,0,e_3,773,814,855,13,0,0,0,3,0,0,41,41,82
p_144,6,0,e_0,815,836,856,7,1,0,0,3,0,0,21,20,41
p_141,12,0,e_1,770,799,857,18,1,1,3,5,1,0,29,58,87
p_150,3,0,e_1,860,872,883,3,0,0,0,3,0,0,12,11,23
p_149,6,0,e_0,859,879,937,6,0,0,0,3,0,0,20,58,78
p_151,12,0,e_0,863,899,937,12,0,0,1,5,0,1,36,38,74
p_156,12,0,e_0,884,899,937,8,2,2,7,5,1,1,15,38,53
p_157,7,0,e_1,889,912,943,10,3,1,0,3,0,0,23,31,54
p_158,7,0,e_1,892,912,943,9,2,1,0,5,0,1,20,31,51
p_159,8,0,e_1,893,917,943,8,2,1,1,5,0,1,24,26,50
p_152,2,0,e_3,868,876,944,2,0,0,0,3,0,0,8,68,76
p_154,4,0,e_3,874,884,944,6,2,1,2,5,0,2,10,60,70
p_153,6,0,e_3,872,892,944,5,1,0,1,5,0,1,20,52,72
p_155,11,0,e_3,884,909,944,7,2,0,4,5,1,1,25,35,60
p_147,6,0,e_2,849,866,944,26,1,1,1,5,0,2,17,78,95
p_146,10,0,e_2,846,880,944,23,1,1,0,3,0,0,34,64,98
p_148,15,0,e_2,849,897,944,17,1,1,0,5,0,1,48,47,95
p_3,4,0,e_2,25,39,87,4,0,0,0,3,0,0,14,48,62
p_4,5,0,e_2,34,44,87,5,0,0,2,5,0,1,10,43,53
p_5,9,0,e_2,41,58,87,9,0,0,4,5,1,1,17,29,46
p_6,9,0,e_2,45,58,87,9,0,0,5,5,1,1,13,29,42
p_2,11,0,e_1,19,54,89,11,0,0,0,3,0,0,35,35,70
p_1,13,0,e_0,13,54,95,13,0,0,0,3,0,0,41,41,82
p_12,0,8,e_2,86,87,113,21,4,4,0,4,1,0,1,26,27
p_16,4,0,e_1,101,115,129,13,3,1,0,3,0,0,14,14,28
p_15,5,0,e_0,99,117,134,13,4,2,0,3,0,0,18,17,35
p_19,0,7,e_1,125,129,154,10,2,0,1,4,1,0,4,25,29
p_7,2,0,e_3,55,63,161,2,0,0,0,3,0,0,8,98,106
p_10,9,0,e_3,77,86,161,15,3,2,6,5,1,2,9,75,84
p_9,10,0,e_3,67,91,161,17,2,1,3,5,1,1,24,70,94
p_14,13,0,e_3,87,102,161,8,4,1,9,5,1,3,15,59,74
p_8,15,0,e_3,62,110,161,17,0,0,2,2,0,0,48,51,99
p_11,4,0,e_3,84,145,161,18,4,3,8,5,1,3,61,16,77
p_20,3,0,e_3,142,150,161,2,2,1,5,4,1,1,8,11,19
p_21,0,10,e_0,142,142,176,5,2,0,0,3,0,0,0,34,34
p_13,8,0,e_2,87,113,185,13,5,3,0,5,1,0,26,72,98
p_17,10,0,e_2,112,121,185,5,2,0,8,5,1,0,9,64,73
p_18,15,0,e_2,120,138,185,27,2,2,10,5,1,1,18,47,65
p_30,2,0,e_2,200,209,217,16,2,1,0,3,0,0,9,8,17
p_22,6,0,e_1,146,149,231,28,2,2,5,5,1,0,3,82,85
p_23,15,0,e_1,150,180,231,18,1,1,6,5,2,0,30,51,81
p_28,7,0,e_1,184,206,231,6,3,1,14,4,1,0,22,25,47
p_33,1,0,e_1,213,226,231,13,2,0,5,4,1,0,13,5,18
p_24,14,0,e_0,157,190,238,17,1,1,4,5,1,0,33,48,81
p_31,5,0,e_0,203,219,238,13,2,1,10,4,1,0,16,19,35
p_36,1,0,e_0,225,233,238,10,1,0,4,4,1,0,8,5,13
p_32,0,10,e_2,209,217,249,15,2,2,2,2,0,0,8,32,40
p_35,0,6,e_1,222,231,251,12,2,0,2,4,1,1,9,20,29
p_27,5,0,e_3,180,181,260,8,2,2,5,5,0,2,1,79,80
p_26,6,0,e_3,169,186,260,11,1,1,1,5,0,1,17,74,91
p_25,9,0,e_3,163,197,260,9,0,0,0,3,0,0,34,63,97
p_29,14,0,e_3,192,214,260,6,2,0,8,5,1,1,22,46,68
p_34,11,0,e_3,217,225,260,3,1,0,14,4,1,0,8,35,43
p_42,4,0,e_3,269,283,297,4,0,0,0,3,0,0,14,14,28
p_43,4,0,e_3,270,283,297,4,1,0,0,5,0,1,13,14,27
p_44,4,0,e_3,275,283,297,3,1,0,1,5,0,1,8,14,22
p_41,7,0,e_0,257,280,303,24,1,1,0,3,0,0,23,23,46
p_37,15,0,e_2,228,266,315,25,1,1,3,5,1,0,38,49,87
p_40,15,0,e_2,255,266,315,16,1,1,11,5,0,1,11,49,60
p_47,3,0,e_2,293,304,315,28,2,2,6,4,1,0,11,11,22
p_49,3,0,e_2,298,304,315,19,1,1,5,4,1,1,6,11,17
p_38,12,0,e_1,240,271,319,24,1,1,2,5,1,0,31,48,79
p_39,13,0,e_1,247,276,319,21,1,1,5,5,1,1,29,43,72
p_46,8,0,e_1,291,293,319,24,2,2,9,4,1,0,2,26,28
p_51,0,4,e_2,309,315,329,18,1,1,2,4,1,0,6,14,20
p_57,1,0,e_1,327,332,337,18,2,2,0,3,0,0,5,5,10
p_58,0,6,e_1,330,337,357,17,2,2,1,5,0,1,7,20,27
p_54,7,0,e_0,313,326,369,16,2,2,3,5,0,1,13,43,56
p_53,8,0,e_0,313,331,369,15,2,2,3,5,0,2,18,38,56
p_48,9,0,e_0,294,336,369,22,2,2,3,4,1,0,42,33,75
p_59,3,0,e_0,335,356,369,14,2,1,9,5,1,1,21,13,34
p_62,1,0,e_0,345,364,369,13,1,0,7,4,1,1,19,5,24
p_63,3,0,e_1,364,375,386,4,1,0,6,3,0,0,11,11,22
p_45,11,0,e_3,290,332,387,21,1,1,2,4,1,0,42,55,97
p_50,11,0,e_3,299,332,387,11,1,0,0,5,0,1,33,55,88
p_52,14,0,e_3,312,343,387,9,1,0,5,5,0,1,31,44,75
p_55,14,0,e_3,314,343,387,9,2,0,5,5,0,2,29,44,73
p_56,8,0,e_2,324,343,397,12,2,2,2,5,1,0,19,54,73
p_61,12,0,e_2,341,357,397,3,2,1,8,5,0,2,16,40,56
p_60,2,0,e_2,338,389,397,13,2,1,7,5,0,1,51,8,59
p_68,2,0,e_3,389,398,406,2,0,0,0,3,0,0,9,8,17
p_69,2,0,e_3,391,398,406,2,1,0,0,5,0,1,7,8,15
p_65,0,7,e_1,369,386,409,6,1,0,5,4,0,1,17,23,40
p_64,0,15,e_0,365,369,420,7,1,0,1,4,1,0,4,51,55
p_70,3,0,e_2,398,410,421,5,0,0,0,3,0,0,12,11,23
p_71,7,0,e_1,403,409,432,24,1,1,5,5,1,0,6,23,29
p_73,3,0,e_2,423,435,446,7,1,1,0,3,0,0,12,11,23
p_72,6,0,e_3,417,437,457,6,0,0,0,3,0,0,20,20,40
p_66,11,0,e_0,376,404,471,22,1,1,2,5,1,0,28,67,95
p_67,12,0,e_0,377,409,471,21,1,1,2,5,1,1,32,62,94
p_74,10,0,e_0,424,437,471,8,1,0,14,4,1,0,13,34,47
p_77,4,0,e_0,455,457,471,27,1,1,5,4,1,0,2,14,16
p_81,1,0,e_0,493,498,503,1,0,0,0,3,0,0,5,5,10
p_79,9,0,e_2,457,487,516,9,0,0,0,3,0,0,30,29,59
p_75,3,0,e_1,438,450,527,3,1,0,0,3,0,0,12,77,89
p_76,10,0,e_1,440,473,527,26,1,1,0,5,0,1,33,54,87
p_78,12,0,e_1,455,481,527,18,1,1,4,5,1,1,26,46,72
p_80,13,0,e_1,474,486,527,13,0,0,10,5,1,1,12,41,53
p_82,0,12,e_3,494,495,535,0,0,0,0,3,0,0,1,40,41
p_83,0,12,e_0,501,503,543,23,1,1,1,4,1,0,2,40,42
p_87,3,0,e_1,528,540,567,15,2,2,0,3,0,0,12,27,39
p_89,5,0,e_1,535,548,567,11,1,1,2,5,0,1,13,19,32
p_94,3,0,e_1,546,556,567,10,1,0,4,5,1,1,10,11,21
p_90,1,0,e_2,538,544,569,14,2,1,0,3,0,0,6,25,31
p_93,4,0,e_2,543,555,569,10,1,0,1,2,0,0,12,14,26
p_88,10,0,e_0,531,535,585,7,2,2,9,5,1,0,4,50,54
p_92,10,0,e_0,540,551,585,5,2,1,11,5,2,0,11,34,45
p_95,10,0,e_0,547,551,585,3,1,0,11,4,1,1,4,34,38
p_96,7,0,e_0,551,562,585,5,1,0,10,4,1,0,11,23,34
p_84,12,0,e_3,504,535,591,10,1,0,2,5,1,0,31,56,87
p_85,14,0,e_3,517,543,591,8,1,0,6,5,1,0,26,48,74
p_86,14,0,e_3,518,543,591,7,2,0,7,5,1,1,25,48,73
p_91,14,0,e_3,539,543,591,1,2,0,13,5,1,1,4,48,52
p_99,9,0,e_3,556,560,591,1,2,0,10,4,1,1,4,31,35
p_98,6,0,e_3,555,571,591,5,1,0,11,4,1,0,16,20,36
p_111,2,0,e_3,607,615,623,2,0,0,0,3,0,0,8,8,16
p_101,9,0,e_1,566,596,663,29,2,2,0,4,1,1,30,67,97
p_100,10,0,e_1,557,601,663,30,3,3,3,4,1,0,44,62,106
p_105,12,0,e_1,582,609,663,21,1,1,5,5,0,3,27,54,81
p_110,12,0,e_1,590,609,663,18,1,1,7,5,0,4,19,54,73
p_102,14,0,e_1,568,617,663,23,2,2,0,5,0,2,49,46,95
p_116,7,0,e_1,633,640,663,19,1,1,9,4,1,0,7,23,30
p_109,10,0,e_0,590,622,664,20,1,1,0,3,0,0,32,42,74
p_112,11,0,e_0,613,627,664,9,1,0,7,5,0,1,14,37,51
p_115,9,0,e_0,632,635,664,17,1,1,10,4,1,0,3,29,32
p_97,5,0,e_2,552,586,665,6,1,0,3,5,1,1,34,79,113
p_106,5,0,e_2,583,586,665,28,1,1,4,5,0,2,3,79,82
p_108,7,0,e_2,584,594,665,25,1,1,4,5,0,3,10,71,81
p_103,14,0,e_2,577,617,665,20,1,1,2,5,0,1,40,48,88
p_104,14,0,e_2,581,617,665,19,1,1,4,5,0,2,36,48,84
p_113,9,0,e_2,629,634,665,9,0,0,10,4,1,1,5,31,36
p_107,3,0,e_2,584,654,665,29,1,1,4,5,0,2,70,11,81
p_117,0,2,e_1,636,663,671,25,1,1,8,4,1,1,27,8,35
p_123,0,2,e_1,661,663,671,17,4,4,0,4,1,0,2,8,10
p_125,2,0,e_1,668,671,679,13,4,1,1,5,1,0,3,8,11
p_126,1,0,e_1,681,687,692,10,3,2,0,3,0,0,6,5,11
p_124,7,0,e_0,664,687,710,10,4,1,0,3,1,0,23,23,46
p_118,8,0,e_3,649,658,720,13,1,1,5,5,0,1,9,62,71
p_119,8,0,e_3,650,658,720,12,2,1,6,5,0,2,8,62,70
p_114,13,0,e_3,632,675,720,13,0,0,0,3,0,0,43,45,88
p_120,13,0,e_3,653,675,720,7,2,0,6,5,0,2,22,45,67
p_122,7,0,e_3,657,695,720,11,2,1,8,2,0,2,38,25,63
p_121,3,0,e_3,656,709,720,15,2,1,8,5,0,2,53,11,64
p_127,7,0,e_1,701,725,750,29,2,2,0,3,0,0,24,25,49
p_131,7,0,e_1,722,725,750,7,0,0,6,5,0,1,3,25,28
p_132,4,0,e_1,730,736,750,4,0,0,6,4,1,0,6,14,20
p_128,0,15,e_0,705,710,757,4,2,0,1,4,1,0,5,47,52
p_129,5,0,e_2,705,723,804,29,2,2,0,3,0,1,18,81,99
p_130,11,0,e_2,705,743,804,23,2,2,0,3,0,0,38,61,99
p_134,14,0,e_2,734,754,804,14,0,0,8,5,1,1,20,50,70
p_136,14,0,e_2,749,754,804,10,2,0,13,5,1,1,5,50,55
p_137,13,0,e_2,755,759,804,7,1,0,14,4,1,0,4,45,49
p_138,12,0,e_2,756,764,804,6,2,0,14,4,1,1,8,40,48
p_140,5,0,e_2,768,787,804,7,2,1,11,4,1,0,19,17,36
p_143,5,0,e_2,780,787,804,4,1,0,7,4,1,1,7,17,24
p_139,0,15,e_1,758,758,807,16,2,2,0,3,0,0,0,49,49
p_133,6,0,e_3,734,755,807,6,0,0,0,3,0,0,21,52,73
p_135,11,0,e_3,739,772,807,10,1,0,1,5,0,1,33,35,68
p_142,13,0,e_0,773,779,822,28,1,1,15,4,0,1,6,43,49
p_141,12,0,e_0,770,784,822,2,2,0,15,3,0,0,14,38,52
p_145,1,0,e_3,820,825,830,1,0,0,0,3,0,0,5,5,10
p_144,6,0,e_2,815,835,855,6,0,0,0,3,0,0,20,20,40
p_150,3,0,e_2,860,871,884,24,1,1,0,3,0,0,11,13,24
p_152,2,0,e_2,868,876,884,22,1,1,2,5,0,1,8,8,16
p_146,10,0,e_1,846,863,899,10,0,0,15,3,0,0,17,36,53
p_153,6,0,e_1,872,877,899,17,1,1,8,4,1,0,5,22,27
p_154,4,0,e_1,874,885,899,18,1,1,7,4,1,1,11,14,25
p_147,6,0,e_0,849,870,932,6,0,0,0,3,0,0,21,62,83
p_149,6,0,e_0,859,870,932,21,1,1,3,5,0,1,11,62,73
p_155,11,0,e_0,884,887,932,8,1,1,10,5,1,1,3,45,48
p_151,12,0,e_0,863,892,932,14,1,1,4,5,0,1,29,40,69
p_156,12,0,e_0,884,892,932,7,1,1,10,5,1,1,8,40,48
p_159,8,0,e_0,893,906,932,8,1,1,12,4,1,0,13,26,39
p_157,7,0,e_2,889,913,936,10,1,1,0,3,0,0,24,23,47
p_158,7,0,e_2,892,913,936,9,1,1,0,5,0,1,21,23,44
p_148,15,0,e_3,849,897,944,15,0,0,0,3,0,0,48,47,95
p_3,4,0,e_2,25,40,88,4,0,0,0,3,0,0,15,48,63
p_4,5,0,e_2,34,45,88,5,0,0,2,5,0,1,11,43,54
p_5,9,0,e_2,41,59,88,9,0,0,4,5,1,1,18,29,47
p_6,9,0,e_2,45,59,88,9,0,0,5,5,1,1,14,29,43
p_2,11,0,e_1,19,55,90,11,0,0,0,3,0,0,36,35,71
p_1,13,0,e_0,13,55,96,13,0,0,0,3,0,0,42,41,83
p_12,0,8,e_1,86,90,116,21,4,4,1,4,1,0,4,26,30
p_16,4,0,e_0,101,113,135,13,3,1,0,5,0,1,12,22,34
p_15,5,0,e_0,99,118,135,13,4,2,0,3,0,0,19,17,36
p_13,8,0,e_2,87,114,140,13,5,3,0,3,1,0,27,26,53
p_19,0,7,e_0,125,135,158,10,2,0,3,4,1,0,10,23,33
p_7,2,0,e_3,55,63,159,2,0,0,0,3,0,0,8,96,104
p_10,9,0,e_3,77,86,159,15,3,2,6,5,1,2,9,73,82
p_9,10,0,e_3,67,91,159,17,2,1,3,5,1,1,24,68,92
p_14,13,0,e_3,87,102,159,8,4,1,9,5,1,3,15,57,72
p_8,15,0,e_3,62,110,159,13,1,0,2,5,0,1,48,49,97
p_11,4,0,e_3,84,145,159,17,4,2,9,5,1,3,61,14,75
p_20,3,0,e_2,142,153,184,2,2,1,0,3,0,0,11,31,42
p_22,6,0,e_2,146,164,184,28,1,1,1,5,0,1,18,20,38
p_17,10,0,e_1,112,124,188,5,2,0,7,5,1,0,12,64,76
p_18,15,0,e_1,120,141,188,27,2,2,9,5,0,1,21,47,68
p_21,0,10,e_3,142,159,195,5,2,0,5,4,1,1,17,36,53
p_30,2,0,e_1,200,208,216,15,3,1,0,3,0,0,8,8,16
p_24,14,0,e_0,157,181,235,16,1,1,7,2,1,1,24,54,78
p_23,15,0,e_0,150,186,235,18,1,1,4,5,1,0,36,49,85
p_33,1,0,e_0,213,230,235,12,2,1,6,4,1,0,17,5,22
p_28,7,0,e_2,184,208,235,6,4,2,0,3,0,0,24,27,51
p_31,5,0,e_2,203,216,235,11,3,1,6,5,0,1,13,19,32
p_36,1,0,e_2,225,230,235,9,2,1,2,4,1,0,5,5,10
p_32,0,10,e_1,209,216,248,14,2,0,2,4,1,0,7,32,39
p_35,0,6,e_2,222,235,255,11,2,0,3,4,1,0,13,20,33
p_26,6,0,e_3,169,179,257,11,2,2,3,5,1,1,10,78,88
p_25,9,0,e_3,163,190,257,10,1,1,1,5,1,0,27,67,94
p_29,14,0,e_3,192,209,257,5,3,0,9,5,2,1,17,48,65
p_34,11,0,e_3,217,220,257,1,2,0,12,4,1,1,3,37,40
p_27,5,0,e_3,180,240,257,9,3,2,6,5,2,1,60,17,77
p_42,4,0,e_3,269,283,297,4,0,0,0,3,0,0,14,14,28
p_43,4,0,e_3,270,283,297,4,1,0,0,5,0,1,13,14,27
p_44,4,0,e_3,275,283,297,2,1,0,2,5,0,1,8,14,22
p_41,7,0,e_0,257,281,306,7,0,0,0,3,0,0,24,25,49
p_47,3,0,e_0,293,295,306,28,3,3,4,4,1,0,2,11,13
p_38,12,0,e_2,240,275,313,23,1,1,1,5,1,0,35,38,73
p_39,13,0,e_1,247,259,316,20,1,1,10,2,1,1,12,57,69
p_37,15,0,e_1,228,267,316,24,2,2,3,5,1,0,39,49,88
p_40,15,0,e_1,255,267,316,16,1,1,12,5,0,2,12,49,61
p_49,3,0,e_1,298,305,316,19,3,3,5,4,1,0,7,11,18
p_51,0,4,e_0,309,309,325,19,3,3,0,3,0,0,0,16,16
p_57,1,0,e_1,327,333,338,18,3,2,0,3,0,0,6,5,11
p_58,0,6,e_1,330,338,358,19,3,3,0,5,0,1,8,20,28
p_53,8,0,e_0,313,339,365,15,4,3,0,5,1,0,26,26,52
p_56,8,0,e_0,324,339,365,12,4,3,4,5,1,1,15,26,41
p_54,7,0,e_2,313,337,366,16,4,4,0,3,0,0,24,29,53
p_59,3,0,e_2,335,351,366,14,3,1,6,5,0,1,16,15,31
p_60,2,0,e_2,338,356,366,15,2,1,7,4,1,1,18,10,28
p_62,1,0,e_2,345,361,366,14,3,1,5,4,1,2,16,5,21
p_63,3,0,e_0,364,376,387,6,1,0,0,3,1,0,12,11,23
p_46,8,0,e_3,291,323,393,24,2,2,2,4,1,1,32,70,102
p_48,9,0,e_3,294,328,393,22,3,3,1,4,1,2,34,65,99
p_45,11,0,e_3,290,336,393,21,1,1,2,4,1,0,46,57,103
p_50,11,0,e_3,299,336,393,11,3,0,0,5,0,3,37,57,94
p_52,14,0,e_3,312,347,393,9,3,0,5,5,0,3,35,46,81
p_55,14,0,e_3,314,347,393,9,4,0,5,5,0,4,33,46,79
p_61,12,0,e_3,341,355,393,4,2,1,12,5,1,1,14,38,52
p_65,0,7,e_0,369,387,412,8,1,0,1,5,0,1,18,25,43
p_64,0,15,e_2,365,366,415,9,1,0,0,3,1,0,1,49,50
p_70,3,0,e_3,398,409,420,3,0,0,0,3,0,0,11,11,22
p_66,11,0,e_1,376,393,436,24,1,1,6,3,0,0,17,43,60
p_67,12,0,e_1,377,398,436,23,1,1,6,5,0,1,21,38,59
p_68,2,0,e_0,389,395,437,29,1,1,0,5,1,0,6,42,48
p_69,2,0,e_0,391,395,437,29,1,1,1,5,1,1,4,42,46
p_71,7,0,e_0,403,412,437,6,1,0,4,5,2,0,9,25,34
p_73,3,0,e_0,423,426,437,3,0,0,4,4,1,0,3,11,14
p_75,3,0,e_0,438,450,461,3,0,0,0,3,0,0,12,11,23
p_74,10,0,e_2,424,435,471,10,0,0,14,4,0,1,11,36,47
p_72,6,0,e_2,417,449,471,25,1,1,15,3,0,0,32,22,54
p_77,4,0,e_2,455,457,471,4,0,0,5,4,1,0,2,14,16
p_81,1,0,e_0,493,498,503,6,1,0,0,3,0,0,5,5,10
p_79,9,0,e_3,457,487,516,9,0,0,0,3,0,0,30,29,59
p_76,10,0,e_1,440,473,527,10,0,0,0,3,0,0,33,54,87
p_78,12,0,e_1,455,481,527,12,0,0,4,5,0,1,26,46,72
p_80,13,0,e_1,474,486,527,8,1,0,10,5,1,1,12,41,53
p_82,0,12,e_2,494,494,534,7,1,0,0,3,0,0,0,40,40
p_83,0,12,e_0,501,503,543,5,1,0,1,4,1,0,2,40,42
p_90,1,0,e_3,538,544,549,1,0,0,0,3,0,0,6,5,11
p_87,3,0,e_1,528,539,568,3,0,0,0,3,0,0,11,29,40
p_89,5,0,e_1,535,547,568,5,0,0,2,5,0,1,12,21,33
p_93,4,0,e_1,543,552,568,5,0,0,4,5,1,1,9,16,25
p_94,3,0,e_1,546,557,568,28,1,1,5,5,1,2,11,11,22
p_88,10,0,e_0,531,535,587,10,0,0,9,5,1,0,4,52,56
p_92,10,0,e_0,540,551,587,10,1,0,11,5,2,0,11,36,47
p_95,10,0,e_0,547,551,587,21,1,1,11,4,1,1,4,36,40
p_96,7,0,e_0,551,562,587,7,0,0,10,4,1,0,11,25,36
p_98,6,0,e_0,555,567,587,5,1,0,9,4,1,1,12,20,32
p_84,12,0,e_2,504,534,588,22,1,1,2,5,1,0,30,54,84
p_85,14,0,e_2,517,542,588,14,0,0,6,5,1,0,25,46,71
p_86,14,0,e_2,518,542,588,14,0,0,7,5,1,1,24,46,70
p_91,14,0,e_2,539,542,588,14,1,0,13,5,1,1,3,46,49
p_99,9,0,e_2,556,559,588,8,1,0,10,4,1,0,3,29,32
p_111,2,0,e_2,607,615,623,11,1,0,0,3,0,0,8,8,16
p_107,3,0,e_1,584,595,634,16,4,3,0,3,0,1,11,39,50
p_106,5,0,e_1,583,603,634,14,4,3,0,3,0,0,20,31,51
p_108,7,0,e_1,584,611,634,12,4,3,0,3,0,2,27,23,50
p_117,0,2,e_1,636,636,646,4,1,0,0,3,0,0,0,10,10
p_97,5,0,e_3,552,569,648,5,0,0,0,3,0,0,17,79,96
p_101,9,0,e_3,566,583,648,7,2,1,4,5,0,2,17,65,82
p_100,10,0,e_3,557,588,648,9,1,0,1,5,0,1,31,60,91
p_105,12,0,e_3,582,596,648,7,4,1,9,5,1,3,14,52,66
p_110,12,0,e_3,590,596,648,6,3,1,10,5,1,2,6,52,58
p_102,14,0,e_3,568,604,648,9,2,0,5,2,0,2,36,44,80
p_103,14,0,e_3,577,604,648,7,4,0,7,5,1,3,27,44,71
p_104,14,0,e_3,581,604,648,5,4,0,9,5,1,3,23,44,67
p_109,10,0,e_0,590,623,667,8,3,2,0,3,0,0,33,44,77
p_112,11,0,e_0,613,628,667,30,1,1,7,5,0,1,15,39,54
p_113,9,0,e_0,629,636,667,27,1,1,11,4,1,0,7,31,38
p_115,9,0,e_0,632,636,667,26,1,1,10,4,1,1,4,31,35
p_116,7,0,e_0,633,644,667,28,1,1,10,4,1,1,11,23,34
p_123,0,2,e_0,661,667,675,5,1,1,2,4,1,0,6,8,14
p_121,3,0,e_3,656,668,681,3,0,0,0,3,0,0,12,13,25
p_125,2,0,e_3,668,673,681,1,1,0,3,4,1,0,5,8,13
p_126,1,0,e_0,681,687,692,1,0,0,2,3,0,0,6,5,11
p_122,7,0,e_1,657,666,697,7,1,0,4,5,0,1,9,31,40
p_124,7,0,e_1,664,666,697,5,1,0,6,5,0,2,2,31,33
p_118,8,0,e_1,649,671,697,8,0,0,2,3,0,0,22,26,48
p_119,8,0,e_1,650,671,697,8,0,0,2,5,0,1,21,26,47
p_114,13,0,e_2,632,674,715,22,1,1,0,3,0,0,42,41,83
p_120,13,0,e_2,653,674,715,13,0,0,6,5,0,1,21,41,62
p_129,5,0,e_3,705,722,739,5,0,0,0,3,0,0,17,17,34
p_128,0,15,e_1,705,705,754,0,0,0,0,3,0,0,0,49,49
p_132,4,0,e_2,730,736,772,29,1,1,2,5,0,1,6,36,42
p_133,6,0,e_2,734,744,772,25,1,1,4,5,0,2,10,28,38
p_131,7,0,e_2,722,749,772,12,0,0,0,3,0,0,27,23,50
p_127,7,0,e_0,701,725,802,7,0,0,0,3,0,0,24,77,101
p_130,11,0,e_0,705,739,802,11,1,0,1,5,0,1,34,63,97
p_135,11,0,e_0,739,739,802,11,0,0,11,2,1,1,0,63,63
p_134,14,0,e_0,734,752,802,18,1,1,9,5,1,1,18,50,68
p_136,14,0,e_0,749,752,802,14,0,0,13,5,1,1,3,50,53
p_137,13,0,e_0,755,757,802,13,0,0,14,4,1,0,2,45,47
p_138,12,0,e_0,756,762,802,12,0,0,13,1,1,0,6,40,46
p_140,5,0,e_0,768,785,802,23,1,1,11,4,1,0,17,17,34
p_143,5,0,e_0,780,785,802,19,1,1,6,4,1,1,5,17,22
p_139,0,15,e_3,758,758,807,0,0,0,0,3,0,0,0,49,49
p_142,13,0,e_1,773,779,822,13,1,1,15,4,0,1,6,43,49
p_141,12,0,e_1,770,784,822,15,1,1,15,3,0,0,14,38,52
p_145,1,0,e_2,820,825,830,14,0,0,0,3,0,0,5,5,10
p_144,6,0,e_0,815,835,855,9,0,0,0,3,0,0,20,20,40
p_152,2,0,e_0,868,869,885,7,1,0,2,5,0,1,1,16,17
p_150,3,0,e_0,860,874,885,8,1,1,0,3,0,0,14,11,25
p_146,10,0,e_3,846,863,899,5,0,0,15,3,0,0,17,36,53
p_153,6,0,e_3,872,877,899,1,1,0,7,4,1,0,5,22,27
p_154,4,0,e_3,874,885,899,3,2,1,7,4,1,1,11,14,25
p_147,6,0,e_2,849,870,934,8,1,1,0,3,0,0,21,64,85
p_149,6,0,e_2,859,870,934,5,1,1,3,5,0,1,11,64,75
p_155,11,0,e_2,884,887,934,23,1,1,10,5,1,1,3,47,50
p_151,12,0,e_2,863,892,934,28,0,0,4,5,0,1,29,42,71
p_156,12,0,e_2,884,892,934,22,1,1,10,5,1,1,8,42,50
p_159,8,0,e_2,893,906,934,24,1,1,12,4,1,1,13,28,41
p_158,7,0,e_2,892,911,934,25,1,1,12,4,1,0,19,23,42
p_157,7,0,e_0,889,912,935,26,1,1,0,3,0,0,23,23,46
p_148,15,0,e_1,849,896,943,19,1,1,0,3,0,0,47,47,94
p_3,4,0,e_2,25,39,87,4,0,0,0,3,0,0,14,48,62
p_4,5,0,e_2,34,44,87,5,0,0,3,5,0,1,10,43,53
p_5,9,0,e_2,41,58,87,9,0,0,4,5,1,1,17,29,46
p_6,9,0,e_2,45,58,87,9,0,0,5,5,1,1,13,29,42
p_2,11,0,e_1,19,55,90,11,0,0,0,3,0,0,36,35,71
p_1,13,0,e_0,13,55,96,13,0,0,0,3,0,0,42,41,83
p_12,0,8,e_2,86,87,113,21,5,5,0,4,1,0,1,26,27
p_16,4,0,e_1,101,116,130,13,4,1,0,3,0,0,15,14,29
p_15,5,0,e_0,99,116,133,13,4,2,0,3,0,0,17,17,34
p_19,0,7,e_1,125,130,153,11,2,0,2,4,1,1,5,23,28
p_13,8,0,e_2,87,113,153,13,4,2,0,3,1,0,26,40,66
p_17,10,0,e_2,112,121,153,5,2,0,8,5,1,0,9,32,41
p_7,2,0,e_3,55,64,162,2,0,0,0,3,0,0,9,98,107
p_10,9,0,e_3,77,87,162,15,3,2,6,5,1,2,10,75,85
p_9,10,0,e_3,67,92,162,18,2,1,2,5,1,1,25,70,95
p_14,13,0,e_3,87,103,162,8,4,1,9,2,1,3,16,59,75
p_8,15,0,e_3,62,111,162,13,1,0,2,5,0,1,49,51,100
p_11,4,0,e_3,84,146,162,18,4,3,8,5,1,3,62,16,78
p_20,3,0,e_3,142,151,162,2,2,1,5,4,1,1,9,11,20
p_21,0,10,e_0,142,143,181,5,2,0,0,3,0,0,1,38,39
p_26,6,0,e_2,169,190,212,6,0,0,0,3,0,0,21,22,43
p_30,2,0,e_2,200,204,212,21,2,1,3,4,1,0,4,8,12
p_22,6,0,e_0,146,165,215,28,2,2,0,5,1,0,19,50,69
p_25,9,0,e_0,163,176,215,9,0,0,5,5,1,1,13,39,52
p_28,7,0,e_0,184,192,215,6,1,0,10,4,1,0,8,23,31
p_24,14,0,e_1,157,176,232,17,1,1,8,5,0,1,19,56,75
p_18,15,0,e_1,120,181,232,28,2,2,3,4,1,0,61,51,112
p_23,15,0,e_1,150,181,232,18,1,1,6,5,1,1,31,51,82
p_31,5,0,e_1,203,213,232,16,2,1,8,4,1,0,10,19,29
p_33,1,0,e_1,213,227,232,17,2,1,5,1,1,0,14,5,19
p_36,1,0,e_1,225,227,232,13,2,0,2,4,1,1,2,5,7
p_32,0,10,e_2,209,212,244,19,2,2,1,4,1,0,3,32,35
p_35,0,6,e_0,222,223,245,15,3,3,0,3,0,0,1,22,23
p_27,5,0,e_3,180,197,272,5,0,0,0,3,0,0,17,75,92
p_29,14,0,e_3,192,226,272,11,1,0,3,5,0,1,34,46,80
p_34,11,0,e_3,217,237,272,6,2,1,11,5,1,1,20,35,55
p_44,4,0,e_3,275,289,303,4,0,0,0,3,0,0,14,14,28
p_41,7,0,e_1,257,281,304,28,1,1,0,3,0,0,24,23,47
p_38,12,0,e_0,240,265,307,29,1,1,4,5,1,0,25,42,67
p_42,4,0,e_0,269,291,307,27,1,1,11,4,1,0,22,16,38
p_43,4,0,e_0,270,291,307,26,1,1,11,4,1,1,21,16,37
p_47,3,0,e_0,293,296,307,30,1,1,4,4,1,1,3,11,14
p_39,13,0,e_2,247,255,312,25,1,1,11,5,0,1,8,57,65
p_37,15,0,e_2,228,263,312,29,2,2,5,5,1,0,35,49,84
p_40,15,0,e_2,255,263,312,20,1,1,13,5,1,1,8,49,57
p_49,3,0,e_2,298,301,312,28,2,2,4,4,1,0,3,11,14
p_51,0,4,e_2,309,312,326,21,2,2,1,4,1,0,3,14,17
p_54,7,0,e_2,313,337,362,12,2,2,0,5,1,0,24,25,49
p_59,3,0,e_2,335,351,362,9,2,1,7,5,0,2,16,11,27
p_46,8,0,e_0,291,333,363,26,1,1,4,1,1,0,42,30,72
p_53,8,0,e_0,313,333,363,11,2,2,2,5,0,1,20,30,50
p_56,8,0,e_0,324,333,363,7,2,2,5,5,0,1,9,30,39
p_60,2,0,e_0,338,353,363,10,2,1,7,4,1,1,15,10,25
p_57,1,0,e_0,327,358,363,14,2,2,6,5,0,1,31,5,36
p_62,1,0,e_0,345,358,363,9,1,0,4,4,1,2,13,5,18
p_48,9,0,e_3,294,332,375,24,1,1,3,4,1,0,38,43,81
p_50,11,0,e_3,299,340,375,20,2,2,1,4,1,1,41,35,76
p_58,0,6,e_2,330,362,382,13,2,2,5,5,0,1,32,20,52
p_45,11,0,e_1,290,339,396,23,1,1,4,4,1,0,49,57,106
p_61,12,0,e_1,341,344,396,29,1,1,11,5,1,1,3,52,55
p_52,14,0,e_1,312,352,396,12,2,0,2,5,0,1,40,44,84
p_55,14,0,e_1,314,352,396,11,2,0,3,5,0,2,38,44,82
p_65,0,7,e_3,369,375,398,2,1,0,2,4,1,0,6,23,29
p_64,0,15,e_0,365,365,416,3,1,0,0,3,0,1,0,51,51
p_68,2,0,e_3,389,415,423,8,1,1,4,5,1,0,26,8,34
p_69,2,0,e_3,391,415,423,7,2,1,5,5,1,1,24,8,32
p_66,11,0,e_2,376,399,444,11,1,0,4,5,1,0,23,45,68
p_67,12,0,e_2,377,404,444,12,1,0,5,5,1,1,27,40,67
p_72,6,0,e_2,417,424,444,26,1,1,8,4,1,0,7,20,27
p_70,3,0,e_1,398,409,446,4,1,0,0,3,0,0,11,37,48
p_71,7,0,e_1,403,423,446,27,1,1,1,5,0,1,20,23,43
p_73,3,0,e_3,423,435,446,3,0,0,0,3,0,0,12,11,23
p_63,3,0,e_0,364,378,467,30,1,1,0,3,0,0,14,89,103
p_74,10,0,e_0,424,433,467,10,1,0,13,4,1,0,9,34,43
p_75,3,0,e_0,438,456,467,30,1,1,9,4,1,0,18,11,29
p_77,4,0,e_1,455,469,483,4,0,0,0,3,0,0,14,14,28
p_81,1,0,e_0,493,498,503,6,1,0,0,3,0,0,5,5,10
p_79,9,0,e_3,457,486,515,9,0,0,0,3,0,0,29,29,58
p_76,10,0,e_2,440,476,530,22,1,1,1,4,1,0,36,54,90
p_78,12,0,e_2,455,484,530,12,0,0,3,5,0,1,29,46,75
p_80,13,0,e_2,474,489,530,8,1,0,9,5,0,2,15,41,56
p_82,0,12,e_1,494,494,534,7,1,0,0,3,0,0,0,40,40
p_83,0,12,e_0,501,503,543,4,1,0,0,4,1,0,2,40,42
p_90,1,0,e_2,538,543,548,7,2,2,0,3,0,0,5,5,10
p_87,3,0,e_3,528,540,569,3,0,0,0,3,0,0,12,29,41
p_93,4,0,e_3,543,545,569,2,2,1,4,5,1,1,2,24,26
p_89,5,0,e_3,535,550,569,3,1,0,2,5,0,1,15,19,34
p_94,3,0,e_3,546,558,569,3,2,1,4,5,1,1,12,11,23
p_88,10,0,e_0,531,535,585,10,1,0,9,5,1,0,4,50,54
p_92,10,0,e_0,540,551,585,7,2,0,11,5,2,0,11,34,45
p_95,10,0,e_0,547,551,585,6,3,0,11,4,1,1,4,34,38
p_96,7,0,e_0,551,562,585,28,2,2,10,4,1,0,11,23,34
p_84,12,0,e_1,504,534,590,22,1,1,2,5,1,0,30,56,86
p_85,14,0,e_1,517,542,590,14,0,0,6,5,1,0,25,48,73
p_86,14,0,e_1,518,542,590,14,0,0,7,5,1,1,24,48,72
p_91,14,0,e_1,539,542,590,11,2,0,13,5,1,1,3,48,51
p_99,9,0,e_1,556,559,590,25,2,2,10,4,1,1,3,31,34
p_98,6,0,e_1,555,570,590,28,2,2,10,4,1,0,15,20,35
p_111,2,0,e_1,607,616,624,6,2,1,0,3,0,0,9,8,17
p_107,3,0,e_3,584,594,633,11,2,2,0,5,0,2,10,39,49
p_106,5,0,e_3,583,602,633,5,0,0,0,3,0,0,19,31,50
p_108,7,0,e_3,584,610,633,7,1,0,0,5,0,1,26,23,49
p_117,0,2,e_3,636,636,646,0,0,0,0,3,0,0,0,10,10
p_97,5,0,e_2,552,569,648,30,2,2,0,3,0,0,17,79,96
p_101,9,0,e_2,566,583,648,22,1,1,4,5,0,2,17,65,82
p_100,10,0,e_2,557,588,648,23,1,1,1,5,0,1,31,60,91
p_105,12,0,e_2,582,596,648,12,0,0,9,5,1,3,14,52,66
p_110,12,0,e_2,590,596,648,10,3,0,10,5,1,2,6,52,58
p_102,14,0,e_2,568,604,648,16,1,1,5,5,0,3,36,44,80
p_103,14,0,e_2,577,604,648,14,0,0,7,5,1,3,27,44,71
p_104,14,0,e_2,581,604,648,14,0,0,9,5,1,3,23,44,67
p_109,10,0,e_0,590,623,669,8,3,0,0,3,0,0,33,46,79
p_112,11,0,e_0,613,628,669,25,1,1,7,5,0,1,15,41,56
p_113,9,0,e_0,629,636,669,22,1,1,11,4,1,0,7,33,40
p_115,9,0,e_0,632,636,669,9,0,0,10,4,1,1,4,33,37
p_116,7,0,e_0,633,644,669,7,0,0,10,4,1,1,11,25,36
p_121,3,0,e_0,656,658,669,9,1,1,4,4,1,0,2,11,13
p_123,0,2,e_2,661,661,671,11,2,2,0,3,0,0,0,10,10
p_125,2,0,e_2,668,671,679,7,2,1,1,5,1,0,3,8,11
p_126,1,0,e_0,681,687,692,5,1,0,0,3,0,0,6,5,11
p_122,7,0,e_3,657,667,698,5,1,1,4,5,0,1,10,31,41
p_124,7,0,e_3,664,667,698,3,2,1,6,5,0,2,3,31,34
p_118,8,0,e_3,649,672,698,6,0,0,2,3,0,0,23,26,49
p_119,8,0,e_3,650,672,698,6,1,0,2,5,0,1,22,26,48
p_114,13,0,e_1,632,673,714,17,1,1,0,3,0,0,41,41,82
p_120,13,0,e_1,653,673,714,10,1,0,7,5,0,1,20,41,61
p_129,5,0,e_2,705,722,739,5,0,0,0,3,0,0,17,17,34
p_128,0,15,e_3,705,706,757,0,0,0,0,3,0,0,1,51,52
p_127,7,0,e_0,701,725,796,7,0,0,0,3,0,0,24,71,95
p_130,11,0,e_0,705,739,796,11,0,0,1,5,0,1,34,57,91
p_134,14,0,e_0,734,750,796,8,1,1,9,5,1,1,16,46,62
p_140,5,0,e_0,768,779,796,8,1,0,8,4,1,0,11,17,28
p_136,14,0,e_3,749,752,806,3,1,1,13,5,1,0,3,54,57
p_137,13,0,e_3,755,765,806,3,2,1,14,5,2,0,10,41,51
p_132,4,0,e_1,730,736,808,19,1,1,2,5,0,1,6,72,78
p_133,6,0,e_1,734,744,808,16,1,1,4,5,0,2,10,64,74
p_131,7,0,e_1,722,749,808,19,1,1,0,3,0,0,27,59,86
p_135,11,0,e_1,739,763,808,9,1,1,5,5,1,2,24,45,69
p_138,12,0,e_1,756,768,808,3,3,0,9,5,1,1,12,40,52
p_143,5,0,e_1,780,791,808,4,1,0,8,4,1,0,11,17,28
p_139,0,15,e_2,758,759,812,15,2,0,0,3,0,0,1,53,54
p_145,1,0,e_1,820,826,831,1,0,0,0,3,0,0,6,5,11
p_144,6,0,e_0,815,836,856,6,0,0,0,3,0,0,21,20,41
p_141,12,0,e_2,770,799,859,30,1,1,3,5,1,0,29,60,89
p_142,13,0,e_2,773,804,859,28,1,1,4,5,1,1,31,55,86
p_150,3,0,e_0,860,871,882,6,1,1,0,3,0,0,11,11,22
p_147,6,0,e_3,849,869,929,6,0,0,0,3,0,0,20,60,80
p_149,6,0,e_3,859,869,929,3,1,0,3,5,0,1,10,60,70
p_155,11,0,e_3,884,886,929,3,2,1,10,5,1,1,2,43,45
p_151,12,0,e_3,863,891,929,8,1,0,4,5,0,1,28,38,66
p_156,12,0,e_3,884,891,929,2,3,0,10,5,1,2,7,38,45
p_152,2,0,e_2,868,877,929,16,1,1,0,3,0,0,9,52,61
p_154,4,0,e_2,874,885,929,13,2,1,1,5,0,2,11,44,55
p_153,6,0,e_2,872,893,929,12,2,1,1,5,0,1,21,36,57
p_157,7,0,e_2,889,898,929,6,2,1,5,5,1,1,9,31,40
p_158,7,0,e_2,892,898,929,5,1,0,6,5,1,2,6,31,37
p_159,8,0,e_2,893,903,929,4,1,0,6,2,1,1,10,26,36
p_146,10,0,e_1,846,878,942,10,0,0,0,3,0,0,32,64,96
p_148,15,0,e_1,849,895,942,15,1,0,0,5,0,1,46,47,93
p_3,4,0,e_2,25,39,53,4,0,0,0,3,0,0,14,14,28
p_7,2,0,e_2,55,63,71,10,2,1,0,3,0,0,8,8,16
p_6,9,0,e_1,45,49,92,6,2,0,8,5,0,1,4,43,47
p_2,11,0,e_1,19,57,92,11,0,0,0,3,0,0,38,35,73
p_1,13,0,e_0,13,54,95,13,0,0,0,3,0,0,41,41,82
p_12,0,8,e_1,86,92,118,15,1,1,2,4,1,0,6,26,32
p_15,5,0,e_0,99,116,133,7,1,0,0,3,0,0,17,17,34
p_4,5,0,e_3,34,51,138,5,0,0,0,3,0,0,17,87,104
p_5,9,0,e_3,41,65,138,7,1,0,2,5,0,1,24,73,97
p_9,10,0,e_3,67,70,138,11,2,1,9,5,1,1,3,68,71
p_8,15,0,e_3,62,87,138,7,2,0,8,5,1,1,25,51,76
p_14,13,0,e_3,87,95,138,2,1,0,15,4,1,0,8,43,51
p_16,4,0,e_3,101,124,138,8,1,0,12,4,1,0,23,14,37
p_11,4,0,e_2,84,91,139,12,2,1,2,5,0,1,7,48,55
p_13,8,0,e_2,87,105,139,7,2,1,3,5,0,2,18,34,52
p_10,9,0,e_2,77,110,139,9,2,1,0,3,0,0,33,29,62
p_19,0,7,e_0,125,133,156,4,1,0,3,4,1,0,8,23,31
p_21,0,10,e_2,142,142,176,0,0,0,0,3,0,0,0,34,34
p_17,10,0,e_1,112,126,192,28,2,2,6,5,1,0,14,66,80
p_18,15,0,e_1,120,143,192,20,2,2,8,5,0,1,23,49,72
p_26,6,0,e_1,169,172,192,5,2,1,7,4,1,0,3,20,23
p_20,3,0,e_3,142,154,207,3,0,0,0,3,0,0,12,53,65
p_22,6,0,e_3,146,165,207,6,1,0,0,5,0,1,19,42,61
p_25,9,0,e_3,163,176,207,3,2,0,6,5,1,1,13,31,44
p_27,5,0,e_3,180,190,207,3,1,0,8,4,1,0,10,17,27
p_23,15,0,e_0,150,182,233,13,2,0,5,5,1,0,32,51,83
p_28,7,0,e_0,184,208,233,30,2,2,15,4,1,0,24,25,49
p_33,1,0,e_0,213,228,233,19,1,1,6,4,1,0,15,5,20
p_36,1,0,e_0,225,228,233,17,2,2,2,4,1,1,3,5,8
p_24,14,0,e_2,157,190,238,10,2,0,4,5,1,0,33,48,81
p_31,5,0,e_2,203,219,238,26,1,1,10,4,1,1,16,19,35
p_30,2,0,e_2,200,230,238,30,1,1,11,4,1,0,30,8,38
p_32,0,10,e_3,209,210,244,0,0,0,0,3,0,0,1,34,35
p_35,0,6,e_0,222,233,253,19,2,2,3,4,1,1,11,20,31
p_29,14,0,e_1,192,237,293,21,1,1,0,3,0,0,45,56,101
p_37,15,0,e_1,228,242,293,10,2,0,11,5,0,1,14,51,65
p_38,12,0,e_1,240,253,293,3,2,0,15,5,1,1,13,40,53
p_42,4,0,e_1,269,279,293,5,1,0,7,4,1,0,10,14,24
p_44,4,0,e_1,275,279,293,4,2,0,5,4,1,1,4,14,18
p_34,11,0,e_3,217,249,300,10,1,0,1,5,1,0,32,51,83
p_39,13,0,e_3,247,257,300,3,1,0,10,5,0,1,10,43,53
p_43,4,0,e_3,270,286,300,5,1,0,9,4,1,0,16,14,30
p_41,7,0,e_2,257,281,304,6,1,0,0,3,0,0,24,23,47
p_51,0,4,e_2,309,310,326,0,0,0,0,3,0,0,1,16,17
p_40,15,0,e_0,255,284,339,3,2,0,6,3,0,0,29,55,84
p_45,11,0,e_0,290,298,339,22,1,1,14,4,1,0,8,41,49
p_46,8,0,e_0,291,309,339,25,1,1,13,4,1,1,18,30,48
p_49,3,0,e_0,298,326,339,28,1,1,11,1,1,1,28,13,41
p_57,1,0,e_0,327,334,339,22,1,1,3,4,1,0,7,5,12
p_58,0,6,e_0,330,339,359,23,1,1,2,4,1,1,9,20,29
p_47,3,0,e_1,293,304,369,29,1,1,0,3,1,0,11,65,76
p_48,9,0,e_1,294,324,369,23,1,1,0,5,0,1,30,45,75
p_50,11,0,e_1,299,332,369,19,1,1,2,5,0,2,33,37,70
p_59,3,0,e_1,335,358,369,18,1,1,10,4,1,0,23,11,34
p_54,7,0,e_2,313,337,370,21,1,1,0,5,1,0,24,33,57
p_53,8,0,e_2,313,342,370,20,1,1,0,5,1,1,29,28,57
p_56,8,0,e_2,324,342,370,16,1,1,4,5,1,2,18,28,46
p_60,2,0,e_2,338,362,370,18,1,1,7,5,1,1,24,8,32
p_63,3,0,e_0,364,370,383,9,1,0,5,4,0,1,6,13,19
p_62,1,0,e_0,345,378,383,17,2,2,2,5,1,0,33,5,38
p_65,0,7,e_1,369,369,394,11,1,0,0,3,1,0,0,25,25
p_61,12,0,e_3,341,350,404,7,1,1,9,5,0,1,9,54,63
p_52,14,0,e_3,312,358,404,14,0,0,0,3,0,0,46,46,92
p_55,14,0,e_3,314,358,404,14,1,0,0,5,0,1,44,46,90
p_69,2,0,e_3,391,396,404,1,1,0,3,4,1,0,5,8,13
p_68,2,0,e_0,389,397,405,2,1,0,0,3,0,0,8,8,16
p_64,0,15,e_1,365,369,420,12,1,0,1,4,1,0,4,51,55
p_71,7,0,e_3,403,427,452,7,0,0,0,3,1,0,24,25,49
p_75,3,0,e_3,438,441,452,1,1,0,4,4,1,0,3,11,14
p_66,11,0,e_2,376,411,456,27,1,1,0,3,0,0,35,45,80
p_67,12,0,e_2,377,416,456,26,1,1,0,5,0,1,39,40,79
p_73,3,0,e_2,423,445,456,5,1,1,10,4,1,0,22,11,33
p_72,6,0,e_0,417,437,457,4,1,1,0,3,0,0,20,20,40
p_74,10,0,e_1,424,437,471,4,1,0,14,4,0,1,13,34,47
p_70,3,0,e_1,398,460,471,29,1,1,8,5,1,0,62,11,73
p_77,4,0,e_2,455,470,484,15,1,1,0,3,1,0,15,14,29
p_81,1,0,e_1,493,499,504,11,1,0,0,3,0,0,6,5,11
p_76,10,0,e_3,440,484,530,23,1,1,3,1,1,0,44,46,90
p_78,12,0,e_3,455,492,530,11,1,0,1,5,0,1,37,38,75
p_82,0,12,e_2,494,494,534,12,1,0,0,3,0,0,0,40,40
p_83,0,12,e_1,501,504,542,9,1,0,1,4,1,0,3,38,41
p_79,9,0,e_0,457,486,545,14,2,2,0,3,1,0,29,59,88
p_80,13,0,e_0,474,500,545,6,2,0,5,5,0,1,26,45,71
p_87,3,0,e_0,528,532,545,27,1,1,4,4,1,0,4,13,17
p_90,1,0,e_0,538,540,545,17,1,1,2,4,1,0,2,5,7
p_85,14,0,e_2,517,542,592,20,1,1,7,5,1,0,25,50,75
p_91,14,0,e_2,539,542,592,12,1,0,13,5,0,2,3,50,53
p_95,10,0,e_2,547,556,592,6,2,0,13,4,1,1,9,36,45
p_98,6,0,e_2,555,570,592,7,2,1,10,1,1,1,15,22,37
p_89,5,0,e_2,535,575,592,14,1,1,12,5,0,1,40,17,57
p_93,4,0,e_3,543,545,599,12,1,1,4,5,0,1,2,54,56
p_88,10,0,e_3,531,565,599,10,0,0,0,3,0,0,34,34,68
p_92,10,0,e_3,540,565,599,7,1,0,3,5,0,1,25,34,59
p_100,10,0,e_3,557,565,599,3,2,0,7,5,1,1,8,34,42
p_101,9,0,e_3,566,570,599,1,1,0,10,4,1,0,4,29,33
p_84,12,0,e_1,504,542,600,27,1,1,0,3,1,0,38,58,96
p_86,14,0,e_1,518,550,600,20,1,1,4,5,1,0,32,50,82
p_99,9,0,e_1,556,567,600,4,2,1,13,4,1,1,11,33,44
p_97,5,0,e_1,552,581,600,9,2,1,14,4,1,0,29,19,48
p_107,3,0,e_1,584,589,600,2,1,0,4,4,1,0,5,11,16
p_111,2,0,e_1,607,616,624,2,0,0,0,3,0,0,9,8,17
p_94,3,0,e_0,546,558,647,13,2,1,0,3,0,0,12,89,101
p_96,7,0,e_0,551,572,647,7,2,1,1,5,0,1,21,75,96
p_105,12,0,e_0,582,589,647,24,1,1,10,5,1,1,7,58,65
p_102,14,0,e_0,568,597,647,25,2,2,6,5,1,1,29,50,79
p_103,14,0,e_0,577,597,647,23,1,1,8,5,1,1,20,50,70
p_104,14,0,e_0,581,597,647,22,1,1,10,5,1,1,16,50,66
p_109,10,0,e_0,590,611,647,23,1,1,12,5,1,3,21,36,57
p_108,7,0,e_0,584,622,647,28,1,1,10,5,1,3,38,25,63
p_106,5,0,e_0,583,630,647,30,1,1,10,5,1,2,47,17,64
p_117,0,2,e_0,636,647,655,19,2,2,4,4,1,0,11,8,19
p_110,12,0,e_2,590,630,674,21,1,1,0,4,1,0,40,44,84
p_113,9,0,e_2,629,641,674,8,1,1,12,5,0,1,12,33,45
p_116,7,0,e_2,633,649,674,13,2,2,11,4,1,1,16,25,41
p_121,3,0,e_2,656,663,674,10,1,0,5,4,1,0,7,11,18
p_123,0,2,e_2,661,674,682,12,2,0,3,4,1,1,13,8,21
p_126,1,0,e_2,681,687,692,5,1,0,2,5,1,0,6,5,11
p_119,8,0,e_1,650,659,695,7,2,1,5,5,0,1,9,36,45
p_115,9,0,e_1,632,664,695,11,2,2,0,3,0,0,32,31,63
p_125,2,0,e_1,668,687,695,7,2,1,8,4,1,0,19,8,27
p_112,11,0,e_3,613,648,699,11,0,0,0,3,0,0,35,51,86
p_114,13,0,e_3,632,656,699,7,1,0,6,5,0,1,24,43,67
p_120,13,0,e_3,653,656,699,1,2,0,12,5,1,1,3,43,46
p_122,7,0,e_3,657,676,699,6,1,0,13,4,1,0,19,23,42
p_124,7,0,e_0,664,672,703,4,2,0,5,5,0,1,8,31,39
p_118,8,0,e_0,649,677,703,7,2,1,0,5,1,0,28,26,54
p_129,5,0,e_2,705,723,740,5,0,0,0,3,0,0,18,17,35
p_127,7,0,e_1,701,725,750,7,0,0,0,3,0,0,24,25,49
p_131,7,0,e_1,722,725,750,19,1,1,6,5,0,1,3,25,28
p_132,4,0,e_1,730,736,750,19,1,1,6,4,1,0,6,14,20
p_128,0,15,e_3,705,706,757,0,0,0,0,3,0,0,1,51,52
p_130,11,0,e_0,705,740,801,11,0,0,0,3,0,0,35,61,96
p_134,14,0,e_0,734,751,801,8,1,1,9,5,0,2,17,50,67
p_138,12,0,e_0,756,759,801,3,2,0,13,4,1,1,3,42,45
p_133,6,0,e_0,734,779,801,16,1,1,9,5,0,1,45,22,67
p_143,5,0,e_0,780,784,801,3,2,0,6,4,1,0,4,17,21
p_139,0,15,e_1,758,758,807,15,2,0,0,3,0,0,0,49,49
p_136,14,0,e_3,749,752,808,3,1,1,13,5,1,0,3,56,59
p_137,13,0,e_3,755,765,808,2,2,0,15,5,2,0,10,43,53
p_140,5,0,e_3,768,791,808,8,1,0,13,4,1,0,23,17,40
p_135,11,0,e_2,739,775,826,9,1,1,0,3,1,0,36,51,87
p_141,12,0,e_2,770,780,826,30,2,2,9,5,0,1,10,46,56
p_142,13,0,e_2,773,785,826,28,2,2,11,5,0,2,12,41,53
p_145,1,0,e_3,820,826,831,1,0,0,0,3,0,0,6,5,11
p_144,6,0,e_0,815,836,856,6,0,0,0,3,0,0,21,20,41
p_146,10,0,e_1,846,863,899,10,0,0,15,3,0,0,17,36,53
p_154,4,0,e_1,874,883,899,18,1,1,7,4,1,1,9,16,25
p_152,2,0,e_1,868,891,899,22,1,1,9,4,1,0,23,8,31
p_149,6,0,e_0,859,880,900,21,1,1,0,3,0,0,21,20,41
p_153,6,0,e_0,872,880,900,17,1,1,3,5,0,1,8,20,28
p_147,6,0,e_2,849,869,933,6,0,0,0,3,0,0,20,64,84
p_151,12,0,e_2,863,889,933,14,1,1,4,5,0,2,26,44,70
p_156,12,0,e_2,884,889,933,7,2,1,10,5,1,2,5,44,49
p_159,8,0,e_2,893,903,933,8,2,1,11,4,1,2,10,30,40
p_157,7,0,e_2,889,908,933,10,2,1,12,2,1,1,19,25,44
p_158,7,0,e_2,892,908,933,9,2,1,11,4,1,2,16,25,41
p_150,3,0,e_2,860,922,933,24,1,1,3,5,0,1,62,11,73
p_148,15,0,e_3,849,896,945,15,0,0,0,3,0,0,47,49,96
p_155,11,0,e_3,884,910,945,8,1,1,11,5,0,1,26,35,61
p_3,4,0,e_2,25,40,88,4,0,0,0,3,0,0,15,48,63
p_4,5,0,e_2,34,45,88,5,0,0,2,5,0,1,11,43,54
p_5,9,0,e_2,41,59,88,9,0,0,4,5,1,1,18,29,47
p_6,9,0,e_2,45,59,88,9,0,0,5,2,1,1,14,29,43
p_2,11,0,e_1,19,55,90,11,0,0,0,3,0,0,36,35,71
p_1,13,0,e_0,13,54,95,13,0,0,0,3,0,0,41,41,82
p_12,0,8,e_2,86,88,114,21,3,3,0,4,1,1,2,26,28
p_11,4,0,e_1,84,104,126,17,3,2,2,4,1,0,20,22,42
p_16,4,0,e_1,101,104,126,13,2,1,3,5,0,2,3,22,25
p_15,5,0,e_1,99,109,126,12,3,1,2,5,0,1,10,17,27
p_13,8,0,e_0,87,121,147,13,3,2,2,4,1,0,34,26,60
p_19,0,7,e_1,125,126,151,10,1,0,0,3,1,0,1,25,26
p_7,2,0,e_3,55,63,157,2,0,0,0,3,0,0,8,94,102
p_9,10,0,e_3,67,89,157,17,2,1,3,5,1,1,22,68,90
p_14,13,0,e_3,87,100,157,8,3,1,9,5,1,2,13,57,70
p_8,15,0,e_3,62,108,157,13,1,0,2,5,0,1,46,49,95
p_20,3,0,e_3,142,146,157,1,1,0,4,4,1,0,4,11,15
p_21,0,10,e_0,142,147,179,4,1,0,2,4,1,0,5,32,37
p_10,9,0,e_2,77,119,190,15,3,2,3,4,1,0,42,71,113
p_17,10,0,e_2,112,124,190,4,1,0,7,5,1,1,12,66,78
p_18,15,0,e_2,120,141,190,26,1,1,9,5,1,1,21,49,70
p_22,6,0,e_2,146,170,190,27,1,1,14,4,1,0,24,20,44
p_30,2,0,e_2,200,208,216,6,1,0,0,3,0,0,8,8,16
p_26,6,0,e_3,169,183,227,10,1,1,2,5,0,1,14,44,58
p_25,9,0,e_3,163,194,227,9,0,0,0,3,0,0,31,33,64
p_31,5,0,e_3,203,208,227,1,1,0,6,4,1,0,5,19,24
p_33,1,0,e_3,213,222,227,3,1,0,4,4,1,0,9,5,14
p_23,15,0,e_1,150,177,228,17,1,1,7,5,1,0,27,51,78
p_28,7,0,e_1,184,203,228,5,2,1,13,4,1,1,19,25,44
p_27,5,0,e_1,180,211,228,8,2,2,14,4,1,0,31,17,48
p_24,14,0,e_0,157,193,239,14,0,0,3,5,1,0,36,46,82
p_29,14,0,e_0,192,193,239,6,2,0,14,5,0,1,1,46,47
p_36,1,0,e_0,225,234,239,30,1,1,4,4,1,0,9,5,14
p_35,0,6,e_3,222,227,247,1,1,0,1,1,1,0,5,20,25
p_32,0,10,e_2,209,216,248,5,1,0,2,4,1,0,7,32,39
p_42,4,0,e_1,269,284,298,10,2,1,0,3,0,0,15,14,29
p_44,4,0,e_1,275,284,298,9,2,0,1,5,0,1,9,14,23
p_41,7,0,e_0,257,280,303,10,2,2,0,3,0,0,23,23,46
p_38,12,0,e_3,240,267,315,8,1,0,4,5,1,0,27,48,75
p_39,13,0,e_3,247,272,315,7,1,0,6,2,1,1,25,43,68
p_43,4,0,e_3,270,301,315,9,2,0,13,5,1,1,31,14,45
p_34,11,0,e_2,217,253,316,22,2,2,0,5,1,0,36,63,99
p_37,15,0,e_2,228,267,316,15,1,0,3,5,1,1,39,49,88
p_40,15,0,e_2,255,267,316,7,2,0,11,5,1,1,12,49,61
p_47,3,0,e_2,293,305,316,3,2,1,7,4,1,0,12,11,23
p_49,3,0,e_2,298,305,316,2,2,1,5,4,1,1,7,11,18
p_51,0,4,e_2,309,316,330,2,1,0,2,4,1,0,7,14,21
p_57,1,0,e_3,327,332,337,1,0,0,0,3,0,0,5,5,10
p_54,7,0,e_0,313,326,359,24,1,1,3,5,0,1,13,33,46
p_46,8,0,e_0,291,331,359,29,2,2,4,4,1,0,40,28,68
p_53,8,0,e_0,313,331,359,23,1,1,3,5,0,2,18,28,46
p_56,8,0,e_0,324,331,359,8,0,0,6,5,0,2,7,28,35
p_59,3,0,e_0,335,348,359,27,1,1,7,4,1,0,13,11,24
p_58,0,6,e_2,330,344,364,1,1,1,4,3,1,0,14,20,34
p_63,3,0,e_0,364,376,387,14,2,1,0,3,0,0,12,11,23
p_48,9,0,e_1,294,327,392,27,2,2,1,4,1,1,33,65,98
p_45,11,0,e_1,290,335,392,26,2,2,3,4,1,0,45,57,102
p_50,11,0,e_1,299,335,392,23,2,2,0,5,0,2,36,57,93
p_52,14,0,e_1,312,346,392,17,1,1,4,5,0,2,34,46,80
p_55,14,0,e_1,314,346,392,16,1,1,5,5,0,3,32,46,78
p_62,1,0,e_1,345,387,392,21,2,1,14,5,1,1,42,5,47
p_68,2,0,e_0,389,398,406,8,1,0,0,3,0,0,9,8,17
p_69,2,0,e_0,391,398,406,7,1,0,0,5,0,1,7,8,15
p_65,0,7,e_2,369,385,408,15,2,2,5,4,0,1,16,23,39
p_60,2,0,e_3,338,347,419,2,0,0,0,3,0,0,9,72,81
p_61,12,0,e_3,341,379,419,12,1,0,0,5,0,1,38,40,78
p_67,12,0,e_3,377,379,419,0,3,0,12,5,1,2,2,40,42
p_66,11,0,e_3,376,384,419,2,2,1,11,5,1,1,8,35,43
p_64,0,15,e_2,365,385,434,17,2,2,6,3,0,0,20,49,69
p_73,3,0,e_3,423,434,445,3,0,0,0,3,0,0,11,11,22
p_70,3,0,e_1,398,409,446,4,1,0,0,3,0,0,11,37,48
p_71,7,0,e_1,403,423,446,28,1,1,1,5,0,1,20,23,43
p_72,6,0,e_0,417,437,483,24,1,1,0,3,0,0,20,46,66
p_74,10,0,e_0,424,451,483,10,1,0,2,5,0,1,27,32,59
p_76,10,0,e_0,440,451,483,21,1,1,6,5,1,1,11,32,43
p_77,4,0,e_1,455,469,483,4,0,0,0,3,0,0,14,14,28
p_79,9,0,e_2,457,459,490,15,1,1,10,4,0,1,2,31,33
p_75,3,0,e_2,438,479,490,29,1,1,15,3,0,0,41,11,52
p_81,1,0,e_0,493,499,504,13,1,1,0,3,0,0,6,5,11
p_82,0,12,e_1,494,495,535,14,1,1,0,3,0,0,1,40,41
p_78,12,0,e_3,455,494,542,12,0,0,0,3,0,0,39,48,87
p_80,13,0,e_3,474,499,542,7,1,0,6,5,0,1,25,43,68
p_87,3,0,e_3,528,531,542,1,1,0,4,4,1,0,3,11,14
p_83,0,12,e_2,501,502,542,13,1,0,0,3,0,0,1,40,41
p_93,4,0,e_3,543,557,587,4,0,0,0,3,0,0,14,30,44
p_97,5,0,e_3,552,562,587,3,1,0,2,5,0,1,10,25,35
p_98,6,0,e_3,555,567,587,2,2,0,4,5,0,2,12,20,32
p_95,10,0,e_2,547,550,588,9,1,0,11,4,0,2,3,38,41
p_96,7,0,e_2,551,561,588,5,1,0,10,4,1,2,10,27,37
p_89,5,0,e_2,535,569,588,27,1,1,10,5,1,0,34,19,53
p_90,1,0,e_2,538,583,588,30,1,1,11,5,1,1,45,5,50
p_84,12,0,e_1,504,535,591,30,1,1,2,5,1,0,31,56,87
p_85,14,0,e_1,517,543,591,24,1,1,6,5,1,0,26,48,74
p_86,14,0,e_1,518,543,591,23,1,1,7,5,1,1,25,48,73
p_91,14,0,e_1,539,543,591,17,1,1,13,5,1,1,4,48,52
p_99,9,0,e_1,556,560,591,5,3,0,10,4,1,1,4,31,35
p_94,3,0,e_1,546,580,591,5,1,1,13,4,1,0,34,11,45
p_88,10,0,e_0,531,563,599,23,1,1,0,3,0,0,32,36,68
p_92,10,0,e_0,540,563,599,21,1,1,2,5,0,1,23,36,59
p_100,10,0,e_0,557,563,599,6,3,0,8,5,0,1,6,36,42
p_101,9,0,e_0,566,568,599,3,2,0,10,4,1,0,2,31,33
p_107,3,0,e_0,584,588,599,28,2,2,4,4,1,1,4,11,15
p_106,5,0,e_2,583,605,674,26,2,2,1,4,1,1,22,69,91
p_112,11,0,e_2,613,625,674,10,2,1,7,5,1,2,12,49,61
p_105,12,0,e_2,582,630,674,19,2,2,1,1,1,0,48,44,92
p_110,12,0,e_2,590,630,674,15,2,1,0,5,0,2,40,44,84
p_113,9,0,e_2,629,641,674,6,2,1,12,5,1,2,12,33,45
p_115,9,0,e_2,632,641,674,5,2,0,12,4,1,2,9,33,42
p_121,3,0,e_2,656,661,674,5,2,1,4,4,1,1,5,13,18
p_111,2,0,e_2,607,666,674,20,2,2,5,5,1,1,59,8,67
p_117,0,2,e_2,636,674,682,13,2,0,11,4,1,2,38,8,46
p_123,0,2,e_2,661,674,682,6,1,0,3,4,1,1,13,8,21
p_108,7,0,e_3,584,610,683,24,2,2,1,4,1,1,26,73,99
p_102,14,0,e_3,568,633,683,22,1,1,6,4,1,0,65,50,115
p_118,8,0,e_3,649,653,683,1,2,0,9,4,1,1,4,30,34
p_119,8,0,e_3,650,653,683,1,3,0,9,4,1,2,3,30,33
p_116,7,0,e_3,633,658,683,21,1,0,14,2,1,0,25,25,50
p_125,2,0,e_3,668,675,683,2,2,0,4,4,1,1,7,8,15
p_109,10,0,e_1,590,623,685,17,2,1,0,3,1,1,33,62,95
p_114,13,0,e_1,632,634,685,27,1,0,12,5,1,1,2,51,53
p_104,14,0,e_1,581,639,685,18,2,2,3,4,1,0,58,46,104
p_122,7,0,e_1,657,662,685,30,2,2,8,4,1,1,5,23,28
p_103,14,0,e_0,577,643,689,19,2,2,6,4,1,0,66,46,112
p_126,1,0,e_0,681,684,689,30,2,2,2,4,1,0,3,5,8
p_128,0,15,e_0,705,706,757,7,1,1,0,3,0,0,1,51,52
p_124,7,0,e_3,664,706,761,28,1,1,5,4,1,0,42,55,97
p_127,7,0,e_3,701,706,761,2,1,0,5,5,0,1,5,55,60
p_130,11,0,e_3,705,720,761,8,1,0,7,2,0,1,15,41,56
p_131,7,0,e_3,722,734,761,4,2,0,11,4,1,1,12,27,39
p_133,6,0,e_3,734,739,761,1,2,0,7,4,1,1,5,22,27
p_129,5,0,e_3,705,744,761,2,1,0,7,5,0,1,39,17,56
p_120,13,0,e_1,653,726,767,25,2,2,10,4,1,0,73,41,114
p_140,5,0,e_1,768,785,802,23,1,1,0,3,0,0,17,17,34
p_143,5,0,e_1,780,785,802,19,1,1,3,5,0,1,5,17,22
p_135,11,0,e_0,739,743,808,25,2,2,10,5,1,0,4,65,69
p_137,13,0,e_0,755,765,808,19,1,1,14,5,2,0,10,43,53
p_138,12,0,e_0,756,770,808,19,1,1,15,5,2,1,14,38,52
p_139,0,15,e_3,758,761,808,1,1,0,1,4,1,0,3,47,50
p_132,4,0,e_2,730,738,818,4,3,2,2,3,0,0,8,80,88
p_134,14,0,e_2,734,770,818,23,3,3,3,5,0,1,36,48,84
p_136,14,0,e_2,749,770,818,20,1,1,7,5,1,1,21,48,69
p_142,13,0,e_2,773,775,818,14,1,1,14,4,1,1,2,43,45
p_141,12,0,e_2,770,780,818,15,1,1,14,4,1,0,10,38,48
p_145,1,0,e_1,820,826,831,14,0,0,0,3,0,0,6,5,11
p_144,6,0,e_0,815,835,855,9,0,0,0,3,0,0,20,20,40
p_150,3,0,e_0,860,871,882,8,1,1,0,3,0,0,11,11,22
p_146,10,0,e_3,846,863,901,5,0,0,15,3,0,0,17,38,55
p_153,6,0,e_3,872,877,901,2,2,0,8,4,1,1,5,24,29
p_154,4,0,e_3,874,885,901,3,3,1,7,4,1,2,11,16,27
p_152,2,0,e_3,868,893,901,7,1,0,9,4,1,0,25,8,33
p_147,6,0,e_2,849,869,931,9,1,1,0,3,0,0,20,62,82
p_149,6,0,e_2,859,869,931,5,1,1,3,5,0,1,10,62,72
p_151,12,0,e_2,863,889,931,28,1,1,4,5,0,1,26,42,68
p_156,12,0,e_2,884,889,931,22,2,2,11,5,1,1,5,42,47
p_159,8,0,e_2,893,903,931,24,1,1,11,4,1,1,10,28,38
p_157,7,0,e_2,889,908,931,26,2,2,12,2,1,0,19,23,42
p_158,7,0,e_2,892,908,931,25,1,1,11,4,1,1,16,23,39
p_148,15,0,e_1,849,896,943,20,1,1,0,3,0,0,47,47,94
p_155,11,0,e_0,884,920,955,23,3,3,0,3,0,0,36,35,71
p_3,4,0,e_2,25,39,87,4,0,0,0,3,0,0,14,48,62
p_4,5,0,e_2,34,44,87,5,0,0,3,5,0,1,10,43,53
p_5,9,0,e_2,41,58,87,9,0,0,4,5,1,1,17,29,46
p_6,9,0,e_2,45,58,87,9,0,0,5,5,1,1,13,29,42
p_2,11,0,e_1,19,55,90,11,0,0,0,3,0,0,36,35,71
p_1,13,0,e_0,13,55,96,13,0,0,0,3,0,0,42,41,83
p_12,0,8,e_2,86,87,115,21,4,4,0,3,1,0,1,28,29
p_16,4,0,e_1,101,115,129,13,3,1,0,3,0,0,14,14,28
p_15,5,0,e_0,99,116,133,13,3,1,0,3,0,0,17,17,34
p_19,0,7,e_1,125,129,154,10,2,0,1,4,1,0,4,25,29
p_7,2,0,e_3,55,63,159,2,0,0,0,3,0,0,8,96,104
p_10,9,0,e_3,77,86,159,15,3,2,6,5,1,2,9,73,82
p_9,10,0,e_3,67,91,159,17,2,1,3,5,1,1,24,68,92
p_8,15,0,e_3,62,108,159,17,0,0,2,2,0,0,46,51,97
p_17,10,0,e_3,112,125,159,4,2,0,14,4,1,1,13,34,47
p_11,4,0,e_3,84,145,159,17,4,2,9,5,1,3,61,14,75
p_20,3,0,e_0,142,153,164,2,2,1,0,3,0,0,11,11,22
p_13,8,0,e_2,87,115,187,13,4,2,0,3,1,1,28,72,100
p_14,13,0,e_2,87,132,187,8,4,1,0,3,1,0,45,55,100
p_18,15,0,e_2,120,140,187,26,3,3,9,5,1,1,20,47,67
p_21,0,10,e_3,142,159,193,5,2,0,5,4,1,1,17,34,51
p_30,2,0,e_2,200,208,216,14,2,1,0,3,0,0,8,8,16
p_27,5,0,e_0,180,187,222,8,2,2,3,5,0,1,7,35,42
p_26,6,0,e_0,169,192,222,11,2,2,0,3,0,0,23,30,53
p_28,7,0,e_0,184,197,222,5,2,2,4,5,0,2,13,25,38
p_33,1,0,e_0,213,217,222,11,1,0,2,4,1,0,4,5,9
p_22,6,0,e_1,146,149,233,28,1,1,5,5,1,0,3,84,87
p_24,14,0,e_1,157,177,233,17,1,1,8,5,1,1,20,56,76
p_23,15,0,e_1,150,182,233,18,1,1,6,5,2,0,32,51,83
p_31,5,0,e_1,203,214,233,10,2,1,9,4,1,0,11,19,30
p_36,1,0,e_1,225,228,233,8,1,0,2,4,1,0,3,5,8
p_35,0,6,e_0,222,223,245,9,1,0,0,3,0,0,1,22,23
p_32,0,10,e_2,209,216,248,14,1,0,2,4,1,0,7,32,39
p_25,9,0,e_3,163,188,251,10,1,1,1,5,1,0,25,63,88
p_29,14,0,e_3,192,207,251,4,2,0,10,5,2,0,15,44,59
p_42,4,0,e_3,269,283,297,4,0,0,0,3,0,0,14,14,28
p_43,4,0,e_3,270,283,297,4,1,0,0,5,0,1,13,14,27
p_44,4,0,e_3,275,283,297,2,1,0,2,5,0,1,8,14,22
p_41,7,0,e_1,257,281,304,7,0,0,0,3,0,0,24,23,47
p_38,12,0,e_0,240,265,313,22,1,1,4,5,1,0,25,48,73
p_39,13,0,e_0,247,270,313,18,1,1,6,5,0,1,23,43,66
p_47,3,0,e_0,293,302,313,28,2,2,6,4,1,0,9,11,20
p_34,11,0,e_2,217,253,316,30,1,1,0,5,1,0,36,63,99
p_37,15,0,e_2,228,267,316,22,1,1,4,5,1,1,39,49,88
p_40,15,0,e_2,255,267,316,15,0,0,11,5,1,1,12,49,61
p_49,3,0,e_2,298,305,316,19,2,2,5,4,1,0,7,11,18
p_51,0,4,e_0,309,313,327,19,2,2,1,4,1,0,4,14,18
p_54,7,0,e_0,313,338,367,16,3,3,0,5,1,0,25,29,54
p_59,3,0,e_0,335,352,367,14,2,1,6,5,0,3,17,15,32
p_60,2,0,e_0,338,357,367,14,2,1,7,4,1,2,19,10,29
p_57,1,0,e_0,327,362,367,18,3,2,4,3,1,1,35,5,40
p_56,8,0,e_2,324,351,381,11,3,2,0,3,0,0,27,30,57
p_63,3,0,e_2,364,368,381,6,1,0,4,4,1,1,4,13,17
p_62,1,0,e_2,345,376,381,13,2,0,6,5,0,1,31,5,36
p_58,0,6,e_0,330,367,387,18,3,3,4,5,0,2,37,20,57
p_48,9,0,e_3,294,326,391,22,2,2,1,4,1,1,32,65,97
p_45,11,0,e_3,290,334,391,21,1,1,2,4,1,0,44,57,101
p_50,11,0,e_3,299,334,391,11,2,0,0,5,0,2,35,57,92
p_52,14,0,e_3,312,345,391,9,2,0,5,5,0,2,33,46,79
p_61,12,0,e_3,341,353,391,3,2,1,13,5,1,1,12,38,50
p_46,8,0,e_1,291,330,394,24,2,2,4,4,1,0,39,64,103
p_53,8,0,e_1,313,330,394,15,3,3,2,5,0,1,17,64,81
p_55,14,0,e_1,314,350,394,9,3,0,3,5,0,1,36,44,80
p_65,0,7,e_2,369,381,404,7,1,0,3,4,1,1,12,23,35
p_69,2,0,e_3,391,399,407,2,0,0,0,3,1,0,8,8,16
p_64,0,15,e_0,365,367,420,8,1,0,0,4,1,0,2,53,55
p_68,2,0,e_2,389,421,429,28,1,1,2,5,1,0,32,8,40
p_70,3,0,e_1,398,410,447,5,0,0,0,3,0,0,12,37,49
p_71,7,0,e_1,403,424,447,24,1,1,1,5,0,1,21,23,44
p_73,3,0,e_3,423,429,460,8,1,1,1,5,0,1,6,31,37
p_72,6,0,e_3,417,440,460,6,0,0,0,3,0,0,23,20,43
p_66,11,0,e_0,376,404,469,24,1,1,3,5,2,0,28,65,93
p_67,12,0,e_0,377,409,469,22,1,1,3,5,2,1,32,60,92
p_74,10,0,e_0,424,437,469,9,2,0,14,4,1,0,13,32,45
p_81,1,0,e_0,493,498,503,1,0,0,0,3,0,0,5,5,10
p_77,4,0,e_1,455,469,515,27,1,1,0,3,0,0,14,46,60
p_79,9,0,e_1,457,486,515,22,1,1,0,5,0,1,29,29,58
p_75,3,0,e_2,438,450,527,3,2,0,0,3,0,0,12,77,89
p_76,10,0,e_2,440,473,527,16,1,0,0,5,0,1,33,54,87
p_78,12,0,e_2,455,481,527,19,1,1,4,5,1,1,26,46,72
p_80,13,0,e_2,474,486,527,13,0,0,10,5,1,1,12,41,53
p_82,0,12,e_3,494,494,534,0,0,0,0,3,0,0,0,40,40
p_83,0,12,e_0,501,503,543,23,1,1,1,4,1,0,2,40,42
p_87,3,0,e_1,528,540,553,15,2,2,0,3,0,0,12,13,25
p_90,1,0,e_1,538,548,553,14,2,1,2,5,0,1,10,5,15
p_93,4,0,e_2,543,549,573,10,2,1,2,5,0,1,6,24,30
p_89,5,0,e_2,535,554,573,11,2,1,0,3,0,0,19,19,38
p_94,3,0,e_2,546,562,573,10,2,1,3,5,0,2,16,11,27
p_88,10,0,e_0,531,535,585,7,2,2,9,5,1,0,4,50,54
p_95,10,0,e_0,547,551,585,3,2,0,11,4,1,0,4,34,38
p_96,7,0,e_0,551,562,585,4,2,1,10,1,1,0,11,23,34
p_84,12,0,e_3,504,534,592,10,1,0,2,5,1,0,30,58,88
p_85,14,0,e_3,517,542,592,7,1,0,7,5,1,0,25,50,75
p_86,14,0,e_3,518,542,592,7,2,0,7,5,1,1,24,50,74
p_91,14,0,e_3,539,542,592,1,2,0,13,5,1,1,3,50,53
p_92,10,0,e_3,540,556,592,4,2,0,14,5,1,1,16,36,52
p_99,9,0,e_3,556,561,592,1,2,0,10,1,1,1,5,31,36
p_98,6,0,e_3,555,572,592,4,1,0,10,1,1,0,17,20,37
p_111,2,0,e_3,607,615,623,2,0,0,0,3,0,0,8,8,16
p_97,5,0,e_1,552,570,651,6,2,1,0,3,1,0,18,81,99
p_101,9,0,e_1,566,584,651,29,2,2,4,5,0,2,18,67,85
p_100,10,0,e_1,557,589,651,30,3,3,1,5,0,1,32,62,94
p_105,12,0,e_1,582,597,651,21,1,1,8,5,1,3,15,54,69
p_110,12,0,e_1,590,597,651,19,1,1,10,5,1,2,7,54,61
p_102,14,0,e_1,568,605,651,23,2,2,5,5,0,3,37,46,83
p_104,14,0,e_1,581,605,651,20,1,1,8,5,1,3,24,46,70
p_112,11,0,e_1,613,616,651,9,1,0,12,4,1,0,3,35,38
p_107,3,0,e_0,584,596,653,29,1,1,0,3,1,1,12,57,69
p_108,7,0,e_0,584,610,653,25,1,1,0,3,1,0,26,43,69
p_109,10,0,e_0,590,621,653,21,1,1,1,5,0,2,31,32,63
p_117,0,2,e_1,636,651,659,26,1,1,5,4,1,0,15,8,23
p_106,5,0,e_2,583,594,671,28,1,1,2,5,0,1,11,77,88
p_103,14,0,e_2,577,623,671,21,1,1,0,3,0,0,46,48,94
p_113,9,0,e_2,629,640,671,9,0,0,13,4,1,0,11,31,42
p_115,9,0,e_2,632,640,671,9,0,0,11,4,1,1,8,31,39
p_116,7,0,e_2,633,648,671,19,1,1,11,4,1,1,15,23,38
p_123,0,2,e_2,661,671,679,18,2,2,3,4,1,0,10,8,18
p_121,3,0,e_0,656,667,680,16,2,2,0,3,0,0,11,13,24
p_125,2,0,e_0,668,672,680,13,2,1,3,4,1,0,4,8,12
p_126,1,0,e_0,681,687,692,11,1,0,0,3,0,0,6,5,11
p_122,7,0,e_1,657,676,699,11,2,1,1,5,1,0,19,23,42
p_124,7,0,e_1,664,676,699,10,2,1,3,5,0,1,12,23,35
p_118,8,0,e_3,649,659,717,13,1,1,5,5,0,1,10,58,68
p_119,8,0,e_3,650,659,717,13,2,1,5,5,0,2,9,58,67
p_114,13,0,e_3,632,676,717,13,0,0,0,3,0,0,44,41,85
p_120,13,0,e_3,653,676,717,7,2,0,6,5,0,2,23,41,64
p_129,5,0,e_1,705,723,740,29,1,1,0,3,0,0,18,17,35
p_128,0,15,e_0,705,705,756,4,1,0,0,3,0,0,0,51,51
p_127,7,0,e_2,701,718,769,28,1,1,2,3,0,0,17,51,68
p_130,11,0,e_2,705,732,769,23,1,1,3,5,0,1,27,37,64
p_133,6,0,e_2,734,749,769,5,2,1,11,4,1,0,15,20,35
p_134,14,0,e_0,734,751,805,11,2,0,9,5,1,0,17,54,71
p_136,14,0,e_0,749,751,805,7,2,0,13,5,1,1,2,54,56
p_143,5,0,e_0,780,788,805,7,1,0,7,4,1,0,8,17,25
p_139,0,15,e_1,758,758,807,16,4,4,0,3,0,0,0,49,49
p_132,4,0,e_3,730,737,815,8,1,1,2,5,0,1,7,78,85
p_131,7,0,e_3,722,748,815,7,0,0,0,3,0,0,26,67,93
p_135,11,0,e_3,739,762,815,7,2,0,4,5,1,1,23,53,76
p_138,12,0,e_3,756,767,815,5,3,1,9,5,1,2,11,48,59
p_137,13,0,e_3,755,772,815,4,2,0,9,5,1,1,17,43,60
p_141,12,0,e_3,770,777,815,1,2,0,13,5,1,1,7,38,45
p_145,1,0,e_3,820,826,831,1,0,0,0,3,0,0,6,5,11
p_140,5,0,e_2,768,786,853,9,2,1,0,3,1,0,18,67,85
p_142,13,0,e_2,773,812,853,30,2,2,1,5,0,1,39,41,80
p_144,6,0,e_0,815,835,855,6,0,0,0,3,0,0,20,20,40
p_152,2,0,e_2,868,869,885,22,1,1,2,5,0,1,1,16,17
p_150,3,0,e_2,860,874,885,24,1,1,0,3,0,0,14,11,25
p_146,10,0,e_1,846,863,899,10,0,0,15,3,0,0,17,36,53
p_147,6,0,e_1,849,877,899,24,1,1,14,4,0,1,28,22,50
p_153,6,0,e_1,872,877,899,17,1,1,7,4,1,1,5,22,27
p_154,4,0,e_1,874,885,899,18,1,1,7,4,1,1,11,14,25
p_149,6,0,e_0,859,880,940,21,1,1,0,3,0,0,21,60,81
p_155,11,0,e_0,884,897,940,8,1,1,7,5,1,1,13,43,56
p_151,12,0,e_0,863,902,940,14,1,1,1,5,0,1,39,38,77
p_157,7,0,e_2,889,913,944,11,2,1,0,3,0,0,24,31,55
p_158,7,0,e_2,892,913,944,10,2,1,0,5,0,1,21,31,52
p_159,8,0,e_2,893,918,944,8,2,1,1,5,0,1,25,26,51
p_156,12,0,e_3,884,887,945,7,1,1,11,5,0,1,3,58,61
p_148,15,0,e_3,849,898,945,15,0,0,0,3,0,0,49,47,96
p_3,4,0,e_2,25,40,88,4,0,0,0,3,0,0,15,48,63
p_4,5,0,e_2,34,45,88,5,0,0,2,5,0,1,11,43,54
p_5,9,0,e_2,41,59,88,9,0,0,4,5,1,1,18,29,47
p_6,9,0,e_2,45,59,88,9,0,0,5,2,1,1,14,29,43
p_2,11,0,e_1,19,54,89,11,0,0,0,3,0,0,35,35,70
p_1,13,0,e_0,13,55,96,13,0,0,0,3,0,0,42,41,83
p_12,0,8,e_1,86,89,115,21,4,4,1,4,1,0,3,26,29
p_16,4,0,e_2,101,115,129,13,5,1,0,3,0,0,14,14,28
p_15,5,0,e_0,99,117,134,13,5,2,0,3,0,0,18,17,35
p_19,0,7,e_2,125,129,154,11,3,0,1,4,1,0,4,25,29
p_7,2,0,e_3,55,63,163,2,0,0,0,3,0,0,8,100,108
p_10,9,0,e_3,77,86,163,15,3,2,6,5,1,2,9,77,86
p_9,10,0,e_3,67,91,163,17,2,1,3,5,1,1,24,72,96
p_14,13,0,e_3,87,102,163,8,5,1,9,5,1,4,15,61,76
p_8,15,0,e_3,62,110,163,13,1,0,2,5,0,1,48,53,101
p_13,8,0,e_3,87,133,163,13,4,2,9,5,1,3,46,30,76
p_11,4,0,e_3,84,147,163,17,4,2,9,5,1,3,63,16,79
p_20,3,0,e_3,142,152,163,2,2,1,5,4,1,1,10,11,21
p_21,0,10,e_0,142,142,178,5,3,0,0,3,0,0,0,36,36
p_17,10,0,e_1,112,123,187,5,3,0,7,5,1,0,11,64,75
p_18,15,0,e_1,120,140,187,27,3,3,9,5,0,1,20,47,67
p_27,5,0,e_3,180,187,212,4,1,1,3,5,0,1,7,25,32
p_26,6,0,e_3,169,192,212,6,0,0,0,3,0,0,23,20,43
p_25,9,0,e_0,163,173,214,9,0,0,6,5,1,0,10,41,51
p_28,7,0,e_0,184,189,214,3,2,0,8,4,1,0,5,25,30
p_30,2,0,e_0,200,206,214,2,1,0,4,4,1,0,6,8,14
p_33,1,0,e_3,213,219,224,1,0,0,0,3,0,0,6,5,11
p_22,6,0,e_2,146,149,233,28,3,3,5,5,1,0,3,84,87
p_24,14,0,e_2,157,177,233,18,1,1,7,5,1,1,20,56,76
p_23,15,0,e_2,150,182,233,19,2,2,6,5,2,0,32,51,83
p_31,5,0,e_2,203,214,233,28,1,1,9,4,1,0,11,19,30
p_36,1,0,e_2,225,228,233,11,1,1,2,4,1,0,3,5,8
p_35,0,6,e_3,222,224,244,1,1,0,1,4,1,0,2,20,22
p_32,0,10,e_0,209,214,246,1,1,0,1,4,1,0,5,32,37
p_34,11,0,e_1,217,227,294,11,1,0,8,5,0,1,10,67,77
p_29,14,0,e_1,192,238,294,22,1,1,0,3,0,0,46,56,102
p_37,15,0,e_1,228,243,294,14,1,0,11,5,1,1,15,51,66
p_39,13,0,e_1,247,251,294,7,0,0,14,4,1,0,4,43,47
p_43,4,0,e_1,270,280,294,16,1,1,7,4,1,0,10,14,24
p_44,4,0,e_1,275,280,294,14,1,1,5,4,1,1,5,14,19
p_38,12,0,e_0,240,254,296,7,1,0,8,5,1,0,14,42,56
p_41,7,0,e_0,257,271,296,17,1,1,11,4,1,0,14,25,39
p_42,4,0,e_0,269,282,296,16,1,1,7,4,1,1,13,14,27
p_51,0,4,e_0,309,310,326,9,2,0,0,3,0,0,1,16,17
p_40,15,0,e_3,255,285,342,9,0,0,6,3,0,0,30,57,87
p_45,11,0,e_3,290,299,342,3,1,0,14,4,1,0,9,43,52
p_48,9,0,e_3,294,307,342,4,3,1,13,4,1,2,13,35,48
p_46,8,0,e_3,291,312,342,5,2,1,13,4,1,1,21,30,51
p_54,7,0,e_3,313,317,342,1,1,0,8,4,1,0,4,25,29
p_57,1,0,e_3,327,337,342,3,1,0,4,4,1,0,10,5,15
p_58,0,6,e_3,330,342,362,3,2,0,3,4,1,1,12,20,32
p_53,8,0,e_2,313,340,368,30,2,2,0,3,0,0,27,28,55
p_60,2,0,e_2,338,360,368,29,1,1,8,5,0,1,22,8,30
p_56,8,0,e_0,324,340,370,27,1,1,4,5,1,0,16,30,46
p_59,3,0,e_0,335,357,370,28,2,2,7,5,0,1,22,13,35
p_62,1,0,e_0,345,365,370,11,1,1,7,4,1,1,20,5,25
p_63,3,0,e_3,364,375,386,3,0,0,6,3,0,0,11,11,22
p_47,3,0,e_1,293,305,388,10,3,2,0,3,1,0,12,83,95
p_49,3,0,e_1,298,305,388,8,3,2,1,5,0,1,7,83,90
p_50,11,0,e_1,299,331,388,30,3,3,1,5,0,1,32,57,89
p_52,14,0,e_1,312,342,388,24,1,1,5,5,1,1,30,46,76
p_55,14,0,e_1,314,342,388,24,2,2,5,5,1,2,28,46,74
p_61,12,0,e_1,341,350,388,12,0,0,14,5,1,1,9,38,47
p_65,0,7,e_0,369,370,395,5,1,0,0,3,1,0,1,25,26
p_68,2,0,e_1,389,397,405,2,0,0,0,3,0,0,8,8,16
p_64,0,15,e_0,365,370,421,6,1,0,1,1,1,0,5,51,56
p_69,2,0,e_3,391,399,443,2,0,0,0,3,0,0,8,44,52
p_70,3,0,e_3,398,404,443,1,1,0,2,5,0,1,6,39,45
p_71,7,0,e_3,403,418,443,4,2,0,3,5,1,1,15,25,40
p_73,3,0,e_3,423,432,443,3,1,0,6,4,1,0,9,11,20
p_66,11,0,e_2,376,412,455,22,1,1,0,3,0,0,36,43,79
p_67,12,0,e_2,377,417,455,21,1,1,0,5,0,1,40,38,78
p_72,6,0,e_1,417,437,459,13,1,0,0,3,0,0,20,22,42
p_75,3,0,e_1,438,448,459,29,1,1,6,4,1,0,10,11,21
p_74,10,0,e_0,424,441,475,26,2,2,15,3,0,0,17,34,51
p_76,10,0,e_0,440,441,475,21,1,1,10,4,0,1,1,34,35
p_77,4,0,e_0,455,461,475,4,0,0,6,4,1,0,6,14,20
p_81,1,0,e_0,493,498,503,6,1,0,0,3,0,0,5,5,10
p_79,9,0,e_3,457,486,515,9,0,0,0,3,0,0,29,29,58
p_82,0,12,e_1,494,494,534,7,1,0,0,3,0,0,0,40,40
p_78,12,0,e_2,455,494,542,12,0,0,0,3,0,0,39,48,87
p_80,13,0,e_2,474,499,542,8,1,0,6,5,0,1,25,43,68
p_87,3,0,e_2,528,531,542,3,0,0,4,4,1,0,3,11,14
p_83,0,12,e_0,501,503,543,4,1,0,0,4,1,0,2,40,42
p_90,1,0,e_3,538,540,571,9,1,1,0,5,0,1,2,31,33
p_89,5,0,e_3,535,554,571,5,0,0,0,3,0,0,19,17,36
p_97,5,0,e_3,552,554,571,1,2,0,4,5,1,1,2,17,19
p_94,3,0,e_2,546,554,573,4,2,1,1,5,0,1,8,19,27
p_93,4,0,e_2,543,559,573,5,2,1,0,3,0,0,16,14,30
p_88,10,0,e_0,531,535,585,10,0,0,9,5,1,0,4,50,54
p_92,10,0,e_0,540,551,585,9,2,0,11,5,2,0,11,34,45
p_95,10,0,e_0,547,551,585,7,2,0,11,4,1,1,4,34,38
p_96,7,0,e_0,551,562,585,3,2,0,10,1,1,0,11,23,34
p_84,12,0,e_1,504,534,588,22,1,1,2,5,1,0,30,54,84
p_85,14,0,e_1,517,542,588,14,0,0,6,5,1,0,25,46,71
p_86,14,0,e_1,518,542,588,14,0,0,7,5,1,1,24,46,70
p_91,14,0,e_1,539,542,588,13,1,0,13,5,1,1,3,46,49
p_99,9,0,e_1,556,559,588,26,1,1,10,4,1,0,3,29,32
p_111,2,0,e_1,607,616,624,15,2,1,0,3,0,0,9,8,17
p_108,7,0,e_0,584,608,651,17,2,2,0,3,1,0,24,43,67
p_109,10,0,e_0,590,619,651,12,2,1,1,5,0,1,29,32,61
p_117,0,2,e_0,636,651,659,9,1,0,5,4,1,0,15,8,23
p_106,5,0,e_2,583,590,661,19,2,2,3,5,0,3,7,71,78
p_98,6,0,e_2,555,595,661,29,1,1,3,5,1,1,40,66,106
p_100,10,0,e_2,557,609,661,24,1,1,4,5,1,2,52,52,104
p_105,12,0,e_2,582,617,661,13,2,1,3,5,0,2,35,44,79
p_110,12,0,e_2,590,617,661,10,2,1,5,2,0,4,27,44,71
p_112,11,0,e_2,613,622,661,4,2,1,11,5,1,2,9,39,48
p_116,7,0,e_2,633,636,661,2,2,0,8,4,1,1,3,25,28
p_107,3,0,e_2,584,650,661,21,2,2,3,5,0,4,66,11,77
p_101,9,0,e_3,566,600,663,23,1,1,2,4,1,0,34,63,97
p_102,14,0,e_3,568,617,663,17,2,2,1,4,1,1,49,46,95
p_103,14,0,e_3,577,617,663,12,2,0,2,5,0,2,40,46,86
p_104,14,0,e_3,581,617,663,11,2,0,3,5,0,2,36,46,82
p_113,9,0,e_3,629,634,663,1,1,0,10,4,1,0,5,29,34
p_123,0,2,e_2,661,661,671,1,1,0,0,3,1,0,0,10,10
p_125,2,0,e_2,668,671,679,2,0,0,1,5,1,0,3,8,11
p_126,1,0,e_2,681,686,691,1,0,0,0,3,0,0,5,5,10
p_121,3,0,e_0,656,664,701,29,1,1,1,5,1,0,8,37,45
p_122,7,0,e_0,657,678,701,25,1,1,2,5,1,1,21,23,44
p_124,7,0,e_0,664,678,701,7,0,0,3,2,0,1,14,23,37
p_118,8,0,e_1,649,658,718,27,1,1,5,5,0,2,9,60,69
p_119,8,0,e_1,650,658,718,26,1,1,6,5,0,3,8,60,68
p_115,9,0,e_1,632,663,718,30,2,2,0,3,0,1,31,55,86
p_114,13,0,e_1,632,677,718,26,2,2,0,3,0,0,45,41,86
p_120,13,0,e_1,653,677,718,20,1,1,6,5,0,3,24,41,65
p_129,5,0,e_2,705,722,739,5,0,0,0,3,0,0,17,17,34
p_128,0,15,e_3,705,705,756,0,0,0,0,3,0,0,0,51,51
p_127,7,0,e_0,701,724,795,7,0,0,0,3,1,0,23,71,94
p_130,11,0,e_0,705,738,795,11,0,0,1,5,0,1,33,57,90
p_134,14,0,e_0,734,749,795,7,1,1,10,5,1,1,15,46,61
p_140,5,0,e_0,768,778,795,7,1,0,8,4,1,0,10,17,27
p_132,4,0,e_1,730,736,806,19,1,1,2,5,0,1,6,70,76
p_133,6,0,e_1,734,744,806,15,1,1,3,5,0,2,10,62,72
p_131,7,0,e_1,722,749,806,19,1,1,0,3,0,0,27,57,84
p_135,11,0,e_1,739,763,806,9,1,1,5,5,1,2,24,43,67
p_138,12,0,e_1,756,768,806,3,2,0,9,5,1,1,12,38,50
p_136,14,0,e_3,749,751,807,3,1,1,13,5,1,0,2,56,58
p_137,13,0,e_3,755,764,807,2,2,0,15,5,2,0,9,43,52
p_143,5,0,e_3,780,790,807,3,1,0,8,4,1,0,10,17,27
p_139,0,15,e_2,758,759,812,15,2,0,0,3,0,0,1,53,54
p_145,1,0,e_1,820,825,830,1,0,0,0,3,0,0,5,5,10
p_144,6,0,e_0,815,836,856,6,0,0,0,3,0,0,21,20,41
p_141,12,0,e_2,770,799,859,29,1,1,3,5,1,0,29,60,89
p_142,13,0,e_2,773,804,859,28,1,1,4,5,1,1,31,55,86
p_150,3,0,e_2,860,871,884,24,1,1,0,3,0,0,11,13,24
p_152,2,0,e_2,868,876,884,22,1,1,2,5,0,1,8,8,16
p_149,6,0,e_0,859,879,901,21,1,1,0,3,0,0,20,22,42
p_153,6,0,e_0,872,879,901,17,1,1,4,5,0,1,7,22,29
p_154,4,0,e_0,874,887,901,18,1,1,5,5,0,1,13,14,27
p_147,6,0,e_1,849,866,932,24,1,1,1,5,0,1,17,66,83
p_146,10,0,e_1,846,880,932,10,0,0,0,3,0,0,34,52,86
p_155,11,0,e_1,884,885,932,8,1,1,11,5,1,1,1,47,48
p_151,12,0,e_1,863,890,932,14,1,1,5,5,0,2,27,42,69
p_156,12,0,e_1,884,890,932,7,1,1,11,5,1,2,6,42,48
p_159,8,0,e_1,893,904,932,8,1,1,11,4,1,1,11,28,39
p_158,7,0,e_1,892,909,932,9,1,1,12,4,1,0,17,23,40
p_157,7,0,e_2,889,913,936,10,1,1,0,3,0,0,24,23,47
p_148,15,0,e_3,849,896,943,15,0,0,0,3,0,0,47,47,94
p_3,4,0,e_2,25,40,88,4,0,0,0,3,0,0,15,48,63
p_4,5,0,e_2,34,45,88,5,0,0,2,5,0,1,11,43,54
p_5,9,0,e_2,41,59,88,9,0,0,4,5,1,1,18,29,47
p_6,9,0,e_2,45,59,88,9,0,0,5,5,1,1,14,29,43
p_2,11,0,e_1,19,54,89,11,0,0,0,3,0,0,35,35,70
p_1,13,0,e_0,13,54,95,13,0,0,0,3,0,0,41,41,82
p_12,0,8,e_1,86,89,115,21,5,5,1,4,1,0,3,26,29
p_16,4,0,e_2,101,115,129,14,5,2,0,3,0,0,14,14,28
p_15,5,0,e_0,99,117,134,13,5,2,0,3,0,0,18,17,35
p_19,0,7,e_2,125,129,154,11,3,0,1,4,1,0,4,25,29
p_7,2,0,e_3,55,64,162,2,0,0,0,3,0,0,9,98,107
p_10,9,0,e_3,77,87,162,15,3,2,6,5,1,2,10,75,85
p_9,10,0,e_3,67,92,162,18,2,1,2,5,1,1,25,70,95
p_14,13,0,e_3,87,103,162,8,5,1,9,5,1,4,16,59,75
p_8,15,0,e_3,62,111,162,13,1,0,2,5,0,1,49,51,100
p_13,8,0,e_3,87,134,162,13,4,2,9,5,1,3,47,28,75
p_11,4,0,e_3,84,148,162,18,4,3,8,5,1,3,64,14,78
p_21,0,10,e_0,142,144,180,6,2,0,0,5,0,1,2,36,38
p_17,10,0,e_1,112,123,187,5,3,0,7,5,1,0,11,64,75
p_18,15,0,e_1,120,140,187,27,3,3,9,5,0,1,20,47,67
p_27,5,0,e_3,180,186,213,4,1,1,3,5,0,1,6,27,33
p_26,6,0,e_3,169,191,213,6,0,0,0,3,0,0,22,22,44
p_30,2,0,e_3,200,205,213,2,1,0,4,4,1,0,5,8,13
p_20,3,0,e_0,142,155,214,3,2,1,0,3,0,0,13,59,72
p_25,9,0,e_0,163,175,214,9,0,0,5,5,2,0,12,39,51
p_28,7,0,e_0,184,191,214,3,2,0,9,4,1,0,7,23,30
p_22,6,0,e_2,146,149,233,28,2,2,5,5,1,0,3,84,87
p_24,14,0,e_2,157,177,233,18,1,1,7,5,1,1,20,56,76
p_23,15,0,e_2,150,182,233,19,1,1,6,5,2,0,32,51,83
p_31,5,0,e_2,203,214,233,28,2,2,9,4,1,0,11,19,30
p_36,1,0,e_2,225,228,233,16,2,1,2,4,1,0,3,5,8
p_32,0,10,e_3,209,213,247,1,1,0,1,4,1,0,4,34,38
p_35,0,6,e_2,222,233,253,18,2,2,3,4,1,0,11,20,31
p_33,1,0,e_3,213,218,279,1,0,0,0,3,1,0,5,61,66
p_41,7,0,e_2,257,263,288,30,1,1,6,3,0,0,6,25,31
p_42,4,0,e_2,269,274,288,29,1,1,6,4,1,0,5,14,19
p_43,4,0,e_2,270,274,288,29,1,1,5,4,1,1,4,14,18
p_29,14,0,e_1,192,237,293,22,1,1,0,3,0,0,45,56,101
p_37,15,0,e_1,228,242,293,11,2,0,11,5,0,1,14,51,65
p_39,13,0,e_1,247,250,293,23,1,0,14,4,1,0,3,43,46
p_44,4,0,e_1,275,279,293,27,1,1,5,4,1,0,4,14,18
p_34,11,0,e_0,217,253,316,10,1,0,0,3,0,0,36,63,99
p_38,12,0,e_0,240,258,316,4,2,0,7,5,0,1,18,58,76
p_40,15,0,e_0,255,269,316,23,1,1,11,5,1,1,14,47,61
p_47,3,0,e_1,293,305,316,13,1,1,0,3,0,0,12,11,23
p_49,3,0,e_1,298,305,316,13,2,2,1,5,0,1,7,11,18
p_51,0,4,e_0,309,316,330,13,2,2,2,4,1,0,7,14,21
p_57,1,0,e_1,327,333,338,7,1,0,0,3,0,0,6,5,11
p_54,7,0,e_3,313,314,357,4,2,2,7,5,0,2,1,43,44
p_46,8,0,e_3,291,319,357,8,0,0,0,3,0,0,28,38,66
p_53,8,0,e_3,313,319,357,3,3,1,7,5,0,3,6,38,44
p_48,9,0,e_3,294,324,357,9,1,0,0,5,0,1,30,33,63
p_59,3,0,e_3,335,344,357,3,1,0,6,4,1,0,9,13,22
p_62,1,0,e_3,345,352,357,2,1,0,3,4,1,0,7,5,12
p_58,0,6,e_1,330,338,360,7,1,0,0,5,0,1,8,22,30
p_56,8,0,e_0,324,344,370,17,1,0,2,5,1,0,20,26,46
p_60,2,0,e_1,338,346,380,3,2,1,0,3,1,0,8,34,42
p_45,11,0,e_2,290,326,383,11,0,0,0,3,0,0,36,57,93
p_50,11,0,e_2,299,326,383,9,2,0,2,5,0,1,27,57,84
p_52,14,0,e_2,312,337,383,7,2,0,6,5,0,1,25,46,71
p_55,14,0,e_2,314,337,383,7,3,0,7,5,0,2,23,46,69
p_61,12,0,e_2,341,345,383,22,2,2,13,4,1,0,4,38,42
p_63,3,0,e_3,364,375,386,3,0,0,0,3,0,0,11,11,22
p_65,0,7,e_0,369,370,393,5,1,1,0,4,1,0,1,23,24
p_68,2,0,e_1,389,398,406,2,0,0,0,3,0,0,9,8,17
p_69,2,0,e_2,391,399,407,2,0,0,0,3,0,0,8,8,16
p_64,0,15,e_0,365,370,423,6,1,1,1,4,1,0,5,53,58
p_73,3,0,e_1,423,435,446,5,2,1,0,3,0,0,12,11,23
p_70,3,0,e_3,398,410,469,3,0,0,0,3,0,0,12,59,71
p_72,6,0,e_3,417,421,469,3,2,1,5,5,1,1,4,48,52
p_71,7,0,e_3,403,426,469,6,1,0,1,5,0,1,23,43,66
p_74,10,0,e_3,424,437,469,3,2,0,7,5,1,1,13,32,45
p_66,11,0,e_0,376,407,472,22,1,1,2,5,2,0,31,65,96
p_67,12,0,e_0,377,412,472,21,1,1,2,5,2,1,35,60,95
p_77,4,0,e_0,455,458,472,30,1,1,5,4,1,0,3,14,17
p_81,1,0,e_0,493,499,504,1,0,0,0,3,0,0,6,5,11
p_79,9,0,e_1,457,486,515,25,1,1,0,3,0,0,29,29,58
p_75,3,0,e_2,438,450,527,7,1,0,0,3,0,0,12,77,89
p_76,10,0,e_2,440,473,527,30,1,1,0,5,0,1,33,54,87
p_78,12,0,e_2,455,481,527,22,1,1,4,5,1,1,26,46,72
p_80,13,0,e_2,474,486,527,13,0,0,10,5,1,1,12,41,53
p_82,0,12,e_3,494,495,535,0,0,0,0,3,0,0,1,40,41
p_83,0,12,e_0,501,504,544,23,1,1,1,4,1,0,3,40,43
p_87,3,0,e_1,528,540,567,15,2,2,0,3,0,0,12,27,39
p_89,5,0,e_1,535,548,567,11,1,1,2,5,0,1,13,19,32
p_94,3,0,e_1,546,556,567,11,1,0,5,5,1,1,10,11,21
p_90,1,0,e_2,538,544,569,15,2,1,0,3,0,0,6,25,31
p_93,4,0,e_2,543,555,569,18,1,0,1,5,0,1,12,14,26
p_88,10,0,e_0,531,536,586,7,2,2,9,5,1,0,5,50,55
p_92,10,0,e_0,540,552,586,5,2,1,11,5,2,0,12,34,46
p_96,7,0,e_0,551,563,586,5,2,1,10,4,1,1,12,23,35
p_84,12,0,e_3,504,535,591,10,1,0,2,5,1,0,31,56,87
p_85,14,0,e_3,517,543,591,8,1,0,6,5,1,0,26,48,74
p_86,14,0,e_3,518,543,591,8,2,0,6,5,1,1,25,48,73
p_91,14,0,e_3,539,543,591,1,2,0,13,5,1,1,4,48,52
p_95,10,0,e_3,547,557,591,3,1,0,13,4,1,0,10,34,44
p_99,9,0,e_3,556,562,591,1,1,0,10,1,1,0,6,29,35
p_109,10,0,e_0,590,622,664,10,0,0,0,3,0,0,32,42,74
p_112,11,0,e_0,613,627,664,6,1,1,7,5,0,2,14,37,51
p_111,2,0,e_0,607,656,664,17,1,1,5,5,0,1,49,8,57
p_101,9,0,e_1,566,596,665,29,1,1,0,3,1,1,30,69,99
p_100,10,0,e_1,557,601,665,30,2,2,3,4,1,0,44,64,108
p_105,12,0,e_1,582,609,665,21,1,1,4,5,0,3,27,56,83
p_102,14,0,e_1,568,617,665,23,1,1,0,5,0,2,49,48,97
p_104,14,0,e_1,581,617,665,19,1,1,4,5,0,3,36,48,84
p_113,9,0,e_1,629,634,665,3,1,0,10,4,1,0,5,31,36
p_116,7,0,e_1,633,642,665,4,2,1,9,1,1,0,9,23,32
p_97,5,0,e_2,552,586,665,7,2,1,3,5,1,1,34,79,113
p_106,5,0,e_2,583,586,665,28,1,1,4,5,0,3,3,79,82
p_98,6,0,e_2,555,591,665,5,2,1,4,3,1,1,36,74,110
p_108,7,0,e_2,584,596,665,25,1,1,4,5,0,3,12,69,81
p_103,14,0,e_2,577,619,665,20,1,1,2,5,0,2,42,46,88
p_107,3,0,e_2,584,654,665,29,1,1,5,5,0,4,70,11,81
p_110,12,0,e_3,590,629,671,12,0,0,0,3,1,0,39,42,81
p_115,9,0,e_3,632,640,671,2,1,0,11,4,1,0,8,31,39
p_121,3,0,e_3,656,660,671,1,2,0,4,4,1,1,4,11,15
p_117,0,2,e_1,636,665,673,10,2,0,9,4,1,1,29,8,37
p_123,0,2,e_1,661,665,673,3,2,0,1,4,1,1,4,8,12
p_125,2,0,e_1,668,673,719,29,2,2,1,5,1,1,5,46,51
p_118,8,0,e_1,649,693,719,28,1,1,5,4,1,0,44,26,70
p_124,7,0,e_2,664,688,721,25,2,2,0,3,1,1,24,33,57
p_119,8,0,e_2,650,693,721,28,1,1,4,4,1,1,43,28,71
p_126,1,0,e_2,681,716,721,22,1,1,5,5,0,2,35,5,40
p_122,7,0,e_0,657,687,750,27,3,3,2,4,1,1,30,63,93
p_114,13,0,e_0,632,707,750,29,1,1,10,4,1,1,75,43,118
p_127,7,0,e_0,701,727,750,10,1,1,11,5,1,1,26,23,49
p_131,7,0,e_0,722,727,750,4,2,0,8,4,1,1,5,23,28
p_130,11,0,e_3,705,706,759,4,1,1,11,5,0,1,1,53,54
p_120,13,0,e_3,653,714,759,22,1,1,5,4,1,0,61,45,106
p_133,6,0,e_3,734,737,759,1,2,0,7,4,1,1,3,22,25
p_129,5,0,e_3,705,742,759,10,1,1,11,2,0,1,37,17,54
p_128,0,15,e_1,705,719,768,15,1,1,5,4,1,0,14,49,63
p_140,5,0,e_3,768,785,802,5,0,0,0,3,0,0,17,17,34
p_143,5,0,e_3,780,785,802,2,1,0,3,5,0,1,5,17,22
p_139,0,15,e_0,758,759,808,0,1,0,0,3,0,0,1,49,50
p_132,4,0,e_2,730,744,816,4,2,1,0,3,0,0,14,72,86
p_135,11,0,e_2,739,767,816,25,2,2,3,5,0,1,28,49,77
p_137,13,0,e_2,755,775,816,18,1,1,7,5,1,1,20,41,61
p_142,13,0,e_2,773,775,816,12,1,0,13,5,1,1,2,41,43
p_134,14,0,e_1,734,763,817,23,3,3,5,5,1,0,29,54,83
p_136,14,0,e_1,749,763,817,19,1,1,10,5,1,1,14,54,68
p_138,12,0,e_1,756,779,817,19,1,1,12,5,1,1,23,38,61
p_141,12,0,e_1,770,779,817,12,1,0,15,4,1,1,9,38,47
p_145,1,0,e_1,820,825,830,1,0,0,0,3,0,0,5,5,10
p_144,6,0,e_2,815,836,856,6,0,0,0,3,1,0,21,20,41
p_150,3,0,e_2,860,872,885,24,1,1,0,3,0,0,12,13,25
p_152,2,0,e_2,868,877,885,22,1,1,2,5,0,1,9,8,17
p_146,10,0,e_0,846,863,899,10,0,0,15,3,0,0,17,36,53
p_153,6,0,e_0,872,877,899,17,1,1,7,4,1,0,5,22,27
p_154,4,0,e_0,874,885,899,18,1,1,7,4,1,1,11,14,25
p_147,6,0,e_1,849,870,934,6,0,0,0,3,0,0,21,64,85
p_149,6,0,e_1,859,870,934,22,1,1,2,5,0,1,11,64,75
p_155,11,0,e_1,884,887,934,8,1,1,10,5,1,1,3,47,50
p_151,12,0,e_1,863,892,934,14,1,1,4,5,0,1,29,42,71
p_156,12,0,e_1,884,892,934,7,1,1,10,5,1,1,8,42,50
p_159,8,0,e_1,893,906,934,8,1,1,12,4,1,1,13,28,41
p_158,7,0,e_1,892,911,934,9,1,1,12,4,1,0,19,23,42
p_157,7,0,e_2,889,913,936,11,1,1,0,3,0,0,24,23,47
p_148,15,0,e_3,849,897,944,15,0,0,0,3,0,0,48,47,95
p_3,4,0,e_2,25,40,54,4,0,0,0,3,0,0,15,14,29
p_7,2,0,e_2,55,63,71,10,2,1,0,3,0,0,8,8,16
p_6,9,0,e_1,45,49,92,6,2,0,8,5,0,1,4,43,47
p_2,11,0,e_1,19,57,92,11,0,0,0,3,0,0,38,35,73
p_1,13,0,e_0,13,54,95,13,0,0,0,3,0,0,41,41,82
p_12,0,8,e_1,86,92,118,15,1,1,2,4,1,0,6,26,32
p_15,5,0,e_0,99,116,133,7,1,0,0,3,0,0,17,17,34
p_4,5,0,e_3,34,51,136,5,0,0,0,3,0,0,17,85,102
p_5,9,0,e_3,41,65,136,7,1,0,2,5,0,1,24,71,95
p_9,10,0,e_3,67,70,136,11,2,1,9,5,1,1,3,66,69
p_8,15,0,e_3,62,87,136,7,2,0,8,5,1,1,25,49,74
p_16,4,0,e_3,101,122,136,7,1,0,11,4,1,0,21,14,35
p_19,0,7,e_0,125,133,156,4,1,0,2,4,1,0,8,23,31
p_17,10,0,e_1,112,126,158,27,2,2,6,5,1,0,14,32,46
p_20,3,0,e_3,142,153,164,3,0,0,0,3,0,0,11,11,22
p_11,4,0,e_2,84,91,181,12,2,1,2,5,0,1,7,90,97
p_13,8,0,e_2,87,105,181,23,1,0,3,5,0,2,18,76,94
p_10,9,0,e_2,77,110,181,9,2,1,0,3,0,0,33,71,104
p_14,13,0,e_2,87,124,181,28,1,0,3,5,0,3,37,57,94
p_18,15,0,e_2,120,132,181,20,2,2,12,5,1,1,12,49,61
p_22,6,0,e_2,146,161,181,5,1,0,11,4,1,0,15,20,35
p_21,0,10,e_1,142,158,192,6,1,1,5,4,1,0,16,34,50
p_27,5,0,e_3,180,186,213,4,1,1,3,5,0,1,6,27,33
p_26,6,0,e_3,169,191,213,6,0,0,0,3,0,0,22,22,44
p_30,2,0,e_3,200,205,213,2,1,0,4,4,1,0,5,8,13
p_25,9,0,e_1,163,187,228,21,1,1,1,5,1,0,24,41,65
p_31,5,0,e_1,203,209,228,28,2,2,7,4,1,0,6,19,25
p_33,1,0,e_1,213,223,228,19,1,1,4,4,1,0,10,5,15
p_24,14,0,e_0,157,179,233,18,1,1,7,5,0,1,22,54,76
p_23,15,0,e_0,150,184,233,13,1,0,5,5,1,0,34,49,83
p_36,1,0,e_0,225,228,233,17,2,2,2,4,1,0,3,5,8
p_32,0,10,e_3,209,213,245,1,1,0,1,4,1,0,4,32,36
p_35,0,6,e_0,222,233,253,19,2,2,3,4,1,0,11,20,31
p_28,7,0,e_2,184,208,287,3,2,0,0,3,0,0,24,79,103
p_29,14,0,e_2,192,231,287,22,1,1,2,5,0,1,39,56,95
p_37,15,0,e_2,228,236,287,11,2,0,13,5,1,1,8,51,59
p_38,12,0,e_2,240,247,287,4,2,0,14,4,1,0,7,40,47
p_43,4,0,e_2,270,273,287,10,1,0,5,4,1,0,3,14,17
p_41,7,0,e_0,257,263,288,10,2,1,6,3,0,0,6,25,31
p_42,4,0,e_0,269,274,288,10,1,0,5,4,1,0,5,14,19
p_44,4,0,e_1,275,289,303,9,1,0,0,3,0,0,14,14,28
p_34,11,0,e_3,217,250,315,10,1,0,1,5,1,0,33,65,98
p_39,13,0,e_3,247,258,315,3,1,0,10,5,0,1,11,57,68
p_40,15,0,e_3,255,266,315,3,2,0,12,5,1,1,11,49,60
p_47,3,0,e_3,293,304,315,4,1,0,7,4,1,0,11,11,22
p_49,3,0,e_3,298,304,315,2,2,0,5,4,1,1,6,11,17
p_51,0,4,e_1,309,309,325,2,1,0,0,3,0,0,0,16,16
p_57,1,0,e_3,327,332,337,1,0,0,0,3,0,0,5,5,10
p_58,0,6,e_3,330,337,357,2,1,1,0,5,0,1,7,20,27
p_46,8,0,e_2,291,317,357,29,1,1,0,3,0,0,26,40,66
p_53,8,0,e_2,313,317,357,22,1,1,7,5,0,2,4,40,44
p_48,9,0,e_2,294,322,357,27,2,2,1,5,0,1,28,35,63
p_56,8,0,e_2,324,327,357,8,0,0,9,4,1,0,3,30,33
p_59,3,0,e_2,335,344,357,27,1,1,6,4,1,0,9,13,22
p_62,1,0,e_2,345,352,357,9,1,1,3,4,1,0,7,5,12
p_54,7,0,e_1,313,336,361,23,1,1,0,5,1,0,23,25,48
p_60,2,0,e_1,338,353,361,10,1,1,7,4,1,0,15,8,23
p_45,11,0,e_0,290,326,383,26,1,1,0,3,0,0,36,57,93
p_50,11,0,e_0,299,326,383,24,2,2,2,5,0,1,27,57,84
p_52,14,0,e_0,312,337,383,17,1,1,6,5,0,1,25,46,71
p_55,14,0,e_0,314,337,383,14,0,0,7,5,0,2,23,46,69
p_61,12,0,e_0,341,345,383,11,1,0,13,4,1,0,4,38,42
p_63,3,0,e_1,364,375,386,3,0,0,0,3,0,0,11,11,22
p_68,2,0,e_0,389,397,405,2,0,0,0,3,0,0,8,8,16
p_65,0,7,e_3,369,389,412,6,0,0,6,3,0,0,20,23,43
p_69,2,0,e_1,391,400,416,12,1,1,0,3,0,0,9,16,25
p_70,3,0,e_1,398,405,416,9,1,1,1,5,0,1,7,11,18
p_64,0,15,e_2,365,366,419,6,0,0,0,3,0,0,1,53,54
p_71,7,0,e_3,403,412,435,3,1,0,4,5,1,0,9,23,32
p_73,3,0,e_1,423,435,446,1,1,0,0,3,0,0,12,11,23
p_72,6,0,e_0,417,437,457,30,1,1,0,3,0,0,20,20,40
p_66,11,0,e_2,376,403,468,23,1,1,2,5,1,0,27,65,92
p_67,12,0,e_2,377,408,468,22,1,1,2,5,1,1,31,60,91
p_74,10,0,e_2,424,436,468,23,1,1,14,4,1,0,12,32,44
p_81,1,0,e_2,493,498,503,3,1,0,0,3,0,0,5,5,10
p_75,3,0,e_3,438,449,504,3,0,0,0,3,0,0,11,55,66
p_76,10,0,e_3,440,472,504,10,1,0,0,5,0,1,32,32,64
p_77,4,0,e_1,455,469,533,12,2,1,0,3,0,1,14,64,78
p_78,12,0,e_1,455,495,533,8,2,0,0,3,0,0,40,38,78
p_82,0,12,e_3,494,504,542,3,1,0,3,4,1,0,10,38,48
p_83,0,12,e_2,501,503,543,1,1,0,0,4,1,0,2,40,42
p_79,9,0,e_0,457,486,545,6,2,1,0,3,1,0,29,59,88
p_80,13,0,e_0,474,500,545,27,1,1,5,5,0,1,26,45,71
p_87,3,0,e_0,528,532,545,18,2,2,4,4,1,0,4,13,17
p_90,1,0,e_0,538,540,545,16,2,2,2,4,1,0,2,5,7
p_94,3,0,e_0,546,557,594,12,2,1,0,3,0,0,11,37,48
p_96,7,0,e_0,551,571,594,7,2,0,1,5,0,1,20,23,43
p_88,10,0,e_2,531,535,599,10,2,2,9,5,1,1,4,64,68
p_84,12,0,e_2,504,543,599,12,1,0,0,5,1,0,39,56,95
p_85,14,0,e_2,517,551,599,10,1,0,4,5,1,0,34,48,82
p_98,6,0,e_2,555,577,599,7,2,0,13,4,1,1,22,22,44
p_97,5,0,e_2,552,582,599,9,2,0,14,4,1,0,30,17,47
p_86,14,0,e_3,518,550,600,10,1,0,4,5,1,0,32,50,82
p_91,14,0,e_3,539,550,600,3,2,0,11,5,1,1,11,50,61
p_99,9,0,e_3,556,567,600,3,2,0,12,4,1,1,11,33,44
p_93,4,0,e_3,543,584,600,12,1,1,12,5,0,1,41,16,57
p_107,3,0,e_3,584,589,600,1,1,0,4,1,1,0,5,11,16
p_111,2,0,e_2,607,616,624,2,0,0,0,3,0,0,9,8,17
p_89,5,0,e_1,535,552,637,13,2,2,0,3,0,0,17,85,102
p_92,10,0,e_1,540,569,637,6,2,1,1,5,0,1,29,68,97
p_95,10,0,e_1,547,569,637,5,2,1,4,5,0,2,22,68,90
p_100,10,0,e_1,557,569,637,2,3,0,6,5,1,1,12,68,80
p_102,14,0,e_1,568,583,637,25,2,2,10,5,1,2,15,54,69
p_103,14,0,e_1,577,583,637,22,2,2,12,5,1,2,6,54,60
p_104,14,0,e_1,581,583,637,21,2,2,14,5,1,2,2,54,56
p_105,12,0,e_1,582,591,637,23,2,2,14,5,1,2,9,46,55
p_109,10,0,e_1,590,599,637,23,1,1,12,1,1,3,9,38,47
p_101,9,0,e_1,566,604,637,30,2,2,9,5,1,1,38,33,71
p_108,7,0,e_1,584,612,637,27,1,1,14,4,1,3,28,25,53
p_106,5,0,e_1,583,620,637,29,1,1,14,2,1,2,37,17,54
p_117,0,2,e_1,636,637,647,13,1,1,0,3,1,0,1,10,11
p_112,11,0,e_0,613,629,686,11,0,0,6,5,0,1,16,57,73
p_110,12,0,e_0,590,634,686,21,1,1,1,4,1,0,44,52,96
p_114,13,0,e_0,632,639,686,13,0,0,11,5,1,2,7,47,54
p_113,9,0,e_0,629,653,686,9,0,0,11,2,0,1,24,33,57
p_122,7,0,e_0,657,661,686,2,2,1,8,4,1,1,4,25,29
p_121,3,0,e_0,656,675,686,6,2,1,8,4,1,0,19,11,30
p_116,7,0,e_3,633,656,693,7,0,0,0,3,0,0,23,37,60
p_118,8,0,e_3,649,661,693,3,1,0,5,5,0,1,12,32,44
p_124,7,0,e_3,664,666,693,1,1,0,8,4,1,0,2,27,29
p_125,2,0,e_3,668,683,693,5,1,0,7,4,1,0,15,10,25
p_126,1,0,e_3,681,688,693,1,2,0,2,4,1,1,7,5,12
p_123,0,2,e_0,661,686,694,8,1,1,7,4,1,1,25,8,33
p_119,8,0,e_1,650,671,697,3,2,0,2,3,0,0,21,26,47
p_115,9,0,e_2,632,662,717,9,0,0,0,3,0,0,30,55,85
p_120,13,0,e_2,653,676,717,7,2,0,6,5,0,1,23,41,64
p_129,5,0,e_1,705,722,739,5,0,0,0,3,0,0,17,17,34
p_128,0,15,e_3,705,706,757,0,0,0,0,3,0,0,1,51,52
p_127,7,0,e_0,701,719,770,7,0,0,2,3,0,0,18,51,69
p_130,11,0,e_0,705,733,770,11,0,0,3,5,0,1,28,37,65
p_133,6,0,e_0,734,750,770,16,2,2,11,4,1,0,16,20,36
p_132,4,0,e_2,730,737,771,19,1,1,2,5,0,1,7,34,41
p_131,7,0,e_2,722,748,771,19,1,1,0,3,0,0,26,23,49
p_134,14,0,e_3,734,752,808,8,1,1,8,5,1,0,18,56,74
p_136,14,0,e_3,749,752,808,3,2,1,13,5,1,1,3,56,59
p_137,13,0,e_3,755,765,808,2,2,0,15,5,2,0,10,43,53
p_140,5,0,e_3,768,791,808,7,1,0,12,4,1,0,23,17,40
p_143,5,0,e_2,780,797,814,4,2,0,0,3,0,0,17,17,34
p_139,0,15,e_0,758,770,817,15,2,0,4,4,1,0,12,47,59
p_135,11,0,e_1,739,774,825,9,2,2,0,3,1,0,35,51,86
p_138,12,0,e_1,756,779,825,3,3,0,5,5,0,1,23,46,69
p_141,12,0,e_1,770,779,825,30,2,2,10,5,0,2,9,46,55
p_142,13,0,e_1,773,784,825,28,2,2,11,2,0,1,11,41,52
p_145,1,0,e_3,820,826,831,1,0,0,0,3,0,0,6,5,11
p_144,6,0,e_2,815,836,856,6,0,0,0,3,0,0,21,20,41
p_150,3,0,e_2,860,871,884,6,1,1,0,3,0,0,11,13,24
p_152,2,0,e_2,868,876,884,16,1,1,2,5,0,1,8,8,16
p_146,10,0,e_0,846,864,900,10,0,0,15,3,0,0,18,36,54
p_153,6,0,e_0,872,878,900,11,2,1,8,4,1,0,6,22,28
p_154,4,0,e_0,874,886,900,13,2,1,7,4,1,1,12,14,26
p_147,6,0,e_3,849,869,933,6,0,0,0,3,0,0,20,64,84
p_149,6,0,e_3,859,869,933,3,1,0,3,5,0,1,10,64,74
p_155,11,0,e_3,884,886,933,3,2,1,10,5,1,1,2,47,49
p_151,12,0,e_3,863,891,933,8,1,0,4,5,0,1,28,42,70
p_156,12,0,e_3,884,891,933,1,3,0,11,5,1,2,7,42,49
p_159,8,0,e_3,893,905,933,4,2,0,12,4,1,1,12,28,40
p_158,7,0,e_3,892,910,933,5,1,0,12,4,1,0,18,23,41
p_157,7,0,e_2,889,912,935,5,2,0,0,3,0,0,23,23,46
p_148,15,0,e_1,849,896,943,15,0,0,0,3,0,0,47,47,94
p_3,4,0,e_2,25,39,87,4,0,0,0,3,0,0,14,48,62
p_4,5,0,e_2,34,44,87,5,0,0,3,5,0,1,10,43,53
p_5,9,0,e_2,41,58,87,9,0,0,4,5,1,1,17,29,46
p_6,9,0,e_2,45,58,87,9,0,0,5,5,1,1,13,29,42
p_2,11,0,e_1,19,54,89,11,0,0,0,3,0,0,35,35,70
p_1,13,0,e_0,13,54,95,13,0,0,0,3,0,0,41,41,82
p_12,0,8,e_2,86,87,113,21,3,3,0,4,1,1,1,26,27
p_11,4,0,e_1,84,103,125,18,3,2,2,4,1,0,19,22,41
p_15,5,0,e_1,99,108,125,12,3,1,3,5,0,1,9,17,26
p_16,4,0,e_0,101,116,130,13,2,1,0,3,0,0,15,14,29
p_19,0,7,e_1,125,126,151,10,1,0,0,3,0,0,1,25,26
p_7,2,0,e_3,55,63,157,2,0,0,0,3,0,0,8,94,102
p_9,10,0,e_3,67,89,157,17,2,1,3,5,1,1,22,68,90
p_14,13,0,e_3,87,100,157,7,3,1,10,5,1,2,13,57,70
p_8,15,0,e_3,62,108,157,13,1,0,2,5,0,1,46,49,95
p_20,3,0,e_3,142,146,157,1,1,0,4,4,1,0,4,11,15
p_21,0,10,e_0,142,143,177,4,2,0,0,3,0,0,1,34,35
p_13,8,0,e_2,87,113,189,13,3,2,0,3,1,1,26,76,102
p_10,9,0,e_2,77,118,189,15,3,2,3,4,1,0,41,71,112
p_17,10,0,e_2,112,123,189,4,1,0,8,2,1,1,11,66,77
p_18,15,0,e_2,120,140,189,27,1,1,9,5,1,1,20,49,69
p_22,6,0,e_2,146,169,189,27,1,1,13,4,1,0,23,20,43
p_30,2,0,e_2,200,209,217,16,2,1,0,3,0,0,9,8,17
p_24,14,0,e_1,157,180,230,14,0,0,7,3,0,0,23,50,73
p_28,7,0,e_1,184,203,230,5,1,1,13,4,1,1,19,27,46
p_27,5,0,e_1,180,211,230,8,2,2,14,2,0,0,31,19,50
p_31,5,0,e_1,203,211,230,12,2,1,7,4,1,1,8,19,27
p_33,1,0,e_1,213,225,230,13,1,0,5,4,1,0,12,5,17
p_23,15,0,e_0,150,194,243,17,1,1,1,5,1,0,44,49,93
p_36,1,0,e_0,225,238,243,10,1,0,5,4,1,0,13,5,18
p_32,0,10,e_2,209,217,249,15,2,2,2,2,0,0,8,32,40
p_35,0,6,e_1,222,230,250,11,2,0,2,4,1,1,8,20,28
p_26,6,0,e_3,169,184,258,11,1,1,1,5,0,1,15,74,89
p_25,9,0,e_3,163,195,258,9,0,0,0,3,0,0,32,63,95
p_29,14,0,e_3,192,212,258,6,2,0,8,5,1,1,20,46,66
p_34,11,0,e_3,217,223,258,2,1,0,13,4,1,0,6,35,41
p_42,4,0,e_3,269,283,297,4,0,0,0,3,0,0,14,14,28
p_43,4,0,e_3,270,283,297,4,1,0,0,5,0,1,13,14,27
p_44,4,0,e_3,275,283,297,3,1,0,1,5,0,1,8,14,22
p_41,7,0,e_0,257,280,303,23,1,1,0,3,0,0,23,23,46
p_37,15,0,e_2,228,266,315,25,1,1,3,5,1,0,38,49,87
p_40,15,0,e_2,255,266,315,16,1,1,11,5,0,1,11,49,60
p_47,3,0,e_2,293,304,315,28,2,2,6,4,1,0,11,11,22
p_49,3,0,e_2,298,304,315,19,1,1,5,4,1,1,6,11,17
p_38,12,0,e_1,240,270,316,24,1,1,3,5,1,0,30,46,76
p_39,13,0,e_1,247,275,316,20,1,1,5,5,1,1,28,41,69
p_51,0,4,e_2,309,315,329,18,1,1,2,4,1,0,6,14,20
p_57,1,0,e_2,327,340,345,18,2,2,3,5,1,0,13,5,18
p_54,7,0,e_0,313,326,361,16,2,2,3,5,0,1,13,35,48
p_46,8,0,e_0,291,331,361,24,2,2,4,4,1,0,40,30,70
p_53,8,0,e_0,313,331,361,15,2,2,3,5,0,2,18,30,48
p_56,8,0,e_0,324,331,361,11,2,2,7,5,0,2,7,30,37
p_59,3,0,e_0,335,348,361,14,2,1,7,4,1,0,13,13,26
p_60,2,0,e_0,338,353,361,14,2,1,6,4,1,1,15,8,23
p_58,0,6,e_2,330,345,365,18,2,2,4,4,0,1,15,20,35
p_48,9,0,e_1,294,345,376,22,2,2,7,4,1,0,51,31,82
p_62,1,0,e_1,345,371,376,13,2,1,9,2,0,0,26,5,31
p_63,3,0,e_0,364,376,387,5,1,0,0,3,0,0,12,11,23
p_45,11,0,e_3,290,332,389,21,1,1,2,4,1,0,42,57,99
p_50,11,0,e_3,299,332,389,11,1,0,0,5,0,1,33,57,90
p_52,14,0,e_3,312,343,389,10,1,0,4,5,0,1,31,46,77
p_55,14,0,e_3,314,343,389,9,2,0,5,5,0,2,29,46,75
p_61,12,0,e_3,341,351,389,2,2,0,14,5,1,1,10,38,48
p_65,0,7,e_1,369,376,399,6,1,0,2,4,1,1,7,23,30
p_68,2,0,e_0,389,397,405,2,0,0,0,3,0,0,8,8,16
p_69,2,0,e_3,391,399,415,2,0,0,0,3,0,0,8,16,24
p_70,3,0,e_3,398,404,415,5,0,0,2,2,0,0,6,11,17
p_64,0,15,e_1,365,376,425,8,1,0,3,4,1,1,11,49,60
p_66,11,0,e_2,376,393,440,23,1,1,6,3,0,0,17,47,64
p_67,12,0,e_2,377,398,440,22,1,1,6,5,0,1,21,42,63
p_71,7,0,e_2,403,415,440,10,1,0,11,4,1,0,12,25,37
p_72,6,0,e_2,417,420,440,6,0,0,7,4,1,0,3,20,23
p_73,3,0,e_0,423,435,446,3,0,0,0,3,0,0,12,11,23
p_77,4,0,e_0,455,469,483,6,1,0,0,3,0,0,14,14,28
p_76,10,0,e_1,440,455,491,5,1,0,15,4,0,1,15,36,51
p_79,9,0,e_1,457,460,491,5,1,1,10,4,1,1,3,31,34
p_75,3,0,e_1,438,480,491,13,1,1,15,3,0,0,42,11,53
p_81,1,0,e_0,493,498,503,2,1,0,0,3,0,0,5,5,10
p_74,10,0,e_3,424,457,503,10,0,0,0,3,0,0,33,46,79
p_78,12,0,e_3,455,465,503,2,1,0,10,5,0,1,10,38,48
p_82,0,12,e_1,494,495,535,3,1,0,0,3,0,0,1,40,41
p_83,0,12,e_0,501,503,541,0,1,0,0,4,1,0,2,38,40
p_80,13,0,e_2,474,515,564,27,1,1,0,3,0,0,41,49,90
p_89,5,0,e_2,535,541,564,14,2,1,7,4,1,0,6,23,29
p_93,4,0,e_2,543,546,564,12,2,1,5,4,1,1,3,18,21
p_94,3,0,e_2,546,551,564,13,2,1,4,1,1,1,5,13,18
p_90,1,0,e_2,538,559,564,17,2,2,6,4,1,1,21,5,26
p_92,10,0,e_0,540,549,583,7,2,0,12,5,1,0,9,34,43
p_95,10,0,e_0,547,549,583,5,2,0,11,4,0,1,2,34,36
p_96,7,0,e_0,551,560,583,7,2,1,10,4,1,0,9,23,32
p_84,12,0,e_1,504,535,593,12,0,0,2,5,1,0,31,58,89
p_85,14,0,e_1,517,543,593,14,0,0,6,5,1,0,26,50,76
p_86,14,0,e_1,518,543,593,14,0,0,7,5,1,1,25,50,75
p_91,14,0,e_1,539,543,593,11,2,0,13,5,1,1,4,50,54
p_99,9,0,e_1,556,560,593,3,2,1,10,4,1,2,4,33,37
p_98,6,0,e_1,555,571,593,7,2,1,11,4,1,1,16,22,38
p_97,5,0,e_1,552,576,593,8,2,1,11,4,1,0,24,17,41
p_87,3,0,e_3,528,540,597,3,0,0,0,3,0,0,12,57,69
p_88,10,0,e_3,531,563,597,10,1,0,0,5,0,1,32,34,66
p_100,10,0,e_3,557,563,597,2,2,0,8,5,1,1,6,34,40
p_107,3,0,e_3,584,586,597,1,1,0,4,4,1,0,2,11,13
p_117,0,2,e_3,636,637,647,0,0,0,0,3,0,0,1,10,11
p_101,9,0,e_2,566,596,663,30,1,1,0,3,0,0,30,67,97
p_109,10,0,e_2,590,601,663,22,1,1,7,5,0,2,11,62,73
p_102,14,0,e_2,568,615,663,25,1,1,0,5,0,1,47,48,95
p_103,14,0,e_2,577,615,663,22,1,1,3,5,0,2,38,48,86
p_104,14,0,e_2,581,615,663,20,1,1,4,5,0,2,34,48,82
p_113,9,0,e_2,629,632,663,9,0,0,10,4,1,0,3,31,34
p_116,7,0,e_2,633,640,663,7,0,0,9,4,1,0,7,23,30
p_106,5,0,e_0,583,600,665,29,1,1,0,5,0,1,17,65,82
p_108,7,0,e_0,584,608,665,27,2,2,0,5,0,2,24,57,81
p_105,12,0,e_0,582,625,665,22,1,1,0,3,1,0,43,40,83
p_110,12,0,e_0,590,625,665,20,1,1,2,5,0,3,35,40,75
p_115,9,0,e_0,632,636,665,9,0,0,10,4,1,0,4,29,33
p_123,0,2,e_2,661,663,671,21,2,2,0,4,1,0,2,8,10
p_125,2,0,e_2,668,671,679,16,2,1,1,5,1,0,3,8,11
p_126,1,0,e_0,681,687,692,14,2,1,0,3,0,0,6,5,11
p_111,2,0,e_1,607,615,697,2,0,0,0,3,0,0,8,82,90
p_112,11,0,e_1,613,644,697,11,0,0,1,5,0,1,31,53,84
p_114,13,0,e_1,632,652,697,13,0,0,7,5,1,1,20,45,65
p_122,7,0,e_1,657,672,697,15,2,2,12,4,1,1,15,25,40
p_124,7,0,e_1,664,672,697,13,2,2,10,4,1,2,8,25,33
p_121,3,0,e_1,656,686,697,19,2,2,12,4,1,0,30,11,41
p_118,8,0,e_3,649,670,730,6,0,0,2,3,0,0,21,60,81
p_119,8,0,e_3,650,670,730,6,1,1,2,3,0,1,20,60,80
p_120,13,0,e_3,653,687,730,11,1,0,2,5,0,1,34,43,77
p_127,7,0,e_3,701,707,730,2,1,0,9,4,1,0,6,23,29
p_129,5,0,e_1,705,722,753,3,2,1,0,3,0,0,17,31,48
p_131,7,0,e_1,722,730,753,26,1,1,5,2,0,0,8,23,31
p_128,0,15,e_2,705,705,754,7,2,0,0,3,0,0,0,49,49
p_130,11,0,e_0,705,740,799,27,2,2,0,3,0,0,35,59,94
p_134,14,0,e_0,734,751,799,13,2,0,9,5,0,1,17,48,65
p_136,14,0,e_0,749,751,799,9,3,0,14,5,1,1,2,48,50
p_138,12,0,e_0,756,759,799,6,2,0,13,4,1,0,3,40,43
p_140,5,0,e_0,768,782,799,7,2,1,10,4,1,0,14,17,31
p_143,5,0,e_0,780,782,799,18,1,0,6,4,1,1,2,17,19
p_137,13,0,e_2,755,763,804,7,2,0,15,3,0,0,8,41,49
p_139,0,15,e_1,758,758,807,15,2,2,0,3,0,0,0,49,49
p_132,4,0,e_3,730,745,821,4,0,0,0,3,0,0,15,76,91
p_133,6,0,e_3,734,753,821,6,1,0,0,5,0,1,19,68,87
p_135,11,0,e_3,739,770,821,9,2,0,2,5,0,2,31,51,82
p_141,12,0,e_3,770,775,821,23,1,0,11,2,1,0,5,46,51
p_142,13,0,e_3,773,780,821,1,2,0,12,5,1,1,7,41,48
p_145,1,0,e_2,820,825,830,1,0,0,0,3,0,0,5,5,10
p_144,6,0,e_0,815,836,856,26,1,1,0,3,0,0,21,20,41
p_150,3,0,e_0,860,871,882,24,1,1,0,3,0,0,11,11,22
p_146,10,0,e_1,846,864,902,10,0,0,15,3,0,0,18,38,56
p_153,6,0,e_1,872,878,902,17,1,1,8,4,1,1,6,24,30
p_154,4,0,e_1,874,886,902,18,1,1,7,4,1,2,12,16,28
p_152,2,0,e_1,868,894,902,22,1,1,9,4,1,0,26,8,34
p_147,6,0,e_2,849,870,932,6,0,0,0,3,0,0,21,62,83
p_149,6,0,e_2,859,870,932,21,1,1,3,5,0,1,11,62,73
p_151,12,0,e_2,863,890,932,14,1,1,4,5,0,1,27,42,69
p_156,12,0,e_2,884,890,932,7,1,1,10,5,1,1,6,42,48
p_159,8,0,e_2,893,904,932,8,1,1,12,4,1,1,11,28,39
p_157,7,0,e_2,889,909,932,10,1,1,12,5,1,1,20,23,43
p_158,7,0,e_2,892,909,932,9,1,1,12,4,1,1,17,23,40
p_148,15,0,e_3,849,896,943,15,0,0,0,3,0,0,47,47,94
p_155,11,0,e_0,884,919,954,8,1,1,0,3,0,0,35,35,70
p_3,4,0,e_2,25,39,87,4,0,0,0,3,0,0,14,48,62
p_4,5,0,e_2,34,44,87,5,0,0,2,5,0,1,10,43,53
p_5,9,0,e_2,41,58,87,9,0,0,4,5,1,1,17,29,46
p_6,9,0,e_2,45,58,87,9,0,0,5,5,1,1,13,29,42
p_2,11,0,e_1,19,55,90,11,0,0,0,3,0,0,36,35,71
p_1,13,0,e_0,13,55,96,13,0,0,0,3,0,0,42,41,83
p_12,0,8,e_2,86,87,115,21,4,4,0,3,1,0,1,28,29
p_16,4,0,e_1,101,115,129,14,4,2,0,3,0,0,14,14,28
p_15,5,0,e_0,99,117,134,13,4,2,0,3,0,0,18,17,35
p_19,0,7,e_1,125,129,154,11,2,0,1,4,1,0,4,25,29
p_7,2,0,e_3,55,64,160,2,0,0,0,3,0,0,9,96,105
p_10,9,0,e_3,77,87,160,15,3,2,6,5,1,2,10,73,83
p_9,10,0,e_3,67,92,160,18,2,1,2,5,1,1,25,68,93
p_14,13,0,e_3,87,103,160,8,4,1,9,2,1,3,16,57,73
p_8,15,0,e_3,62,111,160,14,1,0,1,5,0,1,49,49,98
p_11,4,0,e_3,84,146,160,18,4,3,8,5,1,3,62,14,76
p_21,0,10,e_0,142,143,179,5,2,0,0,3,0,0,1,36,37
p_13,8,0,e_2,87,115,187,13,4,2,0,5,1,1,28,72,100
p_17,10,0,e_2,112,123,187,5,2,0,7,5,1,0,11,64,75
p_18,15,0,e_2,120,140,187,28,2,2,9,5,1,1,20,47,67
p_30,2,0,e_2,200,208,216,15,2,1,0,3,0,0,8,8,16
p_20,3,0,e_0,142,156,217,2,2,1,0,3,0,1,14,61,75
p_28,7,0,e_0,184,190,217,5,1,1,9,4,1,2,6,27,33
p_26,6,0,e_0,169,195,217,11,1,1,7,5,2,0,26,22,48
p_27,5,0,e_0,180,200,217,8,1,1,10,4,1,1,20,17,37
p_22,6,0,e_1,146,149,233,28,1,1,5,5,1,0,3,84,87
p_24,14,0,e_1,157,177,233,17,1,1,7,5,1,1,20,56,76
p_23,15,0,e_1,150,182,233,18,1,1,6,5,2,0,32,51,83
p_31,5,0,e_1,203,214,233,11,2,1,9,4,1,0,11,19,30
p_33,1,0,e_1,213,228,233,12,1,0,5,1,1,0,15,5,20
p_36,1,0,e_1,225,228,233,9,1,0,2,4,1,1,3,5,8
p_35,0,6,e_0,222,223,245,11,1,0,0,3,0,0,1,22,23
p_32,0,10,e_2,209,216,248,14,2,2,2,4,1,0,7,32,39
p_25,9,0,e_3,163,193,256,9,0,0,0,3,0,0,30,63,93
p_29,14,0,e_3,192,210,256,5,1,0,9,5,0,1,18,46,64
p_34,11,0,e_3,217,221,256,1,1,0,12,4,1,0,4,35,39
p_42,4,0,e_3,269,284,298,4,0,0,0,3,0,0,15,14,29
p_43,4,0,e_3,270,284,298,4,1,0,0,5,0,1,14,14,28
p_44,4,0,e_3,275,284,298,3,1,0,1,5,0,1,9,14,23
p_41,7,0,e_1,257,280,303,7,0,0,0,3,0,0,23,23,46
p_38,12,0,e_0,240,265,313,23,1,1,5,5,1,0,25,48,73
p_39,13,0,e_0,247,270,313,20,1,1,6,5,0,1,23,43,66
p_47,3,0,e_0,293,302,313,29,2,2,6,4,1,0,9,11,20
p_37,15,0,e_2,228,265,314,24,1,1,3,5,1,0,37,49,86
p_40,15,0,e_2,255,265,314,15,1,1,12,5,0,1,10,49,59
p_49,3,0,e_2,298,303,314,19,2,2,4,4,1,0,5,11,16
p_51,0,4,e_0,309,313,327,19,2,2,1,4,1,0,4,14,18
p_57,1,0,e_2,327,332,337,18,3,2,0,3,0,0,5,5,10
p_58,0,6,e_2,330,337,357,19,3,3,0,5,0,1,7,20,27
p_54,7,0,e_0,313,338,373,17,3,3,0,3,1,0,25,35,60
p_56,8,0,e_0,324,343,373,12,3,3,3,5,1,1,19,30,49
p_59,3,0,e_0,335,360,373,14,2,1,6,5,0,2,25,13,38
p_60,2,0,e_0,338,365,373,15,2,1,7,2,0,2,27,8,35
p_63,3,0,e_2,364,368,381,6,1,0,4,4,0,1,4,13,17
p_62,1,0,e_2,345,376,381,15,1,0,2,5,1,0,31,5,36
p_48,9,0,e_3,294,327,390,22,2,2,1,4,1,1,33,63,96
p_45,11,0,e_3,290,335,390,22,1,1,3,4,1,0,45,55,100
p_50,11,0,e_3,299,335,390,11,2,0,0,5,0,2,36,55,91
p_52,14,0,e_3,312,346,390,10,2,0,4,5,0,2,34,44,78
p_46,8,0,e_1,291,329,395,24,2,2,4,4,1,0,38,66,104
p_53,8,0,e_1,313,329,395,16,3,3,3,5,0,1,16,66,82
p_61,12,0,e_1,341,343,395,4,2,1,12,5,1,1,2,52,54
p_55,14,0,e_1,314,351,395,9,3,0,3,5,0,1,37,44,81
p_65,0,7,e_0,369,373,396,7,1,0,1,4,1,0,4,23,27
p_68,2,0,e_3,389,398,406,2,0,0,0,3,1,0,9,8,17
p_69,2,0,e_3,391,398,406,2,1,0,0,5,0,1,7,8,15
p_64,0,15,e_0,365,373,424,8,1,0,2,1,1,0,8,51,59
p_70,3,0,e_1,398,410,449,29,1,1,0,3,0,0,12,39,51
p_71,7,0,e_1,403,424,449,24,1,1,1,5,0,1,21,25,46
p_73,3,0,e_1,423,438,449,8,1,1,7,5,1,1,15,11,26
p_66,11,0,e_2,376,416,453,24,1,1,1,1,1,0,40,37,77
p_75,3,0,e_2,438,442,453,3,1,0,4,4,1,0,4,11,15
p_72,6,0,e_3,417,438,458,6,0,0,0,3,0,0,21,20,41
p_67,12,0,e_0,377,413,475,22,1,1,1,5,2,0,36,62,98
p_74,10,0,e_0,424,441,475,9,1,0,15,4,1,0,17,34,51
p_77,4,0,e_0,455,461,475,27,1,1,6,4,1,0,6,14,20
p_81,1,0,e_0,493,499,504,1,0,0,0,3,0,0,6,5,11
p_78,12,0,e_2,455,493,531,19,1,1,0,3,0,0,38,38,76
p_79,9,0,e_1,457,478,535,21,1,1,2,5,0,1,21,57,78
p_76,10,0,e_1,440,483,535,26,1,1,3,4,1,0,43,52,95
p_80,13,0,e_1,474,494,535,13,0,0,8,5,0,2,20,41,61
p_82,0,12,e_3,494,495,535,0,0,0,0,3,0,0,1,40,41
p_83,0,12,e_0,501,504,544,23,1,1,1,4,1,0,3,40,43
p_90,1,0,e_2,538,543,568,15,2,1,0,3,0,0,5,25,30
p_93,4,0,e_2,543,554,568,18,1,0,1,2,0,0,11,14,25
p_88,10,0,e_0,531,536,588,7,2,2,9,5,1,1,5,52,57
p_92,10,0,e_0,540,552,588,5,2,1,11,5,2,1,12,36,48
p_98,6,0,e_0,555,566,588,5,2,1,10,4,1,1,11,22,33
p_87,3,0,e_0,528,577,588,15,2,2,8,5,1,0,49,11,60
p_84,12,0,e_3,504,535,591,10,1,0,2,5,1,0,31,56,87
p_85,14,0,e_3,517,543,591,8,1,0,6,5,1,0,26,48,74
p_86,14,0,e_3,518,543,591,8,2,0,6,5,1,1,25,48,73
p_91,14,0,e_3,539,543,591,1,2,0,13,5,1,1,4,48,52
p_95,10,0,e_3,547,557,591,3,1,0,13,4,1,0,10,34,44
p_99,9,0,e_3,556,562,591,1,2,0,10,4,1,1,6,29,35
p_89,5,0,e_1,535,553,642,11,2,1,0,3,0,0,18,89,107
p_96,7,0,e_1,551,561,642,5,2,1,4,5,0,2,10,81,91
p_101,9,0,e_1,566,569,642,29,1,1,8,5,1,2,3,73,76
p_100,10,0,e_1,557,574,642,30,2,2,6,5,1,2,17,68,85
p_102,14,0,e_1,568,588,642,23,1,1,9,5,1,3,20,54,74
p_103,14,0,e_1,577,588,642,20,1,1,11,5,1,2,11,54,65
p_104,14,0,e_1,581,588,642,19,1,1,12,5,1,2,7,54,61
p_110,12,0,e_1,590,596,642,18,1,1,14,4,1,4,6,46,52
p_109,10,0,e_1,590,604,642,20,1,1,14,4,1,3,14,38,52
p_108,7,0,e_1,584,615,642,25,1,1,13,5,1,3,31,27,58
p_106,5,0,e_1,583,623,642,28,1,1,12,5,1,2,40,19,59
p_94,3,0,e_1,546,631,642,10,1,0,3,5,0,1,85,11,96
p_107,3,0,e_1,584,631,642,29,1,1,13,5,1,3,47,11,58
p_97,5,0,e_2,552,585,646,6,2,1,4,5,1,1,33,61,94
p_105,12,0,e_2,582,608,646,21,1,1,4,5,0,1,26,38,64
p_117,0,2,e_1,636,642,650,16,2,2,2,4,1,0,6,8,14
p_121,3,0,e_1,656,661,672,15,3,2,2,3,0,0,5,11,16
p_123,0,2,e_1,661,672,680,17,2,2,3,4,1,0,11,8,19
p_126,1,0,e_1,681,686,691,11,1,0,2,3,0,0,5,5,10
p_111,2,0,e_0,607,615,697,2,0,0,0,3,0,0,8,82,90
p_115,9,0,e_0,632,638,697,9,1,0,7,5,1,1,6,59,65
p_112,11,0,e_0,613,646,697,11,0,0,2,5,0,1,33,51,84
p_114,13,0,e_0,632,654,697,12,1,0,7,5,1,2,22,43,65
p_122,7,0,e_0,657,674,697,11,3,2,12,4,1,0,17,23,40
p_124,7,0,e_0,664,674,697,10,2,1,10,4,1,1,10,23,33
p_118,8,0,e_2,649,676,704,4,2,1,0,3,0,0,27,28,55
p_125,2,0,e_2,668,696,704,13,2,1,6,5,0,1,28,8,36
p_116,7,0,e_3,633,652,717,10,1,1,1,5,0,1,19,65,84
p_119,8,0,e_3,650,657,717,3,2,1,7,5,0,2,7,60,67
p_113,9,0,e_3,629,662,717,9,0,0,0,3,0,0,33,55,88
p_120,13,0,e_3,653,676,717,6,3,0,7,5,1,2,23,41,64
p_129,5,0,e_1,705,722,739,29,1,1,0,3,0,0,17,17,34
p_127,7,0,e_0,701,725,750,28,1,1,0,3,0,0,24,25,49
p_131,7,0,e_0,722,725,750,7,0,0,6,5,0,1,3,25,28
p_132,4,0,e_0,730,736,750,4,0,0,6,4,1,0,6,14,20
p_128,0,15,e_2,705,705,758,4,1,0,0,3,0,1,0,53,53
p_133,6,0,e_3,734,755,775,6,0,0,0,3,0,0,21,20,41
p_139,0,15,e_0,758,759,808,6,1,0,0,3,0,0,1,49,50
p_130,11,0,e_2,705,742,809,23,1,1,0,3,0,0,37,67,104
p_134,14,0,e_2,734,753,809,14,0,0,8,5,1,1,19,56,75
p_136,14,0,e_2,749,753,809,10,1,0,13,5,2,1,4,56,60
p_137,13,0,e_2,755,766,809,19,0,0,14,5,2,0,11,43,54
p_138,12,0,e_2,756,771,809,24,1,1,15,5,2,1,15,38,53
p_143,5,0,e_3,780,797,814,5,0,0,0,3,0,0,17,17,34
p_135,11,0,e_1,739,774,827,10,1,0,0,3,1,0,35,53,88
p_141,12,0,e_1,770,779,827,20,1,1,10,5,0,2,9,48,57
p_142,13,0,e_1,773,784,827,17,1,1,11,5,0,3,11,43,54
p_140,5,0,e_1,768,810,827,27,1,1,9,5,0,1,42,17,59
p_145,1,0,e_3,820,825,830,1,0,0,0,3,0,0,5,5,10
p_144,6,0,e_2,815,836,856,6,0,0,0,3,0,0,21,20,41
p_150,3,0,e_2,860,871,884,6,1,1,0,3,0,0,11,13,24
p_152,2,0,e_2,868,876,884,17,2,2,2,5,0,1,8,8,16
p_146,10,0,e_0,846,863,899,10,0,0,15,3,0,0,17,36,53
p_153,6,0,e_0,872,877,899,12,2,1,8,4,1,0,5,22,27
p_154,4,0,e_0,874,885,899,13,2,1,7,4,1,1,11,14,25
p_147,6,0,e_3,849,870,934,6,0,0,0,3,0,0,21,64,85
p_149,6,0,e_3,859,870,934,3,1,0,3,5,0,1,11,64,75
p_155,11,0,e_3,884,887,934,3,2,1,10,5,1,1,3,47,50
p_151,12,0,e_3,863,892,934,8,1,0,4,5,0,1,29,42,71
p_156,12,0,e_3,884,892,934,2,2,0,10,5,1,1,8,42,50
p_159,8,0,e_3,893,906,934,4,2,0,12,4,1,1,13,28,41
p_158,7,0,e_3,892,911,934,5,1,0,12,4,1,0,19,23,42
p_157,7,0,e_2,889,913,936,6,2,1,0,3,0,0,24,23,47
p_148,15,0,e_1,849,896,943,15,0,0,0,3,0,0,47,47,94
p_3,4,0,e_2,25,40,54,4,0,0,0,3,0,0,15,14,29
p_7,2,0,e_2,55,64,72,10,2,1,0,3,0,0,9,8,17
p_6,9,0,e_1,45,48,91,6,2,0,8,5,0,1,3,43,46
p_2,11,0,e_1,19,56,91,11,0,0,0,3,0,0,37,35,72
p_1,13,0,e_0,13,54,95,13,0,0,0,3,0,0,41,41,82
p_12,0,8,e_1,86,91,117,15,1,1,2,4,1,0,5,26,31
p_15,5,0,e_0,99,117,134,7,1,0,0,3,0,0,18,17,35
p_4,5,0,e_3,34,51,138,5,0,0,0,3,0,0,17,87,104
p_5,9,0,e_3,41,65,138,7,1,0,2,5,0,1,24,73,97
p_9,10,0,e_3,67,70,138,11,2,1,9,5,1,1,3,68,71
p_8,15,0,e_3,62,87,138,7,2,0,8,5,1,1,25,51,76
p_14,13,0,e_3,87,95,138,2,1,0,15,4,1,0,8,43,51
p_16,4,0,e_3,101,124,138,8,1,0,12,4,1,0,23,14,37
p_11,4,0,e_2,84,91,139,12,2,1,2,5,0,1,7,48,55
p_13,8,0,e_2,87,105,139,23,1,0,3,5,0,2,18,34,52
p_10,9,0,e_2,77,110,139,9,2,1,0,3,0,0,33,29,62
p_19,0,7,e_0,125,134,157,4,1,0,3,4,1,0,9,23,32
p_21,0,10,e_3,142,143,177,0,0,0,0,3,0,0,1,34,35
p_17,10,0,e_1,112,125,189,28,2,2,6,5,1,0,13,64,77
p_18,15,0,e_1,120,142,189,20,2,2,8,5,0,1,22,47,69
p_20,3,0,e_2,142,154,211,3,0,0,0,3,0,0,12,57,69
p_22,6,0,e_2,146,165,211,14,1,1,1,5,0,1,19,46,65
p_25,9,0,e_2,163,176,211,13,2,2,6,5,1,1,13,35,48
p_26,6,0,e_2,169,187,211,14,2,2,7,5,1,1,18,24,42
p_27,5,0,e_2,180,192,211,13,1,1,8,4,1,1,12,19,31
p_30,2,0,e_2,200,203,211,10,1,0,3,4,1,0,3,8,11
p_23,15,0,e_0,150,183,234,14,1,0,5,5,1,0,33,51,84
p_28,7,0,e_0,184,209,234,9,1,1,15,4,1,0,25,25,50
p_33,1,0,e_0,213,229,234,6,2,1,6,4,1,0,16,5,21
p_24,14,0,e_3,157,191,239,11,1,0,3,5,1,0,34,48,82
p_31,5,0,e_3,203,220,239,6,1,0,11,4,1,0,17,19,36
p_36,1,0,e_3,225,234,239,3,1,0,4,4,1,0,9,5,14
p_32,0,10,e_2,209,211,243,9,2,0,1,4,1,0,2,32,34
p_35,0,6,e_3,222,239,259,5,1,0,5,4,1,0,17,20,37
p_34,11,0,e_2,217,248,287,25,2,2,1,5,1,0,31,39,70
p_41,7,0,e_2,257,262,287,18,2,1,9,4,1,0,5,25,30
p_42,4,0,e_2,269,273,287,17,1,1,5,4,1,0,4,14,18
p_29,14,0,e_1,192,236,292,30,1,1,0,3,0,0,44,56,100
p_37,15,0,e_1,228,241,292,18,2,2,12,5,0,1,13,51,64
p_38,12,0,e_1,240,252,292,12,1,0,15,5,1,1,12,40,52
p_43,4,0,e_1,270,278,292,17,1,1,7,4,1,0,8,14,22
p_44,4,0,e_1,275,278,292,15,1,1,5,4,1,1,3,14,17
p_47,3,0,e_1,293,304,315,11,1,0,0,3,0,0,11,11,22
p_49,3,0,e_1,298,304,315,9,2,1,1,5,0,1,6,11,17
p_51,0,4,e_1,309,315,329,9,2,0,2,4,1,0,6,14,20
p_39,13,0,e_0,247,288,331,11,1,0,0,3,0,0,41,43,84
p_45,11,0,e_0,290,296,331,4,1,0,13,4,1,0,6,35,41
p_40,15,0,e_3,255,288,343,10,1,0,5,5,1,0,33,55,88
p_50,11,0,e_3,299,302,343,1,2,0,12,4,1,1,3,41,44
p_48,9,0,e_3,294,310,343,4,1,0,13,4,1,0,16,33,49
p_54,7,0,e_3,313,318,343,2,1,0,9,4,1,0,5,25,30
p_57,1,0,e_3,327,338,343,4,1,0,5,4,1,0,11,5,16
p_62,1,0,e_3,345,350,355,1,0,0,0,3,0,0,5,5,10
p_58,0,6,e_0,330,331,355,4,2,0,0,3,1,0,1,24,25
p_56,8,0,e_1,324,343,371,27,1,1,3,5,1,0,19,28,47
p_59,3,0,e_1,335,360,371,29,2,2,6,5,0,1,25,11,36
p_60,2,0,e_0,338,341,375,29,1,1,1,5,1,0,3,34,37
p_46,8,0,e_2,291,317,383,6,1,0,0,3,0,0,26,66,92
p_53,8,0,e_2,313,317,383,30,2,2,7,5,0,2,4,66,70
p_52,14,0,e_2,312,337,383,25,1,1,6,5,0,1,25,46,71
p_55,14,0,e_2,314,337,383,24,2,2,7,5,0,2,23,46,69
p_61,12,0,e_2,341,345,383,18,1,1,13,4,1,0,4,38,42
p_63,3,0,e_3,364,375,386,3,0,0,0,3,0,0,11,11,22
p_65,0,7,e_1,369,371,394,5,1,1,1,4,1,0,2,23,25
p_68,2,0,e_2,389,398,406,2,0,0,0,3,0,0,9,8,17
p_64,0,15,e_1,365,371,420,6,1,1,2,4,1,0,6,49,55
p_69,2,0,e_3,391,399,443,2,0,0,0,3,0,0,8,44,52
p_70,3,0,e_3,398,404,443,5,0,0,2,2,0,0,6,39,45
p_71,7,0,e_3,403,418,443,4,2,0,3,5,1,1,15,25,40
p_73,3,0,e_3,423,432,443,3,1,0,6,4,1,0,9,11,20
p_66,11,0,e_0,376,411,456,22,1,1,0,3,0,0,35,45,80
p_67,12,0,e_0,377,416,456,21,1,1,0,5,0,1,39,40,79
p_75,3,0,e_0,438,445,456,29,1,1,5,4,1,0,7,11,18
p_72,6,0,e_2,417,437,457,1,2,0,0,3,0,0,20,20,40
p_74,10,0,e_1,424,442,474,25,2,2,15,3,0,0,18,32,50
p_76,10,0,e_1,440,442,474,21,1,1,10,4,0,1,2,32,34
p_77,4,0,e_0,455,470,484,4,0,0,0,3,1,0,15,14,29
p_81,1,0,e_0,493,498,503,13,1,1,0,3,0,0,5,5,10
p_79,9,0,e_2,457,486,515,15,1,1,0,3,1,0,29,29,58
p_82,0,12,e_1,494,495,535,14,1,1,0,3,0,0,1,40,41
p_78,12,0,e_3,455,494,540,12,0,0,0,3,0,0,39,46,85
p_80,13,0,e_3,474,499,540,7,1,0,6,5,0,1,25,41,66
p_83,0,12,e_0,501,503,541,13,1,0,0,4,1,0,2,38,40
p_84,12,0,e_1,504,535,593,30,1,1,2,5,1,0,31,58,89
p_85,14,0,e_1,517,543,593,24,1,1,6,5,1,0,26,50,76
p_98,6,0,e_1,555,569,593,10,1,1,10,4,1,2,14,24,38
p_89,5,0,e_1,535,574,593,26,1,1,12,5,1,1,39,19,58
p_97,5,0,e_1,552,574,593,12,1,1,12,4,1,2,22,19,41
p_94,3,0,e_1,546,582,593,16,1,1,13,4,1,1,36,11,47
p_87,3,0,e_2,528,539,596,1,1,0,0,3,0,0,11,57,68
p_88,10,0,e_2,531,562,596,23,1,1,1,5,0,1,31,34,65
p_90,1,0,e_2,538,591,596,30,1,1,3,5,0,2,53,5,58
p_86,14,0,e_0,518,549,599,23,1,1,4,5,1,0,31,50,81
p_91,14,0,e_0,539,549,599,16,1,1,11,5,1,1,10,50,60
p_96,7,0,e_0,551,572,599,10,1,1,14,4,1,1,21,27,48
p_93,4,0,e_0,543,583,599,16,1,1,12,5,0,1,40,16,56
p_107,3,0,e_0,584,588,599,13,4,1,4,4,1,0,4,11,15
p_111,2,0,e_0,607,616,624,8,3,2,0,3,0,0,9,8,17
p_99,9,0,e_3,556,570,643,6,1,1,5,5,0,1,14,73,87
p_101,9,0,e_3,566,570,643,3,2,1,8,5,0,2,4,73,77
p_92,10,0,e_3,540,575,643,10,0,0,0,3,0,0,35,68,103
p_95,10,0,e_3,547,575,643,9,1,0,1,5,0,1,28,68,96
p_100,10,0,e_3,557,575,643,5,2,0,5,5,0,2,18,68,86
p_105,12,0,e_3,582,583,643,4,2,1,12,5,1,1,1,60,61
p_102,14,0,e_3,568,591,643,5,2,0,9,5,0,2,23,52,75
p_103,14,0,e_3,577,591,643,4,2,0,10,5,1,1,14,52,66
p_104,14,0,e_3,581,591,643,3,2,0,11,5,1,1,10,52,62
p_110,12,0,e_3,590,599,643,6,4,0,14,2,1,3,9,44,53
p_109,10,0,e_3,590,607,643,4,4,0,14,5,1,3,17,36,53
p_108,7,0,e_3,584,618,643,9,3,1,12,5,1,2,34,25,59
p_106,5,0,e_3,583,626,643,11,2,1,12,5,1,1,43,17,60
p_117,0,2,e_3,636,643,651,2,1,0,2,4,1,0,7,8,15
p_116,7,0,e_0,633,653,694,26,1,1,0,5,0,1,20,41,61
p_113,9,0,e_0,629,661,694,26,1,1,0,3,0,0,32,33,65
p_124,7,0,e_0,664,669,694,3,2,1,8,4,1,0,5,25,30
p_126,1,0,e_0,681,689,694,4,2,1,3,4,1,0,8,5,13
p_119,8,0,e_2,650,658,694,6,2,0,5,5,0,1,8,36,44
p_115,9,0,e_2,632,663,694,24,1,1,0,3,0,0,31,31,62
p_122,7,0,e_2,657,671,694,5,2,1,8,2,0,1,14,23,37
p_112,11,0,e_1,613,648,699,27,3,3,0,3,0,0,35,51,86
p_114,13,0,e_1,632,656,699,20,1,1,6,5,0,1,24,43,67
p_120,13,0,e_1,653,656,699,11,1,0,12,5,1,1,3,43,46
p_125,2,0,e_1,668,691,699,7,2,1,9,4,1,0,23,8,31
p_118,8,0,e_3,649,671,699,7,1,0,1,5,1,0,22,28,50
p_121,3,0,e_3,656,688,699,10,1,1,3,5,0,1,32,11,43
p_123,0,2,e_0,661,694,702,11,2,2,9,2,1,0,33,8,41
p_129,5,0,e_2,705,722,739,5,0,0,0,3,0,0,17,17,34
p_127,7,0,e_1,701,724,749,7,0,0,0,3,0,0,23,25,48
p_131,7,0,e_1,722,724,749,19,1,1,6,5,0,1,2,25,27
p_132,4,0,e_1,730,735,749,19,1,1,6,4,1,0,5,14,19
p_128,0,15,e_3,705,706,757,0,0,0,0,3,0,0,1,51,52
p_130,11,0,e_0,705,734,771,11,0,0,2,3,0,0,29,37,66
p_133,6,0,e_0,734,751,771,16,1,1,11,4,1,0,17,20,37
p_139,0,15,e_1,758,759,808,15,3,0,0,3,0,0,1,49,50
p_134,14,0,e_3,734,752,810,8,1,1,8,5,1,0,18,58,76
p_136,14,0,e_3,749,752,810,3,2,1,13,5,1,1,3,58,61
p_137,13,0,e_3,755,765,810,3,2,1,14,5,2,0,10,45,55
p_138,12,0,e_3,756,770,810,3,2,0,15,2,2,1,14,40,54
p_143,5,0,e_3,780,793,810,4,1,0,9,4,1,0,13,17,30
p_135,11,0,e_2,739,775,820,9,2,2,0,3,0,0,36,45,81
p_141,12,0,e_2,770,780,820,30,1,1,10,5,0,2,10,40,50
p_140,5,0,e_2,768,803,820,7,2,0,9,5,0,1,35,17,52
p_145,1,0,e_2,820,825,830,10,1,1,0,3,1,0,5,5,10
p_142,13,0,e_0,773,814,855,28,1,1,0,3,0,0,41,41,82
p_144,6,0,e_3,815,836,856,6,0,0,0,3,0,0,21,20,41
p_152,2,0,e_3,868,869,885,2,1,1,2,5,0,1,1,16,17
p_150,3,0,e_3,860,874,885,3,0,0,0,3,0,0,14,11,25
p_146,10,0,e_1,846,863,899,23,1,1,15,3,0,0,17,36,53
p_147,6,0,e_1,849,877,899,26,1,1,15,4,0,1,28,22,50
p_153,6,0,e_1,872,877,899,4,2,0,8,4,1,1,5,22,27
p_154,4,0,e_1,874,885,899,29,1,1,7,4,1,1,11,14,25
p_149,6,0,e_0,859,879,937,6,0,0,0,3,0,0,20,58,78
p_151,12,0,e_0,863,899,937,12,1,0,1,5,0,1,36,38,74
p_156,12,0,e_0,884,899,937,12,0,0,7,5,1,1,15,38,53
p_157,7,0,e_3,889,913,944,7,0,0,0,3,0,0,24,31,55
p_158,7,0,e_3,892,913,944,7,1,0,0,5,0,1,21,31,52
p_159,8,0,e_3,893,918,944,7,1,0,1,5,0,1,25,26,51
p_148,15,0,e_2,849,896,945,17,1,1,0,3,0,0,47,49,96
p_155,11,0,e_2,884,910,945,19,1,1,11,5,0,1,26,35,61
