p_300,0,4,e_0,8,9,25,0,0,0,0,3,0,0,1,16,17
p_299,0,5,e_1,9,9,28,0,0,0,0,3,0,0,0,19,19
p_297,0,6,e_3,15,15,37,0,0,0,0,3,0,0,0,22,22
p_298,0,9,e_2,11,11,42,0,0,0,0,3,0,0,0,31,31
p_296,0,4,e_0,28,43,59,9,1,1,4,3,0,0,15,16,31
p_289,0,4,e_0,43,43,59,6,0,0,0,3,0,0,0,16,16
p_286,0,3,e_1,46,47,60,6,0,0,0,3,0,0,1,13,14
p_292,0,6,e_0,38,43,67,6,0,0,1,4,0,1,5,24,29
p_290,0,6,e_0,40,43,67,6,0,0,1,4,0,1,3,24,27
p_295,0,5,e_1,29,47,68,8,1,1,5,3,0,0,18,21,39
p_287,0,5,e_1,45,47,68,6,0,0,1,4,0,1,2,21,23
p_288,0,8,e_1,44,47,79,6,0,0,1,4,0,1,3,32,35
p_281,0,1,e_3,73,74,81,0,0,0,0,3,0,0,1,7,8
p_291,0,11,e_0,39,43,84,6,0,0,1,4,0,1,4,41,45
p_294,0,12,e_0,31,43,89,8,1,1,4,4,0,1,12,46,58
p_293,0,12,e_0,33,43,89,7,1,1,3,4,0,1,10,46,56
p_285,0,4,e_3,53,74,92,6,0,0,6,3,0,0,21,18,39
p_284,0,4,e_3,54,74,92,6,1,0,6,4,0,1,20,18,38
p_282,0,7,e_3,66,74,103,2,1,0,2,4,0,1,8,29,37
p_283,0,9,e_3,57,74,111,5,1,0,5,4,0,1,17,37,54
p_278,0,2,e_2,77,104,112,18,4,4,9,4,0,1,27,8,35
p_279,0,5,e_2,76,104,123,18,4,4,9,4,0,1,28,19,47
p_277,0,6,e_2,82,104,128,17,3,3,7,4,0,1,22,24,46
p_274,0,8,e_2,88,104,136,15,3,3,5,4,0,1,16,32,48
p_271,0,1,e_1,121,136,141,9,0,0,5,4,0,1,15,5,20
p_276,0,11,e_2,84,104,147,16,3,3,6,4,0,1,20,43,63
p_273,0,4,e_1,110,136,152,9,1,1,8,3,0,0,26,16,42
p_280,0,14,e_2,75,104,158,18,4,4,9,3,0,0,29,54,83
p_275,0,14,e_2,86,104,158,16,3,3,6,4,0,1,18,54,72
p_270,0,9,e_1,122,136,169,9,0,0,5,4,0,1,14,33,47
p_269,0,9,e_1,127,136,169,9,0,0,3,4,0,1,9,33,42
p_272,0,10,e_1,113,136,174,9,0,0,8,4,0,1,23,38,61
p_267,0,1,e_3,148,173,178,8,1,0,8,4,0,1,25,5,30
p_268,0,2,e_3,144,173,183,9,0,0,9,3,0,0,29,10,39
p_265,0,4,e_3,152,173,191,7,1,0,7,4,0,1,21,18,39
p_262,0,5,e_3,157,173,196,5,1,0,5,4,0,1,16,23,39
p_261,0,5,e_3,164,173,196,3,1,0,3,4,0,1,9,23,32
p_263,0,7,e_3,154,173,204,6,1,0,6,4,0,1,19,31,50
p_260,0,7,e_3,165,173,204,3,1,0,3,4,0,1,8,31,39
p_258,0,7,e_3,168,173,204,1,1,0,1,4,0,1,5,31,36
p_264,0,11,e_3,153,173,218,7,1,0,7,4,0,1,20,45,65
p_255,0,3,e_1,184,206,219,28,6,6,7,4,0,1,22,13,35
p_254,0,4,e_1,187,206,224,27,6,6,6,4,0,1,19,18,37
p_253,0,5,e_1,190,206,229,4,5,5,5,4,0,1,16,23,39
p_252,0,5,e_1,205,206,229,23,3,3,0,3,0,0,1,23,24
p_257,0,14,e_3,169,173,229,1,1,0,1,4,0,1,4,56,60
p_259,0,15,e_3,167,173,234,2,1,0,2,4,0,1,6,61,67
p_266,0,6,e_1,151,206,234,7,1,0,4,3,3,0,55,28,83
p_256,0,10,e_1,182,206,248,28,6,6,8,4,0,1,24,42,66
p_250,0,2,e_0,217,248,256,19,2,2,10,4,0,1,31,8,39
p_248,0,5,e_0,246,248,267,15,0,0,0,4,0,1,2,19,21
p_249,0,6,e_0,239,248,272,15,0,0,3,4,0,1,9,24,33
p_247,0,5,e_1,250,283,300,15,0,0,10,3,0,0,33,17,50
p_251,0,15,e_0,209,248,301,22,3,3,12,3,0,0,39,53,92
p_245,0,7,e_1,269,283,308,15,0,0,5,4,0,1,14,25,39
p_242,0,8,e_1,277,283,313,15,0,0,2,4,0,1,6,30,36
p_246,0,10,e_1,262,283,321,15,0,0,7,4,0,1,21,38,59
p_244,0,12,e_1,271,283,329,15,0,0,4,4,0,1,12,46,58
p_241,0,1,e_2,283,328,333,15,0,0,14,3,0,0,45,5,50
p_236,0,1,e_2,305,328,333,15,0,0,7,4,0,1,23,5,28
p_233,0,1,e_2,311,328,333,15,0,0,6,4,0,1,17,5,22
p_243,0,15,e_1,272,283,340,15,0,0,3,4,0,1,11,57,68
p_230,0,3,e_2,319,328,341,15,0,0,3,4,0,1,9,13,22
p_228,0,4,e_2,325,328,346,15,0,0,1,4,0,1,3,18,21
p_232,0,5,e_2,314,328,351,15,0,0,4,4,0,1,14,23,37
p_237,0,7,e_2,304,328,359,15,0,0,8,4,0,1,24,31,55
p_231,0,7,e_2,317,328,359,15,0,0,4,4,0,1,11,31,42
p_235,0,8,e_2,308,328,364,15,0,0,7,4,0,1,20,36,56
p_234,0,8,e_2,310,328,364,15,0,0,6,4,0,1,18,36,54
p_240,0,9,e_2,301,328,369,15,0,0,9,4,0,1,27,41,68
p_239,0,11,e_2,302,328,377,15,0,0,9,4,0,1,26,49,75
p_227,0,12,e_2,327,328,382,15,0,0,0,4,0,1,1,54,55
p_216,0,1,e_0,347,376,383,10,1,0,10,4,0,1,29,7,36
p_238,0,13,e_2,303,328,387,15,0,0,8,4,0,1,25,59,84
p_229,0,13,e_2,320,328,387,15,0,0,3,4,0,1,8,59,67
p_226,0,2,e_0,329,376,388,15,0,0,15,3,0,0,47,12,59
p_223,0,2,e_0,336,376,388,14,1,0,13,4,0,1,40,12,52
p_214,0,3,e_0,349,376,393,10,1,0,9,4,0,1,27,17,44
p_225,0,5,e_3,330,378,395,15,0,0,15,3,0,0,48,17,65
p_224,0,5,e_0,331,376,401,15,1,1,15,4,0,1,45,25,70
p_222,0,5,e_0,337,376,401,14,1,0,13,4,0,1,39,25,64
p_219,0,5,e_0,342,376,401,12,1,0,11,4,0,1,34,25,59
p_221,0,6,e_0,339,376,406,13,1,0,12,4,0,1,37,30,67
p_220,0,6,e_0,341,376,406,12,1,0,11,4,0,1,35,30,65
p_217,0,7,e_0,346,376,411,10,1,0,10,4,0,1,30,35,65
p_212,0,7,e_0,351,376,411,9,1,0,8,4,0,1,25,35,60
p_191,0,10,e_3,376,378,412,0,1,0,0,4,0,1,2,34,36
p_218,0,11,e_0,343,376,425,11,1,0,11,4,0,1,33,49,82
p_190,0,1,e_1,379,426,431,20,2,2,15,3,0,0,47,5,52
p_183,0,1,e_1,396,426,431,15,1,1,10,4,0,1,30,5,35
p_182,0,2,e_1,397,426,436,15,1,1,10,4,0,1,29,10,39
p_180,0,2,e_1,399,426,436,14,1,1,9,4,0,1,27,10,37
p_215,0,15,e_0,348,376,439,10,1,0,9,4,0,1,28,63,91
p_213,0,15,e_0,350,376,439,9,1,0,8,4,0,1,26,63,89
p_211,0,15,e_0,353,376,439,8,1,0,8,4,0,1,23,63,86
p_178,0,3,e_1,401,426,441,13,1,1,8,4,0,1,25,15,40
p_186,0,4,e_1,390,426,446,17,2,2,12,4,0,1,36,20,56
p_176,0,4,e_1,403,426,446,13,1,1,8,4,0,1,23,20,43
p_189,0,8,e_2,382,428,454,19,2,2,12,5,1,0,46,26,72
p_179,0,8,e_1,400,426,460,14,1,1,8,4,0,1,26,34,60
p_177,0,9,e_1,402,426,465,13,1,1,8,4,0,1,24,39,63
p_158,0,1,e_3,430,461,466,10,1,0,10,4,0,1,31,5,36
p_146,0,1,e_3,453,461,466,2,1,0,2,4,0,1,8,5,13
p_185,0,10,e_1,391,426,470,16,2,2,11,4,0,1,35,44,79
p_160,0,15,e_2,426,428,477,10,0,0,0,4,0,1,2,49,51
p_187,0,12,e_1,389,426,478,17,2,2,12,4,0,1,37,52,89
p_184,0,12,e_1,392,426,478,16,2,2,11,4,0,1,34,52,86
p_159,0,6,e_3,429,461,483,10,0,0,10,3,0,0,32,22,54
p_150,0,6,e_3,443,461,483,6,1,0,6,4,0,1,18,22,40
p_188,0,13,e_1,384,426,483,19,2,2,14,4,0,1,42,57,99
p_175,0,14,e_1,405,426,488,12,1,1,7,4,0,1,21,62,83
p_154,0,7,e_3,436,461,488,8,1,0,8,4,0,1,25,27,52
p_148,0,8,e_3,449,461,493,4,1,0,4,4,0,1,12,32,44
p_181,0,15,e_1,398,426,493,15,1,1,9,4,0,1,28,67,95
p_209,0,2,e_0,357,486,496,7,1,0,6,4,0,1,129,10,139
p_205,0,2,e_0,362,486,496,5,1,0,5,4,0,1,124,10,134
p_153,0,9,e_3,437,461,498,8,1,0,8,4,0,1,24,37,61
p_147,0,9,e_3,452,461,498,3,1,0,3,4,0,1,9,37,46
p_200,0,4,e_0,367,486,504,3,1,0,3,4,0,1,119,18,137
p_196,0,4,e_0,371,486,504,2,1,0,2,4,0,1,115,18,133
p_145,0,11,e_3,454,461,506,2,1,0,2,4,0,1,7,45,52
p_201,0,5,e_0,366,486,509,4,1,0,3,4,0,1,120,23,143
p_210,0,6,e_0,354,486,514,8,1,0,7,4,0,1,132,28,160
p_208,0,6,e_0,358,486,514,7,1,0,6,4,0,1,128,28,156
p_157,0,14,e_3,431,461,517,10,1,0,10,4,0,1,30,56,86
p_155,0,14,e_3,435,461,517,8,1,0,8,4,0,1,26,56,82
p_156,0,15,e_3,434,461,522,9,1,0,9,4,0,1,27,61,88
p_152,0,15,e_3,441,461,522,6,1,0,6,4,0,1,20,61,81
p_151,0,15,e_3,442,461,522,6,1,0,6,4,0,1,19,61,80
p_149,0,15,e_3,444,461,522,5,1,0,5,4,0,1,17,61,78
p_198,0,9,e_0,369,486,525,3,1,0,2,4,0,1,117,39,156
p_197,0,10,e_0,370,486,530,3,1,0,2,4,0,1,116,44,160
p_207,0,11,e_0,359,486,535,6,1,0,6,4,0,1,127,49,176
p_206,0,12,e_0,361,486,540,6,1,0,5,4,0,1,125,54,179
p_203,0,12,e_0,364,486,540,4,1,0,4,4,0,1,122,54,176
p_113,0,1,e_2,489,535,542,23,6,6,15,4,0,1,46,7,53
p_167,0,1,e_1,413,540,545,10,0,0,4,4,0,1,127,5,132
p_161,0,1,e_1,421,540,545,10,0,0,1,4,0,1,119,5,124
p_204,0,14,e_0,363,486,548,5,1,0,4,4,0,1,123,62,185
p_114,0,3,e_2,488,535,550,23,6,6,15,3,0,1,47,15,62
p_106,0,3,e_2,500,535,550,21,4,4,11,4,0,1,35,15,50
p_202,0,15,e_0,365,486,553,4,1,0,4,4,0,1,121,67,188
p_199,0,15,e_0,368,486,553,3,1,0,3,4,0,1,118,67,185
p_165,0,4,e_1,417,540,556,10,0,0,3,4,0,1,123,16,139
p_88,0,5,e_1,538,540,561,10,1,0,0,4,0,1,2,21,23
p_108,0,6,e_2,496,535,561,22,5,5,13,4,0,1,39,26,65
p_102,0,7,e_2,509,535,566,19,3,3,8,4,0,1,26,31,57
p_111,0,8,e_2,491,535,571,23,6,6,15,4,0,1,44,36,80
p_101,0,8,e_2,511,535,571,18,3,3,8,4,0,1,24,36,60
p_169,0,9,e_1,411,540,575,10,0,0,5,4,0,1,129,35,164
p_115,0,9,e_2,487,535,576,23,7,7,15,3,0,0,48,41,89
p_86,0,2,e_3,544,569,579,8,1,0,8,4,0,1,25,10,35
p_163,0,10,e_1,419,540,580,10,0,0,2,4,0,1,121,40,161
p_112,0,11,e_2,490,535,584,23,6,6,15,4,0,1,45,49,94
p_110,0,11,e_2,492,535,584,22,5,5,14,4,0,1,43,49,92
p_107,0,11,e_2,499,535,584,21,4,4,12,4,0,1,36,49,85
p_103,0,11,e_2,508,535,584,19,3,3,9,4,0,1,27,49,76
p_143,0,3,e_3,456,569,584,2,1,0,2,4,0,1,113,15,128
p_77,0,3,e_3,557,569,584,4,1,0,4,4,0,1,12,15,27
p_173,0,11,e_1,407,540,585,12,1,1,6,4,0,1,133,45,178
p_164,0,11,e_1,418,540,585,10,0,0,3,4,0,1,122,45,167
p_162,0,11,e_1,420,540,585,10,0,0,2,4,0,1,120,45,165
p_105,0,12,e_2,502,535,589,20,4,4,11,4,0,1,33,54,87
p_166,0,12,e_1,416,540,590,10,0,0,3,4,0,1,124,50,174
p_171,0,13,e_1,409,540,595,11,1,1,5,4,0,1,131,55,186
p_168,0,13,e_1,412,540,595,10,0,0,5,4,0,1,128,55,183
p_141,0,6,e_3,458,569,595,1,1,0,1,4,0,1,111,26,137
p_104,0,14,e_2,503,535,597,20,4,4,10,4,0,1,32,62,94
p_80,0,7,e_3,552,569,600,5,1,0,5,4,0,1,17,31,48
p_174,0,14,e_1,406,540,600,12,1,1,6,4,0,1,134,60,194
p_170,0,14,e_1,410,540,600,11,1,1,5,4,0,1,130,60,190
p_109,0,15,e_2,493,535,602,22,5,5,14,4,0,1,42,67,109
p_140,0,8,e_3,459,569,605,1,1,0,1,4,0,1,110,36,146
p_83,0,8,e_3,549,569,605,7,1,0,7,4,0,1,20,36,56
p_172,0,15,e_1,408,540,605,11,1,1,6,4,0,1,132,65,197
p_130,0,1,e_0,472,600,607,28,8,8,4,4,0,1,128,7,135
p_144,0,9,e_3,455,569,610,2,1,0,2,4,0,1,114,41,155
p_142,0,9,e_3,457,569,610,1,1,0,1,4,0,1,112,41,153
p_136,0,3,e_0,465,600,615,29,8,8,7,4,0,1,135,15,150
p_129,0,3,e_0,473,600,615,27,8,8,4,4,0,1,127,15,142
p_137,0,4,e_0,464,600,620,29,9,9,7,4,0,1,136,20,156
p_84,0,12,e_3,546,569,621,7,1,0,7,4,0,1,23,52,75
p_78,0,12,e_3,556,569,621,4,1,0,4,4,0,1,13,52,65
p_194,0,6,e_0,373,600,628,1,1,0,1,4,0,1,227,28,255
p_82,0,14,e_3,550,569,629,6,1,0,6,4,0,1,19,60,79
p_81,0,14,e_3,551,569,629,6,1,0,6,4,0,1,18,60,78
p_79,0,14,e_3,553,569,629,5,1,0,5,4,0,1,16,60,76
p_85,0,15,e_3,545,569,634,8,1,0,8,4,0,1,24,65,89
p_192,0,8,e_0,375,600,636,1,1,0,0,3,0,0,225,36,261
p_139,0,10,e_0,461,600,644,30,8,8,8,4,0,1,139,44,183
p_135,0,10,e_0,466,600,644,29,8,8,7,4,0,1,134,44,178
p_193,0,11,e_0,374,600,649,1,1,0,1,4,0,1,226,49,275
p_138,0,11,e_0,463,600,649,30,8,8,8,4,0,1,137,49,186
p_132,0,11,e_0,470,600,649,28,8,8,5,4,0,1,130,49,179
p_133,0,12,e_0,469,600,654,28,8,8,5,4,0,1,131,54,185
p_96,0,1,e_2,517,649,656,16,2,2,6,4,0,1,132,7,139
p_131,0,14,e_0,471,600,662,28,8,8,5,4,0,1,129,62,191
p_92,0,4,e_2,525,649,667,14,1,0,3,4,0,1,124,18,142
p_195,0,15,e_0,372,600,667,2,1,0,1,4,0,1,228,67,295
p_134,0,15,e_0,467,600,667,29,8,8,6,4,0,1,133,67,200
p_32,0,6,e_1,650,652,672,10,1,0,1,4,0,1,2,20,22
p_99,0,6,e_2,514,649,675,17,3,3,7,4,0,1,135,26,161
p_94,0,6,e_2,519,649,675,16,2,2,5,4,0,1,130,26,156
p_98,0,7,e_2,515,649,680,17,3,3,6,4,0,1,134,31,165
p_97,0,7,e_2,516,649,680,16,2,2,6,4,0,1,133,31,164
p_87,0,8,e_1,539,652,680,10,1,0,0,4,0,1,113,28,141
p_100,0,9,e_2,513,649,688,17,3,3,7,4,0,1,136,39,175
p_89,0,9,e_2,535,649,688,11,1,0,0,3,0,0,114,39,153
p_72,0,3,e_3,562,681,692,2,1,0,2,4,0,1,119,11,130
p_71,0,3,e_3,564,681,692,2,1,0,2,4,0,1,117,11,128
p_70,0,3,e_3,565,681,692,1,1,0,1,4,0,1,116,11,127
p_67,0,3,e_3,568,681,692,0,0,0,0,3,0,0,113,11,124
p_30,0,3,e_3,668,681,692,4,1,0,4,4,0,1,13,11,24
p_91,0,12,e_2,526,649,699,14,1,0,3,4,0,1,123,50,173
p_39,0,12,e_2,607,649,699,22,5,5,14,4,0,1,42,50,92
p_75,0,5,e_3,559,681,700,3,1,0,3,4,0,1,122,19,141
p_29,0,5,e_3,670,681,700,4,1,0,4,4,0,1,11,19,30
p_93,0,13,e_2,520,649,704,15,2,2,5,4,0,1,129,55,184
p_90,0,13,e_2,527,649,704,14,1,0,2,4,0,1,122,55,177
p_40,0,13,e_2,602,649,704,23,6,6,15,2,1,1,47,55,102
p_38,0,13,e_2,608,649,704,22,5,5,13,4,0,1,41,55,96
p_76,0,6,e_3,558,681,705,3,1,0,3,4,0,1,123,24,147
p_31,0,6,e_3,666,681,705,5,1,0,5,4,0,1,15,24,39
p_95,0,14,e_2,518,649,709,16,2,2,6,4,0,1,131,60,191
p_74,0,7,e_3,560,681,710,3,1,0,3,4,0,1,121,29,150
p_24,0,2,e_1,695,710,718,24,7,7,5,4,0,1,15,8,23
p_119,0,1,e_0,483,714,719,24,7,7,1,4,0,1,231,5,236
p_65,0,1,e_0,573,714,719,30,9,9,9,4,0,1,141,5,146
p_27,0,10,e_3,677,681,721,1,1,0,1,4,0,1,4,40,44
p_73,0,11,e_3,561,681,726,3,1,0,3,4,0,1,120,45,165
p_28,0,11,e_3,676,681,726,2,1,0,2,4,0,1,5,45,50
p_66,0,3,e_0,569,714,727,30,10,10,10,4,0,1,145,13,158
p_68,0,13,e_3,567,681,734,0,1,0,0,4,0,1,114,53,167
p_26,0,8,e_1,684,710,738,28,8,8,8,3,0,0,26,28,54
p_25,0,8,e_1,686,710,738,27,8,8,8,4,0,1,24,28,52
p_69,0,14,e_3,566,681,739,1,1,0,1,4,0,1,115,58,173
p_124,0,7,e_0,478,714,741,25,8,8,3,4,0,1,236,27,263
p_118,0,7,e_0,484,714,741,24,7,7,1,4,0,1,230,27,257
p_127,0,10,e_0,475,714,752,27,8,8,4,4,0,1,239,38,277
p_117,0,10,e_0,485,714,752,24,7,7,0,3,0,0,229,38,267
p_116,0,10,e_0,486,714,752,24,7,7,0,3,0,1,228,38,266
p_128,0,11,e_0,474,714,757,27,8,8,4,4,0,1,240,43,283
p_123,0,11,e_0,479,714,757,25,8,8,2,4,0,1,235,43,278
p_121,0,11,e_0,481,714,757,25,8,8,2,4,0,1,233,43,276
p_120,0,11,e_0,482,714,757,24,8,8,1,4,0,1,232,43,275
p_126,0,12,e_0,476,714,762,26,8,8,3,4,0,1,238,48,286
p_22,0,3,e_2,719,753,764,18,4,4,11,4,0,1,34,11,45
p_21,0,4,e_2,731,753,769,16,2,2,7,4,0,1,22,16,38
p_125,0,14,e_0,477,714,770,26,8,8,3,4,0,1,237,56,293
p_122,0,15,e_0,480,714,775,25,8,8,2,4,0,1,234,61,295
p_37,0,9,e_2,615,753,786,20,4,4,11,4,0,1,138,33,171
p_35,0,9,e_2,630,753,786,16,2,2,6,4,0,1,123,33,156
p_16,0,2,e_1,780,781,791,14,0,0,0,3,0,0,1,10,11
p_34,0,12,e_2,646,753,797,12,1,0,1,4,0,1,107,44,151
p_36,0,13,e_2,628,753,802,16,3,3,7,4,0,1,125,49,174
p_20,0,14,e_2,734,753,807,15,1,1,6,4,0,1,19,54,73
p_33,0,15,e_2,649,753,812,10,1,0,0,3,0,0,104,59,163
p_18,0,10,e_1,766,781,817,14,0,0,5,4,0,1,15,36,51
p_17,0,10,e_1,776,781,817,14,0,0,2,4,0,1,5,36,41
p_19,0,11,e_1,754,781,822,14,0,0,8,3,0,0,27,41,68
p_55,0,3,e_0,585,822,833,27,8,8,5,4,0,1,237,11,248
p_54,0,3,e_0,586,822,833,27,8,8,4,4,0,1,236,11,247
p_52,0,3,e_0,588,822,833,26,8,8,4,4,0,1,234,11,245
p_64,0,4,e_0,574,822,838,30,9,9,8,4,0,1,248,16,264
p_61,0,6,e_0,579,822,846,28,9,9,7,4,0,1,243,24,267
p_56,0,6,e_0,584,822,846,27,8,8,5,4,0,1,238,24,262
p_50,0,7,e_0,590,822,851,26,8,8,3,4,0,1,232,29,261
p_53,0,9,e_0,587,822,859,27,8,8,4,4,0,1,235,37,272
p_51,0,9,e_0,589,822,859,26,8,8,4,4,0,1,233,37,270
p_60,0,10,e_0,580,822,864,28,9,9,6,4,0,1,242,42,284
p_58,0,11,e_0,582,822,869,28,9,9,6,4,0,1,240,47,287
p_57,0,11,e_0,583,822,869,27,9,9,5,4,0,1,239,47,286
p_63,0,13,e_0,577,822,877,29,10,10,8,4,0,1,245,55,300
p_62,0,13,e_0,578,822,877,28,10,10,7,4,0,1,244,55,299
p_9,0,2,e_1,846,870,878,14,0,0,8,4,0,1,24,8,32
p_59,0,14,e_0,581,822,882,28,9,9,6,4,0,1,241,60,301
p_10,0,8,e_1,835,870,898,14,0,0,11,3,0,0,35,28,63
p_4,0,1,e_3,886,918,923,11,1,0,11,4,0,1,32,5,37
p_6,0,3,e_3,877,918,931,13,1,0,13,4,0,1,41,13,54
p_45,0,2,e_0,595,926,934,24,7,7,2,4,0,1,331,8,339
p_7,0,5,e_3,875,918,939,14,1,0,14,4,0,1,43,21,64
p_1,0,5,e_3,894,918,939,8,1,0,8,4,0,1,24,21,45
p_48,0,4,e_0,592,926,942,25,8,8,3,4,0,1,334,16,350
p_46,0,4,e_0,594,926,942,24,8,8,2,4,0,1,332,16,348
p_14,0,4,e_0,794,926,942,14,0,0,9,4,0,1,132,16,148
p_5,0,8,e_3,883,918,950,12,1,0,12,4,0,1,35,32,67
p_3,0,8,e_3,888,918,950,10,1,0,10,4,0,1,30,32,62
p_42,0,6,e_0,598,926,950,23,7,7,0,4,0,1,328,24,352
p_43,0,7,e_0,597,926,955,24,7,7,1,4,0,1,329,29,358
p_44,0,8,e_0,596,926,960,24,7,7,1,4,0,1,330,34,364
p_8,0,11,e_3,874,918,961,14,0,0,14,3,0,0,44,43,87
p_2,0,11,e_3,892,918,961,8,1,0,8,4,0,1,26,43,69
p_47,0,9,e_0,593,926,965,25,8,8,2,4,0,1,333,39,372
p_15,0,9,e_0,793,926,965,14,0,0,10,4,0,1,133,39,172
p_11,0,9,e_0,807,926,965,14,0,0,5,4,0,1,119,39,158
p_41,0,11,e_0,600,926,973,23,6,6,0,3,0,0,326,47,373
p_13,0,11,e_0,796,926,973,14,0,0,8,4,0,1,130,47,177
p_12,0,11,e_0,798,926,973,14,0,0,8,4,0,1,128,47,175
p_23,0,12,e_0,711,926,978,21,4,4,1,4,0,1,215,52,267
p_49,0,14,e_0,591,926,986,25,8,8,3,4,0,1,335,60,395
p_300,0,4,e_0,8,8,24,0,0,0,0,3,0,0,0,16,16
p_299,0,5,e_1,9,10,29,0,0,0,0,3,0,0,1,19,20
p_297,0,6,e_3,15,15,37,0,0,0,0,3,0,0,0,22,22
p_298,0,9,e_2,11,11,42,0,0,0,0,3,0,0,0,31,31
p_296,0,4,e_0,28,42,56,9,1,1,4,3,0,0,14,14,28
p_295,0,5,e_0,29,42,61,9,1,1,4,4,0,1,13,19,32
p_292,0,6,e_0,38,42,66,6,0,0,1,4,0,1,4,24,28
p_290,0,6,e_0,40,42,66,6,0,0,0,4,0,1,2,24,26
p_286,0,3,e_1,46,61,72,6,0,0,5,4,0,1,15,11,26
p_289,0,4,e_1,43,61,77,6,0,0,5,3,0,0,18,16,34
p_285,0,4,e_1,53,61,77,6,0,0,2,4,0,1,8,16,24
p_284,0,4,e_1,54,61,77,6,0,0,2,4,0,1,7,16,23
p_287,0,5,e_1,45,61,82,6,0,0,5,4,0,1,16,21,37
p_291,0,11,e_0,39,42,83,6,0,0,1,4,0,1,3,41,44
p_294,0,12,e_0,31,42,88,8,1,1,3,4,0,1,11,46,57
p_293,0,12,e_0,33,42,88,7,1,1,3,4,0,1,9,46,55
p_281,0,1,e_3,73,86,91,4,1,0,4,4,0,1,13,5,18
p_288,0,8,e_1,44,61,93,6,0,0,5,4,0,1,17,32,49
p_278,0,2,e_3,77,86,96,3,1,0,3,4,0,1,9,10,19
p_283,0,9,e_1,57,61,98,6,0,0,1,4,0,1,4,37,41
p_279,0,5,e_3,76,86,107,3,1,0,3,4,0,1,10,21,31
p_277,0,6,e_3,82,86,112,1,1,0,1,4,0,1,4,26,30
p_282,0,7,e_3,66,86,117,6,0,0,6,3,0,0,20,31,51
p_273,0,4,e_2,110,115,129,22,4,4,1,4,0,1,5,14,19
p_276,0,11,e_3,84,86,131,1,1,0,1,4,0,1,2,45,47
p_280,0,14,e_3,75,86,142,3,1,0,3,4,0,1,11,56,67
p_274,0,8,e_2,88,115,143,28,7,7,9,4,0,1,27,28,55
p_272,0,10,e_2,113,115,151,22,3,3,0,4,0,1,2,36,38
p_271,0,1,e_1,121,151,156,20,2,2,9,3,0,0,30,5,35
p_267,0,1,e_1,148,151,156,14,0,0,1,4,0,1,3,5,8
p_268,0,2,e_1,144,151,161,14,0,0,2,4,0,1,7,10,17
p_275,0,14,e_2,86,115,165,28,7,7,9,3,0,0,29,50,79
p_270,0,9,e_1,122,151,184,20,2,2,9,3,0,1,29,33,62
p_269,0,9,e_1,127,151,184,18,2,2,8,4,0,1,24,33,57
p_255,0,3,e_0,184,189,200,14,0,0,2,4,0,1,5,11,16
p_265,0,4,e_0,152,189,205,14,0,0,12,4,0,1,37,16,53
p_254,0,4,e_0,187,189,205,14,0,0,0,4,0,1,2,16,18
p_262,0,5,e_0,157,189,210,14,0,0,10,4,0,1,32,21,53
p_261,0,5,e_0,164,189,210,14,0,0,8,4,0,1,25,21,46
p_266,0,6,e_0,151,189,215,14,0,0,12,3,0,0,38,26,64
p_263,0,7,e_0,154,189,220,14,0,0,11,4,0,1,35,31,66
p_260,0,7,e_0,165,189,220,14,0,0,8,4,0,1,24,31,55
p_258,0,7,e_0,168,189,220,14,0,0,7,4,0,1,21,31,52
p_250,0,2,e_1,217,220,228,14,0,0,1,4,0,1,3,8,11
p_256,0,10,e_0,182,189,231,14,0,0,2,4,0,1,7,42,49
p_264,0,11,e_0,153,189,236,14,0,0,12,4,0,1,36,47,83
p_253,0,5,e_1,190,220,239,14,0,0,9,3,0,0,30,19,49
p_252,0,5,e_1,205,220,239,14,0,0,5,4,0,1,15,19,34
p_257,0,14,e_0,169,189,247,14,0,0,7,4,0,1,20,58,78
p_259,0,15,e_0,167,189,252,14,0,0,7,4,0,1,22,63,85
p_251,0,15,e_1,209,220,271,14,0,0,4,4,0,1,11,51,62
p_241,0,1,e_2,283,284,291,14,0,0,0,3,0,0,1,7,8
p_248,0,5,e_2,246,284,305,14,0,0,13,4,0,1,38,21,59
p_247,0,5,e_2,250,284,305,14,0,0,11,4,0,1,34,21,55
p_249,0,6,e_2,239,284,310,14,0,0,14,3,0,0,45,26,71
p_245,0,7,e_2,269,284,315,14,0,0,5,4,0,1,15,31,46
p_242,0,8,e_2,277,284,320,14,0,0,2,4,0,1,7,36,43
p_246,0,10,e_2,262,284,328,14,0,0,7,4,0,1,22,44,66
p_244,0,12,e_2,271,284,336,14,0,0,4,4,0,1,13,52,65
p_243,0,15,e_2,272,284,347,14,0,0,4,4,0,1,12,63,75
p_236,0,1,e_3,305,346,351,14,1,0,14,4,0,1,41,5,46
p_233,0,1,e_3,311,346,351,12,1,0,12,4,0,1,35,5,40
p_226,0,2,e_3,329,346,356,5,1,0,5,4,0,1,17,10,27
p_223,0,2,e_3,336,346,356,3,1,0,3,4,0,1,10,10,20
p_216,0,1,e_0,347,349,356,26,10,10,1,4,0,1,2,7,9
p_230,0,3,e_3,319,346,361,9,1,0,9,4,0,1,27,15,42
p_214,0,3,e_0,349,349,364,25,11,11,0,3,0,1,0,15,15
p_228,0,4,e_3,325,346,366,7,1,0,7,4,0,1,21,20,41
p_232,0,5,e_3,314,346,371,11,1,0,11,4,0,1,32,25,57
p_225,0,5,e_3,330,346,371,5,1,0,5,4,0,1,16,25,41
p_224,0,5,e_3,331,346,371,5,1,0,5,4,0,1,15,25,40
p_217,0,7,e_0,346,349,378,26,10,10,1,4,0,1,3,29,32
p_237,0,7,e_3,304,346,379,14,1,0,14,4,0,1,42,33,75
p_231,0,7,e_3,317,346,379,10,1,0,10,4,0,1,29,33,62
p_235,0,8,e_0,308,349,383,13,1,0,13,4,0,1,41,34,75
p_234,0,8,e_3,310,346,384,12,1,0,12,4,0,1,36,38,74
p_240,0,9,e_3,301,346,389,14,0,0,14,3,0,0,45,43,88
p_239,0,11,e_0,302,349,394,14,1,1,15,3,0,0,47,45,92
p_227,0,12,e_3,327,346,400,6,1,0,6,4,0,1,19,54,73
p_229,0,13,e_0,320,349,402,9,1,0,9,4,0,1,29,53,82
p_238,0,13,e_3,303,346,405,14,1,0,14,4,0,1,43,59,102
p_209,0,2,e_1,357,398,408,24,9,9,13,4,0,1,41,10,51
p_205,0,2,e_1,362,398,408,23,8,8,12,4,0,1,36,10,46
p_215,0,15,e_0,348,349,410,26,10,10,0,3,0,0,1,61,62
p_200,0,4,e_1,367,398,416,22,7,7,10,4,0,1,31,18,49
p_201,0,5,e_1,366,398,421,22,7,7,11,4,0,1,32,23,55
p_212,0,7,e_2,351,399,424,25,10,10,15,3,0,0,48,25,73
p_210,0,6,e_1,354,398,426,25,10,10,15,4,0,1,44,28,72
p_208,0,6,e_1,358,398,426,24,9,9,13,4,0,1,40,28,68
p_198,0,9,e_1,369,398,437,21,7,7,10,4,0,1,29,39,68
p_207,0,11,e_1,359,398,445,24,9,9,13,4,0,1,39,47,86
p_181,0,15,e_2,398,399,450,14,3,3,0,3,0,0,1,51,52
p_206,0,12,e_1,361,398,450,23,8,8,12,4,0,1,37,52,89
p_203,0,12,e_1,364,398,450,22,8,8,11,4,0,1,34,52,86
p_180,0,2,e_3,399,446,454,14,2,2,12,2,2,1,47,8,55
p_204,0,14,e_1,363,398,458,23,8,8,11,4,0,1,35,60,95
p_178,0,3,e_3,401,446,459,14,2,2,12,5,1,1,45,13,58
p_213,0,15,e_1,350,398,463,25,11,11,15,3,0,0,48,65,113
p_211,0,15,e_1,353,398,463,25,10,10,15,4,0,1,45,65,110
p_202,0,15,e_1,365,398,463,4,7,7,11,4,0,1,33,65,98
p_199,0,15,e_1,368,398,463,22,7,7,10,4,0,1,30,65,95
p_176,0,4,e_3,403,446,464,13,2,2,13,5,1,1,43,18,61
p_222,0,5,e_3,337,446,469,3,1,0,3,4,0,1,109,23,132
p_219,0,5,e_3,342,446,469,1,1,0,1,4,0,1,104,23,127
p_221,0,6,e_3,339,446,474,2,1,0,2,4,0,1,107,28,135
p_220,0,6,e_3,341,446,474,1,1,0,1,4,0,1,105,28,133
p_179,0,8,e_3,400,446,482,14,2,2,12,5,1,1,46,36,82
p_177,0,9,e_3,402,446,487,14,2,2,12,5,1,1,44,41,85
p_218,0,11,e_3,343,446,495,1,1,0,1,4,0,1,103,49,152
p_173,0,11,e_3,407,446,495,13,1,0,13,4,0,1,39,49,88
p_171,0,13,e_3,409,446,503,12,1,0,12,4,0,1,37,57,94
p_146,0,1,e_0,453,497,504,28,12,12,14,4,0,1,44,7,51
p_175,0,14,e_3,405,446,508,13,1,0,13,4,0,1,41,62,103
p_174,0,14,e_3,406,446,508,13,1,0,13,4,0,1,40,62,102
p_143,0,3,e_0,456,497,512,28,11,11,14,4,0,1,41,15,56
p_136,0,3,e_0,465,497,512,26,9,9,10,4,0,1,32,15,47
p_172,0,15,e_3,408,446,513,13,1,0,13,4,0,1,38,67,105
p_137,0,4,e_0,464,497,517,26,9,9,11,4,0,1,33,20,53
p_190,0,1,e_1,379,510,517,19,5,5,6,4,0,1,131,7,138
p_183,0,1,e_1,396,510,517,15,3,3,0,4,0,1,114,7,121
p_141,0,6,e_0,458,497,525,27,11,11,13,4,0,1,39,28,67
p_196,0,4,e_1,371,510,528,21,6,6,9,4,0,1,139,18,157
p_186,0,4,e_1,390,510,528,17,3,3,2,4,0,1,120,18,138
p_147,0,9,e_2,452,499,530,29,12,12,15,3,0,0,47,31,78
p_148,0,8,e_0,449,497,533,29,12,12,15,3,0,0,48,36,84
p_140,0,8,e_0,459,497,533,27,10,10,12,4,0,1,38,36,74
p_194,0,6,e_1,373,510,536,21,6,6,8,4,0,1,137,26,163
p_144,0,9,e_0,455,497,538,28,11,11,14,4,0,1,42,41,83
p_142,0,9,e_0,457,497,538,28,11,11,13,4,0,1,40,41,81
p_107,0,11,e_2,499,499,538,18,4,4,0,3,0,0,0,39,39
p_139,0,10,e_0,461,497,543,27,10,10,12,4,0,1,36,46,82
p_135,0,10,e_0,466,497,543,26,9,9,10,4,0,1,31,46,77
p_192,0,8,e_1,375,510,544,20,6,6,7,4,0,1,135,34,169
p_189,0,8,e_1,382,510,544,19,5,5,5,4,0,1,128,34,162
p_145,0,11,e_0,454,497,548,28,11,11,14,4,0,1,43,51,94
p_138,0,11,e_0,463,497,548,4,9,9,11,4,0,1,34,51,85
p_197,0,10,e_1,370,510,552,21,6,6,9,4,0,1,140,42,182
p_191,0,10,e_1,376,510,552,20,6,6,7,4,0,1,134,42,176
p_185,0,10,e_1,391,510,552,17,3,3,2,4,0,1,119,42,161
p_133,0,12,e_0,469,497,553,25,8,8,9,4,0,1,28,56,84
p_193,0,11,e_1,374,510,557,21,6,6,8,4,0,1,136,47,183
p_187,0,12,e_1,389,510,562,17,3,3,3,4,0,1,121,52,173
p_184,0,12,e_1,392,510,562,16,3,3,2,4,0,1,118,52,170
p_134,0,15,e_0,467,497,564,25,9,9,10,4,0,1,30,67,97
p_167,0,1,e_3,413,560,565,11,1,0,11,4,0,1,147,5,152
p_161,0,1,e_3,421,560,565,8,1,0,8,4,0,1,139,5,144
p_158,0,1,e_3,430,560,565,5,1,0,5,4,0,1,130,5,135
p_188,0,13,e_1,384,510,567,18,4,4,4,4,0,1,126,57,183
p_195,0,15,e_1,372,510,575,21,6,6,9,4,0,1,138,65,203
p_165,0,4,e_3,417,560,576,9,1,0,9,4,0,1,143,16,159
p_159,0,6,e_3,429,560,584,6,1,0,6,4,0,1,131,24,155
p_169,0,9,e_3,411,560,595,12,1,0,12,4,0,1,149,35,184
p_163,0,10,e_3,419,560,600,9,1,0,9,4,0,1,141,40,181
p_65,0,1,e_2,573,596,603,27,10,10,7,4,0,1,23,7,30
p_164,0,11,e_3,418,560,605,9,1,0,9,4,0,1,142,45,187
p_162,0,11,e_3,420,560,605,8,1,0,8,4,0,1,140,45,185
p_166,0,12,e_3,416,560,610,10,1,0,10,4,0,1,144,50,194
p_72,0,3,e_2,562,596,611,30,10,10,11,4,0,1,34,15,49
p_71,0,3,e_2,564,596,611,29,11,11,11,4,0,1,32,15,47
p_70,0,3,e_2,565,596,611,29,10,10,10,4,0,1,31,15,46
p_67,0,3,e_2,568,596,611,29,10,10,9,4,0,1,28,15,43
p_66,0,3,e_2,569,596,611,28,10,10,9,4,0,1,27,15,42
p_168,0,13,e_3,412,560,615,11,1,0,11,4,0,1,148,55,203
p_64,0,4,e_2,574,596,616,26,10,10,7,4,0,1,22,20,42
p_130,0,1,e_0,472,611,616,25,8,8,8,4,0,1,139,5,144
p_119,0,1,e_0,483,611,616,22,6,6,4,4,0,1,128,5,133
p_170,0,14,e_3,410,560,620,12,1,0,12,4,0,1,150,60,210
p_157,0,14,e_3,431,560,620,5,1,0,5,4,0,1,129,60,189
p_61,0,6,e_2,579,596,624,26,9,9,5,4,0,1,17,28,45
p_129,0,3,e_0,473,611,624,24,7,7,8,4,0,1,138,13,151
p_160,0,15,e_3,426,560,625,6,1,0,6,4,0,1,134,65,199
p_156,0,15,e_3,434,560,625,4,1,0,4,4,0,1,126,65,191
p_74,0,7,e_2,560,596,629,30,10,10,11,3,0,0,36,33,69
p_182,0,2,e_1,397,622,630,15,3,3,0,3,0,0,225,8,233
p_106,0,3,e_1,500,622,635,18,4,4,3,4,0,1,122,13,135
p_124,0,7,e_0,478,611,638,23,7,7,6,4,0,1,133,27,160
p_118,0,7,e_0,484,611,638,22,6,6,4,4,0,1,127,27,154
p_60,0,10,e_2,580,596,640,25,9,9,5,4,0,1,16,44,60
p_73,0,11,e_2,561,596,645,30,10,10,11,4,0,1,35,49,84
p_127,0,10,e_0,475,611,649,24,7,7,7,4,0,1,136,38,174
p_102,0,7,e_1,509,622,649,16,2,2,0,3,0,0,113,27,140
p_68,0,13,e_2,567,596,653,29,10,10,10,4,0,1,29,57,86
p_63,0,13,e_2,577,596,653,26,9,9,6,4,0,1,19,57,76
p_62,0,13,e_2,578,596,653,26,9,9,6,4,0,1,18,57,75
p_132,0,11,e_0,470,611,654,25,8,8,9,4,0,1,141,43,184
p_128,0,11,e_0,474,611,654,24,7,7,7,4,0,1,137,43,180
p_123,0,11,e_0,479,611,654,23,7,7,6,4,0,1,132,43,175
p_121,0,11,e_0,481,611,654,22,6,6,5,4,0,1,130,43,173
p_120,0,11,e_0,482,611,654,22,6,6,5,4,0,1,129,43,172
p_37,0,9,e_1,615,622,657,17,3,3,2,4,0,1,7,35,42
p_69,0,14,e_2,566,596,658,29,10,10,10,4,0,1,30,62,92
p_126,0,12,e_0,476,611,659,24,7,7,7,4,0,1,135,48,183
p_103,0,11,e_1,508,622,665,16,2,2,0,4,0,1,114,43,157
p_131,0,14,e_0,471,611,667,25,8,8,8,4,0,1,140,56,196
p_125,0,14,e_0,477,611,667,23,7,7,7,4,0,1,134,56,190
p_105,0,12,e_1,502,622,670,17,4,4,3,4,0,1,120,48,168
p_122,0,15,e_0,480,611,672,23,7,7,6,4,0,1,131,61,192
p_96,0,1,e_3,517,672,677,14,1,0,14,4,0,1,155,5,160
p_104,0,14,e_1,503,622,678,17,3,3,2,4,0,1,119,56,175
p_150,0,6,e_3,443,672,694,1,1,0,1,4,0,1,229,22,251
p_99,0,6,e_3,514,672,694,15,1,0,15,4,0,1,158,22,180
p_94,0,6,e_3,519,672,694,14,1,0,14,4,0,1,153,22,175
p_154,0,7,e_3,436,672,699,3,1,0,3,4,0,1,236,27,263
p_98,0,7,e_3,515,672,699,15,1,0,15,4,0,1,157,27,184
p_97,0,7,e_3,516,672,699,15,1,0,15,4,0,1,156,27,183
p_101,0,8,e_3,511,672,704,16,2,2,14,5,1,1,161,32,193
p_153,0,9,e_3,437,672,709,3,1,0,3,4,0,1,235,37,272
p_100,0,9,e_3,513,672,709,15,1,1,15,2,1,1,159,37,196
p_45,0,2,e_2,595,702,710,21,7,7,0,3,0,0,107,8,115
p_55,0,3,e_2,585,702,715,24,8,8,4,4,0,1,117,13,130
p_54,0,3,e_2,586,702,715,24,8,8,3,4,0,1,116,13,129
p_52,0,3,e_2,588,702,715,23,8,8,3,4,0,1,114,13,127
p_48,0,4,e_2,592,702,720,22,8,8,1,4,0,1,110,18,128
p_46,0,4,e_2,594,702,720,21,8,8,0,4,0,1,108,18,126
p_113,0,1,e_0,489,719,724,21,5,5,3,4,0,1,230,5,235
p_155,0,14,e_3,435,672,726,4,1,0,4,4,0,1,237,54,291
p_95,0,14,e_3,518,672,726,14,1,0,14,4,0,1,154,54,208
p_56,0,6,e_2,584,702,728,24,8,8,4,4,0,1,118,26,144
p_152,0,15,e_3,441,672,731,1,1,0,1,4,0,1,231,59,290
p_151,0,15,e_3,442,672,731,1,1,0,1,4,0,1,230,59,289
p_149,0,15,e_3,444,672,731,1,1,0,1,4,0,1,228,59,287
p_114,0,3,e_0,488,719,732,21,5,5,3,4,0,1,231,13,244
p_50,0,7,e_2,590,702,733,23,8,8,2,4,0,1,112,31,143
p_53,0,9,e_2,587,702,741,24,8,8,3,4,0,1,115,39,154
p_51,0,9,e_2,589,702,741,23,8,8,2,4,0,1,113,39,152
p_47,0,9,e_2,593,702,741,21,8,8,1,4,0,1,109,39,148
p_108,0,6,e_0,496,719,743,19,4,4,0,3,0,0,223,24,247
p_42,0,6,e_0,598,719,743,21,7,7,4,4,0,1,121,24,145
p_43,0,7,e_0,597,719,748,21,7,7,4,4,0,1,122,29,151
p_58,0,11,e_2,582,702,749,24,9,9,5,4,0,1,120,47,167
p_57,0,11,e_2,583,702,749,24,9,9,4,4,0,1,119,47,166
p_111,0,8,e_0,491,719,753,20,5,5,2,4,0,1,228,34,262
p_44,0,8,e_0,596,719,753,21,7,7,5,4,0,1,123,34,157
p_115,0,9,e_0,487,719,758,21,5,5,3,4,0,1,232,39,271
p_59,0,14,e_2,581,702,760,25,9,9,5,4,0,1,121,58,179
p_49,0,14,e_2,591,702,760,22,8,8,2,4,0,1,111,58,169
p_117,0,10,e_0,485,719,763,21,6,6,4,4,0,1,234,44,278
p_116,0,10,e_0,486,719,763,21,5,5,3,4,0,1,233,44,277
p_112,0,11,e_0,490,719,768,20,5,5,2,4,0,1,229,49,278
p_110,0,11,e_0,492,719,768,20,5,5,2,4,0,1,227,49,276
p_41,0,11,e_0,600,719,768,20,6,6,4,4,0,1,119,49,168
p_22,0,3,e_1,719,764,775,18,3,3,14,3,0,0,45,11,56
p_40,0,13,e_0,602,719,776,20,6,6,3,4,0,1,117,57,174
p_21,0,4,e_1,731,764,780,15,1,0,11,4,0,1,33,16,49
p_109,0,15,e_0,493,719,784,20,5,5,1,4,0,1,226,65,291
p_86,0,2,e_3,544,778,786,5,1,0,5,4,0,1,234,8,242
p_92,0,4,e_3,525,778,794,12,1,0,12,4,0,1,253,16,269
p_88,0,5,e_3,538,778,799,7,1,0,7,4,0,1,240,21,261
p_19,0,11,e_1,754,764,803,8,1,0,3,4,0,1,10,39,49
p_80,0,7,e_3,552,778,807,2,1,0,2,4,0,1,226,29,255
p_87,0,8,e_3,539,778,812,7,1,0,7,4,0,1,239,34,273
p_83,0,8,e_3,549,778,812,3,1,0,3,4,0,1,229,34,263
p_24,0,2,e_2,695,804,812,24,6,6,2,4,0,1,109,8,117
p_20,0,14,e_1,734,764,814,15,1,0,10,4,0,1,30,50,80
p_89,0,9,e_3,535,778,817,8,1,0,8,4,0,1,243,39,282
p_14,0,4,e_2,794,804,820,26,9,9,3,4,0,1,10,16,26
p_91,0,12,e_3,526,778,828,11,1,0,11,4,0,1,252,50,302
p_84,0,12,e_3,546,778,828,4,1,0,4,4,0,1,232,50,282
p_93,0,13,e_3,520,778,833,13,1,0,13,4,0,1,258,55,313
p_90,0,13,e_3,527,778,833,11,1,0,11,4,0,1,251,55,306
p_26,0,8,e_2,684,804,834,27,7,7,6,4,0,1,120,30,150
p_25,0,8,e_2,686,804,834,27,7,7,5,4,0,1,118,30,148
p_82,0,14,e_3,550,778,838,3,1,0,3,4,0,1,228,60,288
p_81,0,14,e_3,551,778,838,3,1,0,3,4,0,1,227,60,287
p_79,0,14,e_3,553,778,838,2,1,0,2,4,0,1,225,60,285
p_15,0,9,e_2,793,804,839,4,9,9,3,4,0,1,11,35,46
p_85,0,15,e_3,545,778,843,5,1,0,5,4,0,1,233,65,298
p_27,0,10,e_2,677,804,844,29,7,7,8,4,0,1,127,40,167
p_28,0,11,e_2,676,804,849,29,7,7,8,4,0,1,128,45,173
p_13,0,11,e_2,796,804,849,26,9,9,2,4,0,1,8,45,53
p_12,0,11,e_2,798,804,849,25,8,8,2,4,0,1,6,45,51
p_11,0,9,e_0,807,831,860,23,7,7,8,4,0,1,24,29,53
p_16,0,2,e_1,780,858,866,30,10,10,4,3,3,0,78,8,86
p_9,0,2,e_1,846,858,866,15,1,0,4,4,0,1,12,8,20
p_39,0,12,e_0,607,831,871,19,5,5,1,4,0,1,224,40,264
p_23,0,12,e_0,711,831,871,21,3,3,3,4,0,1,120,40,160
p_38,0,13,e_0,608,831,876,19,5,5,1,4,0,1,223,45,268
p_10,0,8,e_1,835,858,886,17,3,3,8,4,0,1,23,28,51
p_77,0,3,e_3,557,890,901,1,1,0,1,4,0,1,333,11,344
p_30,0,3,e_3,668,890,901,1,1,0,1,4,0,1,222,11,233
p_75,0,5,e_3,559,890,909,0,1,0,0,4,0,1,331,19,350
p_29,0,5,e_3,670,890,909,1,1,0,1,4,0,1,220,19,239
p_76,0,6,e_3,558,890,914,1,1,0,1,4,0,1,332,24,356
p_32,0,6,e_3,650,890,914,7,1,0,7,4,0,1,240,24,264
p_31,0,6,e_3,666,890,914,2,1,0,2,4,0,1,224,24,248
p_35,0,9,e_3,630,890,925,14,1,0,14,4,0,1,260,35,295
p_18,0,10,e_3,766,890,930,4,1,0,4,4,0,1,124,40,164
p_17,0,10,e_3,776,890,930,1,1,0,1,4,0,1,114,40,154
p_8,0,11,e_3,874,890,935,5,1,0,5,4,0,1,16,45,61
p_1,0,5,e_1,894,918,935,29,10,10,8,4,0,1,24,17,41
p_78,0,12,e_3,556,890,940,1,1,0,1,4,0,1,334,50,384
p_34,0,12,e_3,646,890,940,8,1,0,8,4,0,1,244,50,294
p_36,0,13,e_3,628,890,945,14,1,0,14,4,0,1,262,55,317
p_33,0,15,e_3,649,890,953,8,1,0,8,4,0,1,241,63,304
p_2,0,11,e_1,892,918,955,30,9,9,8,3,0,0,26,37,63
p_4,0,1,e_3,886,1000,1005,1,1,0,1,4,0,1,114,5,119
p_6,0,3,e_3,877,1000,1013,4,1,0,4,4,0,1,123,13,136
p_7,0,5,e_3,875,1000,1021,5,1,0,5,4,0,1,125,21,146
p_5,0,8,e_3,883,1000,1032,2,1,0,2,4,0,1,117,32,149
p_3,0,8,e_3,888,1000,1032,1,1,0,1,4,0,1,112,32,144
p_300,0,4,e_0,8,9,25,0,0,0,0,3,0,0,1,16,17
p_299,0,5,e_1,9,10,29,0,0,0,0,3,0,0,1,19,20
p_297,0,6,e_3,15,15,37,0,0,0,0,3,0,0,0,22,22
p_298,0,9,e_2,11,12,43,0,0,0,0,3,0,0,1,31,32
p_296,0,4,e_0,28,42,56,9,1,1,4,3,0,0,14,14,28
p_286,0,3,e_1,46,47,60,6,0,0,0,3,0,0,1,13,14
p_292,0,6,e_0,38,42,64,6,0,0,1,4,0,1,4,22,26
p_290,0,6,e_0,40,42,64,6,0,0,1,4,0,1,2,22,24
p_289,0,4,e_1,43,47,65,6,0,0,1,4,0,1,4,18,22
p_295,0,5,e_1,29,47,70,8,1,1,5,3,0,0,18,23,41
p_287,0,5,e_1,45,47,70,6,0,0,1,4,0,1,2,23,25
p_281,0,1,e_3,73,74,79,0,1,0,0,4,0,1,1,5,6
p_288,0,8,e_1,44,47,81,6,0,0,1,4,0,1,3,34,37
p_291,0,11,e_0,39,42,81,6,0,0,1,4,0,1,3,39,42
p_294,0,12,e_0,31,42,86,8,1,1,3,4,0,1,11,44,55
p_293,0,12,e_0,33,42,86,7,1,1,3,4,0,1,9,44,53
p_285,0,4,e_3,53,74,90,6,0,0,6,3,0,0,21,16,37
p_284,0,4,e_3,54,74,90,6,1,0,6,4,0,1,20,16,36
p_282,0,7,e_3,66,74,101,3,1,0,3,4,0,1,8,27,35
p_283,0,9,e_3,57,74,109,5,1,0,5,4,0,1,17,35,52
p_278,0,2,e_2,77,105,113,17,4,4,9,4,0,1,28,8,36
p_279,0,5,e_2,76,105,124,18,4,4,9,4,0,1,29,19,48
p_277,0,6,e_1,82,108,128,17,3,3,8,3,0,0,26,20,46
p_274,0,8,e_2,88,105,135,15,3,3,5,4,0,1,17,30,47
p_271,0,1,e_3,121,139,144,6,1,0,6,4,0,1,18,5,23
p_276,0,11,e_2,84,105,146,16,3,3,7,4,0,1,21,41,62
p_273,0,4,e_3,110,139,155,9,0,0,9,3,0,0,29,16,45
p_280,0,14,e_2,75,105,157,18,4,4,9,3,0,0,30,52,82
p_275,0,14,e_2,86,105,157,15,3,3,6,4,0,1,19,52,71
p_267,0,1,e_1,148,164,169,18,3,3,5,4,0,1,16,5,21
p_270,0,9,e_3,122,139,172,6,1,0,6,4,0,1,17,33,50
p_269,0,9,e_3,127,139,172,4,1,0,4,4,0,1,12,33,45
p_268,0,2,e_1,144,164,174,19,3,3,6,3,0,0,20,10,30
p_272,0,10,e_3,113,139,177,8,1,0,8,4,0,1,26,38,64
p_265,0,4,e_1,152,164,182,17,3,3,4,4,0,1,12,18,30
p_262,0,5,e_1,157,164,187,16,2,2,2,4,0,1,7,23,30
p_266,0,6,e_1,151,164,192,17,3,3,4,4,0,1,13,28,41
p_263,0,7,e_1,154,164,197,4,2,2,3,4,0,1,10,33,43
p_264,0,11,e_1,153,164,211,16,3,3,3,4,0,1,11,47,58
p_255,0,3,e_0,184,203,214,10,0,0,6,4,0,1,19,11,30
p_254,0,4,e_0,187,203,219,10,0,0,5,4,0,1,16,16,32
p_261,0,5,e_0,164,203,224,14,2,2,12,3,0,0,39,21,60
p_253,0,5,e_0,190,203,224,10,0,0,4,4,0,1,13,21,34
p_252,0,5,e_2,205,210,229,10,0,0,1,4,0,1,5,19,24
p_258,0,7,e_0,168,203,232,12,2,2,12,4,0,1,35,29,64
p_260,0,7,e_2,165,210,237,13,2,2,14,3,0,0,45,27,72
p_256,0,10,e_0,182,203,243,10,0,0,7,4,0,1,21,40,61
p_250,0,2,e_3,217,249,257,10,0,0,10,3,0,0,32,8,40
p_257,0,14,e_0,169,203,257,12,2,2,11,4,0,1,34,54,88
p_259,0,15,e_0,167,203,262,12,2,2,12,4,0,1,36,59,95
p_251,0,15,e_2,209,210,263,10,0,0,0,3,0,0,1,53,54
p_248,0,5,e_3,246,249,268,1,1,0,1,4,0,1,3,19,22
p_249,0,6,e_3,239,249,273,3,1,0,3,4,0,1,10,24,34
p_241,0,1,e_1,283,286,291,6,0,0,1,4,0,1,3,5,8
p_247,0,5,e_1,250,286,305,12,3,3,11,3,0,0,36,19,55
p_245,0,7,e_1,269,286,313,7,1,1,6,4,0,1,17,27,44
p_242,0,8,e_1,277,286,318,6,0,0,3,4,0,1,9,32,41
p_236,0,1,e_3,305,321,326,5,1,0,5,4,0,1,16,5,21
p_233,0,1,e_3,311,321,326,3,1,0,3,4,0,1,10,5,15
p_246,0,10,e_1,262,286,326,9,2,2,8,4,0,1,24,40,64
p_230,0,3,e_3,319,321,334,1,1,0,1,4,0,1,2,13,15
p_244,0,12,e_1,271,286,334,6,1,1,5,4,0,1,15,48,63
p_232,0,5,e_3,314,321,342,2,1,0,2,4,0,1,7,21,28
p_243,0,15,e_1,272,286,345,6,1,1,5,4,0,1,14,59,73
p_237,0,7,e_3,304,321,350,6,1,0,6,4,0,1,17,29,46
p_231,0,7,e_3,317,321,350,1,1,0,1,4,0,1,4,29,33
p_235,0,8,e_3,308,321,355,4,1,0,4,4,0,1,13,34,47
p_234,0,8,e_3,310,321,355,4,1,0,4,4,0,1,11,34,45
p_240,0,9,e_3,301,321,360,6,0,0,6,3,0,0,20,39,59
p_239,0,11,e_3,302,321,368,6,1,0,6,4,0,1,19,47,66
p_238,0,13,e_3,303,321,376,6,1,0,6,4,0,1,18,55,73
p_229,0,13,e_3,320,321,376,0,1,0,0,4,0,1,1,55,56
p_216,0,1,e_0,347,372,377,20,5,5,8,4,0,1,25,5,30
p_226,0,2,e_0,329,372,382,25,7,7,14,4,0,1,43,10,53
p_223,0,2,e_0,336,372,382,23,6,6,12,4,0,1,36,10,46
p_214,0,3,e_0,349,372,387,19,4,4,7,4,0,1,23,15,38
p_228,0,4,e_0,325,372,392,25,7,7,15,3,0,0,47,20,67
p_194,0,6,e_2,373,374,396,14,1,1,0,4,0,1,1,22,23
p_225,0,5,e_0,330,372,397,24,7,7,14,4,0,1,42,25,67
p_224,0,5,e_0,331,372,397,24,7,7,14,4,0,1,41,25,66
p_222,0,5,e_0,337,372,397,22,6,6,11,4,0,1,35,25,60
p_219,0,5,e_0,342,372,397,21,5,5,10,4,0,1,30,25,55
p_221,0,6,e_0,339,372,402,22,6,6,11,4,0,1,33,30,63
p_220,0,6,e_0,341,372,402,21,5,5,10,4,0,1,31,30,61
p_217,0,7,e_0,346,372,407,20,5,5,8,4,0,1,26,35,61
p_193,0,11,e_2,374,374,413,13,1,1,0,3,0,0,0,39,39
p_227,0,12,e_2,327,374,418,25,7,7,15,3,0,0,47,44,91
p_218,0,11,e_0,343,372,421,21,5,5,10,4,0,1,29,49,78
p_190,0,1,e_3,379,417,424,12,1,0,12,4,0,1,38,7,45
p_183,0,1,e_3,396,417,424,7,1,0,7,4,0,1,21,7,28
p_161,0,1,e_1,421,423,428,30,10,10,1,4,0,1,2,5,7
p_195,0,15,e_2,372,374,429,14,1,1,0,4,0,1,2,55,57
p_182,0,2,e_3,397,417,429,7,1,0,7,4,0,1,20,12,32
p_180,0,2,e_3,399,417,429,6,1,0,6,4,0,1,18,12,30
p_178,0,3,e_3,401,417,434,5,1,0,5,4,0,1,16,17,33
p_215,0,15,e_0,348,372,435,19,5,5,8,4,0,1,24,63,87
p_213,0,15,e_0,350,372,435,19,4,4,7,4,0,1,22,63,85
p_186,0,4,e_3,390,417,439,9,1,0,9,4,0,1,27,22,49
p_192,0,8,e_3,375,417,453,13,0,0,13,2,1,0,42,36,78
p_189,0,8,e_3,382,417,453,11,1,0,11,4,0,1,35,36,71
p_179,0,8,e_3,400,417,453,6,1,0,6,4,0,1,17,36,53
p_191,0,10,e_1,376,423,457,13,1,1,15,3,0,0,47,34,81
p_163,0,10,e_1,419,423,457,30,10,10,1,4,0,1,4,34,38
p_177,0,9,e_3,402,417,458,5,1,0,5,4,0,1,15,41,56
p_164,0,11,e_1,418,423,462,30,11,11,2,4,0,1,5,39,44
p_162,0,11,e_1,420,423,462,30,10,10,1,4,0,1,3,39,42
p_185,0,10,e_3,391,417,463,9,1,0,9,4,0,1,26,46,72
p_187,0,12,e_3,389,417,471,9,1,0,9,4,0,1,28,54,82
p_184,0,12,e_3,392,417,471,8,1,0,8,4,0,1,25,54,79
p_188,0,13,e_3,384,417,476,11,1,0,11,4,0,1,33,59,92
p_158,0,1,e_2,430,476,483,28,9,9,15,4,0,1,46,7,53
p_146,0,1,e_2,453,476,483,22,6,6,8,4,0,1,23,7,30
p_181,0,15,e_3,398,417,484,6,1,0,6,4,0,1,19,67,86
p_209,0,2,e_0,357,482,492,18,3,3,5,4,0,1,125,10,135
p_205,0,2,e_0,362,482,492,17,2,2,3,4,0,1,120,10,130
p_159,0,6,e_2,429,476,500,28,9,9,15,2,1,1,47,24,71
p_150,0,6,e_2,443,476,500,25,7,7,11,4,0,1,33,24,57
p_200,0,4,e_0,367,482,500,15,2,2,2,4,0,1,115,18,133
p_201,0,5,e_0,366,482,505,15,2,2,2,4,0,1,116,23,139
p_154,0,7,e_2,436,476,505,27,8,8,13,4,0,1,40,29,69
p_210,0,6,e_0,354,482,510,18,3,3,6,4,0,1,128,28,156
p_208,0,6,e_0,358,482,510,18,3,3,5,4,0,1,124,28,152
p_148,0,8,e_2,449,476,510,23,7,7,9,4,0,1,27,34,61
p_153,0,9,e_2,437,476,515,27,8,8,13,4,0,1,39,39,78
p_147,0,9,e_2,452,476,515,22,6,6,8,4,0,1,24,39,63
p_212,0,7,e_0,351,482,515,19,4,4,7,4,0,1,131,33,164
p_119,0,1,e_1,483,517,522,15,1,1,11,4,0,1,34,5,39
p_113,0,1,e_1,489,517,522,14,1,0,9,4,0,1,28,5,33
p_198,0,9,e_0,369,482,523,15,1,1,1,4,0,1,113,41,154
p_114,0,3,e_1,488,517,530,14,1,0,9,4,0,1,29,13,42
p_106,0,3,e_1,500,517,530,10,1,0,5,4,0,1,17,13,30
p_207,0,11,e_0,359,482,531,17,2,2,4,4,0,1,123,49,172
p_157,0,14,e_2,431,476,532,28,9,9,15,4,0,1,45,56,101
p_155,0,14,e_2,435,476,532,27,8,8,14,4,0,1,41,56,97
p_167,0,1,e_3,413,531,536,1,1,0,1,4,0,1,118,5,123
p_96,0,1,e_3,517,531,536,4,1,0,4,4,0,1,14,5,19
p_206,0,12,e_0,361,482,536,17,2,2,3,4,0,1,121,54,175
p_203,0,12,e_0,364,482,536,16,2,2,3,4,0,1,118,54,172
p_160,0,15,e_2,426,476,537,29,10,10,14,5,1,0,50,61,111
p_156,0,15,e_2,434,476,537,27,8,8,14,4,0,1,42,61,103
p_152,0,15,e_2,441,476,537,26,7,7,11,4,0,1,35,61,96
p_151,0,15,e_2,442,476,537,25,7,7,11,4,0,1,34,61,95
p_149,0,15,e_2,444,476,537,25,7,7,10,4,0,1,32,61,93
p_108,0,6,e_1,496,517,541,11,1,0,7,4,0,1,21,24,45
p_204,0,14,e_0,363,482,544,17,2,2,3,4,0,1,119,62,181
p_118,0,7,e_1,484,517,546,15,1,0,11,4,0,1,33,29,62
p_176,0,4,e_3,403,531,547,5,1,0,5,4,0,1,128,16,144
p_165,0,4,e_3,417,531,547,0,0,0,0,3,0,0,114,16,130
p_211,0,15,e_0,353,482,549,19,4,4,6,4,0,1,129,67,196
p_202,0,15,e_0,365,482,549,16,2,2,2,4,0,1,117,67,184
p_199,0,15,e_0,368,482,549,15,1,1,1,4,0,1,114,67,181
p_111,0,8,e_1,491,517,551,13,1,0,8,4,0,1,26,34,60
p_94,0,6,e_3,519,531,555,4,1,0,4,4,0,1,12,24,36
p_115,0,9,e_1,487,517,556,14,1,0,10,4,0,1,30,39,69
p_117,0,10,e_1,485,517,561,15,1,0,11,4,0,1,32,44,76
p_116,0,10,e_1,486,517,561,15,1,0,10,4,0,1,31,44,75
p_120,0,11,e_1,482,517,566,16,2,2,11,3,0,0,35,49,84
p_112,0,11,e_1,490,517,566,14,1,0,9,4,0,1,27,49,76
p_110,0,11,e_1,492,517,566,13,1,0,8,4,0,1,25,49,74
p_107,0,11,e_1,499,517,566,11,1,0,6,4,0,1,18,49,67
p_169,0,9,e_3,411,531,566,2,1,0,2,4,0,1,120,35,155
p_173,0,11,e_3,407,531,574,3,1,0,3,4,0,1,124,43,167
p_166,0,12,e_3,416,531,579,0,1,0,0,4,0,1,115,48,163
p_109,0,15,e_1,493,517,580,12,1,0,8,4,0,1,24,63,87
p_171,0,13,e_3,409,531,584,3,1,0,3,4,0,1,122,53,175
p_168,0,13,e_3,412,531,584,2,1,0,2,4,0,1,119,53,172
p_175,0,14,e_3,405,531,589,4,1,0,4,4,0,1,126,58,184
p_174,0,14,e_3,406,531,589,4,1,0,4,4,0,1,125,58,183
p_170,0,14,e_3,410,531,589,2,1,0,2,4,0,1,121,58,179
p_95,0,14,e_3,518,531,589,4,1,0,4,4,0,1,13,58,71
p_172,0,15,e_3,408,531,594,3,1,0,3,4,0,1,123,63,186
p_143,0,3,e_2,456,584,595,21,6,6,6,4,0,1,128,11,139
p_136,0,3,e_2,465,584,595,20,4,4,4,4,0,1,119,11,130
p_137,0,4,e_2,464,584,600,20,4,4,4,4,0,1,120,16,136
p_141,0,6,e_2,458,584,608,21,5,5,6,4,0,1,126,24,150
p_55,0,3,e_0,585,596,609,17,3,3,3,4,0,1,11,13,24
p_54,0,3,e_0,586,596,609,17,3,3,3,4,0,1,10,13,23
p_52,0,3,e_0,588,596,609,16,3,3,2,4,0,1,8,13,21
p_196,0,4,e_0,371,596,614,14,1,1,0,4,0,1,225,18,243
p_140,0,8,e_2,459,584,616,21,5,5,5,4,0,1,125,32,157
p_144,0,9,e_2,455,584,621,22,6,6,7,4,0,1,129,37,166
p_142,0,9,e_2,457,584,621,21,6,6,6,4,0,1,127,37,164
p_56,0,6,e_0,584,596,622,17,3,3,4,4,0,1,12,26,38
p_139,0,10,e_2,461,584,626,21,5,5,5,4,0,1,123,42,165
p_135,0,10,e_2,466,584,626,20,4,4,3,4,0,1,118,42,160
p_124,0,7,e_0,478,596,627,17,2,2,1,4,0,1,118,31,149
p_50,0,7,e_0,590,596,627,16,2,2,2,4,0,1,6,31,37
p_145,0,11,e_2,454,584,631,22,6,6,7,4,0,1,130,47,177
p_138,0,11,e_2,463,584,631,20,4,4,4,4,0,1,121,47,168
p_132,0,11,e_2,470,584,631,18,3,3,2,4,0,1,114,47,161
p_53,0,9,e_0,587,596,635,17,3,3,3,4,0,1,9,39,48
p_51,0,9,e_0,589,596,635,16,2,2,2,4,0,1,7,39,46
p_133,0,12,e_2,469,584,636,19,4,4,2,4,0,1,115,52,167
p_197,0,10,e_0,370,596,640,15,1,1,1,4,0,1,226,44,270
p_131,0,14,e_2,471,584,644,18,3,3,2,4,0,1,113,60,173
p_123,0,11,e_0,479,596,645,16,2,2,1,4,0,1,117,49,166
p_121,0,11,e_0,481,596,645,16,2,2,0,3,0,0,115,49,164
p_99,0,6,e_1,514,627,647,5,1,0,1,4,0,1,113,20,133
p_42,0,6,e_1,598,627,647,14,1,0,10,4,0,1,29,20,49
p_134,0,15,e_2,467,584,649,19,4,4,3,4,0,1,117,65,182
p_126,0,12,e_0,476,596,650,17,2,2,2,4,0,1,120,54,174
p_102,0,7,e_1,509,627,652,7,1,0,2,4,0,1,118,25,143
p_98,0,7,e_1,515,627,652,5,1,0,0,4,0,1,112,25,137
p_97,0,7,e_1,516,627,652,5,1,0,0,4,0,1,111,25,136
p_43,0,7,e_1,597,627,652,14,1,0,10,4,0,1,30,25,55
p_92,0,4,e_3,525,641,655,2,1,0,2,4,0,1,116,14,130
p_101,0,8,e_1,511,627,657,6,1,0,2,4,0,1,116,30,146
p_125,0,14,e_0,477,596,658,17,2,2,2,4,0,1,119,62,181
p_100,0,9,e_1,513,627,662,6,1,0,1,4,0,1,114,35,149
p_122,0,15,e_0,480,596,663,16,2,2,1,4,0,1,116,67,183
p_103,0,11,e_1,508,627,670,8,1,0,3,4,0,1,119,43,162
p_41,0,11,e_1,600,627,670,14,1,0,9,4,0,1,27,43,70
p_35,0,9,e_3,630,641,672,3,1,0,3,4,0,1,11,31,42
p_105,0,12,e_1,502,627,675,9,1,0,5,4,0,1,125,48,173
p_39,0,12,e_1,607,627,675,11,1,0,7,4,0,1,20,48,68
p_40,0,13,e_1,602,627,680,13,1,0,8,4,0,1,25,53,78
p_38,0,13,e_1,608,627,680,11,1,0,6,4,0,1,19,53,72
p_91,0,12,e_3,526,641,683,2,1,0,2,4,0,1,115,42,157
p_104,0,14,e_1,503,627,685,9,1,0,4,4,0,1,124,58,182
p_93,0,13,e_3,520,641,688,4,1,0,4,4,0,1,121,47,168
p_90,0,13,e_3,527,641,688,1,1,0,1,4,0,1,114,47,161
p_36,0,13,e_3,628,641,688,4,1,0,4,4,0,1,13,47,60
p_130,0,1,e_2,472,696,703,18,3,3,1,4,0,1,224,7,231
p_86,0,2,e_2,544,696,708,27,9,9,13,4,0,1,152,12,164
p_129,0,3,e_2,473,696,713,18,3,3,1,4,0,1,223,17,240
p_45,0,2,e_0,595,710,718,15,1,0,0,4,0,1,115,8,123
p_88,0,5,e_2,538,696,721,29,9,9,15,4,0,1,158,25,183
p_48,0,4,e_0,592,710,726,16,2,2,1,4,0,1,118,16,134
p_46,0,4,e_0,594,710,726,15,1,1,1,4,0,1,116,16,132
p_80,0,7,e_2,552,696,729,25,8,8,10,4,0,1,144,33,177
p_87,0,8,e_2,539,696,734,29,9,9,15,4,0,1,157,38,195
p_83,0,8,e_2,549,696,734,26,8,8,11,4,0,1,147,38,185
p_89,0,9,e_2,535,696,739,29,9,9,15,5,1,1,161,43,204
p_44,0,8,e_0,596,710,740,15,1,0,0,3,0,0,114,30,144
p_22,0,3,e_1,719,729,740,13,0,0,3,4,0,1,10,11,21
p_127,0,10,e_2,475,696,744,17,2,2,0,3,0,0,221,48,269
p_47,0,9,e_0,593,710,745,15,1,1,1,4,0,1,117,35,152
p_128,0,11,e_2,474,696,749,17,3,3,1,4,0,1,222,53,275
p_84,0,12,e_2,546,696,754,4,8,8,13,4,0,1,150,58,208
p_37,0,9,e_1,615,729,760,8,1,0,4,4,0,1,114,31,145
p_49,0,14,e_0,591,710,762,16,2,2,1,4,0,1,119,52,171
p_82,0,14,e_2,550,696,762,25,8,8,11,4,0,1,146,66,212
p_81,0,14,e_2,551,696,762,25,8,8,11,4,0,1,145,66,211
p_79,0,14,e_2,553,696,762,24,8,8,10,4,0,1,143,66,209
p_85,0,15,e_2,545,696,767,26,9,9,13,4,0,1,151,71,222
p_23,0,12,e_1,711,729,771,13,0,0,6,4,0,1,18,42,60
p_21,0,4,e_3,731,773,787,13,0,0,13,3,0,0,42,14,56
p_18,0,10,e_3,766,773,807,2,1,0,2,4,0,1,7,34,41
p_19,0,11,e_3,754,773,812,6,1,0,6,4,0,1,19,39,58
p_65,0,1,e_2,573,814,819,19,6,6,4,4,0,1,241,5,246
p_20,0,14,e_3,734,773,823,13,1,0,13,4,0,1,39,50,89
p_77,0,3,e_2,557,814,827,24,7,7,9,4,0,1,257,13,270
p_72,0,3,e_2,562,814,827,22,7,7,7,4,0,1,252,13,265
p_71,0,3,e_2,564,814,827,21,7,7,7,4,0,1,250,13,263
p_70,0,3,e_2,565,814,827,21,7,7,6,4,0,1,249,13,262
p_67,0,3,e_2,568,814,827,21,6,6,5,4,0,1,246,13,259
p_66,0,3,e_2,569,814,827,21,6,6,5,4,0,1,245,13,258
p_64,0,4,e_2,574,814,832,19,5,5,3,4,0,1,240,18,258
p_75,0,5,e_2,559,814,837,23,7,7,8,4,0,1,255,23,278
p_76,0,6,e_2,558,814,842,23,7,7,8,4,0,1,256,28,284
p_15,0,9,e_1,793,815,844,23,3,3,7,4,0,1,22,29,51
p_74,0,7,e_2,560,814,847,23,7,7,8,4,0,1,254,33,287
p_17,0,10,e_1,776,815,849,27,4,4,12,3,0,0,39,34,73
p_13,0,11,e_1,796,815,854,21,3,3,6,4,0,1,19,39,58
p_12,0,11,e_1,798,815,854,21,3,3,5,4,0,1,17,39,56
p_73,0,11,e_2,561,814,861,22,7,7,7,4,0,1,253,47,300
p_78,0,12,e_2,556,814,866,24,7,7,9,4,0,1,258,52,310
p_68,0,13,e_2,567,814,871,21,6,6,6,4,0,1,247,57,304
p_69,0,14,e_2,566,814,876,21,6,6,6,4,0,1,248,62,310
p_9,0,2,e_0,846,879,887,14,0,0,11,4,0,1,33,8,41
p_6,0,3,e_0,877,879,892,14,0,0,1,4,0,1,2,13,15
p_7,0,5,e_0,875,879,900,14,0,0,1,4,0,1,4,21,25
p_10,0,8,e_0,835,879,911,14,0,0,14,3,0,0,44,32,76
p_8,0,11,e_0,874,879,922,14,0,0,2,4,0,1,5,43,48
p_4,0,1,e_1,886,919,924,14,0,0,11,4,0,1,33,5,38
p_30,0,3,e_2,668,920,931,18,3,3,9,4,0,1,252,11,263
p_1,0,5,e_1,894,919,938,14,0,0,8,4,0,1,25,19,44
p_29,0,5,e_2,670,920,939,17,3,3,9,4,0,1,250,19,269
p_61,0,6,e_2,579,920,944,18,4,4,2,4,0,1,341,24,365
p_32,0,6,e_2,650,920,944,23,4,4,15,4,0,1,270,24,294
p_31,0,6,e_2,666,920,944,19,3,3,10,4,0,1,254,24,278
p_5,0,8,e_1,883,919,949,14,0,0,11,3,0,0,36,30,66
p_3,0,8,e_1,888,919,949,14,0,0,10,4,0,1,31,30,61
p_60,0,10,e_2,580,920,958,18,4,4,1,4,0,1,340,38,378
p_27,0,10,e_2,677,920,958,16,2,2,6,4,0,1,243,38,281
p_2,0,11,e_1,892,919,960,14,0,0,9,4,0,1,27,41,68
p_58,0,11,e_2,582,920,963,18,4,4,0,4,0,1,338,43,381
p_57,0,11,e_2,583,920,963,17,3,3,0,4,0,1,337,43,380
p_28,0,11,e_2,676,920,963,16,2,2,6,4,0,1,244,43,287
p_34,0,12,e_2,646,920,968,25,4,4,14,5,1,1,274,48,322
p_63,0,13,e_2,577,920,973,18,5,5,2,4,0,1,343,53,396
p_62,0,13,e_2,578,920,973,18,4,4,2,4,0,1,342,53,395
p_59,0,14,e_2,581,920,978,18,4,4,1,4,0,1,339,58,397
p_33,0,15,e_2,649,920,983,24,4,4,15,2,1,1,271,63,334
p_24,0,2,e_2,695,1030,1038,13,0,0,0,3,0,0,335,8,343
p_16,0,2,e_2,780,1030,1038,26,4,4,11,4,0,1,250,8,258
p_14,0,4,e_2,794,1030,1046,22,3,3,6,4,0,1,236,16,252
p_26,0,8,e_2,684,1030,1060,14,1,1,4,4,0,1,346,30,376
p_25,0,8,e_2,686,1030,1060,14,1,1,3,4,0,1,344,30,374
p_11,0,9,e_2,807,1030,1065,18,2,2,2,4,0,1,223,35,258
p_300,0,4,e_0,8,8,24,0,0,0,0,3,0,0,0,16,16
p_299,0,5,e_1,9,9,28,0,0,0,0,3,0,0,0,19,19
p_297,0,6,e_3,15,15,37,0,0,0,0,3,0,0,0,22,22
p_298,0,9,e_2,11,12,43,0,0,0,0,3,0,0,1,31,32
p_296,0,4,e_0,28,42,56,9,1,1,4,3,0,0,14,14,28
p_289,0,4,e_1,43,46,62,6,0,0,1,4,0,1,3,16,19
p_292,0,6,e_0,38,42,64,6,0,0,1,4,0,1,4,22,26
p_290,0,6,e_0,40,42,64,6,0,0,1,4,0,1,2,22,24
p_295,0,5,e_1,29,46,67,9,1,1,5,3,0,0,17,21,38
p_287,0,5,e_1,45,46,67,6,0,0,0,3,0,0,1,21,22
p_288,0,8,e_1,44,46,78,6,0,0,1,4,0,1,2,32,34
p_286,0,3,e_3,46,67,80,6,0,0,6,3,0,0,21,13,34
p_291,0,11,e_0,39,42,81,6,0,0,1,4,0,1,3,39,42
p_285,0,4,e_3,53,67,85,5,1,0,5,4,0,1,14,18,32
p_284,0,4,e_3,54,67,85,4,1,0,4,4,0,1,13,18,31
p_294,0,12,e_0,31,42,86,8,1,1,3,4,0,1,11,44,55
p_293,0,12,e_0,33,42,86,7,1,1,3,4,0,1,9,44,53
p_282,0,7,e_3,66,67,96,0,0,0,0,3,0,0,1,29,30
p_283,0,9,e_3,57,67,104,3,1,0,3,4,0,1,10,37,47
p_281,0,1,e_2,73,103,108,17,4,4,9,3,0,0,30,5,35
p_278,0,2,e_1,77,104,112,16,4,4,8,2,1,0,27,8,35
p_279,0,5,e_2,76,103,122,16,4,4,9,4,0,1,27,19,46
p_277,0,6,e_1,82,104,126,15,3,3,7,4,0,1,22,22,44
p_274,0,8,e_1,88,104,134,13,2,2,5,4,0,1,16,30,46
p_276,0,11,e_1,84,104,145,14,3,3,6,4,0,1,20,41,61
p_271,0,1,e_3,121,140,145,6,1,0,6,4,0,1,19,5,24
p_280,0,14,e_2,75,103,151,16,4,4,9,4,0,1,28,48,76
p_273,0,4,e_3,110,140,156,9,0,0,9,3,0,0,30,16,46
p_275,0,14,e_1,86,104,156,14,2,2,6,4,0,1,18,52,70
p_270,0,9,e_3,122,140,173,6,1,0,6,4,0,1,18,33,51
p_269,0,9,e_3,127,140,173,4,1,0,4,4,0,1,13,33,46
p_272,0,10,e_3,113,140,178,9,1,0,9,4,0,1,27,38,65
p_267,0,1,e_0,148,183,188,18,3,3,11,4,0,1,35,5,40
p_268,0,2,e_0,144,183,193,19,4,4,12,3,0,0,39,10,49
p_265,0,4,e_0,152,183,201,17,3,3,10,4,0,1,31,18,49
p_262,0,5,e_0,157,183,206,16,2,2,9,4,0,1,26,23,49
p_261,0,5,e_0,164,183,206,14,2,2,6,4,0,1,19,23,42
p_266,0,6,e_0,151,183,211,18,3,3,11,4,0,1,32,28,60
p_263,0,7,e_0,154,183,216,16,3,3,9,4,0,1,29,33,62
p_260,0,7,e_0,165,183,216,14,2,2,6,4,0,1,18,33,51
p_258,0,7,e_0,168,183,216,13,2,2,5,4,0,1,15,33,48
p_256,0,10,e_0,182,183,227,10,0,0,0,4,0,1,1,44,45
p_255,0,3,e_3,184,216,227,10,0,0,10,3,0,0,32,11,43
p_264,0,11,e_0,153,183,232,17,3,3,10,4,0,1,30,49,79
p_254,0,4,e_3,187,216,232,10,1,0,10,4,0,1,29,16,45
p_253,0,5,e_3,190,216,237,9,1,0,9,4,0,1,26,21,47
p_252,0,5,e_3,205,216,237,4,1,0,4,4,0,1,11,21,32
p_257,0,14,e_0,169,183,243,12,2,2,5,4,0,1,14,60,74
p_259,0,15,e_0,167,183,248,13,2,2,5,4,0,1,16,65,81
p_250,0,2,e_1,217,261,269,30,4,4,14,3,0,0,44,8,52
p_251,0,15,e_3,209,216,269,2,1,0,2,4,0,1,7,53,60
p_248,0,5,e_1,246,261,280,23,1,1,5,4,0,1,15,19,34
p_247,0,5,e_1,250,261,280,21,1,1,3,4,0,1,11,19,30
p_249,0,6,e_1,239,261,285,25,1,1,7,4,0,1,22,24,46
p_241,0,1,e_1,283,305,312,15,0,0,5,5,1,0,22,7,29
p_236,0,1,e_1,305,305,312,15,0,0,0,3,0,0,0,7,7
p_245,0,7,e_2,269,307,330,15,0,0,12,4,0,1,38,23,61
p_237,0,7,e_1,304,305,332,15,0,0,0,4,0,1,1,27,28
p_242,0,8,e_2,277,307,335,15,0,0,10,4,0,1,30,28,58
p_240,0,9,e_1,301,305,340,15,0,0,1,4,0,1,4,35,39
p_246,0,10,e_2,262,307,343,17,1,1,14,3,0,0,45,36,81
p_239,0,11,e_1,302,305,348,15,0,0,1,4,0,1,3,43,46
p_244,0,12,e_2,271,307,351,15,0,0,12,4,0,1,36,44,80
p_238,0,13,e_1,303,305,356,15,0,0,0,4,0,1,2,51,53
p_233,0,1,e_0,311,356,361,15,1,1,15,4,0,1,45,5,50
p_243,0,15,e_2,272,307,362,15,0,0,11,4,0,1,35,55,90
p_209,0,2,e_3,357,358,366,0,1,0,0,4,0,1,1,8,9
p_226,0,2,e_0,329,356,366,10,1,0,9,4,0,1,27,10,37
p_223,0,2,e_0,336,356,366,7,1,0,7,4,0,1,20,10,30
p_230,0,3,e_0,319,356,371,13,1,0,12,4,0,1,37,15,52
p_228,0,4,e_0,325,356,376,11,1,0,10,4,0,1,31,20,51
p_232,0,5,e_0,314,356,381,14,1,0,14,4,0,1,42,25,67
p_225,0,5,e_0,330,356,381,9,1,0,8,4,0,1,26,25,51
p_224,0,5,e_0,331,356,381,9,1,0,8,4,0,1,25,25,50
p_222,0,5,e_0,337,356,381,7,1,0,6,4,0,1,19,25,44
p_234,0,8,e_3,310,358,386,15,0,0,15,3,0,0,48,28,76
p_221,0,6,e_0,339,356,386,6,1,0,5,4,0,1,17,30,47
p_220,0,6,e_0,341,356,386,5,1,0,5,4,0,1,15,30,45
p_231,0,7,e_0,317,356,391,13,1,0,13,4,0,1,39,35,74
p_235,0,8,e_0,308,356,396,15,0,0,15,3,0,0,48,40,88
p_205,0,2,e_1,362,399,407,15,2,2,12,4,0,1,37,8,45
p_227,0,12,e_0,327,356,410,10,1,0,9,4,0,1,29,54,83
p_200,0,4,e_1,367,399,415,14,1,1,11,4,0,1,32,16,48
p_196,0,4,e_1,371,399,415,13,1,1,9,4,0,1,28,16,44
p_229,0,13,e_0,320,356,415,13,1,0,12,4,0,1,36,59,95
p_201,0,5,e_1,366,399,420,14,1,1,11,4,0,1,33,21,54
p_208,0,6,e_1,358,399,425,16,2,2,13,3,0,0,41,26,67
p_194,0,6,e_1,373,399,425,12,1,1,9,4,0,1,26,26,52
p_167,0,1,e_3,413,425,430,4,1,0,4,4,0,1,12,5,17
p_180,0,2,e_3,399,425,435,8,0,0,8,3,0,0,26,10,36
p_198,0,9,e_1,369,399,436,13,1,1,10,4,0,1,30,37,67
p_178,0,3,e_3,401,425,440,8,1,0,8,4,0,1,24,15,39
p_197,0,10,e_1,370,399,441,13,1,1,9,4,0,1,29,42,71
p_176,0,4,e_3,403,425,445,7,1,0,7,4,0,1,22,20,42
p_207,0,11,e_1,359,399,446,16,2,2,13,4,0,1,40,47,87
p_206,0,12,e_1,361,399,451,16,2,2,13,4,0,1,38,52,90
p_203,0,12,e_1,364,399,451,14,2,2,11,4,0,1,35,52,87
p_179,0,8,e_3,400,425,459,8,1,0,8,4,0,1,25,34,59
p_204,0,14,e_1,363,399,459,15,2,2,12,4,0,1,36,60,96
p_216,0,1,e_0,347,456,463,4,1,0,3,4,0,1,109,7,116
p_158,0,1,e_0,430,456,463,29,11,11,8,4,0,1,26,7,33
p_177,0,9,e_3,402,425,464,8,1,0,8,4,0,1,23,39,62
p_169,0,9,e_3,411,425,464,4,1,0,4,4,0,1,14,39,53
p_202,0,15,e_1,365,399,464,14,2,2,11,4,0,1,34,65,99
p_199,0,15,e_1,368,399,464,14,1,1,10,4,0,1,31,65,96
p_195,0,15,e_1,372,399,464,13,1,1,9,4,0,1,27,65,92
p_214,0,3,e_0,349,456,471,3,1,0,2,4,0,1,107,15,122
p_173,0,11,e_3,407,425,472,6,1,0,6,4,0,1,18,47,65
p_166,0,12,e_3,416,425,477,3,1,0,3,4,0,1,9,52,61
p_219,0,5,e_0,342,456,479,5,1,0,5,4,0,1,114,23,137
p_171,0,13,e_3,409,425,482,5,1,0,5,4,0,1,16,57,73
p_168,0,13,e_3,412,425,482,4,1,0,4,4,0,1,13,57,70
p_210,0,6,e_0,354,456,484,1,1,0,1,4,0,1,102,28,130
p_159,0,6,e_0,429,456,484,29,12,12,9,4,0,1,27,28,55
p_175,0,14,e_3,405,425,487,7,1,0,7,4,0,1,20,62,82
p_174,0,14,e_3,406,425,487,6,1,0,6,4,0,1,19,62,81
p_170,0,14,e_3,410,425,487,5,1,0,5,4,0,1,15,62,77
p_217,0,7,e_0,346,456,489,4,1,0,3,4,0,1,110,33,143
p_212,0,7,e_0,351,456,489,2,1,0,2,4,0,1,105,33,138
p_172,0,15,e_3,408,425,492,6,1,0,6,4,0,1,17,67,84
p_218,0,11,e_0,343,456,503,5,1,0,4,4,0,1,113,47,160
p_130,0,1,e_2,472,504,509,19,5,5,10,4,0,1,32,5,37
p_157,0,14,e_0,431,456,514,29,11,11,8,4,0,1,25,58,83
p_190,0,1,e_1,379,511,516,10,1,1,7,4,0,1,132,5,137
p_183,0,1,e_1,396,511,516,8,0,0,1,4,0,1,115,5,120
p_136,0,3,e_2,465,504,517,21,6,6,13,4,0,1,39,13,52
p_129,0,3,e_2,473,504,517,19,5,5,10,4,0,1,31,13,44
p_215,0,15,e_0,348,456,519,3,1,0,2,4,0,1,108,63,171
p_213,0,15,e_0,350,456,519,3,1,0,2,4,0,1,106,63,169
p_211,0,15,e_0,353,456,519,1,1,0,1,4,0,1,103,63,166
p_160,0,15,e_0,426,456,519,30,11,11,10,4,0,1,30,63,93
p_156,0,15,e_0,434,456,519,28,11,11,7,4,0,1,22,63,85
p_182,0,2,e_1,397,511,521,8,0,0,0,4,0,1,114,10,124
p_137,0,4,e_2,464,504,522,21,6,6,13,4,0,1,40,18,58
p_186,0,4,e_1,390,511,529,8,0,0,3,4,0,1,121,18,139
p_141,0,6,e_2,458,504,530,22,8,8,15,4,0,1,46,26,72
p_140,0,8,e_2,459,504,538,22,7,7,15,4,0,1,45,34,79
p_102,0,7,e_1,509,511,540,10,1,0,0,4,0,1,2,29,31
p_142,0,9,e_2,457,504,543,23,8,8,15,3,0,0,47,39,86
p_192,0,8,e_1,375,511,545,11,1,1,8,4,0,1,136,34,170
p_189,0,8,e_1,382,511,545,9,1,1,6,4,0,1,129,34,163
p_161,0,1,e_3,421,539,546,1,1,0,1,4,0,1,118,7,125
p_96,0,1,e_3,517,539,546,7,1,0,7,4,0,1,22,7,29
p_139,0,10,e_2,461,504,548,22,7,7,14,4,0,1,43,44,87
p_135,0,10,e_2,466,504,548,21,6,6,12,4,0,1,38,44,82
p_191,0,10,e_1,376,511,553,11,1,1,8,4,0,1,135,42,177
p_185,0,10,e_1,391,511,553,8,0,0,2,4,0,1,120,42,162
p_138,0,11,e_2,463,504,553,21,7,7,13,4,0,1,41,49,90
p_132,0,11,e_2,470,504,553,20,6,6,11,4,0,1,34,49,83
p_128,0,11,e_2,474,504,553,19,5,5,10,4,0,1,30,49,79
p_165,0,4,e_3,417,539,557,3,1,0,3,4,0,1,122,18,140
p_92,0,4,e_3,525,539,557,4,1,0,4,4,0,1,14,18,32
p_193,0,11,e_1,374,511,558,12,1,1,8,4,0,1,137,47,184
p_103,0,11,e_1,508,511,558,10,1,0,1,4,0,1,3,47,50
p_133,0,12,e_2,469,504,558,20,6,6,11,4,0,1,35,54,89
p_187,0,12,e_1,389,511,563,8,0,0,3,4,0,1,122,52,174
p_184,0,12,e_1,392,511,563,8,0,0,2,4,0,1,119,52,171
p_99,0,6,e_3,514,539,565,8,1,0,8,4,0,1,25,26,51
p_94,0,6,e_3,519,539,565,7,1,0,7,4,0,1,20,26,46
p_131,0,14,e_2,471,504,566,19,5,5,11,4,0,1,33,62,95
p_188,0,13,e_1,384,511,568,8,1,1,5,4,0,1,127,57,184
p_98,0,7,e_3,515,539,570,8,1,0,8,4,0,1,24,31,55
p_97,0,7,e_3,516,539,570,8,1,0,8,4,0,1,23,31,54
p_134,0,15,e_2,467,504,571,21,6,6,12,4,0,1,37,67,104
p_146,0,1,e_0,453,566,573,24,8,8,1,4,0,1,113,7,120
p_101,0,8,e_3,511,539,575,9,1,0,9,4,0,1,28,36,64
p_181,0,15,e_1,398,511,576,8,0,0,0,4,0,1,113,65,178
p_86,0,2,e_0,544,566,578,28,10,10,7,4,0,1,22,12,34
p_100,0,9,e_3,513,539,580,9,1,0,9,4,0,1,26,41,67
p_143,0,3,e_0,456,566,583,23,8,8,0,3,0,0,110,17,127
p_163,0,10,e_3,419,539,585,2,1,0,2,4,0,1,120,46,166
p_164,0,11,e_3,418,539,590,2,1,0,2,4,0,1,121,51,172
p_162,0,11,e_3,420,539,590,2,1,0,2,4,0,1,119,51,170
p_150,0,6,e_0,443,566,594,26,9,9,4,4,0,1,123,28,151
p_93,0,13,e_3,520,539,598,6,1,0,6,4,0,1,19,59,78
p_154,0,7,e_0,436,566,599,28,10,10,6,4,0,1,130,33,163
p_95,0,14,e_3,518,539,603,7,1,0,7,4,0,1,21,64,85
p_148,0,8,e_0,449,566,604,25,8,8,2,4,0,1,117,38,155
p_153,0,9,e_0,437,566,609,28,10,10,6,4,0,1,129,43,172
p_147,0,9,e_0,452,566,609,24,8,8,1,4,0,1,114,43,157
p_144,0,9,e_0,455,566,609,23,8,8,0,4,0,1,111,43,154
p_145,0,11,e_0,454,566,617,23,8,8,1,4,0,1,112,51,163
p_119,0,1,e_2,483,618,623,17,3,3,7,4,0,1,135,5,140
p_113,0,1,e_2,489,618,623,16,2,2,5,4,0,1,129,5,134
p_155,0,14,e_0,435,566,628,28,10,10,7,4,0,1,131,62,193
p_114,0,3,e_2,488,618,631,16,2,2,5,4,0,1,130,13,143
p_152,0,15,e_0,441,566,633,27,9,9,5,4,0,1,125,67,192
p_151,0,15,e_0,442,566,633,27,9,9,5,4,0,1,124,67,191
p_149,0,15,e_0,444,566,633,26,9,9,4,4,0,1,122,67,189
p_85,0,15,e_0,545,566,633,27,11,11,7,4,0,1,21,67,88
p_124,0,7,e_2,478,618,645,18,4,4,8,4,0,1,140,27,167
p_118,0,7,e_2,484,618,645,17,3,3,7,4,0,1,134,27,161
p_115,0,9,e_2,487,618,653,16,2,2,5,4,0,1,131,35,166
p_127,0,10,e_2,475,618,658,19,5,5,10,4,0,1,143,40,183
p_117,0,10,e_2,485,618,658,16,3,3,6,4,0,1,133,40,173
p_116,0,10,e_2,486,618,658,16,3,3,6,4,0,1,132,40,172
p_123,0,11,e_2,479,618,663,18,4,4,8,4,0,1,139,45,184
p_121,0,11,e_2,481,618,663,17,3,3,7,4,0,1,137,45,182
p_120,0,11,e_2,482,618,663,17,3,3,7,4,0,1,136,45,181
p_68,0,13,e_1,567,623,664,22,8,8,13,2,2,0,56,41,97
p_88,0,5,e_3,538,647,666,0,0,0,0,3,0,0,109,19,128
p_126,0,12,e_2,476,618,668,18,4,4,9,4,0,1,142,50,192
p_125,0,14,e_2,477,618,676,18,4,4,9,4,0,1,141,58,199
p_87,0,8,e_3,539,647,677,0,1,1,0,3,0,1,108,30,138
p_122,0,15,e_2,480,618,681,17,4,4,8,4,0,1,138,63,201
p_89,0,9,e_3,535,647,682,1,1,0,1,4,0,1,112,35,147
p_35,0,9,e_3,630,647,682,5,1,0,5,4,0,1,17,35,52
p_77,0,3,e_0,557,680,691,24,9,9,3,4,0,1,123,11,134
p_72,0,3,e_0,562,680,691,23,9,9,1,4,0,1,118,11,129
p_71,0,3,e_0,564,680,691,22,8,8,0,4,0,1,116,11,127
p_70,0,3,e_0,565,680,691,22,8,8,0,4,0,1,115,11,126
p_91,0,12,e_3,526,647,693,4,1,0,4,4,0,1,121,46,167
p_34,0,12,e_3,646,647,693,0,0,0,0,3,0,0,1,46,47
p_90,0,13,e_3,527,647,698,4,1,0,4,4,0,1,120,51,171
p_36,0,13,e_3,628,647,698,6,1,0,6,4,0,1,19,51,70
p_75,0,5,e_0,559,680,699,24,9,9,2,4,0,1,121,19,140
p_76,0,6,e_0,558,680,704,24,9,9,3,4,0,1,122,24,146
p_80,0,7,e_0,552,680,709,26,10,10,5,4,0,1,128,29,157
p_74,0,7,e_0,560,680,709,24,9,9,2,4,0,1,120,29,149
p_83,0,8,e_0,549,680,714,26,10,10,5,4,0,1,131,34,165
p_73,0,11,e_0,561,680,725,23,9,9,2,4,0,1,119,45,164
p_84,0,12,e_0,546,680,730,27,10,10,6,4,0,1,134,50,184
p_78,0,12,e_0,556,680,730,24,10,10,3,4,0,1,124,50,174
p_65,0,1,e_2,573,728,733,20,7,7,15,4,0,1,155,5,160
p_24,0,2,e_1,695,726,734,14,1,1,10,4,0,1,31,8,39
p_82,0,14,e_0,550,680,738,26,10,10,5,4,0,1,130,58,188
p_81,0,14,e_0,551,680,738,26,10,10,5,4,0,1,129,58,187
p_79,0,14,e_0,553,680,738,25,10,10,4,4,0,1,127,58,185
p_22,0,3,e_1,719,726,739,13,0,0,2,4,0,1,7,13,20
p_106,0,3,e_2,500,728,741,13,1,0,1,4,0,1,228,13,241
p_67,0,3,e_2,568,728,741,22,8,8,14,5,1,1,160,13,173
p_66,0,3,e_2,569,728,741,21,8,8,14,5,1,1,159,13,172
p_64,0,4,e_2,574,728,746,20,7,7,15,4,0,1,154,18,172
p_108,0,6,e_2,496,728,754,14,1,0,2,4,0,1,232,26,258
p_26,0,8,e_1,684,726,756,17,2,2,13,3,0,0,42,30,72
p_25,0,8,e_1,686,726,756,16,2,2,13,4,0,1,40,30,70
p_111,0,8,e_2,491,728,762,15,1,1,4,4,0,1,237,34,271
p_23,0,12,e_1,711,726,770,13,0,0,5,4,0,1,15,44,59
p_112,0,11,e_2,490,728,773,15,2,2,4,4,0,1,238,45,283
p_110,0,11,e_2,492,728,773,15,1,1,4,4,0,1,236,45,281
p_107,0,11,e_2,499,728,773,13,1,0,1,4,0,1,229,45,274
p_105,0,12,e_2,502,728,778,12,1,0,1,4,0,1,226,50,276
p_63,0,13,e_2,577,728,783,20,6,6,14,4,0,1,151,55,206
p_62,0,13,e_2,578,728,783,19,6,6,13,4,0,1,150,55,205
p_21,0,4,e_3,731,772,786,13,0,0,13,3,0,0,41,14,55
p_104,0,14,e_2,503,728,788,12,1,0,0,4,0,1,225,60,285
p_16,0,2,e_0,780,782,790,26,4,4,0,4,0,1,2,8,10
p_109,0,15,e_2,493,728,793,15,1,0,3,4,0,1,235,65,300
p_30,0,3,e_0,668,782,795,21,4,4,4,4,0,1,114,13,127
p_29,0,5,e_0,670,782,803,20,4,4,3,4,0,1,112,21,133
p_18,0,10,e_3,766,772,806,2,1,0,2,4,0,1,6,34,40
p_32,0,6,e_0,650,782,808,26,5,5,10,4,0,1,132,26,158
p_31,0,6,e_0,666,782,808,21,4,4,4,4,0,1,116,26,142
p_19,0,11,e_3,754,772,811,6,1,0,6,4,0,1,18,39,57
p_27,0,10,e_0,677,782,822,18,3,3,1,4,0,1,105,40,145
p_17,0,10,e_0,776,782,822,27,4,4,2,4,0,1,6,40,46
p_20,0,14,e_3,734,772,822,12,1,0,12,4,0,1,38,50,88
p_28,0,11,e_0,676,782,827,18,4,4,1,4,0,1,106,45,151
p_69,0,14,e_0,566,782,838,22,8,8,0,3,0,0,216,56,272
p_33,0,15,e_0,649,782,843,26,5,5,10,4,0,1,133,61,194
p_14,0,4,e_1,794,832,846,22,3,3,12,4,0,1,38,14,52
p_55,0,3,e_2,585,840,851,18,4,4,11,4,0,1,255,11,266
p_54,0,3,e_2,586,840,851,18,4,4,11,4,0,1,254,11,265
p_52,0,3,e_2,588,840,851,17,4,4,10,4,0,1,252,11,263
p_48,0,4,e_2,592,840,856,17,3,3,9,4,0,1,248,16,264
p_15,0,9,e_1,793,832,863,22,3,3,12,3,0,0,39,31,70
p_11,0,9,e_1,807,832,863,18,2,2,8,4,0,1,25,31,56
p_61,0,6,e_2,579,840,864,19,5,5,13,4,0,1,261,24,285
p_56,0,6,e_2,584,840,864,18,4,4,11,4,0,1,256,24,280
p_50,0,7,e_2,590,840,869,17,3,3,9,4,0,1,250,29,279
p_13,0,11,e_1,796,832,871,21,3,3,12,4,0,1,36,39,75
p_12,0,11,e_1,798,832,871,20,3,3,11,4,0,1,34,39,73
p_53,0,9,e_2,587,840,877,18,4,4,10,4,0,1,253,37,290
p_51,0,9,e_2,589,840,877,17,3,3,9,4,0,1,251,37,288
p_47,0,9,e_2,593,840,877,17,3,3,8,4,0,1,247,37,284
p_60,0,10,e_2,580,840,882,19,5,5,13,4,0,1,260,42,302
p_58,0,11,e_2,582,840,887,19,5,5,12,4,0,1,258,47,305
p_57,0,11,e_2,583,840,887,19,5,5,12,4,0,1,257,47,304
p_4,0,1,e_3,886,891,896,2,1,0,2,4,0,1,5,5,10
p_59,0,14,e_2,581,840,898,19,5,5,12,4,0,1,259,58,317
p_49,0,14,e_2,591,840,898,17,3,3,9,4,0,1,249,58,307
p_9,0,2,e_3,846,891,901,14,0,0,14,3,0,0,45,10,55
p_6,0,3,e_3,877,891,906,5,1,0,5,4,0,1,14,15,29
p_7,0,5,e_3,875,891,914,5,1,0,5,4,0,1,16,23,39
p_5,0,8,e_3,883,891,925,2,1,0,2,4,0,1,8,34,42
p_3,0,8,e_3,888,891,925,1,1,0,1,4,0,1,3,34,37
p_8,0,11,e_3,874,891,936,6,1,0,6,4,0,1,17,45,62
p_1,0,5,e_1,894,927,944,21,6,6,11,4,0,1,33,17,50
p_45,0,2,e_2,595,942,950,16,3,3,8,4,0,1,347,8,355
p_46,0,4,e_2,594,942,958,16,3,3,8,4,0,1,348,16,364
p_2,0,11,e_1,892,927,964,22,6,6,11,3,0,0,35,37,72
p_42,0,6,e_2,598,942,966,15,2,2,6,4,0,1,344,24,368
p_43,0,7,e_2,597,942,971,15,2,2,7,4,0,1,345,29,374
p_44,0,8,e_2,596,942,976,16,3,3,7,4,0,1,346,34,380
p_10,0,8,e_2,835,942,976,14,0,0,1,4,0,1,107,34,141
p_37,0,9,e_2,615,942,981,11,1,0,1,4,0,1,327,39,366
p_41,0,11,e_2,600,942,989,15,2,2,6,4,0,1,342,47,389
p_39,0,12,e_2,607,942,994,13,1,0,4,4,0,1,335,52,387
p_40,0,13,e_2,602,942,999,14,1,1,5,4,0,1,340,57,397
p_38,0,13,e_2,608,942,999,13,1,0,3,4,0,1,334,57,391
p_300,0,4,e_0,8,8,24,0,0,0,0,3,0,0,0,16,16
p_299,0,5,e_1,9,10,29,0,0,0,0,3,0,0,1,19,20
p_297,0,6,e_3,15,15,37,0,0,0,0,3,0,0,0,22,22
p_298,0,9,e_2,11,11,42,0,0,0,0,3,0,0,0,31,31
p_296,0,4,e_0,28,43,57,9,1,1,4,3,0,0,15,14,29
p_289,0,4,e_1,43,46,62,6,0,0,1,4,0,1,3,16,19
p_292,0,6,e_0,38,43,65,6,0,0,2,4,0,1,5,22,27
p_290,0,6,e_0,40,43,65,6,0,0,1,4,0,1,3,22,25
p_295,0,5,e_1,29,46,67,9,1,1,5,2,1,0,17,21,38
p_287,0,5,e_1,45,46,67,6,0,0,0,3,0,0,1,21,22
p_288,0,8,e_1,44,46,78,6,0,0,0,4,0,1,2,32,34
p_286,0,3,e_3,46,66,79,6,0,0,6,3,0,0,20,13,33
p_291,0,11,e_0,39,43,82,6,0,0,1,4,0,1,4,39,43
p_285,0,4,e_3,53,66,84,4,1,0,4,4,0,1,13,18,31
p_284,0,4,e_3,54,66,84,4,1,0,4,4,0,1,12,18,30
p_294,0,12,e_0,31,43,87,8,1,1,4,4,0,1,12,44,56
p_293,0,12,e_0,33,43,87,7,1,1,3,4,0,1,10,44,54
p_282,0,7,e_3,66,66,95,0,0,0,0,3,0,0,0,29,29
p_283,0,9,e_3,57,66,103,3,1,0,3,4,0,1,9,37,46
p_281,0,1,e_2,73,102,107,17,4,4,9,3,0,0,29,5,34
p_278,0,2,e_2,77,102,112,16,4,4,8,4,0,1,25,10,35
p_279,0,5,e_2,76,102,123,16,4,4,9,4,0,1,26,21,47
p_277,0,6,e_1,82,109,129,14,3,3,8,3,0,0,27,20,47
p_274,0,8,e_2,88,102,134,13,2,2,5,4,0,1,14,32,46
p_276,0,11,e_2,84,102,145,4,2,2,6,4,0,1,18,43,61
p_271,0,1,e_3,121,140,145,6,1,0,6,4,0,1,19,5,24
p_273,0,4,e_3,110,140,156,9,0,0,9,3,0,0,30,16,46
p_280,0,14,e_2,75,102,156,16,4,4,9,4,0,1,27,54,81
p_275,0,14,e_2,86,102,156,14,2,2,5,4,0,1,16,54,70
p_267,0,1,e_1,148,164,171,18,3,3,5,4,0,1,16,7,23
p_270,0,9,e_3,122,140,173,6,1,0,6,4,0,1,18,33,51
p_269,0,9,e_3,127,140,173,4,1,0,4,4,0,1,13,33,46
p_268,0,2,e_1,144,164,176,19,3,3,6,3,0,0,20,12,32
p_272,0,10,e_3,113,140,178,9,1,0,9,4,0,1,27,38,65
p_265,0,4,e_1,152,164,184,17,3,3,4,4,0,1,12,20,32
p_262,0,5,e_1,157,164,189,16,2,2,2,4,0,1,7,25,32
p_261,0,5,e_1,164,164,189,14,2,2,0,3,0,0,0,25,25
p_266,0,6,e_1,151,164,194,17,3,3,4,4,0,1,13,30,43
p_263,0,7,e_1,154,164,199,16,3,3,3,4,0,1,10,35,45
p_264,0,11,e_1,153,164,213,17,3,3,4,4,0,1,11,49,60
p_255,0,3,e_0,184,204,215,10,0,0,7,4,0,1,20,11,31
p_254,0,4,e_0,187,204,220,10,0,0,6,4,0,1,17,16,33
p_253,0,5,e_0,190,204,225,10,0,0,5,4,0,1,14,21,35
p_260,0,7,e_0,165,204,233,13,2,2,12,3,0,0,39,29,68
p_258,0,7,e_0,168,204,233,12,2,2,12,4,0,1,36,29,65
p_256,0,10,e_0,182,204,244,10,0,0,7,4,0,1,22,40,62
p_250,0,2,e_3,217,237,245,6,1,0,6,4,0,1,20,8,28
p_252,0,5,e_3,205,237,256,10,0,0,10,3,0,0,32,19,51
p_257,0,14,e_0,169,204,258,12,2,2,11,4,0,1,35,54,89
p_259,0,15,e_0,167,204,263,13,2,2,12,4,0,1,37,59,96
p_251,0,15,e_3,209,237,288,9,1,0,9,4,0,1,28,51,79
p_248,0,5,e_1,246,275,292,28,2,2,10,4,0,1,29,17,46
p_247,0,5,e_1,250,275,292,27,2,2,8,4,0,1,25,17,42
p_249,0,6,e_1,239,275,297,30,3,3,11,3,0,0,36,22,58
p_245,0,7,e_1,269,275,302,21,1,1,2,4,0,1,6,27,33
p_246,0,10,e_1,262,275,313,23,1,1,4,4,0,1,13,38,51
p_244,0,12,e_1,271,275,321,20,1,1,1,4,0,1,4,46,50
p_241,0,1,e_2,283,321,326,17,1,1,12,4,0,1,38,5,43
p_236,0,1,e_2,305,321,326,15,0,0,5,4,0,1,16,5,21
p_233,0,1,e_2,311,321,326,15,0,0,3,4,0,1,10,5,15
p_243,0,15,e_1,272,275,332,20,1,1,1,4,0,1,3,57,60
p_230,0,3,e_2,319,321,334,15,0,0,0,4,0,1,2,13,15
p_232,0,5,e_2,314,321,342,15,0,0,2,4,0,1,7,21,28
p_237,0,7,e_2,304,321,350,15,0,0,6,4,0,1,17,29,46
p_231,0,7,e_2,317,321,350,15,0,0,1,4,0,1,4,29,33
p_242,0,8,e_2,277,321,355,18,1,1,14,3,0,0,44,34,78
p_235,0,8,e_2,308,321,355,15,0,0,4,4,0,1,13,34,47
p_234,0,8,e_2,310,321,355,15,0,0,3,4,0,1,11,34,45
p_240,0,9,e_2,301,321,360,15,0,0,6,4,0,1,20,39,59
p_239,0,11,e_2,302,321,368,15,0,0,6,4,0,1,19,47,66
p_238,0,13,e_2,303,321,376,15,0,0,6,4,0,1,18,55,73
p_229,0,13,e_2,320,321,376,15,0,0,0,4,0,1,1,55,56
p_216,0,1,e_0,347,373,378,9,1,0,8,4,0,1,26,5,31
p_226,0,2,e_0,329,373,383,15,1,0,14,4,0,1,44,10,54
p_223,0,2,e_0,336,373,383,12,1,0,12,4,0,1,37,10,47
p_214,0,3,e_0,349,373,388,8,1,0,8,4,0,1,24,15,39
p_228,0,4,e_0,325,373,393,15,0,0,15,3,0,0,48,20,68
p_194,0,6,e_3,373,374,396,0,0,0,0,3,0,0,1,22,23
p_225,0,5,e_0,330,373,398,15,1,0,14,4,0,1,43,25,68
p_224,0,5,e_0,331,373,398,14,1,0,14,4,0,1,42,25,67
p_222,0,5,e_0,337,373,398,12,1,0,12,4,0,1,36,25,61
p_219,0,5,e_0,342,373,398,10,1,0,10,4,0,1,31,25,56
p_221,0,6,e_0,339,373,403,11,1,0,11,4,0,1,34,30,64
p_220,0,6,e_0,341,373,403,11,1,0,11,4,0,1,32,30,62
p_217,0,7,e_0,346,373,408,9,1,0,9,4,0,1,27,35,62
p_193,0,11,e_3,374,374,413,0,1,1,0,3,0,1,0,39,39
p_227,0,12,e_3,327,374,418,15,0,0,15,3,0,0,47,44,91
p_218,0,11,e_0,343,373,422,10,1,0,10,4,0,1,30,49,79
p_190,0,1,e_2,379,417,424,23,3,3,12,4,0,1,38,7,45
p_183,0,1,e_2,396,417,424,18,2,2,7,4,0,1,21,7,28
p_182,0,2,e_2,397,417,429,18,2,2,6,4,0,1,20,12,32
p_180,0,2,e_2,399,417,429,18,2,2,6,4,0,1,18,12,30
p_178,0,3,e_2,401,417,434,17,2,2,5,4,0,1,16,17,33
p_215,0,15,e_0,348,373,436,8,1,0,8,4,0,1,25,63,88
p_213,0,15,e_0,350,373,436,8,1,0,7,4,0,1,23,63,86
p_186,0,4,e_2,390,417,439,20,3,3,9,4,0,1,27,22,49
p_192,0,8,e_2,375,417,453,24,3,3,13,2,1,0,42,36,78
p_189,0,8,e_2,382,417,453,23,3,3,12,4,0,1,35,36,71
p_179,0,8,e_2,400,417,453,17,2,2,5,4,0,1,17,36,53
p_191,0,10,e_2,376,417,461,24,3,3,13,4,0,1,41,44,85
p_185,0,10,e_2,391,417,461,19,3,3,8,4,0,1,26,44,70
p_161,0,1,e_3,421,456,463,11,1,0,11,4,0,1,35,7,42
p_158,0,1,e_3,430,456,463,8,1,0,8,4,0,1,26,7,33
p_187,0,12,e_2,389,417,469,20,3,3,9,4,0,1,28,52,80
p_184,0,12,e_2,392,417,469,19,3,3,8,4,0,1,25,52,77
p_188,0,13,e_2,384,417,474,22,3,3,11,4,0,1,33,57,90
p_159,0,6,e_3,429,456,480,9,1,0,9,4,0,1,27,24,51
p_150,0,6,e_3,443,456,480,4,1,0,4,4,0,1,13,24,37
p_181,0,15,e_2,398,417,482,18,2,2,6,4,0,1,19,65,84
p_154,0,7,e_3,436,456,485,7,1,0,7,4,0,1,20,29,49
p_153,0,9,e_3,437,456,493,6,1,0,6,4,0,1,19,37,56
p_209,0,2,e_0,357,483,493,6,1,0,5,4,0,1,126,10,136
p_205,0,2,e_0,362,483,493,4,1,0,3,4,0,1,121,10,131
p_163,0,10,e_3,419,456,498,12,1,0,12,4,0,1,37,42,79
p_200,0,4,e_0,367,483,501,2,1,0,2,4,0,1,116,18,134
p_164,0,11,e_3,418,456,503,12,0,0,12,2,1,0,38,47,85
p_162,0,11,e_3,420,456,503,12,1,0,12,4,0,1,36,47,83
p_201,0,5,e_0,366,483,506,2,1,0,2,4,0,1,117,23,140
p_210,0,6,e_0,354,483,511,6,1,0,6,4,0,1,129,28,157
p_208,0,6,e_0,358,483,511,5,1,0,5,4,0,1,125,28,153
p_157,0,14,e_3,431,456,514,8,1,0,8,4,0,1,25,58,83
p_155,0,14,e_3,435,456,514,7,1,0,7,4,0,1,21,58,79
p_212,0,7,e_0,351,483,516,7,1,0,7,4,0,1,132,33,165
p_160,0,15,e_3,426,456,519,10,1,0,10,4,0,1,30,63,93
p_156,0,15,e_3,434,456,519,7,1,0,7,4,0,1,22,63,85
p_152,0,15,e_3,441,456,519,5,1,0,5,4,0,1,15,63,78
p_151,0,15,e_3,442,456,519,5,1,0,5,4,0,1,14,63,77
p_198,0,9,e_0,369,483,524,2,1,0,1,4,0,1,114,41,155
p_207,0,11,e_0,359,483,532,5,1,0,4,4,0,1,124,49,173
p_167,0,1,e_2,413,529,534,13,1,1,1,4,0,1,116,5,121
p_206,0,12,e_0,361,483,537,4,1,0,4,4,0,1,122,54,176
p_203,0,12,e_0,364,483,537,3,1,0,3,4,0,1,119,54,173
p_114,0,3,e_2,488,529,542,22,6,6,13,4,0,1,41,13,54
p_204,0,14,e_0,363,483,545,4,1,0,3,4,0,1,120,62,182
p_176,0,4,e_2,403,529,547,16,2,2,5,4,0,1,126,18,144
p_165,0,4,e_2,417,529,547,12,0,0,0,3,0,0,112,18,130
p_211,0,15,e_0,353,483,550,7,1,0,7,4,0,1,130,67,197
p_202,0,15,e_0,365,483,550,3,1,0,3,4,0,1,118,67,185
p_199,0,15,e_0,368,483,550,2,1,0,1,4,0,1,115,67,182
p_99,0,6,e_1,514,531,551,16,2,2,5,4,0,1,17,20,37
p_118,0,7,e_1,484,531,556,23,7,7,15,3,0,0,47,25,72
p_111,0,8,e_1,491,531,561,22,6,6,13,4,0,1,40,30,70
p_177,0,9,e_2,402,529,564,16,2,2,5,4,0,1,127,35,162
p_169,0,9,e_2,411,529,564,13,2,2,2,4,0,1,118,35,153
p_115,0,9,e_1,487,531,566,23,6,6,14,4,0,1,44,35,79
p_116,0,10,e_2,486,529,569,23,6,6,14,4,0,1,43,40,83
p_117,0,10,e_1,485,531,571,23,6,6,15,4,0,1,46,40,86
p_146,0,1,e_3,453,566,573,1,1,0,1,4,0,1,113,7,120
p_173,0,11,e_2,407,529,574,15,2,2,3,4,0,1,122,45,167
p_107,0,11,e_1,499,531,576,20,4,4,10,4,0,1,32,45,77
p_86,0,2,e_3,544,566,578,7,1,0,7,4,0,1,22,12,34
p_166,0,12,e_2,416,529,579,13,1,1,0,4,0,1,113,50,163
p_90,0,13,e_1,527,531,584,13,1,0,1,4,0,1,4,53,57
p_171,0,13,e_2,409,529,584,14,2,2,3,4,0,1,120,55,175
p_168,0,13,e_2,412,529,584,13,2,2,2,4,0,1,117,55,172
p_95,0,14,e_1,518,531,589,15,2,2,4,4,0,1,13,58,71
p_88,0,5,e_3,538,566,589,9,1,0,9,4,0,1,28,23,51
p_175,0,14,e_2,405,529,589,16,2,2,4,4,0,1,124,60,184
p_174,0,14,e_2,406,529,589,15,2,2,3,4,0,1,123,60,183
p_170,0,14,e_2,410,529,589,14,2,2,2,4,0,1,119,60,179
p_172,0,15,e_2,408,529,594,15,2,2,3,4,0,1,121,65,186
p_148,0,8,e_3,449,566,600,2,1,0,2,4,0,1,117,34,151
p_87,0,8,e_3,539,566,600,9,1,0,9,4,0,1,27,34,61
p_83,0,8,e_3,549,566,600,6,1,0,6,4,0,1,17,34,51
p_147,0,9,e_3,452,566,605,1,1,0,1,4,0,1,114,39,153
p_144,0,9,e_3,455,566,605,0,0,0,0,3,0,0,111,39,150
p_89,0,9,e_3,535,566,605,10,1,0,10,4,0,1,31,39,70
p_143,0,3,e_0,456,597,610,30,9,9,9,4,0,1,141,13,154
p_136,0,3,e_0,465,597,610,29,8,8,6,4,0,1,132,13,145
p_145,0,11,e_3,454,566,613,1,1,0,1,4,0,1,112,47,159
p_196,0,4,e_0,371,597,615,1,1,0,0,4,0,1,226,18,244
p_137,0,4,e_0,464,597,615,29,8,8,6,4,0,1,133,18,151
p_84,0,12,e_3,546,566,618,6,1,0,6,4,0,1,20,52,72
p_141,0,6,e_0,458,597,623,30,8,8,8,4,0,1,139,26,165
p_82,0,14,e_3,550,566,626,5,1,0,5,4,0,1,16,60,76
p_81,0,14,e_3,551,566,626,5,1,0,5,4,0,1,15,60,75
p_140,0,8,e_0,459,597,631,30,8,8,8,4,0,1,138,34,172
p_149,0,15,e_3,444,566,631,4,1,0,4,4,0,1,122,65,187
p_85,0,15,e_3,545,566,631,7,1,0,7,4,0,1,21,65,86
p_142,0,9,e_0,457,597,636,30,8,8,8,4,0,1,140,39,179
p_197,0,10,e_0,370,597,641,1,1,0,1,4,0,1,227,44,271
p_139,0,10,e_0,461,597,641,30,8,8,7,4,0,1,136,44,180
p_135,0,10,e_0,466,597,641,28,8,8,5,4,0,1,131,44,175
p_113,0,1,e_2,489,641,646,22,6,6,13,4,0,1,152,5,157
p_96,0,1,e_2,517,641,646,16,2,2,4,4,0,1,124,5,129
p_138,0,11,e_0,463,597,646,29,8,8,7,4,0,1,134,49,183
p_132,0,11,e_0,470,597,646,27,8,8,4,4,0,1,127,49,176
p_133,0,12,e_0,469,597,651,27,8,8,4,4,0,1,128,54,182
p_106,0,3,e_2,500,641,654,20,4,4,9,4,0,1,141,13,154
p_42,0,6,e_1,598,641,661,23,7,7,14,4,0,1,43,20,63
p_195,0,15,e_0,372,597,662,0,1,0,0,4,0,1,225,65,290
p_134,0,15,e_0,467,597,662,28,8,8,5,4,0,1,130,65,195
p_108,0,6,e_2,496,641,665,21,5,5,11,4,0,1,145,24,169
p_43,0,7,e_1,597,641,666,23,7,7,14,3,0,0,44,25,69
p_102,0,7,e_2,509,641,670,17,3,3,6,4,0,1,132,29,161
p_98,0,7,e_2,515,641,670,16,2,2,4,4,0,1,126,29,155
p_97,0,7,e_2,516,641,670,16,2,2,4,4,0,1,125,29,154
p_37,0,9,e_1,615,641,674,19,4,4,9,4,0,1,26,33,59
p_35,0,9,e_1,630,641,674,15,2,2,3,4,0,1,11,33,44
p_101,0,8,e_2,511,641,675,17,3,3,6,4,0,1,130,34,164
p_100,0,9,e_2,513,641,680,16,3,3,5,4,0,1,128,39,167
p_41,0,11,e_1,600,641,682,22,6,6,14,4,0,1,41,41,82
p_39,0,12,e_1,607,641,687,21,5,5,11,4,0,1,34,46,80
p_112,0,11,e_2,490,641,688,22,6,6,13,4,0,1,151,47,198
p_110,0,11,e_2,492,641,688,21,5,5,12,4,0,1,149,47,196
p_103,0,11,e_2,508,641,688,18,3,3,7,4,0,1,133,47,180
p_77,0,3,e_3,557,678,691,3,1,0,3,4,0,1,121,13,134
p_72,0,3,e_3,562,678,691,1,1,0,1,4,0,1,116,13,129
p_71,0,3,e_3,564,678,691,1,1,0,1,4,0,1,114,13,127
p_70,0,3,e_3,565,678,691,0,1,0,0,4,0,1,113,13,126
p_40,0,13,e_1,602,641,692,22,6,6,13,4,0,1,39,51,90
p_38,0,13,e_1,608,641,692,20,5,5,11,4,0,1,33,51,84
p_36,0,13,e_1,628,641,692,16,2,2,4,4,0,1,13,51,64
p_105,0,12,e_2,502,641,693,19,3,3,9,4,0,1,139,52,191
p_75,0,5,e_3,559,678,699,2,1,0,2,4,0,1,119,21,140
p_104,0,14,e_2,503,641,701,19,3,3,8,4,0,1,138,60,198
p_76,0,6,e_3,558,678,704,3,1,0,3,4,0,1,120,26,146
p_32,0,6,e_3,650,678,704,9,1,0,9,4,0,1,28,26,54
p_109,0,15,e_2,493,641,706,21,5,5,12,4,0,1,148,65,213
p_80,0,7,e_3,552,678,709,4,1,0,4,4,0,1,126,31,157
p_74,0,7,e_3,560,678,709,2,1,0,2,4,0,1,118,31,149
p_130,0,1,e_0,472,709,714,26,8,8,3,4,0,1,237,5,242
p_119,0,1,e_0,483,709,714,23,7,7,0,3,0,1,226,5,231
p_129,0,3,e_0,473,709,722,26,8,8,3,4,0,1,236,13,249
p_67,0,3,e_0,568,709,722,30,9,9,10,4,0,1,141,13,154
p_73,0,11,e_3,561,678,723,1,1,0,1,4,0,1,117,45,162
p_78,0,12,e_3,556,678,728,3,1,0,3,4,0,1,122,50,172
p_34,0,12,e_3,646,678,728,10,1,0,10,4,0,1,32,50,82
p_124,0,7,e_0,478,709,736,25,8,8,2,4,0,1,231,27,258
p_79,0,14,e_3,553,678,736,4,1,0,4,4,0,1,125,58,183
p_69,0,14,e_3,566,678,736,0,0,0,0,3,0,0,112,58,170
p_33,0,15,e_3,649,678,741,10,1,0,10,4,0,1,29,63,92
p_127,0,10,e_0,475,709,747,26,8,8,3,4,0,1,234,38,272
p_128,0,11,e_0,474,709,752,26,8,8,3,4,0,1,235,43,278
p_123,0,11,e_0,479,709,752,24,8,8,1,4,0,1,230,43,273
p_121,0,11,e_0,481,709,752,24,7,7,0,4,0,1,228,43,271
p_120,0,11,e_0,482,709,752,24,7,7,0,3,0,0,227,43,270
p_126,0,12,e_0,476,709,757,25,8,8,2,4,0,1,233,48,281
p_68,0,13,e_0,567,709,762,30,9,9,10,4,0,1,142,53,195
p_22,0,3,e_1,719,753,764,20,5,5,11,4,0,1,34,11,45
p_131,0,14,e_0,471,709,767,27,8,8,4,4,0,1,238,58,296
p_125,0,14,e_0,477,709,767,25,8,8,2,4,0,1,232,58,290
p_92,0,4,e_2,525,753,767,14,1,0,1,4,0,1,228,14,242
p_21,0,4,e_1,731,753,769,17,3,3,7,4,0,1,22,16,38
p_122,0,15,e_0,480,709,772,24,7,7,1,4,0,1,229,63,292
p_94,0,6,e_2,519,753,775,15,1,0,3,4,0,1,234,22,256
p_23,0,12,e_1,711,753,795,23,5,5,13,3,0,0,42,42,84
p_91,0,12,e_2,526,753,795,13,1,0,1,4,0,1,227,42,269
p_16,0,2,e_3,780,788,796,3,1,0,3,4,0,1,8,8,16
p_93,0,13,e_2,520,753,800,15,1,0,3,4,0,1,233,47,280
p_30,0,3,e_3,668,788,801,3,1,0,3,4,0,1,120,13,133
p_20,0,14,e_1,734,753,803,17,3,3,6,4,0,1,19,50,69
p_29,0,5,e_3,670,788,809,3,1,0,3,4,0,1,118,21,139
p_31,0,6,e_3,666,788,814,4,1,0,4,4,0,1,122,26,148
p_65,0,1,e_0,573,819,824,29,9,9,8,4,0,1,246,5,251
p_27,0,10,e_3,677,788,828,0,0,0,0,3,0,0,111,40,151
p_18,0,10,e_3,766,788,828,7,1,0,7,4,0,1,22,40,62
p_17,0,10,e_3,776,788,828,4,1,0,4,4,0,1,12,40,52
p_66,0,3,e_0,569,819,832,30,9,9,9,4,0,1,250,13,263
p_55,0,3,e_0,585,819,832,26,8,8,4,4,0,1,234,13,247
p_54,0,3,e_0,586,819,832,26,8,8,4,4,0,1,233,13,246
p_52,0,3,e_0,588,819,832,25,8,8,3,4,0,1,231,13,244
p_28,0,11,e_3,676,788,833,1,1,0,1,4,0,1,112,45,157
p_19,0,11,e_3,754,788,833,11,1,0,11,4,0,1,34,45,79
p_64,0,4,e_0,574,819,837,29,9,9,7,4,0,1,245,18,263
p_61,0,6,e_0,579,819,845,28,8,8,6,4,0,1,240,26,266
p_56,0,6,e_0,584,819,845,27,8,8,4,4,0,1,235,26,261
p_53,0,9,e_0,587,819,856,26,8,8,3,4,0,1,232,37,269
p_60,0,10,e_0,580,819,861,28,8,8,6,4,0,1,239,42,281
p_58,0,11,e_0,582,819,866,27,8,8,5,4,0,1,237,47,284
p_57,0,11,e_0,583,819,866,27,8,8,5,4,0,1,236,47,283
p_63,0,13,e_0,577,819,874,28,8,8,6,4,0,1,242,55,297
p_62,0,13,e_0,578,819,874,28,8,8,6,4,0,1,241,55,296
p_9,0,2,e_3,846,870,878,8,1,0,8,4,0,1,24,8,32
p_59,0,14,e_0,581,819,879,27,8,8,5,4,0,1,238,60,298
p_10,0,8,e_3,835,870,898,11,0,0,11,3,0,0,35,28,63
p_4,0,1,e_2,886,916,921,12,1,1,10,4,0,1,30,5,35
p_6,0,3,e_2,877,916,929,14,2,2,13,4,0,1,39,13,52
p_45,0,2,e_0,595,923,931,23,7,7,0,4,0,1,328,8,336
p_24,0,2,e_0,695,923,931,26,8,8,4,4,0,1,228,8,236
p_7,0,5,e_1,875,919,936,15,2,2,14,3,0,0,44,17,61
p_1,0,5,e_2,894,916,937,9,1,1,7,4,0,1,22,21,43
p_48,0,4,e_0,592,923,939,25,7,7,2,4,0,1,331,16,347
p_46,0,4,e_0,594,923,939,24,7,7,1,4,0,1,329,16,345
p_14,0,4,e_0,794,923,939,20,6,6,8,4,0,1,129,16,145
p_5,0,8,e_2,883,916,948,13,1,1,11,4,0,1,33,32,65
p_3,0,8,e_2,888,916,948,11,1,1,9,4,0,1,28,32,60
p_50,0,7,e_0,590,923,950,25,7,7,2,4,0,1,333,27,360
p_44,0,8,e_0,596,923,955,23,7,7,0,3,0,0,327,32,359
p_26,0,8,e_0,684,923,955,29,9,9,8,4,0,1,239,32,271
p_25,0,8,e_0,686,923,955,29,9,9,7,4,0,1,237,32,269
p_8,0,11,e_2,874,916,959,15,2,2,13,3,0,0,42,43,85
p_2,0,11,e_2,892,916,959,10,1,1,8,4,0,1,24,43,67
p_51,0,9,e_0,589,923,960,25,7,7,2,4,0,1,334,37,371
p_47,0,9,e_0,593,923,960,24,7,7,1,4,0,1,330,37,367
p_15,0,9,e_0,793,923,960,21,6,6,9,4,0,1,130,37,167
p_13,0,11,e_0,796,923,968,20,5,5,7,4,0,1,127,45,172
p_12,0,11,e_0,798,923,968,20,5,5,7,4,0,1,125,45,170
p_49,0,14,e_0,591,923,979,25,7,7,2,4,0,1,332,56,388
p_11,0,9,e_0,807,1023,1052,18,4,4,4,4,0,1,216,29,245
p_300,0,4,e_0,8,9,25,0,0,0,0,3,0,0,1,16,17
p_299,0,5,e_1,9,9,28,0,0,0,0,3,0,0,0,19,19
p_297,0,6,e_3,15,16,38,0,0,0,0,3,0,0,1,22,23
p_298,0,9,e_2,11,11,42,0,0,0,0,3,0,0,0,31,31
p_296,0,4,e_0,28,42,56,9,1,1,4,3,0,0,14,14,28
p_295,0,5,e_0,29,42,61,9,1,1,4,4,0,1,13,19,32
p_292,0,6,e_0,38,42,66,6,0,0,1,4,0,1,4,24,28
p_290,0,6,e_0,40,42,66,6,0,0,1,4,0,1,2,24,26
p_286,0,3,e_1,46,60,71,6,0,0,4,4,0,1,14,11,25
p_289,0,4,e_1,43,60,76,6,0,0,5,3,0,0,17,16,33
p_285,0,4,e_1,53,60,76,6,0,0,2,4,0,1,7,16,23
p_284,0,4,e_1,54,60,76,6,0,0,2,4,0,1,6,16,22
p_287,0,5,e_1,45,60,81,6,0,0,5,4,0,1,15,21,36
p_291,0,11,e_0,39,42,83,6,0,0,1,4,0,1,3,41,44
p_294,0,12,e_0,31,42,88,8,1,1,4,4,0,1,11,46,57
p_293,0,12,e_0,33,42,88,7,1,1,3,4,0,1,9,46,55
p_281,0,1,e_3,73,86,91,4,1,0,4,4,0,1,13,5,18
p_288,0,8,e_1,44,60,92,6,0,0,5,4,0,1,16,32,48
p_278,0,2,e_3,77,86,96,3,1,0,3,4,0,1,9,10,19
p_283,0,9,e_1,57,60,97,6,0,0,1,4,0,1,3,37,40
p_279,0,5,e_3,76,86,107,3,1,0,3,4,0,1,10,21,31
p_277,0,6,e_3,82,86,112,1,1,0,1,4,0,1,4,26,30
p_282,0,7,e_3,66,86,117,6,0,0,6,3,0,0,20,31,51
p_273,0,4,e_2,110,116,130,22,4,4,2,4,0,1,6,14,20
p_276,0,11,e_3,84,86,131,0,1,0,0,4,0,1,2,45,47
p_280,0,14,e_3,75,86,142,3,1,0,3,4,0,1,11,56,67
p_274,0,8,e_2,88,116,144,28,7,7,9,4,0,1,28,28,56
p_272,0,10,e_2,113,116,152,22,3,3,1,4,0,1,3,36,39
p_271,0,1,e_1,121,150,155,20,2,2,9,3,0,0,29,5,34
p_267,0,1,e_1,148,150,155,14,0,0,1,4,0,1,2,5,7
p_268,0,2,e_1,144,150,160,14,0,0,2,4,0,1,6,10,16
p_275,0,14,e_2,86,116,166,28,7,7,9,3,0,0,30,50,80
p_270,0,9,e_1,122,150,183,20,2,2,9,4,0,1,28,33,61
p_269,0,9,e_1,127,150,183,18,2,2,8,4,0,1,23,33,56
p_255,0,3,e_0,184,189,200,14,0,0,1,4,0,1,5,11,16
p_265,0,4,e_0,152,189,205,14,0,0,12,4,0,1,37,16,53
p_254,0,4,e_0,187,189,205,14,0,0,0,4,0,1,2,16,18
p_262,0,5,e_0,157,189,210,14,0,0,11,4,0,1,32,21,53
p_261,0,5,e_0,164,189,210,14,0,0,8,4,0,1,25,21,46
p_266,0,6,e_0,151,189,215,14,0,0,12,3,0,0,38,26,64
p_263,0,7,e_0,154,189,220,14,0,0,12,4,0,1,35,31,66
p_260,0,7,e_0,165,189,220,14,0,0,8,4,0,1,24,31,55
p_258,0,7,e_0,168,189,220,14,0,0,7,4,0,1,21,31,52
p_250,0,2,e_1,217,220,228,14,0,0,1,4,0,1,3,8,11
p_256,0,10,e_0,182,189,231,14,0,0,2,4,0,1,7,42,49
p_264,0,11,e_0,153,189,236,14,0,0,12,4,0,1,36,47,83
p_253,0,5,e_1,190,220,239,14,0,0,9,3,0,0,30,19,49
p_252,0,5,e_1,205,220,239,14,0,0,5,4,0,1,15,19,34
p_257,0,14,e_0,169,189,247,14,0,0,6,4,0,1,20,58,78
p_259,0,15,e_0,167,189,252,14,0,0,7,4,0,1,22,63,85
p_251,0,15,e_1,209,220,271,14,0,0,4,4,0,1,11,51,62
p_241,0,1,e_2,283,284,291,14,0,0,0,3,0,0,1,7,8
p_248,0,5,e_2,246,284,305,14,0,0,13,4,0,1,38,21,59
p_247,0,5,e_2,250,284,305,14,0,0,11,4,0,1,34,21,55
p_249,0,6,e_2,239,284,310,14,0,0,14,3,0,0,45,26,71
p_245,0,7,e_2,269,284,315,14,0,0,5,4,0,1,15,31,46
p_242,0,8,e_2,277,284,320,14,0,0,2,4,0,1,7,36,43
p_246,0,10,e_2,262,284,328,14,0,0,7,4,0,1,22,44,66
p_244,0,12,e_2,271,284,336,14,0,0,4,4,0,1,13,52,65
p_243,0,15,e_2,272,284,347,14,0,0,4,4,0,1,12,63,75
p_236,0,1,e_3,305,345,350,13,1,0,13,4,0,1,40,5,45
p_233,0,1,e_3,311,345,350,11,1,0,11,4,0,1,34,5,39
p_226,0,2,e_3,329,345,355,5,1,0,5,4,0,1,16,10,26
p_230,0,3,e_3,319,345,360,8,1,0,8,4,0,1,26,15,41
p_228,0,4,e_3,325,345,365,6,1,0,6,4,0,1,20,20,40
p_232,0,5,e_3,314,345,370,10,1,0,10,4,0,1,31,25,56
p_237,0,7,e_3,304,345,378,13,1,0,13,4,0,1,41,33,74
p_231,0,7,e_3,317,345,378,9,1,0,9,4,0,1,28,33,61
p_235,0,8,e_3,308,345,383,12,1,0,12,4,0,1,37,38,75
p_234,0,8,e_3,310,345,383,12,1,0,12,4,0,1,35,38,73
p_240,0,9,e_3,301,345,388,14,0,0,14,3,0,0,44,43,87
p_239,0,11,e_3,302,345,396,14,1,0,14,4,0,1,43,51,94
p_216,0,1,e_1,347,394,399,26,11,11,15,3,0,0,47,5,52
p_209,0,2,e_0,357,393,401,24,10,10,12,4,0,1,36,8,44
p_205,0,2,e_0,362,393,401,23,9,9,10,4,0,1,31,8,39
p_227,0,12,e_3,327,345,401,6,1,0,6,4,0,1,18,56,74
p_238,0,13,e_3,303,345,406,14,1,0,14,4,0,1,42,61,103
p_229,0,13,e_3,320,345,406,8,1,0,8,4,0,1,25,61,86
p_214,0,3,e_0,349,393,406,25,12,12,15,4,0,1,44,13,57
p_183,0,1,e_1,396,404,409,15,3,3,0,5,1,0,8,5,13
p_200,0,4,e_0,367,393,411,22,8,8,9,4,0,1,26,18,44
p_182,0,2,e_1,397,404,414,15,3,3,1,5,1,1,7,10,17
p_180,0,2,e_1,399,404,414,14,3,3,1,4,0,1,5,10,15
p_201,0,5,e_0,366,393,416,22,8,8,9,4,0,1,27,23,50
p_178,0,3,e_1,401,404,419,14,2,2,1,4,0,1,3,15,18
p_210,0,6,e_0,354,393,421,24,10,10,13,4,0,1,39,28,67
p_208,0,6,e_0,358,393,421,24,10,10,12,4,0,1,35,28,63
p_176,0,4,e_1,403,404,424,14,2,2,0,4,0,1,1,20,21
p_217,0,7,e_0,346,393,426,26,11,11,15,3,0,0,47,33,80
p_212,0,7,e_0,351,393,426,25,11,11,14,4,0,1,42,33,75
p_179,0,8,e_1,400,404,438,14,3,3,1,4,0,1,4,34,38
p_207,0,11,e_0,359,393,440,23,10,10,11,4,0,1,34,47,81
p_215,0,15,e_2,348,395,442,26,11,11,15,3,0,0,47,47,94
p_177,0,9,e_1,402,404,443,14,2,2,0,4,0,1,2,39,41
p_206,0,12,e_0,361,393,445,23,9,9,10,4,0,1,32,52,84
p_204,0,14,e_0,363,393,453,22,9,9,10,4,0,1,30,60,90
p_223,0,2,e_3,336,447,455,3,1,0,3,4,0,1,111,8,119
p_213,0,15,e_0,350,393,458,25,11,11,14,4,0,1,43,65,108
p_211,0,15,e_0,353,393,458,25,11,11,13,4,0,1,40,65,105
p_199,0,15,e_0,368,393,458,22,8,8,8,4,0,1,25,65,90
p_181,0,15,e_1,398,404,463,15,3,3,1,2,1,1,6,59,65
p_225,0,5,e_3,330,447,466,5,1,0,5,4,0,1,117,19,136
p_224,0,5,e_3,331,447,466,4,1,0,4,4,0,1,116,19,135
p_222,0,5,e_3,337,447,466,2,1,0,2,4,0,1,110,19,129
p_219,0,5,e_3,342,447,466,1,1,0,1,4,0,1,105,19,124
p_221,0,6,e_3,339,447,471,2,1,0,2,4,0,1,108,24,132
p_220,0,6,e_3,341,447,471,1,1,0,1,4,0,1,106,24,130
p_218,0,11,e_3,343,447,488,1,1,0,1,4,0,1,104,41,145
p_173,0,11,e_3,407,447,488,13,1,0,13,4,0,1,40,41,81
p_203,0,12,e_3,364,447,493,4,8,8,4,3,8,1,83,46,129
p_171,0,13,e_3,409,447,498,13,1,0,13,4,0,1,38,51,89
p_146,0,1,e_2,453,497,502,29,9,9,14,4,0,1,44,5,49
p_175,0,14,e_3,405,447,503,13,2,2,13,5,1,1,42,56,98
p_174,0,14,e_3,406,447,503,13,1,0,13,4,0,1,41,56,97
p_202,0,15,e_3,365,447,508,4,8,8,4,3,8,1,82,61,143
p_172,0,15,e_3,408,447,508,13,1,0,13,4,0,1,39,61,100
p_143,0,3,e_2,456,497,510,28,8,8,13,4,0,1,41,13,54
p_136,0,3,e_2,465,497,510,25,7,7,11,4,0,1,32,13,45
p_190,0,1,e_0,379,505,510,19,6,6,4,4,0,1,126,5,131
p_137,0,4,e_2,464,497,515,26,8,8,11,4,0,1,33,18,51
p_196,0,4,e_0,371,505,521,21,7,7,7,4,0,1,134,16,150
p_186,0,4,e_0,390,505,521,17,4,4,1,4,0,1,115,16,131
p_141,0,6,e_2,458,497,523,27,8,8,13,4,0,1,39,26,65
p_194,0,6,e_0,373,505,529,20,7,7,7,4,0,1,132,24,156
p_148,0,8,e_2,449,497,531,30,8,8,15,3,0,0,48,34,82
p_140,0,8,e_2,459,497,531,27,8,8,12,4,0,1,38,34,72
p_147,0,9,e_2,452,497,536,29,9,9,15,4,0,1,45,39,84
p_144,0,9,e_2,455,497,536,28,8,8,14,4,0,1,42,39,81
p_142,0,9,e_2,457,497,536,28,8,8,13,4,0,1,40,39,79
p_192,0,8,e_0,375,505,537,20,7,7,6,4,0,1,130,32,162
p_189,0,8,e_0,382,505,537,18,6,6,4,4,0,1,123,32,155
p_139,0,10,e_2,461,497,541,27,8,8,12,4,0,1,36,44,80
p_135,0,10,e_2,466,497,541,25,7,7,10,4,0,1,31,44,75
p_198,0,9,e_0,369,505,542,21,7,7,8,4,0,1,136,37,173
p_145,0,11,e_2,454,497,546,28,8,8,14,4,0,1,43,49,92
p_138,0,11,e_2,463,497,546,26,8,8,11,4,0,1,34,49,83
p_197,0,10,e_0,370,505,547,21,7,7,8,4,0,1,135,42,177
p_191,0,10,e_0,376,505,547,20,7,7,6,4,0,1,129,42,171
p_185,0,10,e_0,391,505,547,17,4,4,1,4,0,1,114,42,156
p_193,0,11,e_0,374,505,552,20,7,7,6,4,0,1,131,47,178
p_187,0,12,e_0,389,505,557,17,4,4,1,4,0,1,116,52,168
p_184,0,12,e_0,392,505,557,16,4,4,0,4,0,1,113,52,165
p_167,0,1,e_3,413,555,560,11,1,0,11,4,0,1,142,5,147
p_161,0,1,e_3,421,555,560,8,1,0,8,4,0,1,134,5,139
p_158,0,1,e_3,430,555,560,6,1,0,6,4,0,1,125,5,130
p_134,0,15,e_2,467,497,560,25,7,7,10,4,0,1,30,63,93
p_188,0,13,e_0,384,505,562,18,5,5,3,4,0,1,121,57,178
p_86,0,2,e_1,544,556,564,4,1,0,4,4,0,1,12,8,20
p_195,0,15,e_0,372,505,570,21,7,7,7,4,0,1,133,65,198
p_165,0,4,e_3,417,555,571,10,1,0,10,4,0,1,138,16,154
p_92,0,4,e_1,525,556,572,10,1,0,10,4,0,1,31,16,47
p_88,0,5,e_1,538,556,577,6,1,0,6,4,0,1,18,21,39
p_159,0,6,e_3,429,555,579,6,1,0,6,4,0,1,126,24,150
p_94,0,6,e_1,519,556,582,12,1,0,12,4,0,1,37,26,63
p_102,0,7,e_1,509,556,587,15,1,0,15,4,0,1,47,31,78
p_97,0,7,e_1,516,556,587,13,1,0,13,4,0,1,40,31,71
p_80,0,7,e_1,552,556,587,1,1,0,1,4,0,1,4,31,35
p_169,0,9,e_3,411,555,590,12,1,0,12,4,0,1,144,35,179
p_87,0,8,e_1,539,556,592,5,1,0,5,4,0,1,17,36,53
p_83,0,8,e_1,549,556,592,2,1,0,2,4,0,1,7,36,43
p_163,0,10,e_3,419,555,595,9,1,0,9,4,0,1,136,40,176
p_100,0,9,e_1,513,556,597,14,1,0,14,4,0,1,43,41,84
p_164,0,11,e_3,418,555,600,10,1,0,10,4,0,1,137,45,182
p_162,0,11,e_3,420,555,600,9,1,0,9,4,0,1,135,45,180
p_103,0,11,e_1,508,556,605,15,1,1,15,3,0,0,48,49,97
p_166,0,12,e_3,416,555,605,10,1,0,10,4,0,1,139,50,189
p_84,0,12,e_1,546,556,610,3,1,0,3,4,0,1,10,54,64
p_168,0,13,e_3,412,555,610,11,1,0,11,4,0,1,143,55,198
p_130,0,1,e_2,472,607,614,24,6,6,8,4,0,1,135,7,142
p_119,0,1,e_2,483,607,614,21,6,6,5,4,0,1,124,7,131
p_170,0,14,e_3,410,555,615,12,1,0,12,4,0,1,145,60,205
p_157,0,14,e_3,431,555,615,5,1,0,5,4,0,1,124,60,184
p_95,0,14,e_1,518,556,618,12,1,0,12,4,0,1,38,62,100
p_160,0,15,e_3,426,555,620,7,1,0,7,4,0,1,129,65,194
p_156,0,15,e_3,434,555,620,4,1,0,4,4,0,1,121,65,186
p_129,0,3,e_2,473,607,622,24,6,6,8,4,0,1,134,15,149
p_106,0,3,e_0,500,617,628,17,3,3,1,4,0,1,117,11,128
p_124,0,7,e_2,478,607,636,22,6,6,6,4,0,1,129,29,158
p_127,0,10,e_2,475,607,647,23,6,6,7,4,0,1,132,40,172
p_37,0,9,e_0,615,617,648,16,2,2,1,4,0,1,2,31,33
p_132,0,11,e_2,470,607,652,24,6,6,9,4,0,1,137,45,182
p_128,0,11,e_2,474,607,652,24,6,6,8,4,0,1,133,45,178
p_123,0,11,e_2,479,607,652,22,6,6,6,4,0,1,128,45,173
p_121,0,11,e_2,481,607,652,21,6,6,5,4,0,1,126,45,171
p_120,0,11,e_2,482,607,652,21,6,6,5,4,0,1,125,45,170
p_107,0,11,e_0,499,617,656,17,3,3,2,4,0,1,118,39,157
p_133,0,12,e_2,469,607,657,25,7,7,9,4,0,1,138,50,188
p_126,0,12,e_2,476,607,657,23,6,6,7,4,0,1,131,50,181
p_105,0,12,e_0,502,617,661,16,2,2,1,4,0,1,115,44,159
p_131,0,14,e_2,471,607,665,24,6,6,8,4,0,1,136,58,194
p_125,0,14,e_2,477,607,665,23,6,6,7,4,0,1,130,58,188
p_93,0,13,e_0,520,617,666,11,1,0,4,3,9,1,97,49,146
p_38,0,13,e_0,608,617,666,18,4,4,3,4,0,1,9,49,58
p_122,0,15,e_2,480,607,670,21,6,6,5,4,0,1,127,63,190
p_104,0,14,e_0,503,617,671,16,2,2,1,4,0,1,114,54,168
p_96,0,1,e_3,517,667,672,12,1,0,12,4,0,1,150,5,155
p_150,0,6,e_3,443,667,689,1,1,0,1,4,0,1,224,22,246
p_154,0,7,e_3,436,667,694,3,1,0,3,4,0,1,231,27,258
p_101,0,8,e_3,511,667,699,14,1,0,14,4,0,1,156,32,188
p_153,0,9,e_3,437,667,704,3,1,0,3,4,0,1,230,37,267
p_89,0,9,e_3,535,667,704,6,1,0,6,4,0,1,132,37,169
p_91,0,12,e_3,526,667,715,9,1,0,9,4,0,1,141,48,189
p_90,0,13,e_3,527,667,720,9,1,0,9,4,0,1,140,53,193
p_24,0,2,e_1,695,713,721,23,7,7,6,4,0,1,18,8,26
p_113,0,1,e_2,489,717,722,19,5,5,2,4,0,1,228,5,233
p_155,0,14,e_3,435,667,725,4,1,0,4,4,0,1,232,58,290
p_82,0,14,e_3,550,667,725,1,1,0,1,4,0,1,117,58,175
p_81,0,14,e_3,551,667,725,1,1,0,1,4,0,1,116,58,174
p_30,0,3,e_1,668,713,726,30,9,9,14,3,0,0,45,13,58
p_152,0,15,e_3,441,667,730,2,1,0,2,4,0,1,226,63,289
p_151,0,15,e_3,442,667,730,2,1,0,2,4,0,1,225,63,288
p_149,0,15,e_3,444,667,730,1,1,0,1,4,0,1,223,63,286
p_85,0,15,e_3,545,667,730,3,1,0,3,4,0,1,122,63,185
p_114,0,3,e_2,488,717,730,19,5,5,3,4,0,1,229,13,242
p_77,0,3,e_2,557,717,730,30,10,10,14,5,1,1,160,13,173
p_29,0,5,e_1,670,713,734,29,10,10,14,4,0,1,43,21,64
p_108,0,6,e_2,496,717,741,18,4,4,0,4,0,1,221,24,245
p_99,0,6,e_2,514,717,741,13,1,0,4,3,7,1,203,24,227
p_26,0,8,e_1,684,713,745,25,9,9,9,4,0,1,29,32,61
p_25,0,8,e_1,686,713,745,25,9,9,9,4,0,1,27,32,59
p_118,0,7,e_2,484,717,746,20,6,6,4,4,0,1,233,29,262
p_98,0,7,e_2,515,717,746,13,1,0,4,3,7,1,202,29,231
p_111,0,8,e_2,491,717,751,19,5,5,2,4,0,1,226,34,260
p_27,0,10,e_1,677,713,753,28,9,9,12,4,0,1,36,40,76
p_115,0,9,e_2,487,717,756,19,6,6,3,4,0,1,230,39,269
p_28,0,11,e_1,676,713,758,28,9,9,12,4,0,1,37,45,82
p_117,0,10,e_2,485,717,761,20,6,6,4,4,0,1,232,44,276
p_116,0,10,e_2,486,717,761,20,6,6,3,4,0,1,231,44,275
p_23,0,12,e_1,711,713,763,19,5,5,0,4,0,1,2,50,52
p_112,0,11,e_2,490,717,766,19,5,5,2,4,0,1,227,49,276
p_110,0,11,e_2,492,717,766,18,5,5,2,4,0,1,225,49,274
p_78,0,12,e_2,556,717,771,30,10,10,14,5,1,1,161,54,215
p_22,0,3,e_0,719,763,774,17,3,3,14,3,0,0,44,11,55
p_21,0,4,e_0,731,763,779,15,1,0,11,4,0,1,32,16,48
p_109,0,15,e_2,493,717,782,18,4,4,1,4,0,1,224,65,289
p_32,0,6,e_3,650,777,797,6,1,0,6,4,0,1,127,20,147
p_31,0,6,e_3,666,777,797,0,1,0,0,4,0,1,111,20,131
p_19,0,11,e_0,754,763,802,8,1,0,3,4,0,1,9,39,48
p_35,0,9,e_3,630,777,808,12,1,0,12,4,0,1,147,31,178
p_20,0,14,e_0,734,763,813,14,1,0,10,4,0,1,29,50,79
p_18,0,10,e_3,766,777,813,4,1,0,4,4,0,1,11,36,47
p_17,0,10,e_3,776,777,813,0,1,0,0,4,0,1,1,36,37
p_34,0,12,e_3,646,777,821,7,1,0,7,4,0,1,131,44,175
p_16,0,2,e_1,780,818,826,29,7,7,12,3,0,0,38,8,46
p_36,0,13,e_3,628,777,826,13,1,0,13,4,0,1,149,49,198
p_79,0,14,e_3,553,777,831,0,1,0,0,4,0,1,224,54,278
p_65,0,1,e_2,573,829,834,26,9,9,11,4,0,1,256,5,261
p_14,0,4,e_1,794,818,834,25,7,7,8,4,0,1,24,16,40
p_33,0,15,e_3,649,777,836,6,1,0,6,4,0,1,128,59,187
p_72,0,3,e_2,562,829,842,29,10,10,15,4,0,1,267,13,280
p_71,0,3,e_2,564,829,842,28,10,10,14,4,0,1,265,13,278
p_70,0,3,e_2,565,829,842,28,10,10,14,4,0,1,264,13,277
p_67,0,3,e_2,568,829,842,27,10,10,13,4,0,1,261,13,274
p_66,0,3,e_2,569,829,842,26,10,10,12,4,0,1,260,13,273
p_64,0,4,e_2,574,829,847,26,9,9,11,4,0,1,255,18,273
p_15,0,9,e_1,793,818,851,25,7,7,8,4,0,1,25,33,58
p_11,0,9,e_1,807,818,851,21,6,6,4,4,0,1,11,33,44
p_75,0,5,e_2,559,829,852,29,10,10,15,2,1,1,270,23,293
p_76,0,6,e_2,558,829,857,29,11,11,15,5,1,1,271,28,299
p_13,0,11,e_1,796,818,859,24,7,7,7,4,0,1,22,41,63
p_12,0,11,e_1,798,818,859,24,6,6,7,4,0,1,20,41,61
p_74,0,7,e_2,560,829,862,29,10,10,15,4,0,1,269,33,302
p_73,0,11,e_2,561,829,876,29,10,10,15,4,0,1,268,47,315
p_68,0,13,e_2,567,829,884,27,10,10,13,4,0,1,262,55,317
p_63,0,13,e_2,577,829,884,24,9,9,10,4,0,1,252,55,307
p_62,0,13,e_2,578,829,884,24,9,9,9,4,0,1,251,55,306
p_9,0,2,e_0,846,879,887,15,0,0,11,4,0,1,33,8,41
p_69,0,14,e_2,566,829,889,27,10,10,13,4,0,1,263,60,323
p_6,0,3,e_0,877,879,892,15,0,0,0,4,0,1,2,13,15
p_7,0,5,e_0,875,879,900,15,0,0,1,4,0,1,4,21,25
p_10,0,8,e_0,835,879,911,15,0,0,14,3,0,0,44,32,76
p_8,0,11,e_0,874,879,922,15,0,0,1,4,0,1,5,43,48
p_4,0,1,e_1,886,919,924,15,0,0,11,4,0,1,33,5,38
p_1,0,5,e_1,894,919,938,15,0,0,8,4,0,1,25,19,44
p_55,0,3,e_2,585,933,944,22,8,8,7,4,0,1,348,11,359
p_54,0,3,e_2,586,933,944,22,8,8,7,4,0,1,347,11,358
p_52,0,3,e_2,588,933,944,21,8,8,6,4,0,1,345,11,356
p_48,0,4,e_2,592,933,949,21,7,7,5,4,0,1,341,16,357
p_5,0,8,e_1,883,919,949,15,0,0,11,3,0,0,36,30,66
p_3,0,8,e_1,888,919,949,15,0,0,10,4,0,1,31,30,61
p_61,0,6,e_2,579,933,957,24,8,8,9,4,0,1,354,24,378
p_56,0,6,e_2,584,933,957,23,8,8,8,4,0,1,349,24,373
p_2,0,11,e_1,892,919,960,15,0,0,9,4,0,1,27,41,68
p_50,0,7,e_2,590,933,962,21,7,7,6,4,0,1,343,29,372
p_53,0,9,e_2,587,933,970,22,8,8,6,4,0,1,346,37,383
p_51,0,9,e_2,589,933,970,21,7,7,6,4,0,1,344,37,381
p_47,0,9,e_2,593,933,970,21,7,7,5,4,0,1,340,37,377
p_60,0,10,e_2,580,933,975,24,8,8,9,4,0,1,353,42,395
p_58,0,11,e_2,582,933,980,23,8,8,8,4,0,1,351,47,398
p_57,0,11,e_2,583,933,980,23,8,8,8,4,0,1,350,47,397
p_59,0,14,e_2,581,933,991,24,8,8,9,4,0,1,352,58,410
p_49,0,14,e_2,591,933,991,21,7,7,5,4,0,1,342,58,400
p_45,0,2,e_2,595,1035,1043,20,6,6,4,4,0,1,440,8,448
p_46,0,4,e_2,594,1035,1051,20,6,6,4,4,0,1,441,16,457
p_42,0,6,e_2,598,1035,1059,20,6,6,3,4,0,1,437,24,461
p_43,0,7,e_2,597,1035,1064,20,6,6,3,4,0,1,438,29,467
p_44,0,8,e_2,596,1035,1069,20,6,6,4,4,0,1,439,34,473
p_41,0,11,e_2,600,1035,1080,19,5,5,2,4,0,1,435,45,480
p_39,0,12,e_2,607,1035,1085,18,4,4,0,3,0,0,428,50,478
p_40,0,13,e_2,602,1035,1090,19,5,5,2,4,0,1,433,55,488
p_300,0,4,e_0,8,8,24,0,0,0,0,3,0,0,0,16,16
p_299,0,5,e_1,9,10,29,0,0,0,0,3,0,0,1,19,20
p_297,0,6,e_3,15,16,38,0,0,0,0,3,0,0,1,22,23
p_298,0,9,e_2,11,12,43,0,0,0,0,3,0,0,1,31,32
p_296,0,4,e_0,28,43,57,9,1,1,4,3,0,0,15,14,29
p_295,0,5,e_0,29,43,62,9,1,1,4,4,0,1,14,19,33
p_292,0,6,e_0,38,43,67,6,0,0,2,4,0,1,5,24,29
p_290,0,6,e_0,40,43,67,6,0,0,1,4,0,1,3,24,27
p_286,0,3,e_1,46,61,72,6,0,0,5,4,0,1,15,11,26
p_289,0,4,e_1,43,61,77,6,0,0,5,3,0,0,18,16,34
p_285,0,4,e_1,53,61,77,6,0,0,3,4,0,1,8,16,24
p_284,0,4,e_1,54,61,77,6,0,0,2,4,0,1,7,16,23
p_287,0,5,e_1,45,61,82,6,0,0,5,4,0,1,16,21,37
p_291,0,11,e_0,39,43,84,6,0,0,1,4,0,1,4,41,45
p_294,0,12,e_0,31,43,89,8,1,1,4,4,0,1,12,46,58
p_293,0,12,e_0,33,43,89,8,1,1,3,4,0,1,10,46,56
p_281,0,1,e_3,73,87,92,5,1,0,5,4,0,1,14,5,19
p_288,0,8,e_1,44,61,93,6,0,0,5,4,0,1,17,32,49
p_278,0,2,e_3,77,87,97,3,1,0,3,4,0,1,10,10,20
p_283,0,9,e_1,57,61,98,6,0,0,1,4,0,1,4,37,41
p_279,0,5,e_3,76,87,108,3,1,0,3,4,0,1,11,21,32
p_277,0,6,e_3,82,87,113,2,1,0,2,4,0,1,5,26,31
p_282,0,7,e_3,66,87,118,6,0,0,6,3,0,0,21,31,52
p_273,0,4,e_2,110,117,131,23,4,4,2,4,0,1,7,14,21
p_276,0,11,e_3,84,87,132,1,1,0,1,4,0,1,3,45,48
p_280,0,14,e_3,75,87,143,4,1,0,4,4,0,1,12,56,68
p_275,0,14,e_3,86,87,143,0,1,0,0,4,0,1,1,56,57
p_274,0,8,e_2,88,117,145,28,7,7,9,3,0,0,29,28,57
p_272,0,10,e_2,113,117,153,22,3,3,1,4,0,1,4,36,40
p_271,0,1,e_1,121,151,158,20,2,2,9,3,0,0,30,7,37
p_267,0,1,e_1,148,151,158,14,0,0,1,4,0,1,3,7,10
p_268,0,2,e_1,144,151,163,14,0,0,2,4,0,1,7,12,19
p_266,0,6,e_1,151,151,177,14,0,0,0,3,0,0,0,26,26
p_270,0,9,e_1,122,151,188,20,2,2,9,4,0,1,29,37,66
p_269,0,9,e_1,127,151,188,18,2,2,8,4,0,1,24,37,61
p_255,0,3,e_2,184,185,198,14,0,0,0,3,0,0,1,13,14
p_265,0,4,e_2,152,185,203,14,0,0,10,2,1,0,33,18,51
p_262,0,5,e_2,157,185,208,14,0,0,9,4,0,1,28,23,51
p_261,0,5,e_2,164,185,208,14,0,0,7,4,0,1,21,23,44
p_263,0,7,e_2,154,185,216,14,0,0,10,4,0,1,31,31,62
p_260,0,7,e_2,165,185,216,14,0,0,6,4,0,1,20,31,51
p_258,0,7,e_2,168,185,216,14,0,0,6,4,0,1,17,31,48
p_256,0,10,e_2,182,185,227,14,0,0,1,4,0,1,3,42,45
p_254,0,4,e_1,187,217,231,14,0,0,9,2,1,0,30,14,44
p_264,0,11,e_2,153,185,232,14,0,0,10,4,0,1,32,47,79
p_253,0,5,e_1,190,217,236,14,0,0,9,4,0,1,27,19,46
p_252,0,5,e_1,205,217,236,14,0,0,4,4,0,1,12,19,31
p_257,0,14,e_2,169,185,243,14,0,0,5,4,0,1,16,58,74
p_259,0,15,e_2,167,185,248,14,0,0,6,4,0,1,18,63,81
p_250,0,2,e_0,217,255,263,14,0,0,12,3,0,0,38,8,46
p_251,0,15,e_1,209,217,268,14,0,0,3,4,0,1,8,51,59
p_248,0,5,e_0,246,255,274,14,0,0,3,4,0,1,9,19,28
p_247,0,5,e_0,250,255,274,14,0,0,1,4,0,1,5,19,24
p_249,0,6,e_0,239,255,279,14,0,0,5,4,0,1,16,24,40
p_241,0,1,e_0,283,299,304,14,0,0,5,4,0,1,16,5,21
p_245,0,7,e_0,269,299,324,14,0,0,3,5,2,1,30,25,55
p_242,0,8,e_0,277,299,329,14,0,0,6,5,1,1,22,30,52
p_246,0,10,e_0,262,299,337,14,0,0,2,2,3,0,37,38,75
p_244,0,12,e_0,271,299,345,14,0,0,4,5,2,1,28,46,74
p_236,0,1,e_3,305,345,350,13,1,0,13,4,0,1,40,5,45
p_233,0,1,e_3,311,345,350,11,1,0,11,4,0,1,34,5,39
p_226,0,2,e_3,329,345,355,5,1,0,5,4,0,1,16,10,26
p_243,0,15,e_0,272,299,356,14,0,0,5,5,2,1,27,57,84
p_230,0,3,e_3,319,345,360,8,1,0,8,4,0,1,26,15,41
p_228,0,4,e_3,325,345,365,7,1,0,7,4,0,1,20,20,40
p_232,0,5,e_3,314,345,370,10,1,0,10,4,0,1,31,25,56
p_237,0,7,e_3,304,345,378,13,1,0,13,4,0,1,41,33,74
p_231,0,7,e_3,317,345,378,9,1,0,9,4,0,1,28,33,61
p_235,0,8,e_3,308,345,383,12,1,0,12,4,0,1,37,38,75
p_234,0,8,e_3,310,345,383,12,1,0,12,4,0,1,35,38,73
p_240,0,9,e_3,301,345,388,14,0,0,14,3,0,0,44,43,87
p_239,0,11,e_3,302,345,396,14,1,0,14,4,0,1,43,51,94
p_227,0,12,e_3,327,345,401,6,1,0,6,4,0,1,18,56,74
p_209,0,2,e_1,357,393,403,24,10,10,12,4,0,1,36,10,46
p_205,0,2,e_1,362,393,403,23,9,9,10,4,0,1,31,10,41
p_238,0,13,e_3,303,345,406,14,1,0,14,4,0,1,42,61,103
p_229,0,13,e_3,320,345,406,8,1,0,8,4,0,1,25,61,86
p_216,0,1,e_2,347,395,406,26,11,11,15,3,0,0,48,11,59
p_183,0,1,e_2,396,397,406,15,3,3,0,5,1,0,1,9,10
p_214,0,3,e_1,349,393,408,25,11,11,14,4,0,1,44,15,59
p_182,0,2,e_2,397,397,411,15,3,3,0,2,1,0,0,14,14
p_180,0,2,e_2,399,399,411,15,3,3,0,2,2,0,0,12,12
p_210,0,6,e_1,354,393,419,24,11,11,13,4,0,1,39,26,65
p_208,0,6,e_1,358,393,419,24,10,10,11,4,0,1,35,26,61
p_217,0,7,e_1,346,393,424,26,11,11,15,3,0,0,47,31,78
p_212,0,7,e_1,351,393,424,25,11,11,14,4,0,1,42,31,73
p_207,0,11,e_1,359,393,438,23,9,9,11,4,0,1,34,45,79
p_206,0,12,e_1,361,393,443,23,9,9,11,4,0,1,32,50,82
p_203,0,12,e_1,364,393,443,4,8,8,10,4,0,1,29,50,79
p_204,0,14,e_1,363,393,451,23,9,9,10,4,0,1,30,58,88
p_167,0,1,e_3,413,447,452,11,1,0,11,4,0,1,34,5,39
p_181,0,15,e_2,398,399,452,15,3,3,0,5,2,1,1,53,54
p_215,0,15,e_1,348,393,456,25,12,12,15,4,0,1,45,63,108
p_213,0,15,e_1,350,393,456,25,11,11,14,4,0,1,43,63,106
p_211,0,15,e_1,353,393,456,25,11,11,13,4,0,1,40,63,103
p_202,0,15,e_1,365,393,456,4,8,8,9,4,0,1,28,63,91
p_223,0,2,e_3,336,447,457,3,1,0,3,4,0,1,111,10,121
p_178,0,3,e_0,401,448,459,14,2,2,15,4,0,1,47,11,58
p_176,0,4,e_0,403,448,464,14,2,2,15,4,0,1,45,16,61
p_165,0,4,e_0,417,448,464,10,1,0,10,4,0,1,31,16,47
p_225,0,5,e_3,330,447,468,5,1,0,5,4,0,1,117,21,138
p_224,0,5,e_3,331,447,468,4,1,0,4,4,0,1,116,21,137
p_222,0,5,e_3,337,447,468,2,1,0,2,4,0,1,110,21,131
p_219,0,5,e_3,342,447,468,1,1,0,1,4,0,1,105,21,126
p_159,0,6,e_0,429,448,472,6,1,0,6,4,0,1,19,24,43
p_221,0,6,e_3,339,447,473,2,1,0,2,4,0,1,108,26,134
p_220,0,6,e_3,341,447,473,1,1,0,1,4,0,1,106,26,132
p_179,0,8,e_0,400,448,480,14,2,2,15,3,0,0,48,32,80
p_177,0,9,e_0,402,448,485,14,2,2,15,4,0,1,46,37,83
p_169,0,9,e_0,411,448,485,12,1,0,12,4,0,1,37,37,74
p_163,0,10,e_3,419,447,487,9,1,0,9,4,0,1,28,40,68
p_218,0,11,e_3,343,447,492,1,1,0,1,4,0,1,104,45,149
p_164,0,11,e_3,418,447,492,9,1,0,9,4,0,1,29,45,74
p_173,0,11,e_0,407,448,493,13,1,0,13,4,0,1,41,45,86
p_162,0,11,e_0,420,448,493,9,1,0,9,4,0,1,28,45,73
p_166,0,12,e_0,416,448,498,10,1,0,10,4,0,1,32,50,82
p_171,0,13,e_3,409,447,500,12,1,0,12,4,0,1,38,53,91
p_168,0,13,e_3,412,447,500,11,1,0,11,4,0,1,35,53,88
p_146,0,1,e_2,453,499,504,27,8,8,15,4,0,1,46,5,51
p_174,0,14,e_3,406,447,505,13,1,0,13,4,0,1,41,58,99
p_170,0,14,e_3,410,447,505,12,1,0,12,4,0,1,37,58,95
p_175,0,14,e_0,405,448,506,13,2,2,14,4,0,1,43,58,101
p_157,0,14,e_0,431,448,506,5,1,0,5,4,0,1,17,58,75
p_155,0,14,e_0,435,448,506,4,1,0,4,4,0,1,13,58,71
p_190,0,1,e_1,379,503,510,19,6,6,5,4,0,1,124,7,131
p_172,0,15,e_0,408,448,511,13,1,0,13,4,0,1,40,63,103
p_160,0,15,e_0,426,448,511,7,1,0,7,4,0,1,22,63,85
p_143,0,3,e_2,456,499,512,26,8,8,14,4,0,1,43,13,56
p_136,0,3,e_2,465,499,512,24,7,7,11,4,0,1,34,13,47
p_137,0,4,e_2,464,499,517,24,7,7,11,4,0,1,35,18,53
p_200,0,4,e_1,367,503,521,22,8,8,8,4,0,1,136,18,154
p_196,0,4,e_1,371,503,521,21,7,7,7,4,0,1,132,18,150
p_141,0,6,e_2,458,499,525,26,7,7,13,4,0,1,41,26,67
p_201,0,5,e_1,366,503,526,22,8,8,9,4,0,1,137,23,160
p_194,0,6,e_1,373,503,531,21,7,7,7,4,0,1,130,28,158
p_148,0,8,e_2,449,499,533,28,8,8,14,5,1,0,50,34,84
p_140,0,8,e_2,459,499,533,26,7,7,13,4,0,1,40,34,74
p_147,0,9,e_2,452,499,538,27,8,8,15,2,1,1,47,39,86
p_144,0,9,e_2,455,499,538,27,8,8,14,4,0,1,44,39,83
p_142,0,9,e_2,457,499,538,26,7,7,14,4,0,1,42,39,81
p_192,0,8,e_1,375,503,539,20,7,7,6,4,0,1,128,36,164
p_189,0,8,e_1,382,503,539,18,5,5,3,4,0,1,121,36,157
p_139,0,10,e_2,461,499,543,25,7,7,13,4,0,1,38,44,82
p_135,0,10,e_2,466,499,543,23,7,7,11,4,0,1,33,44,77
p_198,0,9,e_1,369,503,544,21,7,7,8,4,0,1,134,41,175
p_145,0,11,e_2,454,499,548,27,8,8,15,4,0,1,45,49,94
p_138,0,11,e_2,463,499,548,25,7,7,12,4,0,1,36,49,85
p_197,0,10,e_1,370,503,549,21,7,7,7,4,0,1,133,46,179
p_191,0,10,e_1,376,503,549,19,7,7,5,4,0,1,127,46,173
p_193,0,11,e_1,374,503,554,20,7,7,6,4,0,1,129,51,180
p_161,0,1,e_3,421,549,556,8,1,0,8,4,0,1,128,7,135
p_158,0,1,e_3,430,549,556,5,1,0,5,4,0,1,119,7,126
p_96,0,1,e_3,517,549,556,11,1,0,11,4,0,1,32,7,39
p_187,0,12,e_1,389,503,559,17,4,4,1,4,0,1,114,56,170
p_134,0,15,e_2,467,499,562,23,6,6,10,4,0,1,32,63,95
p_188,0,13,e_1,384,503,564,18,5,5,3,4,0,1,119,61,180
p_77,0,3,e_0,557,558,571,29,8,8,0,4,0,1,1,13,14
p_199,0,15,e_1,368,503,572,22,8,8,8,4,0,1,135,69,204
p_195,0,15,e_1,372,503,572,21,7,7,7,4,0,1,131,69,200
p_150,0,6,e_3,443,549,573,1,1,0,1,4,0,1,106,24,130
p_99,0,6,e_3,514,549,573,11,1,0,11,4,0,1,35,24,59
p_154,0,7,e_3,436,549,578,3,1,0,3,4,0,1,113,29,142
p_102,0,7,e_3,509,549,578,13,1,0,13,4,0,1,40,29,69
p_98,0,7,e_3,515,549,578,11,1,0,11,4,0,1,34,29,63
p_97,0,7,e_3,516,549,578,11,1,0,11,4,0,1,33,29,62
p_76,0,6,e_0,558,558,582,29,8,8,0,3,0,0,0,24,24
p_101,0,8,e_3,511,549,583,13,1,0,13,4,0,1,38,34,72
p_80,0,7,e_0,552,558,587,30,8,8,2,4,0,1,6,29,35
p_100,0,9,e_3,513,549,588,12,1,0,12,4,0,1,36,39,75
p_153,0,9,e_0,437,558,595,3,1,0,3,4,0,1,121,37,158
p_103,0,11,e_3,508,549,596,13,1,0,13,4,0,1,41,47,88
p_78,0,12,e_0,556,558,606,29,8,8,1,4,0,1,2,48,50
p_95,0,14,e_3,518,549,607,10,1,0,10,4,0,1,31,58,89
p_156,0,15,e_3,434,549,612,4,1,0,4,4,0,1,115,63,178
p_151,0,15,e_3,442,549,612,1,1,0,1,4,0,1,107,63,170
p_82,0,14,e_0,550,558,614,30,8,8,3,4,0,1,8,56,64
p_81,0,14,e_0,551,558,614,30,8,8,2,4,0,1,7,56,63
p_79,0,14,e_0,553,558,614,30,8,8,2,4,0,1,5,56,61
p_130,0,1,e_2,472,609,614,22,5,5,9,4,0,1,137,5,142
p_119,0,1,e_2,483,609,614,19,5,5,5,4,0,1,126,5,131
p_152,0,15,e_0,441,558,619,2,1,0,2,4,0,1,117,61,178
p_149,0,15,e_0,444,558,619,1,1,0,1,4,0,1,114,61,175
p_129,0,3,e_2,473,609,622,22,5,5,8,4,0,1,136,13,149
p_106,0,3,e_1,500,619,630,15,2,2,1,4,0,1,119,11,130
p_186,0,4,e_1,390,619,635,17,4,4,1,4,0,1,229,16,245
p_124,0,7,e_2,478,609,636,21,5,5,7,4,0,1,131,27,158
p_127,0,10,e_2,475,609,647,22,5,5,8,4,0,1,134,38,172
p_132,0,11,e_2,470,609,652,23,6,6,10,4,0,1,139,43,182
p_128,0,11,e_2,474,609,652,22,5,5,8,4,0,1,135,43,178
p_123,0,11,e_2,479,609,652,21,5,5,7,4,0,1,130,43,173
p_121,0,11,e_2,481,609,652,20,5,5,6,4,0,1,128,43,171
p_120,0,11,e_2,482,609,652,20,5,5,6,4,0,1,127,43,170
p_37,0,9,e_1,615,619,652,15,1,0,1,4,0,1,4,33,37
p_185,0,10,e_1,391,619,657,17,4,4,1,4,0,1,228,38,266
p_133,0,12,e_2,469,609,657,23,6,6,10,4,0,1,140,48,188
p_126,0,12,e_2,476,609,657,21,5,5,7,4,0,1,133,48,181
p_107,0,11,e_1,499,619,662,15,3,3,1,4,0,1,120,43,163
p_131,0,14,e_2,471,609,665,22,6,6,9,4,0,1,138,56,194
p_125,0,14,e_2,477,609,665,21,5,5,7,4,0,1,132,56,188
p_86,0,2,e_3,544,659,667,2,1,0,2,4,0,1,115,8,123
p_184,0,12,e_1,392,619,667,16,4,4,0,3,0,0,227,48,275
p_105,0,12,e_1,502,619,667,15,2,2,0,4,0,1,117,48,165
p_122,0,15,e_2,480,609,670,20,5,5,6,4,0,1,129,61,190
p_92,0,4,e_3,525,659,675,8,1,0,8,4,0,1,134,16,150
p_104,0,14,e_1,503,619,675,14,2,2,0,3,0,0,116,56,172
p_88,0,5,e_3,538,659,680,4,1,0,4,4,0,1,121,21,142
p_94,0,6,e_3,519,659,685,10,1,0,10,4,0,1,140,26,166
p_87,0,8,e_3,539,659,693,3,1,0,3,4,0,1,120,34,154
p_83,0,8,e_3,549,659,693,0,0,0,0,3,0,0,110,34,144
p_89,0,9,e_3,535,659,698,5,1,0,5,4,0,1,124,39,163
p_35,0,9,e_3,630,659,698,10,1,0,10,4,0,1,29,39,68
p_91,0,12,e_3,526,659,709,7,1,0,7,4,0,1,133,50,183
p_84,0,12,e_3,546,659,709,1,1,0,1,4,0,1,113,50,163
p_34,0,12,e_3,646,659,709,4,1,0,4,4,0,1,13,50,63
p_93,0,13,e_3,520,659,714,9,1,0,9,4,0,1,139,55,194
p_90,0,13,e_3,527,659,714,7,1,0,7,4,0,1,132,55,187
p_36,0,13,e_3,628,659,714,10,1,0,10,4,0,1,31,55,86
p_24,0,2,e_0,695,713,721,22,5,5,6,4,0,1,18,8,26
p_113,0,1,e_2,489,717,722,18,4,4,3,4,0,1,228,5,233
p_85,0,15,e_3,545,659,722,1,1,0,1,4,0,1,114,63,177
p_30,0,3,e_0,668,713,726,28,9,9,15,4,0,1,45,13,58
p_114,0,3,e_2,488,717,730,18,4,4,4,4,0,1,229,13,242
p_72,0,3,e_2,562,717,730,28,8,8,15,4,0,1,155,13,168
p_29,0,5,e_0,670,713,734,27,9,9,14,4,0,1,43,21,64
p_75,0,5,e_2,559,717,738,29,8,8,14,5,1,1,158,21,179
p_31,0,6,e_0,666,713,739,28,10,10,15,3,0,0,47,26,73
p_108,0,6,e_2,496,717,743,16,3,3,1,4,0,1,221,26,247
p_26,0,8,e_0,684,713,747,24,7,7,10,4,0,1,29,34,63
p_25,0,8,e_0,686,713,747,24,6,6,9,4,0,1,27,34,61
p_118,0,7,e_2,484,717,748,19,5,5,5,4,0,1,233,31,264
p_74,0,7,e_2,560,717,748,28,8,8,14,5,1,1,157,31,188
p_111,0,8,e_2,491,717,753,17,3,3,2,4,0,1,226,36,262
p_27,0,10,e_0,677,713,755,26,8,8,12,4,0,1,36,42,78
p_115,0,9,e_2,487,717,758,18,4,4,4,4,0,1,230,41,271
p_28,0,11,e_0,676,713,760,26,8,8,12,4,0,1,37,47,84
p_117,0,10,e_2,485,717,763,18,5,5,4,4,0,1,232,46,278
p_116,0,10,e_2,486,717,763,18,5,5,4,4,0,1,231,46,277
p_23,0,12,e_0,711,713,765,18,3,3,0,4,0,1,2,52,54
p_112,0,11,e_2,490,717,768,17,4,4,3,4,0,1,227,51,278
p_110,0,11,e_2,492,717,768,17,3,3,2,4,0,1,225,51,276
p_73,0,11,e_2,561,717,768,28,8,8,15,2,1,1,156,51,207
p_22,0,3,e_1,719,764,775,16,2,2,14,3,0,0,45,11,56
p_21,0,4,e_1,731,764,780,12,1,0,11,4,0,1,33,16,49
p_109,0,15,e_2,493,717,782,17,3,3,2,4,0,1,224,65,289
p_32,0,6,e_3,650,769,789,3,1,0,3,4,0,1,119,20,139
p_18,0,10,e_3,766,769,803,1,1,0,1,4,0,1,3,34,37
p_19,0,11,e_1,754,764,803,5,1,0,3,4,0,1,10,39,49
p_20,0,14,e_1,734,764,814,12,1,0,10,4,0,1,30,50,80
p_33,0,15,e_3,649,769,820,3,1,0,3,4,0,1,120,51,171
p_14,0,4,e_0,794,815,829,23,2,2,7,4,0,1,21,14,35
p_65,0,1,e_2,573,829,834,24,7,7,12,4,0,1,256,5,261
p_71,0,3,e_2,564,829,842,27,8,8,15,4,0,1,265,13,278
p_70,0,3,e_2,565,829,842,27,8,8,14,4,0,1,264,13,277
p_67,0,3,e_2,568,829,842,25,8,8,13,4,0,1,261,13,274
p_66,0,3,e_2,569,829,842,25,8,8,13,4,0,1,260,13,273
p_15,0,9,e_0,793,815,846,23,2,2,7,4,0,1,22,31,53
p_11,0,9,e_0,807,815,846,19,1,1,2,4,0,1,8,31,39
p_64,0,4,e_2,574,829,847,24,7,7,11,4,0,1,255,18,273
p_17,0,10,e_0,776,815,851,28,3,3,12,3,0,0,39,36,75
p_61,0,6,e_2,579,829,855,23,6,6,10,4,0,1,250,26,276
p_13,0,11,e_0,796,815,856,22,2,2,6,4,0,1,19,41,60
p_12,0,11,e_0,798,815,856,21,2,2,5,4,0,1,17,41,58
p_16,0,2,e_1,780,858,866,27,3,3,4,3,3,0,78,8,86
p_9,0,2,e_1,846,858,866,15,0,0,4,4,0,1,12,8,20
p_60,0,10,e_2,580,829,869,23,6,6,10,4,0,1,249,40,289
p_58,0,11,e_2,582,829,874,22,6,6,9,4,0,1,247,45,292
p_57,0,11,e_2,583,829,874,22,5,5,9,4,0,1,246,45,291
p_68,0,13,e_2,567,829,882,26,8,8,14,4,0,1,262,53,315
p_63,0,13,e_2,577,829,882,23,7,7,11,4,0,1,252,53,305
p_62,0,13,e_2,578,829,882,23,6,6,10,4,0,1,251,53,304
p_10,0,8,e_1,835,858,886,15,0,0,7,4,0,1,23,28,51
p_69,0,14,e_2,566,829,887,26,8,8,14,4,0,1,263,58,321
p_59,0,14,e_2,581,829,887,23,6,6,9,4,0,1,248,58,306
p_4,0,1,e_1,886,912,917,15,0,0,8,2,1,0,26,5,31
p_6,0,3,e_0,877,909,920,15,0,0,11,4,0,1,32,11,43
p_7,0,5,e_0,875,909,928,15,0,0,11,4,0,1,34,19,53
p_1,0,5,e_0,894,909,928,15,0,0,5,4,0,1,15,19,34
p_45,0,2,e_2,595,931,939,19,4,4,5,4,0,1,336,8,344
p_5,0,8,e_0,883,909,939,15,0,0,9,4,0,1,26,30,56
p_3,0,8,e_0,888,909,939,15,0,0,7,4,0,1,21,30,51
p_55,0,3,e_2,585,931,944,22,5,5,8,4,0,1,346,13,359
p_54,0,3,e_2,586,931,944,21,5,5,7,4,0,1,345,13,358
p_52,0,3,e_2,588,931,944,21,4,4,7,4,0,1,343,13,356
p_48,0,4,e_2,592,931,949,20,4,4,5,4,0,1,339,18,357
p_46,0,4,e_2,594,931,949,20,4,4,5,4,0,1,337,18,355
p_8,0,11,e_0,874,909,950,15,0,0,11,3,0,0,35,41,76
p_2,0,11,e_0,892,909,950,15,0,0,5,4,0,1,17,41,58
p_56,0,6,e_2,584,931,957,22,5,5,8,4,0,1,347,26,373
p_42,0,6,e_2,598,931,957,19,3,3,4,4,0,1,333,26,359
p_50,0,7,e_2,590,931,962,21,4,4,6,4,0,1,341,31,372
p_43,0,7,e_2,597,931,962,19,3,3,4,4,0,1,334,31,365
p_44,0,8,e_2,596,931,967,19,3,3,4,4,0,1,335,36,371
p_53,0,9,e_2,587,931,972,21,5,5,7,4,0,1,344,41,385
p_51,0,9,e_2,589,931,972,21,4,4,6,4,0,1,342,41,383
p_47,0,9,e_2,593,931,972,20,4,4,5,4,0,1,338,41,379
p_49,0,14,e_2,591,931,989,20,4,4,6,4,0,1,340,58,398
p_41,0,11,e_2,600,1033,1068,18,3,3,3,4,0,1,433,35,468
p_39,0,12,e_2,607,1033,1073,16,2,2,1,4,0,1,426,40,466
p_40,0,13,e_2,602,1033,1078,18,3,3,2,4,0,1,431,45,476
p_38,0,13,e_2,608,1033,1078,16,2,2,0,4,0,1,425,45,470
p_300,0,4,e_0,8,8,24,0,0,0,0,3,0,0,0,16,16
p_299,0,5,e_1,9,9,28,0,0,0,0,3,0,0,0,19,19
p_297,0,6,e_3,15,15,37,0,0,0,0,3,0,0,0,22,22
p_298,0,9,e_2,11,11,42,0,0,0,0,3,0,0,0,31,31
p_296,0,4,e_0,28,42,56,9,1,1,4,3,0,0,14,14,28
p_295,0,5,e_0,29,42,61,8,1,1,4,4,0,1,13,19,32
p_292,0,6,e_0,38,42,66,6,0,0,1,4,0,1,4,24,28
p_290,0,6,e_0,40,42,66,6,0,0,0,4,0,1,2,24,26
p_286,0,3,e_1,46,60,71,6,0,0,4,4,0,1,14,11,25
p_289,0,4,e_1,43,60,76,6,0,0,5,3,0,0,17,16,33
p_285,0,4,e_1,53,60,76,6,0,0,2,4,0,1,7,16,23
p_284,0,4,e_1,54,60,76,6,0,0,2,4,0,1,6,16,22
p_287,0,5,e_1,45,60,81,6,0,0,5,4,0,1,15,21,36
p_291,0,11,e_0,39,42,83,6,0,0,1,4,0,1,3,41,44
p_294,0,12,e_0,31,42,88,8,1,1,3,4,0,1,11,46,57
p_293,0,12,e_0,33,42,88,7,1,1,3,4,0,1,9,46,55
p_288,0,8,e_1,44,60,92,6,0,0,5,4,0,1,16,32,48
p_281,0,1,e_3,73,87,94,5,1,0,5,4,0,1,14,7,21
p_283,0,9,e_1,57,60,97,6,0,0,1,4,0,1,3,37,40
p_278,0,2,e_3,77,87,99,3,1,0,3,4,0,1,10,12,22
p_279,0,5,e_3,76,87,110,4,1,0,4,4,0,1,11,23,34
p_277,0,6,e_3,82,87,115,1,1,0,1,4,0,1,5,28,33
p_282,0,7,e_3,66,87,120,6,0,0,6,3,0,0,21,33,54
p_273,0,4,e_2,110,118,132,23,4,4,3,4,0,1,8,14,22
p_276,0,11,e_3,84,87,134,1,1,0,1,4,0,1,3,47,50
p_280,0,14,e_3,75,87,145,4,1,0,4,4,0,1,12,58,70
p_275,0,14,e_3,86,87,145,0,0,0,0,3,0,0,1,58,59
p_274,0,8,e_2,88,118,146,28,8,8,9,3,0,0,30,28,58
p_272,0,10,e_2,113,118,154,23,4,4,2,4,0,1,5,36,41
p_271,0,1,e_1,121,150,155,21,2,2,9,3,0,0,29,5,34
p_267,0,1,e_1,148,150,155,14,0,0,0,4,0,1,2,5,7
p_268,0,2,e_1,144,150,160,14,0,0,2,4,0,1,6,10,16
p_270,0,9,e_1,122,150,183,21,2,2,9,4,0,1,28,33,61
p_269,0,9,e_1,127,150,183,19,2,2,8,4,0,1,23,33,56
p_255,0,3,e_2,184,186,197,14,0,0,0,4,0,1,2,11,13
p_265,0,4,e_0,152,190,204,14,0,0,12,4,0,1,38,14,52
p_254,0,4,e_0,187,190,204,14,0,0,1,4,0,1,3,14,17
p_262,0,5,e_2,157,186,205,14,0,0,9,4,0,1,29,19,48
p_261,0,5,e_2,164,186,205,14,0,0,7,4,0,1,22,19,41
p_266,0,6,e_0,151,190,212,14,0,0,12,3,0,0,39,22,61
p_263,0,7,e_2,154,186,213,14,0,0,10,2,1,0,32,27,59
p_260,0,7,e_2,165,186,213,14,0,0,7,4,0,1,21,27,48
p_258,0,7,e_2,168,186,213,14,0,0,6,4,0,1,18,27,45
p_256,0,10,e_2,182,186,224,14,0,0,1,4,0,1,4,38,42
p_250,0,2,e_1,217,220,228,14,0,0,1,4,0,1,3,8,11
p_264,0,11,e_0,153,190,229,14,0,0,12,4,0,1,37,39,76
p_257,0,14,e_2,169,186,238,14,0,0,5,4,0,1,17,52,69
p_253,0,5,e_1,190,220,239,14,0,0,9,3,0,0,30,19,49
p_252,0,5,e_1,205,220,239,14,0,0,5,4,0,1,15,19,34
p_259,0,15,e_2,167,186,243,14,0,0,6,4,0,1,19,57,76
p_251,0,15,e_1,209,220,271,14,0,0,3,4,0,1,11,51,62
p_248,0,5,e_0,246,274,291,14,0,0,9,4,0,1,28,17,45
p_247,0,5,e_0,250,274,291,14,0,0,8,4,0,1,24,17,41
p_249,0,6,e_0,239,274,296,14,0,0,11,3,0,0,35,22,57
p_245,0,7,e_0,269,274,301,14,0,0,2,4,0,1,5,27,32
p_246,0,10,e_0,262,274,312,14,0,0,4,4,0,1,12,38,50
p_244,0,12,e_0,271,274,320,14,0,0,1,4,0,1,3,46,49
p_241,0,1,e_3,283,322,327,13,1,0,13,4,0,1,39,5,44
p_236,0,1,e_3,305,322,327,6,1,0,6,4,0,1,17,5,22
p_233,0,1,e_3,311,322,327,3,1,0,3,4,0,1,11,5,16
p_243,0,15,e_0,272,274,331,14,0,0,1,4,0,1,2,57,59
p_230,0,3,e_3,319,322,335,1,1,0,1,4,0,1,3,13,16
p_232,0,5,e_3,314,322,343,2,1,0,2,4,0,1,8,21,29
p_237,0,7,e_3,304,322,351,6,1,0,6,4,0,1,18,29,47
p_231,0,7,e_3,317,322,351,2,1,0,2,4,0,1,5,29,34
p_242,0,8,e_3,277,322,356,14,0,0,14,3,0,0,45,34,79
p_235,0,8,e_3,308,322,356,4,1,0,4,4,0,1,14,34,48
p_234,0,8,e_3,310,322,356,4,1,0,4,4,0,1,12,34,46
p_240,0,9,e_3,301,322,361,7,1,0,7,4,0,1,21,39,60
p_239,0,11,e_3,302,322,369,7,1,0,7,4,0,1,20,47,67
p_238,0,13,e_3,303,322,377,6,1,0,6,4,0,1,19,55,74
p_229,0,13,e_3,320,322,377,0,1,0,0,4,0,1,2,55,57
p_216,0,1,e_1,347,373,378,20,5,5,8,4,0,1,26,5,31
p_226,0,2,e_1,329,373,383,25,7,7,15,4,0,1,44,10,54
p_223,0,2,e_1,336,373,383,23,6,6,12,4,0,1,37,10,47
p_214,0,3,e_1,349,373,388,20,5,5,8,4,0,1,24,15,39
p_228,0,4,e_1,325,373,393,25,8,8,15,3,0,0,48,20,68
p_194,0,6,e_2,373,374,396,14,1,1,0,3,0,0,1,22,23
p_225,0,5,e_1,330,373,398,24,7,7,14,4,0,1,43,25,68
p_224,0,5,e_1,331,373,398,24,7,7,14,4,0,1,42,25,67
p_222,0,5,e_1,337,373,398,23,6,6,12,4,0,1,36,25,61
p_219,0,5,e_1,342,373,398,21,6,6,10,4,0,1,31,25,56
p_221,0,6,e_1,339,373,403,22,6,6,11,4,0,1,34,30,64
p_220,0,6,e_1,341,373,403,22,6,6,10,4,0,1,32,30,62
p_217,0,7,e_1,346,373,408,20,5,5,9,4,0,1,27,35,62
p_193,0,11,e_2,374,374,413,14,1,1,0,3,0,1,0,39,39
p_227,0,12,e_2,327,374,418,25,7,7,15,3,0,0,47,44,91
p_218,0,11,e_1,343,373,422,21,5,5,10,4,0,1,30,49,79
p_190,0,1,e_3,379,418,425,13,1,0,13,4,0,1,39,7,46
p_183,0,1,e_3,396,418,425,7,1,0,7,4,0,1,22,7,29
p_161,0,1,e_0,421,423,428,30,10,10,0,4,0,1,2,5,7
p_182,0,2,e_3,397,418,430,7,1,0,7,4,0,1,21,12,33
p_180,0,2,e_3,399,418,430,6,1,0,6,4,0,1,19,12,31
p_178,0,3,e_3,401,418,435,5,1,0,5,4,0,1,17,17,34
p_215,0,15,e_1,348,373,436,20,5,5,8,4,0,1,25,63,88
p_213,0,15,e_1,350,373,436,19,4,4,7,4,0,1,23,63,86
p_186,0,4,e_3,390,418,440,9,1,0,9,4,0,1,28,22,50
p_192,0,8,e_0,375,423,451,14,1,1,15,3,0,0,48,28,76
p_189,0,8,e_3,382,418,454,12,1,0,12,4,0,1,36,36,72
p_179,0,8,e_3,400,418,454,6,1,0,6,4,0,1,18,36,54
p_163,0,10,e_0,419,423,459,30,10,10,1,4,0,1,4,36,40
p_177,0,9,e_3,402,418,459,5,1,0,5,4,0,1,16,41,57
p_162,0,11,e_0,420,423,464,30,10,10,1,4,0,1,3,41,44
p_191,0,10,e_3,376,418,464,13,0,0,13,2,1,0,42,46,88
p_185,0,10,e_3,391,418,464,9,1,0,9,4,0,1,27,46,73
p_187,0,12,e_3,389,418,472,9,1,0,9,4,0,1,29,54,83
p_184,0,12,e_3,392,418,472,9,1,0,9,4,0,1,26,54,80
p_158,0,1,e_2,430,465,472,28,9,9,11,4,0,1,35,7,42
p_146,0,1,e_2,453,465,472,22,6,6,4,4,0,1,12,7,19
p_188,0,13,e_3,384,418,477,11,1,0,11,4,0,1,34,59,93
p_181,0,15,e_3,398,418,485,7,1,0,7,4,0,1,20,67,87
p_159,0,6,e_2,429,465,489,28,10,10,12,4,0,1,36,24,60
p_150,0,6,e_2,443,465,489,25,7,7,7,4,0,1,22,24,46
p_209,0,2,e_1,357,483,493,18,3,3,5,4,0,1,126,10,136
p_205,0,2,e_1,362,483,493,17,2,2,4,4,0,1,121,10,131
p_154,0,7,e_2,436,465,494,27,8,8,10,4,0,1,29,29,58
p_148,0,8,e_2,449,465,499,23,7,7,5,4,0,1,16,34,50
p_200,0,4,e_1,367,483,501,16,2,2,2,4,0,1,116,18,134
p_153,0,9,e_2,437,465,504,27,8,8,9,4,0,1,28,39,67
p_147,0,9,e_2,452,465,504,22,7,7,4,4,0,1,13,39,52
p_201,0,5,e_1,366,483,506,16,2,2,2,4,0,1,117,23,140
p_210,0,6,e_1,354,483,511,19,4,4,6,4,0,1,129,28,157
p_208,0,6,e_1,358,483,511,18,3,3,5,4,0,1,125,28,153
p_212,0,7,e_1,351,483,516,19,4,4,7,4,0,1,132,33,165
p_157,0,14,e_2,431,465,521,28,9,9,11,4,0,1,34,56,90
p_155,0,14,e_2,435,465,521,27,8,8,10,4,0,1,30,56,86
p_198,0,9,e_1,369,483,524,15,1,1,1,4,0,1,114,41,155
p_160,0,15,e_2,426,465,526,29,10,10,12,3,0,0,39,61,100
p_156,0,15,e_2,434,465,526,27,9,9,10,4,0,1,31,61,92
p_152,0,15,e_2,441,465,526,26,7,7,8,4,0,1,24,61,85
p_151,0,15,e_2,442,465,526,26,7,7,8,4,0,1,23,61,84
p_149,0,15,e_2,444,465,526,25,7,7,7,4,0,1,21,61,82
p_113,0,1,e_0,489,520,527,14,1,0,10,4,0,1,31,7,38
p_207,0,11,e_1,359,483,532,18,3,3,5,4,0,1,124,49,173
p_114,0,3,e_0,488,520,535,14,1,0,11,4,0,1,32,15,47
p_106,0,3,e_0,500,520,535,10,1,0,6,4,0,1,20,15,35
p_167,0,1,e_3,413,532,537,2,1,0,2,4,0,1,119,5,124
p_206,0,12,e_1,361,483,537,17,2,2,4,4,0,1,122,54,176
p_203,0,12,e_1,364,483,537,16,2,2,3,4,0,1,119,54,173
p_204,0,14,e_1,363,483,545,17,2,2,3,4,0,1,120,62,182
p_108,0,6,e_0,496,520,546,12,1,0,8,4,0,1,24,26,50
p_176,0,4,e_3,403,532,548,5,1,0,5,4,0,1,129,16,145
p_165,0,4,e_3,417,532,548,0,1,0,0,4,0,1,115,16,131
p_92,0,4,e_3,525,532,548,2,1,0,2,4,0,1,7,16,23
p_211,0,15,e_1,353,483,550,19,4,4,6,4,0,1,130,67,197
p_202,0,15,e_1,365,483,550,16,2,2,3,4,0,1,118,67,185
p_199,0,15,e_1,368,483,550,15,2,2,2,4,0,1,115,67,182
p_118,0,7,e_0,484,520,551,15,1,1,11,3,0,0,36,31,67
p_111,0,8,e_0,491,520,556,14,1,0,10,4,0,1,29,36,65
p_115,0,9,e_0,487,520,561,15,1,0,11,4,0,1,33,41,74
p_169,0,9,e_3,411,532,565,2,1,0,2,4,0,1,121,33,154
p_117,0,10,e_0,485,520,566,15,1,0,11,4,0,1,35,46,81
p_116,0,10,e_0,486,520,566,15,1,0,11,4,0,1,34,46,80
p_112,0,11,e_0,490,520,571,14,1,0,10,4,0,1,30,51,81
p_110,0,11,e_0,492,520,571,13,1,0,9,4,0,1,28,51,79
p_107,0,11,e_0,499,520,571,11,1,0,7,4,0,1,21,51,72
p_173,0,11,e_3,407,532,573,4,1,0,4,4,0,1,125,41,166
p_164,0,11,e_3,418,532,573,0,0,0,0,3,0,0,114,41,155
p_105,0,12,e_0,502,520,576,10,1,0,6,4,0,1,18,56,74
p_166,0,12,e_3,416,532,578,0,1,0,0,4,0,1,116,46,162
p_91,0,12,e_3,526,532,578,2,1,0,2,4,0,1,6,46,52
p_86,0,2,e_2,544,573,581,27,8,8,9,4,0,1,29,8,37
p_171,0,13,e_3,409,532,583,3,1,0,3,4,0,1,123,51,174
p_168,0,13,e_3,412,532,583,2,1,0,2,4,0,1,120,51,171
p_104,0,14,e_0,503,520,584,9,1,0,6,4,0,1,17,64,81
p_143,0,3,e_2,456,573,586,22,6,6,3,4,0,1,117,13,130
p_136,0,3,e_2,465,573,586,20,4,4,0,3,0,1,108,13,121
p_175,0,14,e_3,405,532,588,4,1,0,4,4,0,1,127,56,183
p_174,0,14,e_3,406,532,588,4,1,0,4,4,0,1,126,56,182
p_170,0,14,e_3,410,532,588,3,1,0,3,4,0,1,122,56,178
p_109,0,15,e_0,493,520,589,13,1,0,9,4,0,1,27,69,96
p_137,0,4,e_2,464,573,591,20,4,4,0,3,0,0,109,18,127
p_172,0,15,e_3,408,532,593,3,1,0,3,4,0,1,124,61,185
p_88,0,5,e_2,538,573,596,29,8,8,12,4,0,1,35,23,58
p_141,0,6,e_2,458,573,601,21,5,5,2,4,0,1,115,28,143
p_130,0,1,e_1,472,597,604,18,3,3,3,4,0,1,125,7,132
p_140,0,8,e_2,459,573,609,21,5,5,2,4,0,1,114,36,150
p_87,0,8,e_2,539,573,609,29,8,8,11,4,0,1,34,36,70
p_129,0,3,e_1,473,597,612,18,3,3,3,4,0,1,124,15,139
p_144,0,9,e_2,455,573,614,22,6,6,3,4,0,1,118,41,159
p_142,0,9,e_2,457,573,614,21,6,6,3,4,0,1,116,41,157
p_89,0,9,e_2,535,573,614,29,9,9,12,4,0,1,38,41,79
p_196,0,4,e_1,371,597,617,15,1,1,0,4,0,1,226,20,246
p_139,0,10,e_2,461,573,619,21,5,5,1,4,0,1,112,46,158
p_145,0,11,e_2,454,573,624,22,6,6,3,4,0,1,119,51,170
p_138,0,11,e_2,463,573,624,20,5,5,1,4,0,1,110,51,161
p_124,0,7,e_1,478,597,628,17,2,2,1,4,0,1,119,31,150
p_85,0,15,e_2,545,573,638,27,8,8,9,4,0,1,28,65,93
p_197,0,10,e_1,370,597,639,15,1,1,1,4,0,1,227,42,269
p_135,0,10,e_1,466,597,639,20,4,4,6,4,0,1,131,42,173
p_127,0,10,e_1,475,597,639,18,3,3,3,4,0,1,122,42,164
p_96,0,1,e_0,517,636,641,5,1,0,1,4,0,1,119,5,124
p_132,0,11,e_1,470,597,644,19,4,4,4,4,0,1,127,47,174
p_128,0,11,e_1,474,597,644,18,3,3,3,4,0,1,123,47,170
p_133,0,12,e_1,469,597,649,19,4,4,5,4,0,1,128,52,180
p_126,0,12,e_1,476,597,649,17,2,2,2,4,0,1,121,52,173
p_131,0,14,e_1,471,597,657,18,3,3,4,4,0,1,126,60,186
p_125,0,14,e_1,477,597,657,17,2,2,2,4,0,1,120,60,180
p_99,0,6,e_0,514,636,658,6,1,0,2,4,0,1,122,22,144
p_94,0,6,e_0,519,636,658,4,1,0,0,4,0,1,117,22,139
p_42,0,6,e_0,598,636,658,14,1,0,13,4,0,1,38,22,60
p_195,0,15,e_1,372,597,662,15,1,1,0,4,0,1,225,65,290
p_134,0,15,e_1,467,597,662,19,4,4,5,4,0,1,130,65,195
p_102,0,7,e_0,509,636,663,7,1,0,3,4,0,1,127,27,154
p_98,0,7,e_0,515,636,663,6,1,0,2,4,0,1,121,27,148
p_97,0,7,e_0,516,636,663,5,1,0,1,4,0,1,120,27,147
p_101,0,8,e_0,511,636,668,7,1,0,3,4,0,1,125,32,157
p_100,0,9,e_0,513,636,673,6,1,0,2,4,0,1,123,37,160
p_90,0,13,e_3,527,640,681,2,1,0,2,4,0,1,113,41,154
p_103,0,11,e_0,508,636,681,8,1,0,4,4,0,1,128,45,173
p_41,0,11,e_0,600,636,681,13,1,0,12,4,0,1,36,45,81
p_39,0,12,e_0,607,636,686,11,1,0,9,4,0,1,29,50,79
p_93,0,13,e_0,520,636,691,4,1,0,0,3,0,0,116,55,171
p_40,0,13,e_0,602,636,691,13,1,0,11,4,0,1,34,55,89
p_95,0,14,e_0,518,636,696,4,1,0,0,4,0,1,118,60,178
p_77,0,3,e_2,557,685,698,24,7,7,5,4,0,1,128,13,141
p_72,0,3,e_2,562,685,698,22,7,7,3,4,0,1,123,13,136
p_71,0,3,e_2,564,685,698,21,6,6,3,4,0,1,121,13,134
p_70,0,3,e_2,565,685,698,21,6,6,2,4,0,1,120,13,133
p_75,0,5,e_2,559,685,706,23,7,7,4,4,0,1,126,21,147
p_76,0,6,e_2,558,685,711,23,7,7,5,4,0,1,127,26,153
p_119,0,1,e_1,483,709,714,16,2,2,0,3,0,0,226,5,231
p_65,0,1,e_1,573,709,714,19,5,5,8,4,0,1,136,5,141
p_80,0,7,e_2,552,685,716,25,7,7,7,4,0,1,133,31,164
p_74,0,7,e_2,560,685,716,22,7,7,4,4,0,1,125,31,156
p_83,0,8,e_2,549,685,721,26,7,7,8,4,0,1,136,36,172
p_64,0,4,e_1,574,709,725,19,5,5,8,4,0,1,135,16,151
p_73,0,11,e_2,561,685,732,22,7,7,4,4,0,1,124,47,171
p_61,0,6,e_1,579,709,733,18,4,4,6,4,0,1,130,24,154
p_56,0,6,e_1,584,709,733,17,3,3,4,4,0,1,125,24,149
p_84,0,12,e_2,546,685,737,27,8,8,9,4,0,1,139,52,191
p_78,0,12,e_2,556,685,737,24,7,7,5,4,0,1,129,52,181
p_82,0,14,e_2,550,685,745,26,7,7,8,4,0,1,135,60,195
p_81,0,14,e_2,551,685,745,26,7,7,7,4,0,1,134,60,194
p_79,0,14,e_2,553,685,745,25,7,7,7,4,0,1,132,60,192
p_60,0,10,e_1,580,709,747,18,4,4,5,4,0,1,129,38,167
p_22,0,3,e_0,719,740,751,13,0,0,7,4,0,1,21,11,32
p_123,0,11,e_1,479,709,752,17,2,2,1,4,0,1,230,43,273
p_121,0,11,e_1,481,709,752,16,2,2,1,4,0,1,228,43,271
p_120,0,11,e_1,482,709,752,16,2,2,0,4,0,1,227,43,270
p_58,0,11,e_1,582,709,752,17,4,4,5,4,0,1,127,43,170
p_57,0,11,e_1,583,709,752,17,3,3,4,4,0,1,126,43,169
p_21,0,4,e_0,731,740,756,13,0,0,3,4,0,1,9,16,25
p_63,0,13,e_1,577,709,760,18,4,4,7,4,0,1,132,51,183
p_62,0,13,e_1,578,709,760,18,4,4,6,4,0,1,131,51,182
p_59,0,14,e_1,581,709,765,17,4,4,5,4,0,1,128,56,184
p_122,0,15,e_1,480,709,770,17,2,2,1,4,0,1,229,61,290
p_37,0,9,e_0,615,740,773,8,1,0,7,4,0,1,125,33,158
p_35,0,9,e_0,630,740,773,3,1,0,2,4,0,1,110,33,143
p_23,0,12,e_0,711,740,784,13,0,0,10,4,0,1,29,44,73
p_38,0,13,e_0,608,740,789,10,1,0,9,4,0,1,132,49,181
p_36,0,13,e_0,628,740,789,4,1,0,3,4,0,1,112,49,161
p_20,0,14,e_0,734,740,794,13,0,0,2,4,0,1,6,54,60
p_67,0,3,e_2,568,789,800,20,6,6,1,4,0,1,221,11,232
p_66,0,3,e_2,569,789,800,20,6,6,1,4,0,1,220,11,231
p_30,0,3,e_2,668,789,800,17,1,1,5,4,0,1,121,11,132
p_29,0,5,e_2,670,789,808,17,1,1,5,4,0,1,119,19,138
p_32,0,6,e_2,650,789,813,23,1,1,12,4,0,1,139,24,163
p_31,0,6,e_2,666,789,813,18,1,1,6,4,0,1,123,24,147
p_26,0,8,e_2,684,789,821,13,0,0,0,3,0,0,105,32,137
p_45,0,2,e_1,595,817,825,15,1,0,0,4,0,1,222,8,230
p_24,0,2,e_1,695,817,825,13,0,0,5,4,0,1,122,8,130
p_27,0,10,e_2,677,789,829,14,1,1,3,4,0,1,112,40,152
p_18,0,10,e_2,766,789,829,13,0,0,8,4,0,1,23,40,63
p_55,0,3,e_1,585,817,830,17,3,3,4,4,0,1,232,13,245
p_54,0,3,e_1,586,817,830,16,3,3,3,4,0,1,231,13,244
p_52,0,3,e_1,588,817,830,16,2,2,3,4,0,1,229,13,242
p_28,0,11,e_2,676,789,834,14,1,1,3,4,0,1,113,45,158
p_19,0,11,e_2,754,789,834,13,0,0,12,4,0,1,35,45,80
p_48,0,4,e_1,592,817,835,15,1,1,1,4,0,1,225,18,243
p_46,0,4,e_1,594,817,835,15,1,0,1,4,0,1,223,18,241
p_34,0,12,e_2,646,789,839,25,1,1,13,4,0,1,143,50,193
p_68,0,13,e_2,567,789,844,21,6,6,2,4,0,1,222,55,277
p_50,0,7,e_1,590,817,846,16,2,2,2,4,0,1,227,29,256
p_43,0,7,e_1,597,817,846,14,1,0,0,3,0,1,220,29,249
p_69,0,14,e_2,566,789,849,21,6,6,2,4,0,1,223,60,283
p_44,0,8,e_1,596,817,851,15,1,0,0,3,0,0,221,34,255
p_25,0,8,e_1,686,817,851,13,0,0,8,4,0,1,131,34,165
p_33,0,15,e_2,649,789,854,23,1,1,12,4,0,1,140,65,205
p_53,0,9,e_1,587,817,856,16,3,3,3,4,0,1,230,39,269
p_51,0,9,e_1,589,817,856,16,2,2,3,4,0,1,228,39,267
p_47,0,9,e_1,593,817,856,15,1,0,1,4,0,1,224,39,263
p_49,0,14,e_1,591,817,873,15,2,2,2,4,0,1,226,56,282
p_9,0,2,e_3,846,876,886,10,1,0,10,4,0,1,30,10,40
p_7,0,5,e_3,875,876,897,0,0,0,0,3,0,0,1,21,22
p_4,0,1,e_2,886,901,906,20,3,3,5,4,0,1,15,5,20
p_10,0,8,e_3,835,876,908,13,0,0,13,3,0,0,41,32,73
p_16,0,2,e_2,780,901,911,13,0,0,3,4,0,1,121,10,131
p_6,0,3,e_2,877,901,916,22,4,4,8,4,0,1,24,15,39
p_8,0,11,e_3,874,876,919,0,1,0,0,4,0,1,2,43,45
p_1,0,5,e_2,894,901,924,18,3,3,2,4,0,1,7,23,30
p_14,0,4,e_1,794,917,931,13,0,0,7,4,0,1,123,14,137
p_5,0,8,e_2,883,901,935,21,4,4,6,4,0,1,18,34,52
p_3,0,8,e_2,888,901,935,20,3,3,4,4,0,1,13,34,47
p_17,0,10,e_2,776,901,943,13,0,0,4,4,0,1,125,42,167
p_15,0,9,e_1,793,917,948,13,0,0,8,4,0,1,124,31,155
p_11,0,9,e_1,807,917,948,13,0,0,3,4,0,1,110,31,141
p_2,0,11,e_2,892,901,948,19,3,3,3,4,0,1,9,47,56
p_13,0,11,e_1,796,917,956,13,0,0,7,4,0,1,121,39,160
p_12,0,11,e_1,798,917,956,13,0,0,6,4,0,1,119,39,158
p_300,0,4,e_0,8,9,25,0,0,0,0,3,0,0,1,16,17
p_299,0,5,e_1,9,9,28,0,0,0,0,3,0,0,0,19,19
p_297,0,6,e_3,15,16,38,0,0,0,0,3,0,0,1,22,23
p_298,0,9,e_2,11,11,42,0,0,0,0,3,0,0,0,31,31
p_296,0,4,e_0,28,42,56,9,1,1,4,3,0,0,14,14,28
p_286,0,3,e_1,46,47,58,6,0,0,0,4,0,1,1,11,12
p_289,0,4,e_1,43,47,63,6,0,0,1,4,0,1,4,16,20
p_292,0,6,e_0,38,42,64,6,0,0,1,4,0,1,4,22,26
p_290,0,6,e_0,40,42,64,6,0,0,0,4,0,1,2,22,24
p_295,0,5,e_1,29,47,68,9,1,1,5,3,0,0,18,21,39
p_287,0,5,e_1,45,47,68,6,0,0,0,4,0,1,2,21,23
p_288,0,8,e_1,44,47,79,6,0,0,1,4,0,1,3,32,35
p_281,0,1,e_3,73,73,80,0,0,0,0,3,0,0,0,7,7
p_291,0,11,e_0,39,42,81,6,0,0,1,4,0,1,3,39,42
p_294,0,12,e_0,31,42,86,8,1,1,3,4,0,1,11,44,55
p_293,0,12,e_0,33,42,86,7,1,1,3,4,0,1,9,44,53
p_285,0,4,e_3,53,73,91,6,0,0,6,3,0,0,20,18,38
p_284,0,4,e_3,54,73,91,6,1,0,6,4,0,1,19,18,37
p_282,0,7,e_3,66,73,102,2,1,0,2,4,0,1,7,29,36
p_283,0,9,e_3,57,73,110,5,1,0,5,4,0,1,16,37,53
p_278,0,2,e_2,77,104,112,18,4,4,9,4,0,1,27,8,35
p_279,0,5,e_2,76,104,123,18,4,4,9,4,0,1,28,19,47
p_277,0,6,e_1,82,109,129,17,3,3,8,3,0,0,27,20,47
p_274,0,8,e_2,88,104,134,15,3,3,5,4,0,1,16,30,46
p_276,0,11,e_2,84,104,145,16,3,3,6,4,0,1,20,41,61
p_271,0,1,e_3,121,140,145,6,1,0,6,4,0,1,19,5,24
p_280,0,14,e_2,75,104,156,18,4,4,9,3,0,0,29,52,81
p_275,0,14,e_2,86,104,156,15,3,3,6,4,0,1,18,52,70
p_273,0,4,e_3,110,140,156,9,0,0,9,3,0,0,30,16,46
p_267,0,1,e_1,148,165,172,19,3,3,6,4,0,1,17,7,24
p_270,0,9,e_3,122,140,173,6,1,0,6,4,0,1,18,33,51
p_269,0,9,e_3,127,140,173,4,1,0,4,4,0,1,13,33,46
p_268,0,2,e_1,144,165,177,19,3,3,6,3,0,0,21,12,33
p_272,0,10,e_3,113,140,178,9,1,0,9,4,0,1,27,38,65
p_265,0,4,e_1,152,165,185,17,3,3,4,4,0,1,13,20,33
p_262,0,5,e_1,157,165,190,16,2,2,3,4,0,1,8,25,33
p_261,0,5,e_1,164,165,190,14,2,2,0,4,0,1,1,25,26
p_266,0,6,e_1,151,165,195,17,3,3,5,4,0,1,14,30,44
p_263,0,7,e_1,154,165,200,17,3,3,4,4,0,1,11,35,46
p_260,0,7,e_1,165,165,200,14,2,2,0,3,0,0,0,35,35
p_264,0,11,e_1,153,165,214,17,3,3,4,4,0,1,12,49,61
p_255,0,3,e_0,184,206,217,10,0,0,7,4,0,1,22,11,33
p_254,0,4,e_0,187,206,222,10,0,0,6,4,0,1,19,16,35
p_253,0,5,e_0,190,206,227,10,0,0,5,4,0,1,16,21,37
p_252,0,5,e_0,205,206,227,10,0,0,0,4,0,1,1,21,22
p_258,0,7,e_2,168,213,236,13,2,2,14,3,0,0,45,23,68
p_256,0,10,e_0,182,206,244,10,0,0,8,4,0,1,24,38,62
p_257,0,14,e_0,169,206,258,12,2,2,12,4,0,1,37,52,89
p_250,0,2,e_3,217,250,260,10,0,0,10,3,0,0,33,10,43
p_251,0,15,e_2,209,213,262,10,0,0,1,4,0,1,4,49,53
p_259,0,15,e_0,167,206,263,13,2,2,12,3,0,0,39,57,96
p_248,0,5,e_3,246,250,271,1,1,0,1,4,0,1,4,21,25
p_247,0,5,e_3,250,250,271,0,0,0,0,3,0,0,0,21,21
p_249,0,6,e_3,239,250,276,3,1,0,3,4,0,1,11,26,37
p_241,0,1,e_3,283,296,301,4,1,0,4,4,0,1,13,5,18
p_245,0,7,e_1,269,298,321,7,2,2,9,4,0,1,29,23,52
p_242,0,8,e_3,277,296,324,6,1,0,6,4,0,1,19,28,47
p_246,0,10,e_1,262,298,332,10,2,2,11,3,0,0,36,34,70
p_244,0,12,e_3,271,296,338,7,1,1,5,5,1,0,25,42,67
p_243,0,15,e_1,272,298,349,7,2,2,9,4,0,1,26,51,77
p_236,0,1,e_0,305,349,356,22,2,2,14,4,0,1,44,7,51
p_233,0,1,e_0,311,349,356,20,2,2,12,4,0,1,38,7,45
p_226,0,2,e_0,329,349,361,15,1,1,6,4,0,1,20,12,32
p_214,0,3,e_2,349,350,363,12,0,0,0,4,0,1,1,13,14
p_230,0,3,e_0,319,349,366,18,2,2,10,4,0,1,30,17,47
p_228,0,4,e_0,325,349,371,16,1,1,8,4,0,1,24,22,46
p_232,0,5,e_0,314,349,376,19,2,2,11,4,0,1,35,27,62
p_225,0,5,e_0,330,349,376,14,1,1,6,4,0,1,19,27,46
p_237,0,7,e_0,304,349,384,23,2,2,15,4,0,1,45,35,80
p_231,0,7,e_0,317,349,384,18,2,2,10,4,0,1,32,35,67
p_235,0,8,e_0,308,349,389,21,2,2,14,4,0,1,41,40,81
p_234,0,8,e_0,310,349,389,20,2,2,13,4,0,1,39,40,79
p_239,0,11,e_2,302,350,389,23,2,2,15,3,0,0,48,39,87
p_240,0,9,e_0,301,349,394,23,2,2,15,3,0,0,48,45,93
p_209,0,2,e_3,357,389,399,10,1,0,10,4,0,1,32,10,42
p_205,0,2,e_3,362,389,399,9,1,0,9,4,0,1,27,10,37
p_213,0,15,e_2,350,350,403,12,0,0,0,3,0,0,0,53,53
p_227,0,12,e_0,327,349,405,16,1,1,7,4,0,1,22,56,78
p_200,0,4,e_3,367,389,407,7,1,0,7,4,0,1,22,18,40
p_238,0,13,e_0,303,349,410,23,2,2,15,4,0,1,46,61,107
p_229,0,13,e_0,320,349,410,17,2,2,10,4,0,1,29,61,90
p_201,0,5,e_3,366,389,412,8,1,0,8,4,0,1,23,23,46
p_210,0,6,e_3,354,389,417,12,1,0,12,4,0,1,35,28,63
p_208,0,6,e_3,358,389,417,10,1,0,10,4,0,1,31,28,59
p_212,0,7,e_3,351,389,422,12,0,0,12,3,0,0,38,33,71
p_198,0,9,e_3,369,389,430,7,1,0,7,4,0,1,20,41,61
p_207,0,11,e_3,359,389,438,10,1,0,10,4,0,1,30,49,79
p_206,0,12,e_3,361,389,443,9,1,0,9,4,0,1,28,54,82
p_203,0,12,e_3,364,389,443,8,1,0,8,4,0,1,25,54,79
p_183,0,1,e_1,396,438,443,29,11,11,14,4,0,1,42,5,47
p_182,0,2,e_1,397,438,448,29,11,11,14,4,0,1,41,10,51
p_180,0,2,e_1,399,438,448,28,10,10,13,4,0,1,39,10,49
p_204,0,14,e_3,363,389,451,9,1,0,9,4,0,1,26,62,88
p_178,0,3,e_1,401,438,453,28,10,10,12,4,0,1,37,15,52
p_211,0,15,e_3,353,389,456,12,1,0,12,4,0,1,36,67,103
p_202,0,15,e_3,365,389,456,8,1,0,8,4,0,1,24,67,91
p_199,0,15,e_3,368,389,456,7,1,0,7,4,0,1,21,67,88
p_216,0,1,e_0,347,451,456,12,0,0,1,4,0,1,104,5,109
p_186,0,4,e_1,390,438,458,30,10,10,15,3,0,0,48,20,68
p_176,0,4,e_1,403,438,458,27,10,10,11,4,0,1,35,20,55
p_223,0,2,e_0,336,451,461,12,1,1,4,4,0,1,115,10,125
p_179,0,8,e_1,400,438,472,28,10,10,12,4,0,1,38,34,72
p_224,0,5,e_0,331,451,472,14,1,1,6,4,0,1,120,21,141
p_222,0,5,e_0,337,451,472,12,0,0,4,4,0,1,114,21,135
p_219,0,5,e_0,342,451,472,12,0,0,2,4,0,1,109,21,130
p_221,0,6,e_0,339,451,477,12,0,0,3,4,0,1,112,26,138
p_220,0,6,e_0,341,451,477,12,0,0,3,4,0,1,110,26,136
p_150,0,6,e_0,443,451,477,18,3,3,2,4,0,1,8,26,34
p_177,0,9,e_1,402,438,477,27,10,10,12,4,0,1,36,39,75
p_185,0,10,e_1,391,438,482,30,10,10,15,3,0,1,47,44,91
p_217,0,7,e_0,346,451,482,12,0,0,1,4,0,1,105,31,136
p_148,0,8,e_0,449,451,487,17,3,3,1,4,0,1,2,36,38
p_173,0,11,e_1,407,438,487,4,9,9,10,4,0,1,31,49,80
p_184,0,12,e_1,392,438,492,30,10,10,15,4,0,1,46,54,100
p_218,0,11,e_0,343,451,498,12,0,0,2,4,0,1,108,47,155
p_175,0,14,e_1,405,438,500,26,10,10,11,4,0,1,33,62,95
p_174,0,14,e_1,406,438,500,26,10,10,10,4,0,1,32,62,94
p_181,0,15,e_1,398,438,505,28,11,11,13,4,0,1,40,67,107
p_172,0,15,e_1,408,438,505,26,9,9,10,4,0,1,30,67,97
p_146,0,1,e_2,453,499,506,16,2,2,15,4,0,1,46,7,53
p_190,0,1,e_3,379,503,510,3,1,0,3,4,0,1,124,7,131
p_215,0,15,e_0,348,451,512,12,0,0,0,3,0,0,103,61,164
p_152,0,15,e_0,441,451,512,19,4,4,3,4,0,1,10,61,71
p_151,0,15,e_0,442,451,512,18,4,4,3,4,0,1,9,61,70
p_149,0,15,e_0,444,451,512,18,3,3,2,4,0,1,7,61,68
p_143,0,3,e_2,456,499,514,15,1,0,14,4,0,1,43,15,58
p_136,0,3,e_2,465,499,514,13,1,0,11,4,0,1,34,15,49
p_106,0,3,e_3,500,503,518,1,1,0,1,4,0,1,3,15,18
p_137,0,4,e_2,464,499,519,13,1,0,12,4,0,1,35,20,55
p_196,0,4,e_3,371,503,523,6,1,0,6,4,0,1,132,20,152
p_141,0,6,e_2,458,499,527,15,1,0,13,4,0,1,41,28,69
p_194,0,6,e_3,373,503,531,5,1,0,5,4,0,1,130,28,158
p_140,0,8,e_2,459,499,535,15,1,0,13,4,0,1,40,36,76
p_192,0,8,e_3,375,503,539,5,1,0,5,4,0,1,128,36,164
p_189,0,8,e_3,382,503,539,2,1,0,2,4,0,1,121,36,157
p_147,0,9,e_2,452,499,540,16,2,2,15,3,0,0,47,41,88
p_144,0,9,e_2,455,499,540,15,2,2,15,4,0,1,44,41,85
p_142,0,9,e_2,457,499,540,15,1,0,14,4,0,1,42,41,83
p_139,0,10,e_2,461,499,545,14,1,0,13,4,0,1,38,46,84
p_135,0,10,e_2,466,499,545,12,1,0,11,4,0,1,33,46,79
p_197,0,10,e_3,370,503,547,6,1,0,6,4,0,1,133,44,177
p_191,0,10,e_3,376,503,547,4,1,0,4,4,0,1,127,44,171
p_145,0,11,e_2,454,499,550,16,2,2,15,4,0,1,45,51,96
p_138,0,11,e_2,463,499,550,13,1,0,12,4,0,1,36,51,87
p_193,0,11,e_3,374,503,552,5,1,0,5,4,0,1,129,49,178
p_133,0,12,e_2,469,499,555,11,1,0,10,4,0,1,30,56,86
p_187,0,12,e_3,389,503,557,0,0,0,0,3,0,0,114,54,168
p_105,0,12,e_3,502,503,557,0,0,0,0,3,0,0,1,54,55
p_167,0,1,e_1,413,552,559,25,8,8,8,4,0,1,139,7,146
p_161,0,1,e_1,421,552,559,23,6,6,5,4,0,1,131,7,138
p_158,0,1,e_1,430,552,559,21,5,5,3,4,0,1,122,7,129
p_188,0,13,e_3,384,503,562,2,1,0,2,4,0,1,119,59,178
p_134,0,15,e_2,467,499,566,12,1,0,11,4,0,1,32,67,99
p_165,0,4,e_1,417,552,570,24,7,7,7,4,0,1,135,18,153
p_195,0,15,e_3,372,503,570,6,1,0,6,4,0,1,131,67,198
p_77,0,3,e_0,557,559,572,18,2,2,0,4,0,1,2,13,15
p_159,0,6,e_1,429,552,578,21,6,6,3,4,0,1,123,26,149
p_75,0,5,e_0,559,559,580,18,2,2,0,3,0,1,0,21,21
p_76,0,6,e_0,558,559,585,18,2,2,0,3,0,0,1,26,27
p_169,0,9,e_1,411,552,589,25,8,8,9,4,0,1,141,37,178
p_163,0,10,e_1,419,552,594,24,7,7,6,4,0,1,133,42,175
p_164,0,11,e_1,418,552,599,24,7,7,7,4,0,1,134,47,181
p_162,0,11,e_1,420,552,599,24,7,7,6,4,0,1,132,47,179
p_166,0,12,e_1,416,552,604,24,8,8,7,4,0,1,136,52,188
p_78,0,12,e_0,556,559,605,18,3,3,1,4,0,1,3,46,49
p_171,0,13,e_1,409,552,609,26,9,9,9,4,0,1,143,57,200
p_168,0,13,e_1,412,552,609,25,8,8,9,4,0,1,140,57,197
p_104,0,14,e_0,503,559,613,30,11,11,12,5,1,0,56,54,110
p_79,0,14,e_0,553,559,613,19,3,3,2,4,0,1,6,54,60
p_170,0,14,e_1,410,552,614,25,9,9,9,4,0,1,142,62,204
p_157,0,14,e_1,431,552,614,21,5,5,2,4,0,1,121,62,183
p_130,0,1,e_2,472,613,618,10,1,0,9,4,0,1,141,5,146
p_119,0,1,e_2,483,613,618,6,1,0,5,4,0,1,130,5,135
p_160,0,15,e_1,426,552,619,22,6,6,4,4,0,1,126,67,193
p_129,0,3,e_2,473,613,626,10,1,0,8,4,0,1,140,13,153
p_72,0,3,e_3,562,617,628,17,1,1,13,2,2,0,55,11,66
p_124,0,7,e_2,478,613,640,8,1,0,7,4,0,1,135,27,162
p_118,0,7,e_2,484,613,640,6,1,0,5,4,0,1,129,27,156
p_37,0,9,e_3,615,617,648,0,1,0,0,4,0,1,2,31,33
p_127,0,10,e_2,475,613,651,9,1,0,8,4,0,1,138,38,176
p_132,0,11,e_2,470,613,656,11,1,0,9,4,0,1,143,43,186
p_128,0,11,e_2,474,613,656,9,1,0,8,4,0,1,139,43,182
p_123,0,11,e_2,479,613,656,8,1,0,7,4,0,1,134,43,177
p_121,0,11,e_2,481,613,656,7,1,0,6,4,0,1,132,43,175
p_120,0,11,e_2,482,613,656,7,1,0,5,4,0,1,131,43,174
p_126,0,12,e_2,476,613,661,9,1,0,7,4,0,1,137,48,185
p_131,0,14,e_2,471,613,669,10,1,0,9,4,0,1,142,56,198
p_125,0,14,e_2,477,613,669,9,1,0,7,4,0,1,136,56,192
p_96,0,1,e_1,517,666,673,27,8,8,11,4,0,1,149,7,156
p_122,0,15,e_2,480,613,674,8,1,0,6,4,0,1,133,61,194
p_99,0,6,e_1,514,666,690,28,9,9,13,4,0,1,152,24,176
p_94,0,6,e_1,519,666,690,27,8,8,11,4,0,1,147,24,171
p_154,0,7,e_1,436,666,695,20,5,5,1,4,0,1,230,29,259
p_102,0,7,e_1,509,666,695,29,10,10,14,4,0,1,157,29,186
p_98,0,7,e_1,515,666,695,28,9,9,12,4,0,1,151,29,180
p_97,0,7,e_1,516,666,695,28,9,9,12,4,0,1,150,29,179
p_101,0,8,e_1,511,666,700,29,9,9,14,4,0,1,155,34,189
p_153,0,9,e_1,437,666,705,19,4,4,0,4,0,1,229,39,268
p_100,0,9,e_1,513,666,705,29,9,9,13,4,0,1,153,39,192
p_24,0,2,e_3,695,698,706,1,1,0,1,4,0,1,3,8,11
p_30,0,3,e_3,668,698,711,9,0,0,9,3,0,0,30,13,43
p_103,0,11,e_1,508,666,713,30,10,10,15,4,0,1,158,47,205
p_29,0,5,e_3,670,698,719,9,1,0,9,4,0,1,28,21,49
p_93,0,13,e_1,520,666,721,27,8,8,11,4,0,1,146,55,201
p_155,0,14,e_1,435,666,726,20,5,5,1,4,0,1,231,60,291
p_95,0,14,e_1,518,666,726,27,8,8,11,4,0,1,148,60,208
p_113,0,1,e_2,489,721,726,5,1,0,3,4,0,1,232,5,237
p_26,0,8,e_3,684,698,730,4,1,0,4,4,0,1,14,32,46
p_25,0,8,e_3,686,698,730,4,1,0,4,4,0,1,12,32,44
p_156,0,15,e_1,434,666,731,20,5,5,1,4,0,1,232,65,297
p_114,0,3,e_2,488,721,734,5,1,0,4,4,0,1,233,13,246
p_71,0,3,e_2,564,721,734,17,2,2,15,5,1,1,157,13,170
p_70,0,3,e_2,565,721,734,16,2,2,15,2,1,1,156,13,169
p_27,0,10,e_3,677,698,738,7,1,0,7,4,0,1,21,40,61
p_28,0,11,e_3,676,698,743,7,1,0,7,4,0,1,22,45,67
p_108,0,6,e_2,496,721,745,2,1,0,1,4,0,1,225,24,249
p_74,0,7,e_2,560,721,750,17,2,2,13,5,1,1,161,29,190
p_111,0,8,e_2,491,721,755,4,1,0,3,4,0,1,230,34,264
p_115,0,9,e_2,487,721,760,5,1,0,4,4,0,1,234,39,273
p_117,0,10,e_2,485,721,765,6,1,0,5,4,0,1,236,44,280
p_116,0,10,e_2,486,721,765,6,1,0,4,4,0,1,235,44,279
p_112,0,11,e_2,490,721,770,4,1,0,3,4,0,1,231,49,280
p_110,0,11,e_2,492,721,770,3,1,0,2,4,0,1,229,49,278
p_107,0,11,e_2,499,721,770,1,1,0,0,3,0,0,222,49,271
p_73,0,11,e_2,561,721,770,17,2,2,13,5,1,1,160,49,209
p_109,0,15,e_2,493,721,784,3,1,0,2,4,0,1,228,63,291
p_86,0,2,e_1,544,778,786,21,5,5,2,4,0,1,234,8,242
p_21,0,4,e_0,731,775,789,14,2,2,14,3,0,0,44,14,58
p_92,0,4,e_1,525,778,794,26,7,7,9,4,0,1,253,16,269
p_88,0,5,e_1,538,778,799,22,5,5,5,4,0,1,240,21,261
p_80,0,7,e_1,552,778,807,19,3,3,0,3,0,1,226,29,255
p_18,0,10,e_0,766,775,809,11,0,0,3,4,0,1,9,34,43
p_87,0,8,e_1,539,778,812,22,5,5,4,4,0,1,239,34,273
p_83,0,8,e_1,549,778,812,20,4,4,1,4,0,1,229,34,263
p_19,0,11,e_0,754,775,814,11,0,0,7,4,0,1,21,39,60
p_89,0,9,e_1,535,778,817,23,6,6,5,4,0,1,243,39,282
p_35,0,9,e_1,630,778,817,15,1,1,12,4,0,1,148,39,187
p_16,0,2,e_3,780,816,824,11,0,0,11,3,0,0,36,8,44
p_20,0,14,e_0,734,775,825,13,2,2,13,4,0,1,41,50,91
p_91,0,12,e_1,526,778,828,25,7,7,9,4,0,1,252,50,302
p_84,0,12,e_1,546,778,828,20,5,5,2,4,0,1,232,50,282
p_14,0,4,e_3,794,816,832,7,1,0,7,4,0,1,22,16,38
p_90,0,13,e_1,527,778,833,25,7,7,8,4,0,1,251,55,306
p_36,0,13,e_1,628,778,833,15,1,1,12,4,0,1,150,55,205
p_65,0,1,e_2,573,831,836,15,1,0,13,4,0,1,258,5,263
p_82,0,14,e_1,550,778,838,20,4,4,1,4,0,1,228,60,288
p_81,0,14,e_1,551,778,838,19,4,4,0,3,0,0,227,60,287
p_85,0,15,e_1,545,778,843,20,5,5,2,4,0,1,233,65,298
p_67,0,3,e_2,568,831,844,15,2,2,15,4,0,1,263,13,276
p_66,0,3,e_2,569,831,844,15,2,2,14,4,0,1,262,13,275
p_55,0,3,e_2,585,831,844,10,1,0,9,4,0,1,246,13,259
p_64,0,4,e_2,574,831,849,14,1,0,13,4,0,1,257,18,275
p_15,0,9,e_3,793,816,849,7,1,0,7,4,0,1,23,33,56
p_11,0,9,e_3,807,816,849,3,1,0,3,4,0,1,9,33,42
p_61,0,6,e_2,579,831,857,13,1,0,11,4,0,1,252,26,278
p_56,0,6,e_2,584,831,857,11,1,0,10,4,0,1,247,26,273
p_13,0,11,e_3,796,816,857,6,1,0,6,4,0,1,20,41,61
p_12,0,11,e_3,798,816,857,6,1,0,6,4,0,1,18,41,59
p_60,0,10,e_2,580,831,871,12,1,0,11,4,0,1,251,40,291
p_58,0,11,e_2,582,831,876,12,1,0,10,4,0,1,249,45,294
p_57,0,11,e_2,583,831,876,11,1,0,10,4,0,1,248,45,293
p_68,0,13,e_2,567,831,884,16,2,2,15,4,0,1,264,53,317
p_63,0,13,e_2,577,831,884,13,1,0,12,4,0,1,254,53,307
p_62,0,13,e_2,578,831,884,13,1,0,11,4,0,1,253,53,306
p_9,0,2,e_0,846,879,887,14,2,2,11,4,0,1,33,8,41
p_69,0,14,e_2,566,831,889,16,2,2,15,4,0,1,265,58,323
p_59,0,14,e_2,581,831,889,12,1,0,10,4,0,1,250,58,308
p_6,0,3,e_0,877,879,892,11,0,0,1,4,0,1,2,13,15
p_4,0,1,e_1,886,890,895,11,0,0,1,4,0,1,4,5,9
p_7,0,5,e_0,875,879,900,11,0,0,1,4,0,1,4,21,25
p_10,0,8,e_0,835,879,911,18,2,2,14,3,0,0,44,32,76
p_32,0,6,e_1,650,890,912,9,0,0,5,4,0,1,240,22,262
p_31,0,6,e_1,666,890,912,9,0,0,0,3,0,0,224,22,246
p_5,0,8,e_1,883,890,920,11,0,0,2,4,0,1,7,30,37
p_3,0,8,e_1,888,890,920,11,0,0,1,4,0,1,2,30,32
p_8,0,11,e_0,874,879,922,11,0,0,2,4,0,1,5,43,48
p_17,0,10,e_1,776,890,928,11,0,0,1,4,0,1,114,38,152
p_34,0,12,e_1,646,890,936,9,1,1,7,4,0,1,244,46,290
p_45,0,2,e_2,595,933,941,7,1,0,6,4,0,1,338,8,346
p_1,0,5,e_3,894,928,945,11,1,0,11,4,0,1,34,17,51
p_54,0,3,e_2,586,933,946,10,1,0,9,4,0,1,347,13,360
p_52,0,3,e_2,588,933,946,9,1,0,8,4,0,1,345,13,358
p_33,0,15,e_1,649,890,947,9,0,0,5,4,0,1,241,57,298
p_48,0,4,e_2,592,933,951,8,1,0,7,4,0,1,341,18,359
p_46,0,4,e_2,594,933,951,8,1,0,6,4,0,1,339,18,357
p_42,0,6,e_2,598,933,959,6,1,0,5,4,0,1,335,26,361
p_50,0,7,e_2,590,933,964,9,1,0,8,4,0,1,343,31,374
p_43,0,7,e_2,597,933,964,7,1,0,5,4,0,1,336,31,367
p_2,0,11,e_3,892,928,965,11,0,0,11,3,0,0,36,37,73
p_44,0,8,e_2,596,933,969,7,1,0,6,4,0,1,337,36,373
p_53,0,9,e_2,587,933,974,10,1,0,9,4,0,1,346,41,387
p_51,0,9,e_2,589,933,974,9,1,0,8,4,0,1,344,41,385
p_47,0,9,e_2,593,933,974,8,1,0,7,4,0,1,340,41,381
p_41,0,11,e_2,600,933,982,6,1,0,4,4,0,1,333,49,382
p_40,0,13,e_2,602,933,990,5,1,0,4,4,0,1,331,57,388
p_49,0,14,e_2,591,933,995,8,1,0,7,4,0,1,342,62,404
p_22,0,3,e_2,719,1039,1050,17,3,3,0,4,0,1,320,11,331
p_39,0,12,e_2,607,1039,1079,3,1,0,2,4,0,1,432,40,472
p_23,0,12,e_2,711,1039,1079,19,4,4,3,4,0,1,328,40,368
p_38,0,13,e_2,608,1039,1084,3,1,0,2,4,0,1,431,45,476
p_300,0,4,e_0,8,9,25,0,0,0,0,3,0,0,1,16,17
p_299,0,5,e_1,9,9,28,0,0,0,0,3,0,0,0,19,19
p_297,0,6,e_3,15,15,37,0,0,0,0,3,0,0,0,22,22
p_298,0,9,e_2,11,11,42,0,0,0,0,3,0,0,0,31,31
p_296,0,4,e_0,28,42,56,9,1,1,4,3,0,0,14,14,28
p_286,0,3,e_1,46,47,60,4,1,0,0,3,0,0,1,13,14
p_290,0,6,e_0,40,42,64,6,1,0,0,4,0,1,2,22,24
p_295,0,5,e_1,29,47,68,9,1,1,5,3,0,0,18,21,39
p_287,0,5,e_1,45,47,68,4,1,0,0,4,0,1,2,21,23
p_285,0,4,e_3,53,59,73,2,1,0,2,4,0,1,6,14,20
p_284,0,4,e_3,54,59,73,1,1,0,1,4,0,1,5,14,19
p_288,0,8,e_1,44,47,79,5,1,0,1,4,0,1,3,32,35
p_291,0,11,e_0,39,42,81,6,1,0,1,4,0,1,3,39,42
p_292,0,6,e_3,38,59,81,6,0,0,6,3,0,0,21,22,43
p_294,0,12,e_0,31,42,86,8,1,1,3,4,0,1,11,44,55
p_293,0,12,e_0,33,42,86,7,1,1,3,4,0,1,9,44,53
p_289,0,4,e_2,43,73,87,5,1,0,9,3,0,0,30,14,44
p_283,0,9,e_3,57,59,92,1,1,0,1,4,0,1,2,33,35
p_282,0,7,e_2,66,73,98,16,3,3,2,4,0,1,7,25,32
p_281,0,1,e_1,73,105,110,14,2,2,6,5,1,0,32,5,37
p_278,0,2,e_1,77,105,115,13,2,2,8,5,1,1,28,10,38
p_279,0,5,e_1,76,105,126,14,2,2,7,5,1,1,29,21,50
p_271,0,1,e_0,121,124,129,7,1,0,1,4,0,1,3,5,8
p_277,0,6,e_1,82,105,131,12,1,1,7,4,0,1,23,26,49
p_274,0,8,e_1,88,105,139,10,1,1,6,4,0,1,17,34,51
p_273,0,4,e_2,110,133,147,9,0,0,7,3,0,0,23,14,37
p_276,0,11,e_1,84,105,150,12,1,1,7,4,0,1,21,45,66
p_270,0,9,e_0,122,124,155,7,1,0,1,4,0,1,2,31,33
p_280,0,14,e_1,75,105,161,14,2,2,7,5,1,1,30,56,86
p_269,0,9,e_2,127,133,164,5,1,0,2,4,0,1,6,31,37
p_275,0,14,e_0,86,124,172,11,1,1,12,2,1,0,38,48,86
p_272,0,10,e_3,113,142,174,9,0,0,9,3,0,0,29,32,61
p_267,0,1,e_2,148,193,198,18,2,2,4,5,1,0,45,5,50
p_255,0,3,e_2,184,193,206,7,1,0,3,4,0,1,9,13,22
p_265,0,4,e_2,152,193,211,17,2,2,5,5,1,1,41,18,59
p_254,0,4,e_2,187,193,211,6,1,0,2,4,0,1,6,18,24
p_268,0,2,e_3,144,206,214,20,1,1,0,5,1,0,62,8,70
p_262,0,5,e_2,157,193,216,15,2,2,7,5,1,1,36,23,59
p_253,0,5,e_2,190,193,216,5,1,0,1,4,0,1,3,23,26
p_261,0,5,e_1,164,205,224,13,2,2,14,4,0,1,41,19,60
p_252,0,5,e_1,205,205,224,0,1,0,0,3,0,0,0,19,19
p_260,0,7,e_2,165,193,224,13,2,2,9,4,0,1,28,31,59
p_258,0,7,e_2,168,193,224,12,2,2,8,4,0,1,25,31,56
p_266,0,6,e_1,151,205,229,18,2,2,11,5,1,0,54,24,78
p_250,0,2,e_3,217,225,233,2,0,0,2,3,0,0,8,8,16
p_256,0,10,e_2,182,193,235,8,1,0,3,4,0,1,11,42,53
p_263,0,7,e_0,154,216,239,16,2,2,9,2,2,0,62,23,85
p_264,0,11,e_2,153,193,240,17,2,2,6,5,1,1,40,47,87
p_257,0,14,e_2,169,193,251,11,2,2,8,4,0,1,24,58,82
p_259,0,15,e_2,167,193,256,12,2,2,9,4,0,1,26,63,89
p_251,0,15,e_0,209,216,265,4,1,1,2,4,0,1,7,49,56
p_248,0,5,e_3,246,247,266,0,0,0,0,3,0,0,1,19,20
p_249,0,6,e_3,239,247,271,2,0,0,2,3,0,0,8,24,32
p_247,0,5,e_1,250,270,287,12,2,2,6,3,0,0,20,17,37
p_245,0,7,e_1,269,270,295,7,1,1,0,4,0,1,1,25,26
p_241,0,1,e_3,283,292,297,3,1,0,3,4,0,1,9,5,14
p_236,0,1,e_2,305,309,316,21,2,2,1,4,0,1,4,7,11
p_242,0,8,e_3,277,292,320,5,1,0,5,4,0,1,15,28,43
p_233,0,1,e_0,311,319,326,19,2,2,3,4,0,1,8,7,15
p_230,0,3,e_0,319,319,334,16,1,1,0,3,0,0,0,15,15
p_244,0,12,e_3,271,292,334,6,0,0,6,3,0,0,21,42,63
p_237,0,7,e_2,304,309,336,21,2,2,1,4,0,1,5,27,32
p_235,0,8,e_2,308,309,341,20,2,2,0,3,0,0,1,32,33
p_232,0,5,e_0,314,319,342,18,2,2,1,4,0,1,5,23,28
p_246,0,10,e_2,262,309,349,8,2,2,15,3,0,0,47,40,87
p_231,0,7,e_0,317,319,350,17,2,2,0,4,0,1,2,31,33
p_240,0,9,e_1,301,324,353,22,2,2,7,3,0,0,23,29,52
p_239,0,11,e_2,302,309,354,22,2,2,2,4,0,1,7,45,52
p_234,0,8,e_0,310,319,355,19,2,2,3,4,0,1,9,36,45
p_238,0,13,e_2,303,309,362,21,2,2,2,4,0,1,6,53,59
p_229,0,13,e_1,320,324,367,16,1,1,1,4,0,1,4,43,47
p_243,0,15,e_0,272,319,378,6,1,1,15,3,0,0,47,59,106
p_216,0,1,e_3,347,372,379,8,1,0,8,4,0,1,25,7,32
p_226,0,2,e_3,329,372,384,13,2,2,11,5,1,1,43,12,55
p_223,0,2,e_3,336,372,384,12,1,0,12,4,0,1,36,12,48
p_214,0,3,e_3,349,372,389,8,1,0,8,4,0,1,23,17,40
p_228,0,4,e_3,325,372,394,15,1,1,9,5,1,0,47,22,69
p_225,0,5,e_3,330,372,399,13,2,2,11,5,1,1,42,27,69
p_224,0,5,e_3,331,372,399,13,2,2,11,5,1,1,41,27,68
p_222,0,5,e_3,337,372,399,11,1,0,11,4,0,1,35,27,62
p_219,0,5,e_3,342,372,399,10,1,0,10,4,0,1,30,27,57
p_221,0,6,e_3,339,372,404,11,1,0,11,4,0,1,33,32,65
p_220,0,6,e_3,341,372,404,10,1,0,10,4,0,1,31,32,63
p_217,0,7,e_3,346,372,409,8,1,0,8,4,0,1,26,37,63
p_183,0,1,e_2,396,403,410,26,7,7,2,4,0,1,7,7,14
p_182,0,2,e_2,397,403,415,25,7,7,2,4,0,1,6,12,18
p_180,0,2,e_2,399,403,415,25,6,6,1,4,0,1,4,12,16
p_218,0,11,e_3,343,372,423,10,1,0,10,4,0,1,29,51,80
p_186,0,4,e_2,390,403,423,27,8,8,4,4,0,1,13,20,33
p_201,0,5,e_1,366,408,427,2,1,0,13,2,1,0,42,19,61
p_227,0,12,e_3,327,372,428,14,2,2,10,5,1,1,45,56,101
p_194,0,6,e_2,373,403,431,30,11,11,10,4,0,1,30,28,58
p_190,0,1,e_0,379,426,433,29,10,10,15,3,0,0,47,7,54
p_167,0,1,e_0,413,426,433,22,4,4,4,4,0,1,13,7,20
p_161,0,1,e_0,421,426,433,20,4,4,2,4,0,1,5,7,12
p_192,0,8,e_2,375,403,439,30,10,10,9,4,0,1,28,36,64
p_189,0,8,e_2,382,403,439,29,10,10,7,4,0,1,21,36,57
p_215,0,15,e_3,348,372,439,8,1,0,8,4,0,1,24,67,91
p_165,0,4,e_0,417,426,444,21,4,4,3,4,0,1,9,18,27
p_191,0,10,e_2,376,403,447,30,10,10,9,4,0,1,27,44,71
p_185,0,10,e_2,391,403,447,27,8,8,4,4,0,1,12,44,56
p_173,0,11,e_1,407,408,447,24,5,5,0,4,0,1,1,39,40
p_193,0,11,e_2,374,403,452,30,10,10,10,4,0,1,29,49,78
p_206,0,12,e_2,361,403,457,3,1,0,13,2,1,0,42,54,96
p_187,0,12,e_2,389,403,457,27,8,8,5,4,0,1,14,54,68
p_184,0,12,e_2,392,403,457,27,8,8,3,4,0,1,11,54,65
p_175,0,14,e_1,405,408,458,24,5,5,1,4,0,1,3,50,53
p_174,0,14,e_1,406,408,458,24,5,5,0,4,0,1,2,50,52
p_169,0,9,e_0,411,426,461,23,4,4,5,4,0,1,15,35,50
p_188,0,13,e_2,384,403,462,28,9,9,6,4,0,1,19,59,78
p_172,0,15,e_1,408,408,463,23,4,4,0,3,0,0,0,55,55
p_163,0,10,e_0,419,426,466,20,4,4,2,4,0,1,7,40,47
p_181,0,15,e_2,398,403,470,25,7,7,1,4,0,1,5,67,72
p_164,0,11,e_0,418,426,471,21,4,4,3,4,0,1,8,45,53
p_162,0,11,e_0,420,426,471,20,4,4,2,4,0,1,6,45,51
p_166,0,12,e_0,416,426,476,21,4,4,3,4,0,1,10,50,60
p_171,0,13,e_0,409,426,481,23,4,4,6,4,0,1,17,55,72
p_168,0,13,e_0,412,426,481,22,4,4,4,4,0,1,14,55,69
p_170,0,14,e_0,410,426,486,23,4,4,5,4,0,1,16,60,76
p_160,0,15,e_0,426,426,491,19,3,3,0,3,0,0,0,65,65
p_209,0,2,e_3,357,486,494,5,1,0,5,4,0,1,129,8,137
p_205,0,2,e_3,362,486,494,3,1,0,3,4,0,1,124,8,132
p_200,0,4,e_3,367,486,502,2,1,0,2,4,0,1,119,16,135
p_210,0,6,e_3,354,486,510,6,1,0,6,4,0,1,132,24,156
p_208,0,6,e_3,358,486,510,5,1,0,5,4,0,1,128,24,152
p_212,0,7,e_3,351,486,515,7,1,0,7,4,0,1,135,29,164
p_113,0,1,e_1,489,511,516,29,11,11,7,4,0,1,22,5,27
p_198,0,9,e_3,369,486,523,1,1,0,1,4,0,1,117,37,154
p_114,0,3,e_1,488,511,524,30,10,10,8,4,0,1,23,13,36
p_106,0,3,e_1,500,511,524,27,10,10,4,4,0,1,11,13,24
p_197,0,10,e_3,370,486,528,1,1,0,1,4,0,1,116,42,158
p_178,0,3,e_2,401,517,530,25,6,6,0,4,0,1,116,13,129
p_207,0,11,e_3,359,486,533,4,1,0,4,4,0,1,127,47,174
p_108,0,6,e_1,496,511,535,28,10,10,5,4,0,1,15,24,39
p_176,0,4,e_2,403,517,535,24,5,5,0,3,0,0,114,18,132
p_203,0,12,e_3,364,486,538,2,1,0,2,4,0,1,122,52,174
p_102,0,7,e_1,509,511,540,24,9,9,1,4,0,1,2,29,31
p_99,0,6,e_2,514,517,543,23,7,7,1,4,0,1,3,26,29
p_96,0,1,e_0,517,538,543,23,7,7,7,4,0,1,21,5,26
p_111,0,8,e_1,491,511,545,29,11,11,6,4,0,1,20,34,54
p_204,0,14,e_3,363,486,546,3,1,0,3,4,0,1,123,60,183
p_98,0,7,e_2,515,517,548,23,7,7,1,4,0,1,2,31,33
p_97,0,7,e_2,516,517,548,23,7,7,0,3,0,0,1,31,32
p_115,0,9,e_1,487,511,550,30,10,10,8,4,0,1,24,39,63
p_213,0,15,e_3,350,486,551,7,1,0,7,4,0,1,136,65,201
p_211,0,15,e_3,353,486,551,6,1,0,6,4,0,1,133,65,198
p_202,0,15,e_3,365,486,551,2,1,0,2,4,0,1,121,65,186
p_199,0,15,e_3,368,486,551,1,1,0,1,4,0,1,118,65,183
p_179,0,8,e_2,400,517,553,25,6,6,1,4,0,1,117,36,153
p_101,0,8,e_2,511,517,553,24,8,8,2,4,0,1,6,36,42
p_92,0,4,e_0,525,538,554,21,6,6,4,4,0,1,13,16,29
p_116,0,10,e_1,486,511,555,30,10,10,8,4,0,1,25,44,69
p_177,0,9,e_2,402,517,558,25,6,6,0,4,0,1,115,41,156
p_100,0,9,e_2,513,517,558,23,8,8,1,4,0,1,4,41,45
p_138,0,11,e_1,463,511,560,8,1,0,15,3,0,0,48,49,97
p_110,0,11,e_1,492,511,560,28,11,11,6,4,0,1,19,49,68
p_107,0,11,e_1,499,511,560,27,10,10,4,4,0,1,12,49,61
p_103,0,11,e_1,508,511,560,25,9,9,1,4,0,1,3,49,52
p_94,0,6,e_0,519,538,562,22,7,7,6,4,0,1,19,24,43
p_105,0,12,e_1,502,511,565,4,9,9,3,4,0,1,9,54,63
p_104,0,14,e_1,503,511,573,26,9,9,3,4,0,1,8,62,70
p_89,0,9,e_0,535,538,573,19,4,4,1,4,0,1,3,35,38
p_109,0,15,e_1,493,511,578,28,10,10,6,4,0,1,18,67,85
p_112,0,11,e_0,490,538,581,29,11,11,15,2,1,0,48,43,91
p_91,0,12,e_0,526,538,586,20,6,6,4,4,0,1,12,48,60
p_93,0,13,e_0,520,538,591,22,7,7,6,4,0,1,18,53,71
p_90,0,13,e_0,527,538,591,20,5,5,3,4,0,1,11,53,64
p_65,0,1,e_2,573,587,594,8,1,0,5,4,0,1,14,7,21
p_95,0,14,e_0,518,538,596,22,7,7,7,4,0,1,20,58,78
p_86,0,2,e_2,544,587,599,16,3,3,6,5,3,0,43,12,55
p_72,0,3,e_2,562,587,604,12,1,0,8,4,0,1,25,17,42
p_71,0,3,e_2,564,587,604,11,1,0,8,4,0,1,23,17,40
p_70,0,3,e_2,565,587,604,11,1,0,7,4,0,1,22,17,39
p_67,0,3,e_2,568,587,604,10,1,0,6,4,0,1,19,17,36
p_66,0,3,e_2,569,587,604,10,1,0,6,4,0,1,18,17,35
p_158,0,1,e_3,430,598,605,18,2,2,12,5,1,1,168,7,175
p_64,0,4,e_2,574,587,609,8,1,0,4,4,0,1,13,22,35
p_75,0,5,e_2,559,587,614,13,1,0,9,4,0,1,28,27,55
p_196,0,4,e_3,371,598,616,0,0,0,0,3,0,0,227,18,245
p_76,0,6,e_2,558,587,619,13,1,0,9,4,0,1,29,32,61
p_159,0,6,e_3,429,598,624,18,2,2,12,5,1,1,169,26,195
p_150,0,6,e_3,443,598,624,14,1,0,14,4,0,1,155,26,181
p_74,0,7,e_2,560,587,624,13,1,0,9,4,0,1,27,37,64
p_154,0,7,e_3,436,598,629,16,2,2,14,5,1,1,162,31,193
p_148,0,8,e_3,449,598,634,12,1,0,12,4,0,1,149,36,185
p_73,0,11,e_2,561,587,638,12,1,0,9,4,0,1,26,51,77
p_153,0,9,e_3,437,598,639,15,2,2,15,5,1,1,161,41,202
p_147,0,9,e_3,452,598,639,11,1,0,11,4,0,1,146,41,187
p_68,0,13,e_2,567,587,646,10,1,0,7,4,0,1,20,59,79
p_63,0,13,e_2,577,587,646,7,1,0,3,4,0,1,10,59,69
p_69,0,14,e_2,566,587,651,11,1,0,7,4,0,1,21,64,85
p_37,0,9,e_1,615,625,654,26,8,8,3,4,0,1,10,29,39
p_157,0,14,e_3,431,598,656,17,2,2,13,5,1,1,167,58,225
p_155,0,14,e_3,435,598,656,16,2,2,14,5,1,1,163,58,221
p_195,0,15,e_3,372,598,661,0,1,1,0,3,0,1,226,63,289
p_156,0,15,e_3,434,598,661,16,2,2,14,5,1,1,164,63,227
p_152,0,15,e_3,441,598,661,15,1,0,15,4,0,1,157,63,220
p_151,0,15,e_3,442,598,661,14,1,0,14,4,0,1,156,63,219
p_149,0,15,e_3,444,598,661,14,1,0,14,4,0,1,154,63,217
p_41,0,11,e_1,600,625,662,30,8,8,8,4,0,1,25,37,62
p_42,0,6,e_0,598,643,663,0,1,1,14,3,0,0,45,20,65
p_39,0,12,e_1,607,625,667,29,8,8,6,4,0,1,18,42,60
p_62,0,13,e_1,578,625,672,6,1,0,15,2,1,0,47,47,94
p_40,0,13,e_1,602,625,672,30,8,8,7,4,0,1,23,47,70
p_38,0,13,e_1,608,625,672,29,8,8,6,4,0,1,17,47,64
p_35,0,9,e_0,630,643,674,23,5,5,4,4,0,1,13,31,44
p_36,0,13,e_0,628,643,688,23,6,6,5,4,0,1,15,45,60
p_55,0,3,e_2,585,695,708,4,1,0,0,4,0,1,110,13,123
p_54,0,3,e_2,586,695,708,4,1,0,0,4,0,1,109,13,122
p_30,0,3,e_2,668,695,708,13,1,0,9,4,0,1,27,13,40
p_146,0,1,e_3,453,708,713,11,1,0,11,4,0,1,255,5,260
p_29,0,5,e_2,670,695,716,12,1,0,8,4,0,1,25,21,46
p_143,0,3,e_3,456,708,721,10,1,0,10,4,0,1,252,13,265
p_136,0,3,e_3,465,708,721,7,1,0,7,4,0,1,243,13,256
p_61,0,6,e_2,579,695,721,6,1,0,2,4,0,1,116,26,142
p_56,0,6,e_2,584,695,721,5,1,0,1,4,0,1,111,26,137
p_32,0,6,e_2,650,695,721,18,3,3,14,2,1,1,45,26,71
p_31,0,6,e_2,666,695,721,14,1,0,10,4,0,1,29,26,55
p_137,0,4,e_3,464,708,726,7,1,0,7,4,0,1,244,18,262
p_53,0,9,e_2,587,695,732,4,1,0,0,3,0,0,108,37,145
p_141,0,6,e_3,458,708,734,9,1,0,9,4,0,1,250,26,276
p_60,0,10,e_2,580,695,737,6,1,0,2,4,0,1,115,42,157
p_58,0,11,e_2,582,695,742,5,1,0,1,4,0,1,113,47,160
p_57,0,11,e_2,583,695,742,5,1,0,1,4,0,1,112,47,159
p_140,0,8,e_3,459,708,742,9,1,0,9,4,0,1,249,34,283
p_34,0,12,e_2,646,695,747,19,3,3,13,5,1,1,49,52,101
p_144,0,9,e_3,455,708,747,10,1,0,10,4,0,1,253,39,292
p_142,0,9,e_3,457,708,747,9,1,0,9,4,0,1,251,39,290
p_28,0,11,e_1,676,717,752,11,1,0,13,3,0,0,41,35,76
p_139,0,10,e_3,461,708,752,8,1,0,8,4,0,1,247,44,291
p_135,0,10,e_3,466,708,752,6,1,0,6,4,0,1,242,44,286
p_59,0,14,e_2,581,695,755,6,1,0,2,4,0,1,114,60,174
p_145,0,11,e_3,454,708,757,11,1,0,11,4,0,1,254,49,303
p_132,0,11,e_3,470,708,757,5,1,0,5,4,0,1,238,49,287
p_33,0,15,e_2,649,695,760,18,3,3,13,5,1,1,46,65,111
p_133,0,12,e_3,469,708,762,5,1,0,5,4,0,1,239,54,293
p_22,0,3,e_0,719,752,763,27,11,11,11,4,0,1,33,11,44
p_21,0,4,e_0,731,752,768,25,9,9,7,4,0,1,21,16,37
p_131,0,14,e_3,471,708,770,5,1,0,5,4,0,1,237,62,299
p_134,0,15,e_3,467,708,775,6,1,0,6,4,0,1,241,67,308
p_23,0,12,e_0,711,752,794,30,11,11,13,3,0,0,41,42,83
p_16,0,2,e_1,780,789,797,14,1,0,3,4,0,1,9,8,17
p_20,0,14,e_0,734,752,802,24,8,8,6,4,0,1,18,50,68
p_24,0,2,e_2,695,807,817,4,1,0,0,3,0,0,112,10,122
p_18,0,10,e_1,766,789,823,17,3,3,7,4,0,1,23,34,57
p_17,0,10,e_1,776,789,823,15,1,0,4,4,0,1,13,34,47
p_14,0,4,e_2,794,807,825,9,1,0,4,4,0,1,13,18,31
p_130,0,1,e_3,472,822,827,5,1,0,5,4,0,1,350,5,355
p_119,0,1,e_3,483,822,827,1,1,0,1,4,0,1,339,5,344
p_19,0,11,e_1,754,789,828,20,5,5,11,3,0,0,35,39,74
p_129,0,3,e_3,473,822,835,4,1,0,4,4,0,1,349,13,362
p_26,0,8,e_2,684,807,839,8,1,0,3,4,0,1,123,32,155
p_25,0,8,e_2,686,807,839,7,1,0,3,4,0,1,121,32,153
p_88,0,5,e_3,538,822,843,18,3,3,12,2,3,1,284,21,305
p_15,0,9,e_2,793,807,844,10,1,0,5,4,0,1,14,37,51
p_11,0,9,e_2,807,807,844,5,1,0,0,3,0,0,0,37,37
p_27,0,10,e_2,677,807,849,10,1,0,6,4,0,1,130,42,172
p_124,0,7,e_3,478,822,851,3,1,0,3,4,0,1,344,29,373
p_118,0,7,e_3,484,822,851,0,1,0,0,4,0,1,338,29,367
p_13,0,11,e_2,796,807,854,8,1,0,3,4,0,1,11,47,58
p_12,0,11,e_2,798,807,854,8,1,0,3,4,0,1,9,47,56
p_127,0,10,e_3,475,822,862,3,1,0,3,4,0,1,347,40,387
p_117,0,10,e_3,485,822,862,0,1,0,0,4,0,1,337,40,377
p_128,0,11,e_3,474,822,867,4,1,0,4,4,0,1,348,45,393
p_123,0,11,e_3,479,822,867,2,1,0,2,4,0,1,343,45,388
p_121,0,11,e_3,481,822,867,2,1,0,2,4,0,1,341,45,386
p_120,0,11,e_3,482,822,867,1,1,0,1,4,0,1,340,45,385
p_126,0,12,e_3,476,822,872,3,1,0,3,4,0,1,346,50,396
p_125,0,14,e_3,477,822,880,3,1,0,3,4,0,1,345,58,403
p_122,0,15,e_3,480,822,885,2,1,0,2,4,0,1,342,63,405
p_4,0,1,e_0,886,891,896,15,1,0,1,4,0,1,5,5,10
p_10,0,8,e_1,835,871,897,27,8,8,11,3,0,0,36,26,62
p_9,0,2,e_0,846,891,901,24,7,7,14,3,0,0,45,10,55
p_6,0,3,e_0,877,891,906,17,3,3,5,4,0,1,14,15,29
p_7,0,5,e_0,875,891,914,17,3,3,5,4,0,1,16,23,39
p_5,0,8,e_0,883,891,925,15,2,2,3,4,0,1,8,34,42
p_3,0,8,e_0,888,891,925,15,1,0,1,4,0,1,3,34,37
p_1,0,5,e_2,894,909,926,12,1,0,5,4,0,1,15,17,32
p_77,0,3,e_3,557,932,943,13,1,0,13,4,0,1,375,11,386
p_52,0,3,e_3,588,932,943,3,1,0,3,4,0,1,344,11,355
p_8,0,11,e_2,874,909,946,18,3,3,11,3,0,0,35,37,72
p_2,0,11,e_2,892,909,946,13,1,0,6,4,0,1,17,37,54
p_48,0,4,e_3,592,932,948,2,1,0,2,4,0,1,340,16,356
p_80,0,7,e_3,552,932,959,15,1,0,15,4,0,1,380,27,407
p_50,0,7,e_3,590,932,959,3,1,0,3,4,0,1,342,27,369
p_87,0,8,e_3,539,932,964,18,3,3,12,5,2,1,393,32,425
p_83,0,8,e_3,549,932,964,16,2,2,14,5,1,1,383,32,415
p_51,0,9,e_3,589,932,969,3,1,0,3,4,0,1,343,37,380
p_84,0,12,e_3,546,932,980,16,2,2,14,5,1,1,386,48,434
p_78,0,12,e_3,556,932,980,14,1,0,14,4,0,1,376,48,424
p_82,0,14,e_3,550,932,988,15,1,1,15,2,1,1,382,56,438
p_81,0,14,e_3,551,932,988,15,1,1,15,2,1,1,381,56,437
p_79,0,14,e_3,553,932,988,15,1,0,15,4,0,1,379,56,435
p_49,0,14,e_3,591,932,988,2,1,0,2,4,0,1,341,56,397
p_85,0,15,e_3,545,932,993,16,3,3,14,5,2,1,387,61,448
p_45,0,2,e_3,595,1040,1048,1,1,0,1,4,0,1,445,8,453
p_46,0,4,e_3,594,1040,1056,1,1,0,1,4,0,1,446,16,462
p_43,0,7,e_3,597,1040,1067,0,0,0,0,3,0,0,443,27,470
p_44,0,8,e_3,596,1040,1072,0,1,0,0,4,0,1,444,32,476
p_47,0,9,e_3,593,1040,1077,2,1,0,2,4,0,1,447,37,484
p_300,0,4,e_0,8,8,24,0,0,0,0,3,0,0,0,16,16
p_299,0,5,e_1,9,9,28,0,0,0,0,3,0,0,0,19,19
p_297,0,6,e_3,15,16,38,0,0,0,0,3,0,0,1,22,23
p_298,0,9,e_2,11,12,43,0,0,0,0,3,0,0,1,31,32
p_296,0,4,e_0,28,42,56,9,1,1,4,3,0,0,14,14,28
p_289,0,4,e_1,43,46,60,6,0,0,1,4,0,1,3,14,17
p_292,0,6,e_0,38,42,64,6,0,0,1,4,0,1,4,22,26
p_290,0,6,e_0,40,42,64,6,0,0,0,4,0,1,2,22,24
p_295,0,5,e_1,29,46,65,9,1,1,5,3,0,0,17,19,36
p_287,0,5,e_1,45,46,65,6,0,0,0,4,0,1,1,19,20
p_288,0,8,e_1,44,46,76,6,0,0,1,4,0,1,2,30,32
p_286,0,3,e_3,46,67,80,6,0,0,6,3,0,0,21,13,34
p_291,0,11,e_0,39,42,81,6,0,0,1,4,0,1,3,39,42
p_284,0,4,e_3,54,67,85,4,1,0,4,4,0,1,13,18,31
p_294,0,12,e_0,31,42,86,8,1,1,3,4,0,1,11,44,55
p_293,0,12,e_0,33,42,86,8,1,1,3,4,0,1,9,44,53
p_281,0,1,e_2,73,83,90,17,4,4,3,4,0,1,10,7,17
p_278,0,2,e_2,77,83,95,16,4,4,2,4,0,1,6,12,18
p_282,0,7,e_3,66,67,96,0,0,0,0,3,0,0,1,29,30
p_285,0,4,e_2,53,83,103,5,1,0,9,3,0,0,30,20,50
p_283,0,9,e_3,57,67,104,3,1,0,3,4,0,1,10,37,47
p_279,0,5,e_2,76,83,108,16,4,4,2,4,0,1,7,25,32
p_277,0,6,e_2,82,83,113,15,3,3,0,3,0,0,1,30,31
p_271,0,1,e_0,121,124,129,6,1,0,1,4,0,1,3,5,8
p_274,0,8,e_1,88,110,136,13,2,2,7,4,0,1,22,26,48
p_280,0,14,e_2,75,83,139,17,4,4,2,4,0,1,8,56,64
p_276,0,11,e_1,84,110,147,14,3,3,8,3,0,0,26,37,63
p_273,0,4,e_3,110,139,153,9,0,0,9,3,0,0,29,14,43
p_270,0,9,e_0,122,124,155,6,1,0,0,4,0,1,2,31,33
p_272,0,10,e_0,113,124,160,8,1,0,3,4,0,1,11,36,47
p_269,0,9,e_3,127,139,170,4,1,0,4,4,0,1,12,31,43
p_275,0,14,e_0,86,124,174,14,2,2,12,2,1,0,38,50,88
p_267,0,1,e_1,148,183,190,16,2,2,11,3,0,0,35,7,42
p_268,0,2,e_2,144,188,198,17,2,2,14,3,0,0,44,10,54
p_265,0,4,e_1,152,183,201,14,2,2,10,4,0,1,31,18,49
p_255,0,3,e_2,184,188,203,5,1,0,1,4,0,1,4,15,19
p_262,0,5,e_1,157,183,206,13,1,1,8,4,0,1,26,23,49
p_261,0,5,e_1,164,183,206,11,1,1,6,4,0,1,19,23,42
p_254,0,4,e_2,187,188,208,4,1,0,0,3,0,0,1,20,21
p_266,0,6,e_1,151,183,211,14,2,2,10,4,0,1,32,28,60
p_253,0,5,e_3,190,199,216,3,1,0,3,4,0,1,9,17,26
p_263,0,7,e_1,154,183,216,14,1,1,9,4,0,1,29,33,62
p_260,0,7,e_1,165,183,216,10,1,1,6,4,0,1,18,33,51
p_258,0,7,e_1,168,183,216,10,1,1,5,4,0,1,15,33,48
p_256,0,10,e_1,182,183,227,5,1,0,0,3,0,0,1,44,45
p_250,0,2,e_2,217,223,231,23,1,1,2,4,0,1,6,8,14
p_264,0,11,e_1,153,183,232,4,1,1,10,4,0,1,30,49,79
p_257,0,14,e_3,169,199,245,9,0,0,9,2,1,0,30,46,76
p_259,0,15,e_1,167,183,246,10,1,1,5,4,0,1,16,63,79
p_252,0,5,e_0,205,249,266,27,2,2,14,3,0,0,44,17,61
p_248,0,5,e_0,246,249,266,14,0,0,1,4,0,1,3,17,20
p_249,0,6,e_0,239,249,271,16,1,1,3,4,0,1,10,22,32
p_251,0,15,e_2,209,223,272,25,2,2,4,3,0,0,14,49,63
p_241,0,1,e_0,283,291,296,4,1,0,3,4,0,1,8,5,13
p_247,0,5,e_3,250,295,312,14,0,0,14,3,0,0,45,17,62
p_236,0,1,e_1,305,310,317,11,2,2,2,4,0,1,5,7,12
p_242,0,8,e_0,277,291,319,6,1,0,5,4,0,1,14,28,42
p_245,0,7,e_3,269,295,320,8,1,0,8,4,0,1,26,25,51
p_244,0,12,e_0,271,291,333,8,1,0,6,2,1,0,20,42,62
p_237,0,7,e_1,304,310,337,12,2,2,2,4,0,1,6,27,33
p_235,0,8,e_1,308,310,342,10,2,2,1,4,0,1,2,32,34
p_234,0,8,e_1,310,310,342,9,2,2,0,3,0,0,0,32,32
p_243,0,15,e_0,272,291,344,8,1,0,6,4,0,1,19,53,72
p_240,0,9,e_1,301,310,347,12,2,2,3,4,0,1,9,37,46
p_246,0,10,e_1,262,310,352,11,1,0,15,3,0,0,48,42,90
p_226,0,2,e_3,329,343,353,5,1,0,5,4,0,1,14,10,24
p_223,0,2,e_3,336,343,353,2,1,0,2,4,0,1,7,10,17
p_239,0,11,e_1,302,310,357,12,2,2,3,4,0,1,8,47,55
p_228,0,4,e_3,325,343,361,6,1,0,6,4,0,1,18,18,36
p_238,0,13,e_1,303,310,365,12,2,2,2,4,0,1,7,55,62
p_233,0,1,e_2,311,358,365,9,2,2,15,3,0,0,47,7,54
p_216,0,1,e_2,347,358,365,26,7,7,3,4,0,1,11,7,18
p_225,0,5,e_3,330,343,366,4,1,0,4,4,0,1,13,23,36
p_224,0,5,e_3,331,343,366,4,1,0,4,4,0,1,12,23,35
p_222,0,5,e_3,337,343,366,2,1,0,2,4,0,1,6,23,29
p_219,0,5,e_3,342,343,366,0,1,0,0,4,0,1,1,23,24
p_209,0,2,e_2,357,358,370,23,6,6,0,4,0,1,1,12,13
p_221,0,6,e_3,339,343,371,1,1,0,1,4,0,1,4,28,32
p_220,0,6,e_3,341,343,371,1,1,0,1,4,0,1,2,28,30
p_230,0,3,e_2,319,358,375,7,1,1,13,4,0,1,39,17,56
p_214,0,3,e_2,349,358,375,25,7,7,3,4,0,1,9,17,26
p_232,0,5,e_2,314,358,383,9,1,1,15,4,0,1,44,25,69
p_210,0,6,e_2,354,358,388,24,6,6,1,4,0,1,4,30,34
p_208,0,6,e_2,358,358,388,23,6,6,0,3,0,0,0,30,30
p_218,0,11,e_3,343,343,388,0,0,0,0,3,0,0,0,45,45
p_231,0,7,e_2,317,358,393,8,1,1,14,4,0,1,41,35,76
p_217,0,7,e_2,346,358,393,26,7,7,4,4,0,1,12,35,47
p_212,0,7,e_2,351,358,393,25,7,7,2,4,0,1,7,35,42
p_227,0,12,e_3,327,343,393,5,1,0,5,4,0,1,16,50,66
p_229,0,13,e_3,320,343,398,7,0,0,7,2,1,0,23,55,78
p_205,0,2,e_0,362,406,416,22,5,5,15,4,0,1,44,10,54
p_215,0,15,e_2,348,358,419,26,7,7,3,4,0,1,10,61,71
p_213,0,15,e_2,350,358,419,25,7,7,2,4,0,1,8,61,69
p_211,0,15,e_2,353,358,419,24,6,6,1,4,0,1,5,61,66
p_178,0,3,e_1,401,406,419,13,0,0,1,4,0,1,5,13,18
p_200,0,4,e_0,367,406,424,21,4,4,13,4,0,1,39,18,57
p_196,0,4,e_0,371,406,424,20,3,3,11,4,0,1,35,18,53
p_201,0,5,e_0,366,406,429,21,4,4,13,4,0,1,40,23,63
p_194,0,6,e_0,373,406,434,20,3,3,11,4,0,1,33,28,61
p_192,0,8,e_0,375,406,442,19,3,3,10,4,0,1,31,36,67
p_193,0,11,e_1,374,406,445,20,3,3,10,4,0,1,32,39,71
p_198,0,9,e_0,369,406,447,21,4,4,12,4,0,1,37,41,78
p_203,0,12,e_1,364,406,450,22,5,5,13,2,1,0,42,44,86
p_184,0,12,e_1,392,406,450,14,2,2,4,4,0,1,14,44,58
p_197,0,10,e_0,370,406,452,20,3,3,12,4,0,1,36,46,82
p_191,0,10,e_0,376,406,452,19,3,3,10,4,0,1,30,46,76
p_167,0,1,e_3,413,449,454,12,1,0,12,4,0,1,36,5,41
p_161,0,1,e_3,421,449,454,9,1,0,9,4,0,1,28,5,33
p_207,0,11,e_0,359,406,457,23,6,6,15,3,0,0,47,51,98
p_174,0,14,e_1,406,406,458,13,0,0,0,3,0,0,0,52,52
p_206,0,12,e_0,361,406,462,22,5,5,15,4,0,1,45,56,101
p_165,0,4,e_3,417,449,465,10,1,0,10,4,0,1,32,16,48
p_204,0,14,e_0,363,406,470,22,5,5,14,4,0,1,43,64,107
p_159,0,6,e_3,429,449,473,7,1,0,7,4,0,1,20,24,44
p_202,0,15,e_0,365,406,475,21,5,5,13,4,0,1,41,69,110
p_199,0,15,e_0,368,406,475,21,4,4,13,4,0,1,38,69,107
p_195,0,15,e_0,372,406,475,20,3,3,11,4,0,1,34,69,103
p_169,0,9,e_3,411,449,484,13,1,0,13,4,0,1,38,35,73
p_163,0,10,e_3,419,449,489,10,1,0,10,4,0,1,30,40,70
p_173,0,11,e_3,407,449,494,13,0,0,13,3,0,0,42,45,87
p_164,0,11,e_3,418,449,494,10,1,0,10,4,0,1,31,45,76
p_162,0,11,e_3,420,449,494,9,1,0,9,4,0,1,29,45,74
p_166,0,12,e_3,416,449,499,11,1,0,11,4,0,1,33,50,83
p_146,0,1,e_2,453,497,502,29,11,11,15,4,0,1,44,5,49
p_171,0,13,e_3,409,449,504,13,1,0,13,4,0,1,40,55,95
p_168,0,13,e_3,412,449,504,12,1,0,12,4,0,1,37,55,92
p_170,0,14,e_3,410,449,509,13,1,0,13,4,0,1,39,60,99
p_143,0,3,e_2,456,497,510,29,10,10,13,4,0,1,41,13,54
p_136,0,3,e_2,465,497,510,26,9,9,10,4,0,1,32,13,45
p_172,0,15,e_3,408,449,514,13,1,0,13,4,0,1,41,65,106
p_160,0,15,e_3,426,449,514,8,1,0,8,4,0,1,23,65,88
p_106,0,3,e_1,500,502,515,18,4,4,0,4,0,1,2,13,15
p_137,0,4,e_2,464,497,515,4,9,9,11,4,0,1,33,18,51
p_141,0,6,e_2,458,497,523,28,10,10,13,4,0,1,39,26,65
p_190,0,1,e_0,379,522,527,18,3,3,9,4,0,1,143,5,148
p_183,0,1,e_0,396,522,527,13,1,1,3,4,0,1,126,5,131
p_148,0,8,e_2,449,497,531,30,10,10,15,3,0,0,48,34,82
p_140,0,8,e_2,459,497,531,28,10,10,12,4,0,1,38,34,72
p_182,0,2,e_0,397,522,532,13,1,1,3,4,0,1,125,10,135
p_180,0,2,e_0,399,522,532,13,0,0,2,4,0,1,123,10,133
p_142,0,9,e_1,457,502,535,28,10,10,14,2,1,0,45,33,78
p_147,0,9,e_2,452,497,536,29,11,11,15,4,0,1,45,39,84
p_144,0,9,e_2,455,497,536,29,10,10,14,4,0,1,42,39,81
p_186,0,4,e_0,390,522,540,15,2,2,5,4,0,1,132,18,150
p_176,0,4,e_0,403,522,540,13,0,0,1,4,0,1,119,18,137
p_139,0,10,e_2,461,497,541,27,10,10,12,4,0,1,36,44,80
p_135,0,10,e_2,466,497,541,26,9,9,10,4,0,1,31,44,75
p_107,0,11,e_1,499,502,543,18,4,4,1,4,0,1,3,41,44
p_145,0,11,e_2,454,497,546,29,10,10,14,4,0,1,43,49,92
p_138,0,11,e_2,463,497,546,27,10,10,11,4,0,1,34,49,83
p_105,0,12,e_1,502,502,548,18,4,4,0,3,0,0,0,46,46
p_133,0,12,e_2,469,497,551,25,9,9,9,4,0,1,28,54,82
p_189,0,8,e_0,382,522,554,17,3,3,8,4,0,1,140,32,172
p_179,0,8,e_0,400,522,554,13,0,0,2,4,0,1,122,32,154
p_177,0,9,e_0,402,522,559,13,0,0,1,4,0,1,120,37,157
p_134,0,15,e_2,467,497,562,26,9,9,10,4,0,1,30,65,95
p_185,0,10,e_0,391,522,564,14,2,2,5,4,0,1,131,42,173
p_158,0,1,e_3,430,561,566,6,1,0,6,4,0,1,131,5,136
p_187,0,12,e_0,389,522,572,15,2,2,5,4,0,1,133,50,183
p_92,0,4,e_3,525,561,577,12,1,0,12,4,0,1,36,16,52
p_188,0,13,e_0,384,522,577,16,3,3,7,4,0,1,138,55,193
p_175,0,14,e_0,405,522,582,13,0,0,0,3,0,0,117,60,177
p_104,0,14,e_0,503,522,582,17,3,3,6,4,0,1,19,60,79
p_88,0,5,e_3,538,561,582,7,1,0,7,4,0,1,23,21,44
p_150,0,6,e_3,443,561,587,2,1,0,2,4,0,1,118,26,144
p_181,0,15,e_0,398,522,587,13,0,0,2,4,0,1,124,65,189
p_154,0,7,e_3,436,561,592,4,1,0,4,4,0,1,125,31,156
p_153,0,9,e_3,437,561,600,4,1,0,4,4,0,1,124,39,163
p_89,0,9,e_3,535,561,600,9,1,0,9,4,0,1,26,39,65
p_65,0,1,e_1,573,600,607,27,10,10,9,4,0,1,27,7,34
p_91,0,12,e_3,526,561,611,11,1,0,11,4,0,1,35,50,85
p_72,0,3,e_1,562,600,615,30,10,10,12,4,0,1,38,15,53
p_71,0,3,e_1,564,600,615,30,10,10,12,4,0,1,36,15,51
p_70,0,3,e_1,565,600,615,29,10,10,12,4,0,1,35,15,50
p_67,0,3,e_1,568,600,615,29,10,10,11,4,0,1,32,15,47
p_66,0,3,e_1,569,600,615,28,10,10,10,4,0,1,31,15,46
p_90,0,13,e_3,527,561,616,11,1,0,11,4,0,1,34,55,89
p_130,0,1,e_2,472,609,616,24,8,8,8,4,0,1,137,7,144
p_119,0,1,e_2,483,609,616,21,7,7,5,4,0,1,126,7,133
p_64,0,4,e_1,574,600,620,27,10,10,8,4,0,1,26,20,46
p_157,0,14,e_3,431,561,621,6,1,0,6,4,0,1,130,60,190
p_155,0,14,e_3,435,561,621,5,1,0,5,4,0,1,126,60,186
p_129,0,3,e_2,473,609,624,24,8,8,8,4,0,1,136,15,151
p_156,0,15,e_3,434,561,626,5,1,0,5,4,0,1,127,65,192
p_152,0,15,e_3,441,561,626,3,1,0,3,4,0,1,120,65,185
p_151,0,15,e_3,442,561,626,2,1,0,2,4,0,1,119,65,184
p_149,0,15,e_3,444,561,626,2,1,0,2,4,0,1,117,65,182
p_61,0,6,e_1,579,600,628,26,9,9,7,4,0,1,21,28,49
p_124,0,7,e_2,478,609,638,23,8,8,6,4,0,1,131,29,160
p_118,0,7,e_2,484,609,638,21,7,7,4,4,0,1,125,29,154
p_96,0,1,e_0,517,634,639,14,1,0,1,4,0,1,117,5,122
p_60,0,10,e_1,580,600,642,26,9,9,7,4,0,1,20,42,62
p_73,0,11,e_1,561,600,647,30,10,10,12,3,0,0,39,47,86
p_127,0,10,e_2,475,609,649,24,8,8,7,4,0,1,134,40,174
p_132,0,11,e_2,470,609,654,25,9,9,9,4,0,1,139,45,184
p_128,0,11,e_2,474,609,654,24,8,8,8,4,0,1,135,45,180
p_123,0,11,e_2,479,609,654,23,8,8,6,4,0,1,130,45,175
p_121,0,11,e_2,481,609,654,22,8,8,5,4,0,1,128,45,173
p_120,0,11,e_2,482,609,654,22,8,8,5,4,0,1,127,45,172
p_68,0,13,e_1,567,600,655,29,10,10,11,4,0,1,33,55,88
p_63,0,13,e_1,577,600,655,26,9,9,8,4,0,1,23,55,78
p_62,0,13,e_1,578,600,655,26,9,9,7,4,0,1,22,55,77
p_99,0,6,e_0,514,634,656,15,1,1,2,4,0,1,120,22,142
p_94,0,6,e_0,519,634,656,14,1,0,1,4,0,1,115,22,137
p_126,0,12,e_2,476,609,659,24,8,8,7,4,0,1,133,50,183
p_69,0,14,e_1,566,600,660,29,10,10,11,4,0,1,34,60,94
p_59,0,14,e_1,581,600,660,25,9,9,6,4,0,1,19,60,79
p_102,0,7,e_0,509,634,661,16,2,2,4,4,0,1,125,27,152
p_98,0,7,e_0,515,634,661,15,1,0,2,4,0,1,119,27,146
p_97,0,7,e_0,516,634,661,15,1,0,2,4,0,1,118,27,145
p_101,0,8,e_0,511,634,666,16,2,2,4,4,0,1,123,32,155
p_131,0,14,e_2,471,609,667,24,9,9,9,4,0,1,138,58,196
p_125,0,14,e_2,477,609,667,23,8,8,7,4,0,1,132,58,190
p_100,0,9,e_0,513,634,671,15,2,2,3,4,0,1,121,37,158
p_37,0,9,e_0,615,634,671,17,4,4,6,4,0,1,19,37,56
p_35,0,9,e_0,630,634,671,14,1,0,1,4,0,1,4,37,41
p_122,0,15,e_2,480,609,672,22,8,8,6,4,0,1,129,63,192
p_103,0,11,e_0,508,634,679,16,2,2,4,4,0,1,126,45,171
p_86,0,2,e_3,544,673,681,6,1,0,6,4,0,1,129,8,137
p_77,0,3,e_3,557,673,686,1,1,0,1,4,0,1,116,13,129
p_93,0,13,e_0,520,634,687,13,1,0,0,4,0,1,114,53,167
p_36,0,13,e_0,628,634,687,15,1,0,2,4,0,1,6,53,59
p_95,0,14,e_0,518,634,692,14,1,0,1,4,0,1,116,58,174
p_75,0,5,e_3,559,673,694,0,1,0,0,4,0,1,114,21,135
p_76,0,6,e_3,558,673,699,1,1,0,1,4,0,1,115,26,141
p_80,0,7,e_3,552,673,704,3,1,0,3,4,0,1,121,31,152
p_74,0,7,e_3,560,673,704,0,1,0,0,4,0,1,113,31,144
p_87,0,8,e_3,539,673,709,7,1,0,7,4,0,1,134,36,170
p_83,0,8,e_3,549,673,709,4,1,0,4,4,0,1,124,36,160
p_45,0,2,e_1,595,704,712,22,6,6,1,4,0,1,109,8,117
p_55,0,3,e_1,585,704,717,25,8,8,5,4,0,1,119,13,132
p_54,0,3,e_1,586,704,717,24,7,7,5,4,0,1,118,13,131
p_52,0,3,e_1,588,704,717,24,7,7,4,4,0,1,116,13,129
p_48,0,4,e_1,592,704,722,23,6,6,3,4,0,1,112,18,130
p_46,0,4,e_1,594,704,722,23,6,6,2,4,0,1,110,18,128
p_84,0,12,e_3,546,673,723,5,1,0,5,4,0,1,127,50,177
p_78,0,12,e_3,556,673,723,2,1,0,2,4,0,1,117,50,167
p_34,0,12,e_3,646,673,723,9,1,0,9,4,0,1,27,50,77
p_113,0,1,e_2,489,719,724,20,6,6,2,4,0,1,230,5,235
p_56,0,6,e_1,584,704,730,25,8,8,5,4,0,1,120,26,146
p_82,0,14,e_3,550,673,731,3,1,0,3,4,0,1,123,58,181
p_81,0,14,e_3,551,673,731,3,1,0,3,4,0,1,122,58,180
p_79,0,14,e_3,553,673,731,3,1,0,3,4,0,1,120,58,178
p_114,0,3,e_2,488,719,732,20,7,7,3,4,0,1,231,13,244
p_50,0,7,e_1,590,704,735,24,7,7,3,4,0,1,114,31,145
p_85,0,15,e_3,545,673,736,5,1,0,5,4,0,1,128,63,191
p_44,0,8,e_1,596,704,740,22,6,6,1,4,0,1,108,36,144
p_108,0,6,e_2,496,719,743,19,5,5,0,4,0,1,223,24,247
p_53,0,9,e_1,587,704,745,24,7,7,4,4,0,1,117,41,158
p_51,0,9,e_1,589,704,745,24,7,7,3,4,0,1,115,41,156
p_47,0,9,e_1,593,704,745,23,6,6,2,4,0,1,111,41,152
p_111,0,8,e_2,491,719,751,20,6,6,2,4,0,1,228,32,260
p_58,0,11,e_1,582,704,753,25,8,8,6,4,0,1,122,49,171
p_57,0,11,e_1,583,704,753,25,8,8,6,4,0,1,121,49,170
p_115,0,9,e_2,487,719,756,21,7,7,3,4,0,1,232,37,269
p_117,0,10,e_2,485,719,761,21,7,7,4,4,0,1,234,42,276
p_116,0,10,e_2,486,719,761,21,7,7,4,4,0,1,233,42,275
p_49,0,14,e_1,591,704,764,23,7,7,3,4,0,1,113,60,173
p_112,0,11,e_2,490,719,766,20,6,6,2,4,0,1,229,47,276
p_110,0,11,e_2,492,719,766,20,6,6,2,4,0,1,227,47,274
p_39,0,12,e_2,607,719,771,19,5,5,0,4,0,1,112,52,164
p_23,0,12,e_2,711,719,771,22,4,4,3,4,0,1,8,52,60
p_22,0,3,e_0,719,764,775,19,4,4,14,3,0,0,45,11,56
p_40,0,13,e_2,602,719,776,21,5,5,2,4,0,1,117,57,174
p_38,0,13,e_2,608,719,776,19,5,5,0,3,0,0,111,57,168
p_21,0,4,e_0,731,764,780,16,2,2,11,4,0,1,33,16,49
p_109,0,15,e_2,493,719,784,19,6,6,1,4,0,1,226,65,291
p_16,0,2,e_3,780,783,791,1,1,0,1,4,0,1,3,8,11
p_30,0,3,e_3,668,783,796,1,1,0,1,4,0,1,115,13,128
p_19,0,11,e_0,754,764,803,9,1,0,3,4,0,1,10,39,49
p_29,0,5,e_3,670,783,804,1,1,0,1,4,0,1,113,21,134
p_32,0,6,e_3,650,783,809,7,1,0,7,4,0,1,133,26,159
p_31,0,6,e_3,666,783,809,2,1,0,2,4,0,1,117,26,143
p_20,0,14,e_0,734,764,814,15,2,2,10,4,0,1,30,50,80
p_24,0,2,e_1,695,808,816,25,7,7,3,4,0,1,113,8,121
p_18,0,10,e_3,766,783,823,5,1,0,5,4,0,1,17,40,57
p_17,0,10,e_3,776,783,823,2,1,0,2,4,0,1,7,40,47
p_14,0,4,e_1,794,808,824,28,5,5,5,4,0,1,14,16,30
p_42,0,6,e_1,598,808,832,21,6,6,0,4,0,1,210,24,234
p_43,0,7,e_1,597,808,837,22,6,6,1,4,0,1,211,29,240
p_33,0,15,e_3,649,783,840,8,1,0,8,4,0,1,134,57,191
p_26,0,8,e_1,684,808,842,27,9,9,6,4,0,1,124,34,158
p_25,0,8,e_1,686,808,842,27,8,8,6,4,0,1,122,34,156
p_15,0,9,e_1,793,808,847,28,5,5,5,4,0,1,15,39,54
p_11,0,9,e_1,807,808,847,25,3,3,0,4,0,1,1,39,40
p_27,0,10,e_1,677,808,852,29,10,10,9,4,0,1,131,44,175
p_41,0,11,e_1,600,808,857,21,5,5,0,3,0,0,208,49,257
p_28,0,11,e_1,676,808,857,30,9,9,9,4,0,1,132,49,181
p_13,0,11,e_1,796,808,857,27,4,4,4,4,0,1,12,49,61
p_12,0,11,e_1,798,808,857,27,4,4,3,4,0,1,10,49,59
p_6,0,3,e_0,877,880,891,15,0,0,1,4,0,1,3,11,14
p_7,0,5,e_0,875,880,899,15,0,0,1,4,0,1,5,19,24
p_4,0,1,e_2,886,894,901,15,0,0,2,4,0,1,8,7,15
p_9,0,2,e_2,846,894,906,15,0,0,15,3,0,0,48,12,60
p_10,0,8,e_0,835,880,910,17,1,1,14,3,0,0,45,30,75
p_1,0,5,e_2,894,894,917,15,0,0,0,3,0,0,0,23,23
p_8,0,11,e_0,874,880,921,15,0,0,2,4,0,1,6,41,47
p_5,0,8,e_2,883,894,928,15,0,0,4,4,0,1,11,34,45
p_3,0,8,e_2,888,894,928,15,0,0,2,4,0,1,6,34,40
p_2,0,11,e_2,892,894,939,15,0,0,1,4,0,1,2,45,47
p_300,0,4,e_0,8,8,24,0,0,0,0,3,0,0,0,16,16
p_299,0,5,e_1,9,9,28,0,0,0,0,3,0,0,0,19,19
p_297,0,6,e_3,15,15,37,0,0,0,0,3,0,0,0,22,22
p_298,0,9,e_2,11,11,42,0,0,0,0,3,0,0,0,31,31
p_296,0,4,e_0,28,43,57,9,1,1,4,3,0,0,15,14,29
p_286,0,3,e_1,46,47,58,6,0,0,0,4,0,1,1,11,12
p_289,0,4,e_1,43,47,63,6,0,0,1,4,0,1,4,16,20
p_292,0,6,e_0,38,43,65,6,0,0,1,4,0,1,5,22,27
p_290,0,6,e_0,40,43,65,6,0,0,1,4,0,1,3,22,25
p_295,0,5,e_1,29,47,68,8,1,1,5,3,0,0,18,21,39
p_287,0,5,e_1,45,47,68,6,0,0,0,4,0,1,2,21,23
p_288,0,8,e_1,44,47,79,6,0,0,1,4,0,1,3,32,35
p_291,0,11,e_0,39,43,82,6,0,0,1,4,0,1,4,39,43
p_285,0,4,e_3,53,73,87,6,0,0,6,3,0,0,20,14,34
p_284,0,4,e_3,54,73,87,6,1,0,6,4,0,1,19,14,33
p_294,0,12,e_0,31,43,87,8,1,1,4,4,0,1,12,44,56
p_293,0,12,e_0,33,43,87,7,1,1,3,4,0,1,10,44,54
p_282,0,7,e_3,66,73,98,2,1,0,2,4,0,1,7,25,32
p_283,0,9,e_3,57,73,106,5,1,0,5,4,0,1,16,33,49
p_281,0,1,e_2,73,103,108,18,3,3,9,3,0,0,30,5,35
p_278,0,2,e_2,77,103,113,17,3,3,9,4,0,1,26,10,36
p_279,0,5,e_2,76,103,124,17,3,3,9,4,0,1,27,21,48
p_277,0,6,e_1,82,108,128,15,3,3,8,3,0,0,26,20,46
p_274,0,8,e_2,88,103,135,14,2,2,5,4,0,1,15,32,47
p_271,0,1,e_3,121,139,144,6,1,0,6,4,0,1,18,5,23
p_276,0,11,e_2,84,103,146,15,3,3,6,4,0,1,19,43,62
p_273,0,4,e_3,110,139,155,9,0,0,9,3,0,0,29,16,45
p_280,0,14,e_2,75,103,157,18,3,3,9,4,0,1,28,54,82
p_275,0,14,e_2,86,103,157,14,3,3,5,4,0,1,17,54,71
p_267,0,1,e_1,148,164,171,18,3,3,5,4,0,1,16,7,23
p_270,0,9,e_3,122,139,172,5,1,0,5,4,0,1,17,33,50
p_269,0,9,e_3,127,139,172,4,1,0,4,4,0,1,12,33,45
p_268,0,2,e_1,144,164,176,19,3,3,6,3,0,0,20,12,32
p_272,0,10,e_3,113,139,177,9,1,0,9,4,0,1,26,38,64
p_265,0,4,e_1,152,164,184,17,3,3,4,4,0,1,12,20,32
p_262,0,5,e_1,157,164,189,16,2,2,2,4,0,1,7,25,32
p_261,0,5,e_1,164,164,189,14,2,2,0,3,0,0,0,25,25
p_266,0,6,e_1,151,164,194,17,3,3,4,4,0,1,13,30,43
p_263,0,7,e_1,154,164,199,4,2,2,3,4,0,1,10,35,45
p_264,0,11,e_1,153,164,213,17,3,3,4,4,0,1,11,49,60
p_255,0,3,e_0,184,203,214,10,0,0,6,4,0,1,19,11,30
p_254,0,4,e_0,187,203,219,10,0,0,5,4,0,1,16,16,32
p_253,0,5,e_0,190,203,224,10,0,0,4,4,0,1,13,21,34
p_260,0,7,e_0,165,203,232,13,2,2,12,3,0,0,38,29,67
p_258,0,7,e_0,168,203,232,12,2,2,11,4,0,1,35,29,64
p_256,0,10,e_0,182,203,243,10,0,0,7,4,0,1,21,40,61
p_250,0,2,e_3,217,237,245,6,1,0,6,4,0,1,20,8,28
p_252,0,5,e_3,205,237,256,10,0,0,10,3,0,0,32,19,51
p_257,0,14,e_0,169,203,257,12,2,2,11,4,0,1,34,54,88
p_259,0,15,e_0,167,203,262,12,2,2,12,4,0,1,36,59,95
p_251,0,15,e_3,209,237,288,9,1,0,9,4,0,1,28,51,79
p_248,0,5,e_1,246,275,292,28,2,2,10,4,0,1,29,17,46
p_247,0,5,e_1,250,275,292,27,2,2,8,4,0,1,25,17,42
p_249,0,6,e_1,239,275,297,30,3,3,11,3,0,0,36,22,58
p_245,0,7,e_1,269,275,302,21,1,1,2,4,0,1,6,27,33
p_246,0,10,e_1,262,275,313,24,1,1,4,4,0,1,13,38,51
p_244,0,12,e_1,271,275,321,21,1,1,1,4,0,1,4,46,50
p_241,0,1,e_2,283,322,327,17,1,1,13,4,0,1,39,5,44
p_236,0,1,e_2,305,322,327,15,0,0,5,4,0,1,17,5,22
p_233,0,1,e_2,311,322,327,15,0,0,4,4,0,1,11,5,16
p_243,0,15,e_1,272,275,332,20,1,1,1,4,0,1,3,57,60
p_230,0,3,e_2,319,322,335,15,0,0,1,4,0,1,3,13,16
p_232,0,5,e_2,314,322,343,15,0,0,3,4,0,1,8,21,29
p_237,0,7,e_2,304,322,351,15,0,0,6,4,0,1,18,29,47
p_231,0,7,e_2,317,322,351,15,0,0,1,4,0,1,5,29,34
p_242,0,8,e_2,277,322,356,18,1,1,14,3,0,0,45,34,79
p_235,0,8,e_2,308,322,356,15,0,0,4,4,0,1,14,34,48
p_234,0,8,e_2,310,322,356,15,0,0,4,4,0,1,12,34,46
p_240,0,9,e_2,301,322,361,15,0,0,7,4,0,1,21,39,60
p_239,0,11,e_2,302,322,369,15,0,0,7,4,0,1,20,47,67
p_238,0,13,e_2,303,322,377,15,0,0,6,4,0,1,19,55,74
p_229,0,13,e_2,320,322,377,15,0,0,1,4,0,1,2,55,57
p_216,0,1,e_0,347,373,380,9,1,0,9,4,0,1,26,7,33
p_226,0,2,e_0,329,373,385,15,1,0,14,4,0,1,44,12,56
p_223,0,2,e_0,336,373,385,13,1,0,12,4,0,1,37,12,49
p_214,0,3,e_0,349,373,390,8,1,0,8,4,0,1,24,17,41
p_228,0,4,e_0,325,373,395,15,0,0,15,3,0,0,48,22,70
p_225,0,5,e_0,330,373,400,15,1,0,14,4,0,1,43,27,70
p_224,0,5,e_0,331,373,400,15,1,0,14,4,0,1,42,27,69
p_222,0,5,e_0,337,373,400,12,1,0,12,4,0,1,36,27,63
p_219,0,5,e_0,342,373,400,11,1,0,10,4,0,1,31,27,58
p_221,0,6,e_0,339,373,405,12,1,0,11,4,0,1,34,32,66
p_220,0,6,e_0,341,373,405,11,1,0,10,4,0,1,32,32,64
p_193,0,11,e_3,374,375,410,0,1,0,0,4,0,1,1,35,36
p_217,0,7,e_0,346,373,410,10,1,0,9,4,0,1,27,37,64
p_227,0,12,e_3,327,375,415,15,0,0,15,3,0,0,48,40,88
p_218,0,11,e_0,343,373,424,11,1,0,10,4,0,1,30,51,81
p_190,0,1,e_2,379,418,425,23,2,2,13,4,0,1,39,7,46
p_183,0,1,e_2,396,418,425,18,2,2,7,4,0,1,22,7,29
p_161,0,1,e_1,421,423,428,12,0,0,0,4,0,1,2,5,7
p_182,0,2,e_2,397,418,430,17,2,2,7,4,0,1,21,12,33
p_180,0,2,e_2,399,418,430,17,2,2,6,4,0,1,19,12,31
p_178,0,3,e_2,401,418,435,16,2,2,6,4,0,1,17,17,34
p_215,0,15,e_0,348,373,438,9,1,0,8,4,0,1,25,65,90
p_213,0,15,e_0,350,373,438,8,1,0,7,4,0,1,23,65,88
p_186,0,4,e_2,390,418,440,19,2,2,9,4,0,1,28,22,50
p_192,0,8,e_1,375,423,451,24,2,2,15,3,0,0,48,28,76
p_189,0,8,e_2,382,418,454,22,2,2,12,4,0,1,36,36,72
p_179,0,8,e_2,400,418,454,16,2,2,6,4,0,1,18,36,54
p_177,0,9,e_2,402,418,459,15,2,2,5,4,0,1,16,41,57
p_163,0,10,e_1,419,423,459,12,0,0,1,4,0,1,4,36,40
p_191,0,10,e_2,376,418,464,24,2,2,13,2,1,0,42,46,88
p_185,0,10,e_2,391,418,464,19,2,2,9,4,0,1,27,46,73
p_162,0,11,e_1,420,423,464,12,0,0,1,4,0,1,3,41,44
p_158,0,1,e_3,430,464,471,11,1,0,11,4,0,1,34,7,41
p_146,0,1,e_3,453,464,471,4,1,0,4,4,0,1,11,7,18
p_187,0,12,e_2,389,418,472,20,2,2,9,4,0,1,29,54,83
p_184,0,12,e_2,392,418,472,19,2,2,9,4,0,1,26,54,80
p_188,0,13,e_2,384,418,477,22,2,2,11,4,0,1,34,59,93
p_181,0,15,e_2,398,418,485,17,2,2,7,4,0,1,20,67,87
p_159,0,6,e_3,429,464,488,11,1,0,11,4,0,1,35,24,59
p_150,0,6,e_3,443,464,488,7,1,0,7,4,0,1,21,24,45
p_154,0,7,e_3,436,464,493,9,1,0,9,4,0,1,28,29,57
p_209,0,2,e_0,357,485,495,6,1,0,5,4,0,1,128,10,138
p_205,0,2,e_0,362,485,495,4,1,0,3,4,0,1,123,10,133
p_148,0,8,e_3,449,464,498,5,1,0,5,4,0,1,15,34,49
p_153,0,9,e_3,437,464,503,9,1,0,9,4,0,1,27,39,66
p_147,0,9,e_3,452,464,503,4,1,0,4,4,0,1,12,39,51
p_200,0,4,e_0,367,485,503,3,1,0,2,4,0,1,118,18,136
p_201,0,5,e_0,366,485,508,3,1,0,2,4,0,1,119,23,142
p_210,0,6,e_0,354,485,513,7,1,0,6,4,0,1,131,28,159
p_208,0,6,e_0,358,485,513,6,1,0,5,4,0,1,127,28,155
p_212,0,7,e_0,351,485,518,8,1,0,7,4,0,1,134,33,167
p_157,0,14,e_3,431,464,520,11,1,0,11,4,0,1,33,56,89
p_155,0,14,e_3,435,464,520,10,1,0,10,4,0,1,29,56,85
p_160,0,15,e_3,426,464,525,12,0,0,12,3,0,0,38,61,99
p_156,0,15,e_3,434,464,525,10,1,0,10,4,0,1,30,61,91
p_152,0,15,e_3,441,464,525,7,1,0,7,4,0,1,23,61,84
p_151,0,15,e_3,442,464,525,7,1,0,7,4,0,1,22,61,83
p_149,0,15,e_3,444,464,525,7,1,0,7,4,0,1,20,61,81
p_198,0,9,e_0,369,485,526,2,1,0,1,4,0,1,116,41,157
p_113,0,1,e_1,489,522,527,24,6,6,11,4,0,1,33,5,38
p_207,0,11,e_0,359,485,534,5,1,0,5,4,0,1,126,49,175
p_114,0,3,e_1,488,522,535,24,6,6,11,4,0,1,34,13,47
p_106,0,3,e_1,500,522,535,22,4,4,7,4,0,1,22,13,35
p_167,0,1,e_2,413,532,537,12,1,1,2,4,0,1,119,5,124
p_206,0,12,e_0,361,485,539,5,1,0,4,4,0,1,124,54,178
p_203,0,12,e_0,364,485,539,3,1,0,3,4,0,1,121,54,175
p_108,0,6,e_1,496,522,546,22,5,5,8,4,0,1,26,24,50
p_204,0,14,e_0,363,485,547,4,1,0,3,4,0,1,122,62,184
p_176,0,4,e_2,403,532,548,15,2,2,5,4,0,1,129,16,145
p_165,0,4,e_2,417,532,548,12,0,0,0,4,0,1,115,16,131
p_92,0,4,e_2,525,532,548,15,1,1,2,4,0,1,7,16,23
p_102,0,7,e_1,509,522,551,19,3,3,4,4,0,1,13,29,42
p_211,0,15,e_0,353,485,552,7,1,0,6,4,0,1,132,67,199
p_202,0,15,e_0,365,485,552,3,1,0,2,4,0,1,120,67,187
p_199,0,15,e_0,368,485,552,2,1,0,2,4,0,1,117,67,184
p_111,0,8,e_1,491,522,556,23,6,6,10,4,0,1,31,34,65
p_115,0,9,e_1,487,522,561,24,7,7,11,4,0,1,35,39,74
p_169,0,9,e_2,411,532,565,13,1,1,2,4,0,1,121,33,154
p_116,0,10,e_1,486,522,566,24,7,7,11,3,0,0,36,44,80
p_112,0,11,e_1,490,522,571,24,6,6,10,4,0,1,32,49,81
p_110,0,11,e_1,492,522,571,23,6,6,10,4,0,1,30,49,79
p_107,0,11,e_1,499,522,571,22,4,4,8,4,0,1,23,49,72
p_103,0,11,e_1,508,522,571,20,3,3,5,4,0,1,14,49,63
p_173,0,11,e_2,407,532,573,14,2,2,3,4,0,1,125,41,166
p_164,0,11,e_2,418,532,573,12,0,0,0,3,0,0,114,41,155
p_105,0,12,e_1,502,522,576,21,4,4,7,4,0,1,20,54,74
p_166,0,12,e_2,416,532,578,12,0,0,0,4,0,1,116,46,162
p_91,0,12,e_2,526,532,578,15,1,0,2,4,0,1,6,46,52
p_86,0,2,e_3,544,572,580,9,1,0,9,4,0,1,28,8,36
p_171,0,13,e_2,409,532,583,13,1,1,3,4,0,1,123,51,174
p_168,0,13,e_2,412,532,583,13,1,1,2,4,0,1,120,51,171
p_104,0,14,e_1,503,522,584,21,3,3,6,4,0,1,19,62,81
p_143,0,3,e_3,456,572,585,2,1,0,2,4,0,1,116,13,129
p_175,0,14,e_2,405,532,588,14,2,2,4,4,0,1,127,56,183
p_174,0,14,e_2,406,532,588,14,2,2,4,4,0,1,126,56,182
p_170,0,14,e_2,410,532,588,13,1,1,2,4,0,1,122,56,178
p_109,0,15,e_1,493,522,589,23,5,5,9,4,0,1,29,67,96
p_88,0,5,e_3,538,572,593,11,1,0,11,4,0,1,34,21,55
p_172,0,15,e_2,408,532,593,14,2,2,3,4,0,1,124,61,185
p_141,0,6,e_3,458,572,598,2,1,0,2,4,0,1,114,26,140
p_130,0,1,e_0,472,599,606,29,7,7,4,4,0,1,127,7,134
p_140,0,8,e_3,459,572,606,2,1,0,2,4,0,1,113,34,147
p_87,0,8,e_3,539,572,606,11,1,0,11,4,0,1,33,34,67
p_83,0,8,e_3,549,572,606,7,1,0,7,4,0,1,23,34,57
p_144,0,9,e_3,455,572,611,3,1,0,3,4,0,1,117,39,156
p_142,0,9,e_3,457,572,611,2,1,0,2,4,0,1,115,39,154
p_89,0,9,e_3,535,572,611,12,1,0,12,4,0,1,37,39,76
p_136,0,3,e_0,465,599,614,30,7,7,6,4,0,1,134,15,149
p_129,0,3,e_0,473,599,614,29,7,7,4,4,0,1,126,15,141
p_139,0,10,e_3,461,572,616,1,1,0,1,4,0,1,111,44,155
p_196,0,4,e_0,371,599,619,1,1,0,1,4,0,1,228,20,248
p_137,0,4,e_0,464,599,619,30,8,8,7,4,0,1,135,20,155
p_145,0,11,e_3,454,572,621,3,1,0,3,4,0,1,118,49,167
p_138,0,11,e_3,463,572,621,0,0,0,0,3,0,0,109,49,158
p_84,0,12,e_3,546,572,626,9,1,0,9,4,0,1,26,54,80
p_194,0,6,e_0,373,599,627,1,1,0,0,3,0,0,226,28,254
p_85,0,15,e_3,545,572,637,9,1,0,9,4,0,1,27,65,92
p_197,0,10,e_0,370,599,641,1,1,0,1,4,0,1,229,42,271
p_135,0,10,e_0,466,599,641,30,7,7,6,4,0,1,133,42,175
p_127,0,10,e_0,475,599,641,28,7,7,3,4,0,1,124,42,166
p_96,0,1,e_1,517,636,641,17,3,3,2,4,0,1,119,5,124
p_132,0,11,e_0,470,599,646,29,8,8,5,4,0,1,129,47,176
p_128,0,11,e_0,474,599,646,28,7,7,4,4,0,1,125,47,172
p_133,0,12,e_0,469,599,651,30,7,7,5,4,0,1,130,52,182
p_99,0,6,e_1,514,636,658,18,3,3,3,4,0,1,122,22,144
p_94,0,6,e_1,519,636,658,16,3,3,1,4,0,1,117,22,139
p_131,0,14,e_0,471,599,659,29,7,7,4,4,0,1,128,60,188
p_98,0,7,e_1,515,636,663,18,3,3,2,4,0,1,121,27,148
p_97,0,7,e_1,516,636,663,17,3,3,2,4,0,1,120,27,147
p_195,0,15,e_0,372,599,664,1,1,0,0,4,0,1,227,65,292
p_134,0,15,e_0,467,599,664,30,7,7,6,4,0,1,132,65,197
p_101,0,8,e_1,511,636,668,19,3,3,3,4,0,1,125,32,157
p_100,0,9,e_1,513,636,673,18,3,3,3,4,0,1,123,37,160
p_37,0,9,e_1,615,636,673,20,5,5,7,4,0,1,21,37,58
p_41,0,11,e_1,600,636,681,24,7,7,12,4,0,1,36,45,81
p_90,0,13,e_2,527,640,681,15,1,0,2,4,0,1,113,41,154
p_39,0,12,e_1,607,636,686,22,6,6,9,4,0,1,29,50,79
p_93,0,13,e_1,520,636,691,16,2,2,1,4,0,1,116,55,171
p_40,0,13,e_1,602,636,691,23,7,7,11,4,0,1,34,55,89
p_38,0,13,e_1,608,636,691,22,6,6,9,4,0,1,28,55,83
p_36,0,13,e_1,628,636,691,18,2,2,3,4,0,1,8,55,63
p_95,0,14,e_1,518,636,696,17,3,3,1,4,0,1,118,60,178
p_77,0,3,e_3,557,684,697,5,1,0,5,4,0,1,127,13,140
p_72,0,3,e_3,562,684,697,3,1,0,3,4,0,1,122,13,135
p_71,0,3,e_3,564,684,697,2,1,0,2,4,0,1,120,13,133
p_70,0,3,e_3,565,684,697,2,1,0,2,4,0,1,119,13,132
p_75,0,5,e_3,559,684,705,4,1,0,4,4,0,1,125,21,146
p_76,0,6,e_3,558,684,710,5,1,0,5,4,0,1,126,26,152
p_80,0,7,e_3,552,684,715,7,1,0,7,4,0,1,132,31,163
p_74,0,7,e_3,560,684,715,4,1,0,4,4,0,1,124,31,155
p_119,0,1,e_0,483,711,716,26,7,7,0,4,0,1,228,5,233
p_65,0,1,e_0,573,711,716,30,10,10,9,4,0,1,138,5,143
p_64,0,4,e_0,574,711,727,30,10,10,8,4,0,1,137,16,153
p_73,0,11,e_3,561,684,729,3,1,0,3,4,0,1,123,45,168
p_78,0,12,e_3,556,684,734,5,1,0,5,4,0,1,128,50,178
p_61,0,6,e_0,579,711,735,28,10,10,6,4,0,1,132,24,156
p_68,0,13,e_3,567,684,739,1,1,0,1,4,0,1,117,55,172
p_124,0,7,e_0,478,711,740,27,7,7,2,4,0,1,233,29,262
p_118,0,7,e_0,484,711,740,25,7,7,0,4,0,1,227,29,256
p_82,0,14,e_3,550,684,744,7,1,0,7,4,0,1,134,60,194
p_81,0,14,e_3,551,684,744,7,1,0,7,4,0,1,133,60,193
p_79,0,14,e_3,553,684,744,6,1,0,6,4,0,1,131,60,191
p_69,0,14,e_3,566,684,744,2,1,0,2,4,0,1,118,60,178
p_22,0,3,e_1,719,740,751,20,5,5,7,4,0,1,21,11,32
p_117,0,10,e_0,485,711,751,25,7,7,0,3,0,0,226,40,266
p_123,0,11,e_0,479,711,756,27,7,7,2,4,0,1,232,45,277
p_121,0,11,e_0,481,711,756,26,7,7,1,4,0,1,230,45,275
p_120,0,11,e_0,482,711,756,26,7,7,1,4,0,1,229,45,274
p_21,0,4,e_1,731,740,756,17,4,4,3,4,0,1,9,16,25
p_126,0,12,e_0,476,711,761,28,7,7,3,4,0,1,235,50,285
p_63,0,13,e_0,577,711,766,29,11,11,7,4,0,1,134,55,189
p_62,0,13,e_0,578,711,766,29,11,11,7,4,0,1,133,55,188
p_125,0,14,e_0,477,711,771,27,7,7,2,4,0,1,234,60,294
p_35,0,9,e_1,630,740,773,17,2,2,2,4,0,1,110,33,143
p_122,0,15,e_0,480,711,776,26,7,7,2,4,0,1,231,65,296
p_23,0,12,e_1,711,740,784,22,6,6,9,4,0,1,29,44,73
p_20,0,14,e_1,734,740,792,16,3,3,2,4,0,1,6,52,58
p_16,0,2,e_3,780,788,796,3,1,0,3,4,0,1,8,8,16
p_67,0,3,e_3,568,788,801,1,1,0,1,4,0,1,220,13,233
p_66,0,3,e_3,569,788,801,1,1,0,1,4,0,1,219,13,232
p_30,0,3,e_3,668,788,801,5,1,0,5,4,0,1,120,13,133
p_29,0,5,e_3,670,788,809,4,1,0,4,4,0,1,118,21,139
p_32,0,6,e_3,650,788,814,11,1,0,11,4,0,1,138,26,164
p_31,0,6,e_3,666,788,814,6,1,0,6,4,0,1,122,26,148
p_26,0,8,e_3,684,788,822,0,0,0,0,3,0,0,104,34,138
p_27,0,10,e_3,677,788,830,2,1,0,2,4,0,1,111,42,153
p_18,0,10,e_3,766,788,830,7,1,0,7,4,0,1,22,42,64
p_17,0,10,e_3,776,788,830,4,1,0,4,4,0,1,12,42,54
p_55,0,3,e_0,585,823,834,27,9,9,5,4,0,1,238,11,249
p_54,0,3,e_0,586,823,834,27,9,9,4,4,0,1,237,11,248
p_52,0,3,e_0,588,823,834,26,9,9,3,4,0,1,235,11,246
p_28,0,11,e_3,676,788,835,2,1,0,2,4,0,1,112,47,159
p_19,0,11,e_3,754,788,835,11,1,0,11,4,0,1,34,47,81
p_48,0,4,e_0,592,823,839,25,8,8,2,4,0,1,231,16,247
p_46,0,4,e_0,594,823,839,25,8,8,2,4,0,1,229,16,245
p_34,0,12,e_3,646,788,840,12,1,0,12,4,0,1,142,52,194
p_56,0,6,e_0,584,823,847,27,9,9,5,4,0,1,239,24,263
p_33,0,15,e_3,649,788,851,11,1,0,11,4,0,1,139,63,202
p_50,0,7,e_0,590,823,852,26,9,9,3,4,0,1,233,29,262
p_53,0,9,e_0,587,823,860,27,9,9,4,4,0,1,236,37,273
p_51,0,9,e_0,589,823,860,26,9,9,3,4,0,1,234,37,271
p_47,0,9,e_0,593,823,860,25,8,8,2,4,0,1,230,37,267
p_60,0,10,e_0,580,823,865,28,10,10,6,4,0,1,243,42,285
p_58,0,11,e_0,582,823,870,28,10,10,6,4,0,1,241,47,288
p_57,0,11,e_0,583,823,870,27,10,10,5,4,0,1,240,47,287
p_59,0,14,e_0,581,823,881,28,10,10,6,4,0,1,242,58,300
p_49,0,14,e_0,591,823,881,26,9,9,3,4,0,1,232,58,290
p_9,0,2,e_2,846,877,885,16,1,1,10,4,0,1,31,8,39
p_7,0,5,e_2,875,877,896,15,0,0,1,4,0,1,2,19,21
p_10,0,8,e_2,835,877,907,19,2,2,13,3,0,0,42,30,72
p_8,0,11,e_2,874,877,918,15,0,0,1,4,0,1,3,41,44
p_4,0,1,e_1,886,922,927,15,0,0,12,4,0,1,36,5,41
p_45,0,2,e_0,595,925,933,25,8,8,1,4,0,1,330,8,338
p_24,0,2,e_0,695,925,933,25,9,9,5,4,0,1,230,8,238
p_6,0,3,e_1,877,922,935,15,0,0,14,3,0,0,45,13,58
p_14,0,4,e_0,794,925,941,28,9,9,10,4,0,1,131,16,147
p_1,0,5,e_1,894,922,943,15,0,0,9,4,0,1,28,21,49
p_42,0,6,e_0,598,925,949,24,7,7,0,3,0,0,327,24,351
p_5,0,8,e_1,883,922,954,15,0,0,13,4,0,1,39,32,71
p_3,0,8,e_1,888,922,954,15,0,0,11,4,0,1,34,32,66
p_43,0,7,e_0,597,925,954,24,7,7,0,4,0,1,328,29,357
p_44,0,8,e_0,596,925,959,24,8,8,1,4,0,1,329,34,363
p_25,0,8,e_0,686,925,959,28,8,8,8,4,0,1,239,34,273
p_15,0,9,e_0,793,925,964,29,9,9,10,4,0,1,132,39,171
p_11,0,9,e_0,807,925,964,26,7,7,5,4,0,1,118,39,157
p_2,0,11,e_1,892,922,965,15,0,0,10,4,0,1,30,43,73
p_13,0,11,e_0,796,925,972,28,8,8,9,4,0,1,129,47,176
p_12,0,11,e_0,798,925,972,28,8,8,8,4,0,1,127,47,174
p_300,0,4,e_0,8,8,24,0,0,0,0,3,0,0,0,16,16
p_299,0,5,e_1,9,9,28,0,0,0,0,3,0,0,0,19,19
p_297,0,6,e_3,15,16,38,0,0,0,0,3,0,0,1,22,23
p_298,0,9,e_2,11,11,42,0,0,0,0,3,0,0,0,31,31
p_296,0,4,e_0,28,43,57,9,1,1,4,3,0,0,15,14,29
p_286,0,3,e_1,46,46,59,6,0,0,0,3,0,1,0,13,13
p_289,0,4,e_1,43,46,64,6,0,0,1,4,0,1,3,18,21
p_292,0,6,e_0,38,43,65,6,0,0,1,4,0,1,5,22,27
p_290,0,6,e_0,40,43,65,6,0,0,1,4,0,1,3,22,25
p_295,0,5,e_1,29,46,69,9,1,1,5,3,0,0,17,23,40
p_287,0,5,e_1,45,46,69,6,0,0,0,3,0,0,1,23,24
p_288,0,8,e_1,44,46,80,6,0,0,0,4,0,1,2,34,36
p_281,0,1,e_3,73,74,81,0,0,0,0,3,0,0,1,7,8
p_291,0,11,e_0,39,43,82,6,0,0,1,4,0,1,4,39,43
p_294,0,12,e_0,31,43,87,8,1,1,4,4,0,1,12,44,56
p_293,0,12,e_0,33,43,87,8,1,1,3,4,0,1,10,44,54
p_285,0,4,e_3,53,74,92,6,0,0,6,3,0,0,21,18,39
p_284,0,4,e_3,54,74,92,6,1,1,6,3,0,1,20,18,38
p_282,0,7,e_3,66,74,103,2,1,0,2,4,0,1,8,29,37
p_283,0,9,e_3,57,74,111,6,1,0,6,4,0,1,17,37,54
p_278,0,2,e_2,77,105,113,18,4,4,9,4,0,1,28,8,36
p_279,0,5,e_1,76,106,123,18,4,4,7,5,1,0,30,17,47
p_277,0,6,e_1,82,106,128,17,3,3,8,4,0,1,24,22,46
p_274,0,8,e_1,88,106,136,15,3,3,6,4,0,1,18,30,48
p_271,0,1,e_3,121,140,145,6,1,0,6,4,0,1,19,5,24
p_276,0,11,e_1,84,106,147,16,3,3,7,4,0,1,22,41,63
p_280,0,14,e_2,75,105,151,18,5,5,9,3,0,0,30,46,76
p_273,0,4,e_3,110,140,156,9,0,0,9,2,1,0,30,16,46
p_275,0,14,e_1,86,106,158,16,3,3,6,4,0,1,20,52,72
p_270,0,9,e_3,122,140,173,6,1,0,6,4,0,1,18,33,51
p_269,0,9,e_3,127,140,173,4,1,0,4,4,0,1,13,33,46
p_272,0,10,e_3,113,140,178,9,1,0,9,4,0,1,27,38,65
p_267,0,1,e_0,148,182,187,19,3,3,11,4,0,1,34,5,39
p_268,0,2,e_0,144,182,192,19,4,4,12,3,0,0,38,10,48
p_265,0,4,e_0,152,182,200,17,3,3,10,4,0,1,30,18,48
p_262,0,5,e_0,157,182,205,16,2,2,8,4,0,1,25,23,48
p_261,0,5,e_0,164,182,205,14,2,2,6,4,0,1,18,23,41
p_266,0,6,e_0,151,182,210,18,3,3,10,4,0,1,31,28,59
p_263,0,7,e_0,154,182,215,16,3,3,9,4,0,1,28,33,61
p_260,0,7,e_0,165,182,215,14,2,2,6,4,0,1,17,33,50
p_258,0,7,e_0,168,182,215,12,2,2,5,4,0,1,14,33,47
p_255,0,3,e_3,184,214,225,10,1,0,10,4,0,1,30,11,41
p_264,0,11,e_0,153,182,229,17,3,3,10,4,0,1,29,47,76
p_254,0,4,e_3,187,214,230,9,1,0,9,4,0,1,27,16,43
p_253,0,5,e_3,190,214,235,8,1,0,8,4,0,1,24,21,45
p_252,0,5,e_3,205,214,235,3,1,0,3,4,0,1,9,21,30
p_257,0,14,e_0,169,182,240,12,2,2,4,4,0,1,13,58,71
p_259,0,15,e_0,167,182,245,13,2,2,5,4,0,1,15,63,78
p_256,0,10,e_3,182,214,252,10,0,0,10,3,0,0,32,38,70
p_251,0,15,e_3,209,214,269,1,1,0,1,4,0,1,5,55,60
p_250,0,2,e_1,217,262,270,30,5,5,14,3,0,0,45,8,53
p_248,0,5,e_1,246,262,281,22,2,2,5,4,0,1,16,19,35
p_247,0,5,e_1,250,262,281,20,2,2,4,4,0,1,12,19,31
p_249,0,6,e_1,239,262,286,24,2,2,8,4,0,1,23,24,47
p_241,0,1,e_2,283,306,311,15,0,0,7,4,0,1,23,5,28
p_236,0,1,e_2,305,306,311,15,0,0,0,4,0,1,1,5,6
p_245,0,7,e_2,269,306,331,15,0,0,12,4,0,1,37,25,62
p_237,0,7,e_2,304,306,331,15,0,0,1,4,0,1,2,25,27
p_233,0,1,e_1,311,328,335,15,0,0,5,4,0,1,17,7,24
p_242,0,8,e_2,277,306,336,15,0,0,10,4,0,1,29,30,59
p_240,0,9,e_2,301,306,341,15,0,0,1,4,0,1,5,35,40
p_230,0,3,e_1,319,328,343,15,0,0,3,4,0,1,9,15,24
p_246,0,10,e_2,262,306,346,17,1,1,14,3,0,0,44,40,84
p_228,0,4,e_1,325,328,348,15,0,0,1,4,0,1,3,20,23
p_239,0,11,e_2,302,306,351,15,0,0,1,4,0,1,4,45,49
p_232,0,5,e_1,314,328,353,15,0,0,5,4,0,1,14,25,39
p_244,0,12,e_2,271,306,356,15,0,0,12,4,0,1,35,50,85
p_238,0,13,e_2,303,306,361,15,0,0,1,4,0,1,3,55,58
p_231,0,7,e_1,317,328,361,15,0,0,3,4,0,1,11,33,44
p_235,0,8,e_1,308,328,366,15,0,0,6,3,0,0,20,38,58
p_234,0,8,e_1,310,328,366,15,0,0,6,4,0,1,18,38,56
p_243,0,15,e_2,272,306,369,15,0,0,11,4,0,1,34,63,97
p_227,0,12,e_1,327,328,380,15,0,0,0,3,0,0,1,52,53
p_216,0,1,e_0,347,377,384,10,1,0,10,4,0,1,30,7,37
p_229,0,13,e_1,320,328,385,15,0,0,3,4,0,1,8,57,65
p_226,0,2,e_0,329,377,389,15,0,0,15,3,0,0,48,12,60
p_223,0,2,e_0,336,377,389,14,1,0,14,4,0,1,41,12,53
p_214,0,3,e_0,349,377,394,10,1,0,9,4,0,1,28,17,45
p_225,0,5,e_3,330,378,395,15,0,0,15,3,0,0,48,17,65
p_224,0,5,e_0,331,377,402,15,1,1,15,4,0,1,46,25,71
p_222,0,5,e_0,337,377,402,14,1,0,13,4,0,1,40,25,65
p_219,0,5,e_0,342,377,402,12,1,0,12,4,0,1,35,25,60
p_221,0,6,e_0,339,377,407,13,1,0,13,4,0,1,38,30,68
p_220,0,6,e_0,341,377,407,12,1,0,12,4,0,1,36,30,66
p_217,0,7,e_0,346,377,412,11,1,0,10,4,0,1,31,35,66
p_212,0,7,e_0,351,377,412,9,1,0,8,4,0,1,26,35,61
p_190,0,1,e_3,379,412,417,10,1,1,0,5,1,0,33,5,38
p_183,0,1,e_3,396,412,417,5,1,0,5,4,0,1,16,5,21
p_182,0,2,e_3,397,412,422,5,1,0,5,4,0,1,15,10,25
p_180,0,2,e_3,399,412,422,4,1,0,4,4,0,1,13,10,23
p_218,0,11,e_0,343,377,426,11,1,0,11,4,0,1,34,49,83
p_178,0,3,e_3,401,412,427,3,1,0,3,4,0,1,11,15,26
p_167,0,1,e_1,413,426,431,30,10,10,4,4,0,1,13,5,18
p_161,0,1,e_1,421,426,431,28,9,9,2,4,0,1,5,5,10
p_186,0,4,e_3,390,412,432,6,2,2,4,5,1,1,22,20,42
p_176,0,4,e_3,403,412,432,3,1,0,3,4,0,1,9,20,29
p_215,0,15,e_0,348,377,440,10,1,0,9,4,0,1,29,63,92
p_213,0,15,e_0,350,377,440,9,1,0,9,4,0,1,27,63,90
p_211,0,15,e_0,353,377,440,8,1,0,8,4,0,1,24,63,87
p_165,0,4,e_1,417,426,442,29,10,10,3,4,0,1,9,16,25
p_189,0,8,e_3,382,412,446,9,2,2,1,5,1,1,30,34,64
p_179,0,8,e_3,400,412,446,4,1,0,4,4,0,1,12,34,46
p_177,0,9,e_3,402,412,451,3,1,0,3,4,0,1,10,39,49
p_185,0,10,e_3,391,412,456,6,2,2,4,5,1,1,21,44,65
p_163,0,10,e_1,419,426,462,29,10,10,2,4,0,1,7,36,43
p_187,0,12,e_3,389,412,464,7,2,2,3,5,1,1,23,52,75
p_184,0,12,e_3,392,412,464,6,2,2,4,5,1,1,20,52,72
p_164,0,11,e_1,418,426,467,29,10,10,3,4,0,1,8,41,49
p_162,0,11,e_1,420,426,467,28,10,10,2,4,0,1,6,41,47
p_175,0,14,e_3,405,412,472,2,1,0,2,4,0,1,7,60,67
p_166,0,12,e_1,416,426,472,29,10,10,3,4,0,1,10,46,56
p_181,0,15,e_3,398,412,477,5,1,0,5,4,0,1,14,65,79
p_188,0,13,e_1,384,426,477,8,2,2,13,2,1,0,42,51,93
p_168,0,13,e_1,412,426,477,30,10,10,4,4,0,1,14,51,65
p_158,0,1,e_2,430,474,481,27,8,8,15,4,0,1,44,7,51
p_146,0,1,e_2,453,474,481,21,5,5,7,4,0,1,21,7,28
p_209,0,2,e_0,357,487,497,7,1,0,7,4,0,1,130,10,140
p_205,0,2,e_0,362,487,497,5,1,0,5,4,0,1,125,10,135
p_159,0,6,e_2,429,474,498,27,8,8,15,4,0,1,45,24,69
p_150,0,6,e_2,443,474,498,23,7,7,10,4,0,1,31,24,55
p_154,0,7,e_2,436,474,503,25,7,7,13,4,0,1,38,29,67
p_200,0,4,e_0,367,487,505,3,1,0,3,4,0,1,120,18,138
p_196,0,4,e_0,371,487,505,2,1,0,2,4,0,1,116,18,134
p_148,0,8,e_2,449,474,508,21,6,6,8,4,0,1,25,34,59
p_201,0,5,e_0,366,487,510,4,1,0,4,4,0,1,121,23,144
p_153,0,9,e_2,437,474,513,25,7,7,12,4,0,1,37,39,76
p_147,0,9,e_2,452,474,513,21,5,5,7,4,0,1,22,39,61
p_210,0,6,e_0,354,487,515,8,1,0,7,4,0,1,133,28,161
p_208,0,6,e_0,358,487,515,7,1,0,6,4,0,1,129,28,157
p_198,0,9,e_0,369,487,526,3,1,0,3,4,0,1,118,39,157
p_113,0,1,e_3,489,524,529,11,1,0,11,4,0,1,35,5,40
p_157,0,14,e_2,431,474,530,4,7,7,14,4,0,1,43,56,99
p_155,0,14,e_2,435,474,530,26,7,7,13,4,0,1,39,56,95
p_197,0,10,e_0,370,487,531,3,1,0,2,4,0,1,117,44,161
p_160,0,15,e_2,426,474,535,27,8,8,15,3,0,0,48,61,109
p_156,0,15,e_2,434,474,535,26,7,7,13,4,0,1,40,61,101
p_152,0,15,e_2,441,474,535,23,7,7,11,4,0,1,33,61,94
p_151,0,15,e_2,442,474,535,23,7,7,11,4,0,1,32,61,93
p_149,0,15,e_2,444,474,535,23,7,7,10,4,0,1,30,61,91
p_207,0,11,e_0,359,487,536,6,1,0,6,4,0,1,128,49,177
p_106,0,3,e_3,500,524,537,8,1,0,8,4,0,1,24,13,37
p_206,0,12,e_0,361,487,541,5,1,0,5,4,0,1,126,54,180
p_203,0,12,e_0,364,487,541,5,1,0,4,4,0,1,123,54,177
p_114,0,3,e_1,488,530,541,12,1,0,13,3,0,0,42,11,53
p_92,0,4,e_1,525,530,546,30,10,10,2,4,0,1,5,16,21
p_108,0,6,e_3,496,524,548,9,1,0,9,4,0,1,28,24,52
p_204,0,14,e_0,363,487,549,5,1,0,5,4,0,1,124,62,186
p_202,0,15,e_0,365,487,554,4,1,0,4,4,0,1,122,67,189
p_199,0,15,e_0,368,487,554,3,1,0,3,4,0,1,119,67,186
p_111,0,8,e_3,491,524,556,11,1,0,11,4,0,1,33,32,65
p_169,0,9,e_3,411,524,561,0,1,0,0,4,0,1,113,37,150
p_173,0,11,e_3,407,524,569,1,1,0,1,4,0,1,117,45,162
p_112,0,11,e_3,490,524,569,11,1,0,11,4,0,1,34,45,79
p_110,0,11,e_3,492,524,569,10,1,0,10,4,0,1,32,45,77
p_107,0,11,e_3,499,524,569,8,1,0,8,4,0,1,25,45,70
p_91,0,12,e_1,526,530,572,30,10,10,1,4,0,1,4,42,46
p_105,0,12,e_3,502,524,574,7,1,0,7,4,0,1,22,50,72
p_90,0,13,e_1,527,530,577,29,11,11,1,4,0,1,3,47,50
p_171,0,13,e_3,409,524,579,1,1,0,1,4,0,1,115,55,170
p_174,0,14,e_3,406,524,584,2,1,0,2,4,0,1,118,60,178
p_170,0,14,e_3,410,524,584,0,1,0,0,4,0,1,114,60,174
p_172,0,15,e_3,408,524,589,1,1,0,1,4,0,1,116,65,181
p_109,0,15,e_3,493,524,589,10,1,0,10,4,0,1,31,65,96
p_143,0,3,e_2,456,582,595,20,4,4,6,4,0,1,126,13,139
p_136,0,3,e_2,465,582,595,18,3,3,3,4,0,1,117,13,130
p_137,0,4,e_2,464,582,600,18,3,3,3,4,0,1,118,18,136
p_119,0,1,e_0,483,601,606,13,1,0,1,4,0,1,118,5,123
p_141,0,6,e_2,458,582,608,20,4,4,5,4,0,1,124,26,150
p_140,0,8,e_2,459,582,616,20,4,4,5,4,0,1,123,34,157
p_144,0,9,e_2,455,582,621,20,4,4,6,4,0,1,127,39,166
p_142,0,9,e_2,457,582,621,20,4,4,6,4,0,1,125,39,164
p_194,0,6,e_0,373,601,623,1,1,0,1,4,0,1,228,22,250
p_139,0,10,e_2,461,582,626,19,4,4,4,4,0,1,121,44,165
p_135,0,10,e_2,466,582,626,18,3,3,2,4,0,1,116,44,160
p_124,0,7,e_0,478,601,628,15,1,0,3,4,0,1,123,27,150
p_118,0,7,e_0,484,601,628,13,1,0,1,4,0,1,117,27,144
p_145,0,11,e_2,454,582,631,21,5,5,7,4,0,1,128,49,177
p_138,0,11,e_2,463,582,631,18,3,3,3,4,0,1,119,49,168
p_132,0,11,e_2,470,582,631,16,3,3,1,4,0,1,112,49,161
p_192,0,8,e_0,375,601,633,1,1,0,0,4,0,1,226,32,258
p_133,0,12,e_2,469,582,636,17,3,3,1,4,0,1,113,54,167
p_96,0,1,e_3,517,636,641,2,1,0,2,4,0,1,119,5,124
p_191,0,10,e_0,376,601,641,0,1,0,0,3,0,0,225,40,265
p_127,0,10,e_0,475,601,641,15,2,2,4,4,0,1,126,40,166
p_131,0,14,e_2,471,582,644,16,3,3,1,4,0,1,111,62,173
p_193,0,11,e_0,374,601,646,1,1,0,1,4,0,1,227,45,272
p_123,0,11,e_0,479,601,646,15,1,0,3,4,0,1,122,45,167
p_121,0,11,e_0,481,601,646,14,1,0,2,4,0,1,120,45,165
p_120,0,11,e_0,482,601,646,14,1,0,1,4,0,1,119,45,164
p_37,0,9,e_1,615,618,647,7,1,0,1,4,0,1,3,29,32
p_134,0,15,e_2,467,582,649,17,3,3,2,4,0,1,115,67,182
p_126,0,12,e_0,476,601,651,15,2,2,4,4,0,1,125,50,175
p_99,0,6,e_3,514,636,658,3,1,0,3,4,0,1,122,22,144
p_94,0,6,e_3,519,636,658,2,1,0,2,4,0,1,117,22,139
p_39,0,12,e_1,607,618,658,10,1,0,4,4,0,1,11,40,51
p_125,0,14,e_0,477,601,659,15,1,1,3,4,0,1,124,58,182
p_102,0,7,e_3,509,636,663,5,1,0,5,4,0,1,127,27,154
p_98,0,7,e_3,515,636,663,3,1,0,3,4,0,1,121,27,148
p_97,0,7,e_3,516,636,663,2,1,0,2,4,0,1,120,27,147
p_40,0,13,e_1,602,618,663,11,1,0,5,4,0,1,16,45,61
p_38,0,13,e_1,608,618,663,9,1,0,3,4,0,1,10,45,55
p_195,0,15,e_0,372,601,664,2,1,0,2,4,0,1,229,63,292
p_122,0,15,e_0,480,601,664,14,1,0,2,4,0,1,121,63,184
p_101,0,8,e_3,511,636,668,4,1,0,4,4,0,1,125,32,157
p_85,0,15,e_1,545,618,671,25,9,9,4,3,3,0,73,53,126
p_100,0,9,e_3,513,636,673,4,1,0,4,4,0,1,123,37,160
p_35,0,9,e_3,630,636,673,2,1,0,2,4,0,1,6,37,43
p_103,0,11,e_3,508,636,681,5,1,0,5,4,0,1,128,45,173
p_93,0,13,e_3,520,636,689,1,1,0,1,4,0,1,116,53,169
p_36,0,13,e_3,628,636,689,3,1,0,3,4,0,1,8,53,61
p_104,0,14,e_3,503,636,694,7,1,0,7,4,0,1,133,58,191
p_95,0,14,e_3,518,636,694,2,1,0,2,4,0,1,118,58,176
p_130,0,1,e_2,472,696,703,16,2,2,1,4,0,1,224,7,231
p_86,0,2,e_2,544,696,708,25,9,9,13,4,0,1,152,12,164
p_129,0,3,e_2,473,696,713,16,2,2,0,4,0,1,223,17,240
p_77,0,3,e_2,557,696,713,22,7,7,8,4,0,1,139,17,156
p_88,0,5,e_2,538,696,721,27,9,9,14,4,0,1,158,25,183
p_55,0,3,e_0,585,711,722,16,2,2,5,4,0,1,126,11,137
p_54,0,3,e_0,586,711,722,16,2,2,5,4,0,1,125,11,136
p_52,0,3,e_0,588,711,722,15,2,2,4,4,0,1,123,11,134
p_48,0,4,e_0,592,711,727,14,1,0,3,4,0,1,119,16,135
p_46,0,4,e_0,594,711,727,14,1,0,2,4,0,1,117,16,133
p_80,0,7,e_2,552,696,729,23,8,8,10,4,0,1,144,33,177
p_87,0,8,e_2,539,696,734,27,9,9,14,4,0,1,157,38,195
p_83,0,8,e_2,549,696,734,24,8,8,11,4,0,1,147,38,185
p_56,0,6,e_0,584,711,735,16,2,2,6,4,0,1,127,24,151
p_89,0,9,e_2,535,696,739,27,10,10,15,4,0,1,161,43,204
p_50,0,7,e_0,590,711,740,15,1,0,3,4,0,1,121,29,150
p_128,0,11,e_2,474,696,747,16,2,2,0,3,0,0,222,51,273
p_115,0,9,e_0,487,711,748,12,1,0,0,3,0,1,224,37,261
p_53,0,9,e_0,587,711,748,15,2,2,5,4,0,1,124,37,161
p_51,0,9,e_0,589,711,748,15,1,1,4,4,0,1,122,37,159
p_47,0,9,e_0,593,711,748,14,1,0,2,4,0,1,118,37,155
p_84,0,12,e_2,546,696,752,24,9,9,12,4,0,1,150,56,206
p_78,0,12,e_2,556,696,752,22,7,7,9,4,0,1,140,56,196
p_117,0,10,e_0,485,711,753,13,1,0,0,4,0,1,226,42,268
p_116,0,10,e_0,486,711,753,12,1,0,0,3,0,0,225,42,267
p_57,0,11,e_0,583,711,758,16,3,3,6,4,0,1,128,47,175
p_82,0,14,e_2,550,696,760,24,8,8,10,4,0,1,146,64,210
p_81,0,14,e_2,551,696,760,24,8,8,10,4,0,1,145,64,209
p_79,0,14,e_2,553,696,760,23,8,8,9,4,0,1,143,64,207
p_22,0,3,e_3,719,756,767,12,1,0,12,4,0,1,37,11,48
p_49,0,14,e_0,591,711,769,15,1,0,3,4,0,1,120,58,178
p_21,0,4,e_3,731,756,772,8,1,0,8,4,0,1,25,16,41
p_19,0,11,e_3,754,756,795,1,1,0,1,4,0,1,2,39,41
p_23,0,12,e_3,711,756,800,14,0,0,14,3,0,0,45,44,89
p_20,0,14,e_3,734,756,808,7,1,0,7,4,0,1,22,52,74
p_65,0,1,e_2,573,804,809,18,4,4,3,4,0,1,231,5,236
p_72,0,3,e_2,562,804,817,21,6,6,6,4,0,1,242,13,255
p_71,0,3,e_2,564,804,817,20,6,6,6,4,0,1,240,13,253
p_70,0,3,e_2,565,804,817,20,6,6,6,4,0,1,239,13,252
p_67,0,3,e_2,568,804,817,19,6,6,5,4,0,1,236,13,249
p_66,0,3,e_2,569,804,817,19,5,5,4,4,0,1,235,13,248
p_45,0,2,e_0,595,813,821,13,1,0,2,4,0,1,218,8,226
p_64,0,4,e_2,574,804,822,18,4,4,3,4,0,1,230,18,248
p_75,0,5,e_2,559,804,827,22,7,7,8,4,0,1,245,23,268
p_76,0,6,e_2,558,804,832,22,7,7,8,4,0,1,246,28,274
p_42,0,6,e_0,598,813,835,12,1,0,1,4,0,1,215,22,237
p_74,0,7,e_2,560,804,837,21,7,7,7,4,0,1,244,33,277
p_43,0,7,e_0,597,813,840,13,1,0,1,4,0,1,216,27,243
p_44,0,8,e_0,596,813,845,13,1,0,1,4,0,1,217,32,249
p_11,0,9,e_0,807,813,850,14,0,0,2,4,0,1,6,37,43
p_73,0,11,e_2,561,804,851,21,6,6,7,4,0,1,243,47,290
p_41,0,11,e_0,600,813,858,12,1,0,0,4,0,1,213,45,258
p_68,0,13,e_2,567,804,859,19,6,6,5,4,0,1,237,55,292
p_63,0,13,e_2,577,804,859,18,4,4,2,4,0,1,227,55,282
p_62,0,13,e_2,578,804,859,17,4,4,1,4,0,1,226,55,281
p_69,0,14,e_2,566,804,864,20,6,6,5,4,0,1,238,60,298
p_9,0,2,e_3,846,879,887,11,1,0,11,4,0,1,33,8,41
p_6,0,3,e_3,877,879,892,0,1,0,0,4,0,1,2,13,15
p_7,0,5,e_3,875,879,900,1,1,0,1,4,0,1,4,21,25
p_10,0,8,e_3,835,879,911,14,0,0,14,3,0,0,44,32,76
p_24,0,2,e_2,695,908,916,14,0,0,0,3,0,0,213,8,221
p_30,0,3,e_2,668,908,921,20,4,4,9,4,0,1,240,13,253
p_8,0,11,e_3,874,879,922,2,1,0,2,4,0,1,5,43,48
p_29,0,5,e_2,670,908,929,20,4,4,8,4,0,1,238,21,259
p_61,0,6,e_2,579,908,934,17,3,3,1,4,0,1,329,26,355
p_32,0,6,e_2,650,908,934,25,7,7,15,4,0,1,258,26,284
p_31,0,6,e_2,666,908,934,21,5,5,10,4,0,1,242,26,268
p_26,0,8,e_2,684,908,942,17,2,2,4,4,0,1,224,34,258
p_25,0,8,e_2,686,908,942,16,2,2,3,4,0,1,222,34,256
p_60,0,10,e_2,580,908,950,17,3,3,1,4,0,1,328,42,370
p_27,0,10,e_2,677,908,950,18,3,3,6,4,0,1,231,42,273
p_58,0,11,e_2,582,908,955,16,3,3,0,3,0,0,326,47,373
p_28,0,11,e_2,676,908,955,19,3,3,7,4,0,1,232,47,279
p_34,0,12,e_2,646,908,960,26,7,7,14,5,1,1,262,52,314
p_59,0,14,e_2,581,908,968,17,3,3,0,4,0,1,327,60,387
p_33,0,15,e_2,649,908,973,25,7,7,15,4,0,1,259,65,324
p_4,0,1,e_2,886,1020,1025,20,4,4,7,4,0,1,134,5,139
p_16,0,2,e_2,780,1020,1030,22,3,3,8,4,0,1,240,10,250
p_14,0,4,e_2,794,1020,1038,17,2,2,3,4,0,1,226,18,244
p_1,0,5,e_2,894,1020,1043,19,3,3,5,4,0,1,126,23,149
p_5,0,8,e_2,883,1020,1054,21,5,5,8,4,0,1,137,34,171
p_3,0,8,e_2,888,1020,1054,20,4,4,7,4,0,1,132,34,166
p_15,0,9,e_2,793,1020,1059,17,3,3,3,4,0,1,227,39,266
p_18,0,10,e_2,766,1020,1064,25,4,4,12,4,0,1,254,44,298
p_17,0,10,e_2,776,1020,1064,23,3,3,9,4,0,1,244,44,288
p_13,0,11,e_2,796,1020,1069,17,2,2,2,4,0,1,224,49,273
p_12,0,11,e_2,798,1020,1069,16,2,2,2,4,0,1,222,49,271
p_2,0,11,e_2,892,1020,1069,19,3,3,5,4,0,1,128,49,177
p_300,0,4,e_0,8,8,24,0,0,0,0,3,0,0,0,16,16
p_299,0,5,e_1,9,10,29,0,0,0,0,3,0,0,1,19,20
p_297,0,6,e_3,15,15,37,0,0,0,0,3,0,0,0,22,22
p_298,0,9,e_2,11,12,43,0,0,0,0,3,0,0,1,31,32
p_296,0,4,e_0,28,42,56,9,1,1,4,3,0,0,14,14,28
p_295,0,5,e_0,29,42,61,9,1,1,4,4,0,1,13,19,32
p_292,0,6,e_0,38,42,66,6,0,0,1,4,0,1,4,24,28
p_290,0,6,e_0,40,42,66,6,0,0,0,4,0,1,2,24,26
p_286,0,3,e_1,46,60,71,6,0,0,4,4,0,1,14,11,25
p_289,0,4,e_1,43,60,76,6,0,0,5,3,0,0,17,16,33
p_285,0,4,e_1,53,60,76,6,0,0,2,4,0,1,7,16,23
p_284,0,4,e_1,54,60,76,6,0,0,2,4,0,1,6,16,22
p_287,0,5,e_1,45,60,81,6,0,0,5,4,0,1,15,21,36
p_291,0,11,e_0,39,42,83,6,0,0,1,4,0,1,3,41,44
p_294,0,12,e_0,31,42,88,8,1,1,4,4,0,1,11,46,57
p_293,0,12,e_0,33,42,88,7,1,1,3,4,0,1,9,46,55
p_281,0,1,e_3,73,87,92,5,1,0,5,4,0,1,14,5,19
p_288,0,8,e_1,44,60,92,6,0,0,5,4,0,1,16,32,48
p_283,0,9,e_1,57,60,97,6,0,0,1,4,0,1,3,37,40
p_278,0,2,e_3,77,87,97,3,1,0,3,4,0,1,10,10,20
p_279,0,5,e_3,76,87,108,3,1,0,3,4,0,1,11,21,32
p_277,0,6,e_3,82,87,113,1,1,0,1,4,0,1,5,26,31
p_282,0,7,e_3,66,87,118,6,0,0,6,3,0,0,21,31,52
p_273,0,4,e_2,110,117,131,23,4,4,2,4,0,1,7,14,21
p_276,0,11,e_3,84,87,132,1,1,0,1,4,0,1,3,45,48
p_280,0,14,e_3,75,87,143,4,1,0,4,4,0,1,12,56,68
p_275,0,14,e_3,86,87,143,0,1,0,0,4,0,1,1,56,57
p_274,0,8,e_2,88,117,145,28,7,7,9,3,0,0,29,28,57
p_272,0,10,e_2,113,117,153,22,3,3,1,4,0,1,4,36,40
p_271,0,1,e_1,121,150,155,21,2,2,9,3,0,0,29,5,34
p_267,0,1,e_1,148,150,155,14,0,0,0,4,0,1,2,5,7
p_268,0,2,e_1,144,150,160,14,0,0,2,4,0,1,6,10,16
p_270,0,9,e_1,122,150,183,20,2,2,9,4,0,1,28,33,61
p_269,0,9,e_1,127,150,183,19,2,2,7,4,0,1,23,33,56
p_255,0,3,e_2,184,185,198,14,0,0,0,3,0,0,1,13,14
p_265,0,4,e_2,152,185,203,14,0,0,10,5,1,1,33,18,51
p_262,0,5,e_2,157,185,208,14,0,0,9,4,0,1,28,23,51
p_261,0,5,e_2,164,185,208,14,0,0,7,4,0,1,21,23,44
p_266,0,6,e_2,151,185,213,14,0,0,9,5,1,0,34,28,62
p_263,0,7,e_2,154,185,218,14,0,0,10,4,0,1,31,33,64
p_260,0,7,e_2,165,185,218,14,0,0,7,4,0,1,20,33,53
p_258,0,7,e_2,168,185,218,14,0,0,6,4,0,1,17,33,50
p_250,0,2,e_1,217,217,227,14,0,0,0,3,0,0,0,10,10
p_256,0,10,e_2,182,185,229,14,0,0,1,4,0,1,3,44,47
p_264,0,11,e_2,153,185,234,14,0,0,10,4,0,1,32,49,81
p_254,0,4,e_1,187,217,235,14,0,0,9,3,0,0,30,18,48
p_253,0,5,e_1,190,217,240,14,0,0,9,4,0,1,27,23,50
p_252,0,5,e_1,205,217,240,14,0,0,4,4,0,1,12,23,35
p_257,0,14,e_2,169,185,245,14,0,0,5,4,0,1,16,60,76
p_259,0,15,e_2,167,185,250,14,0,0,6,4,0,1,18,65,83
p_251,0,15,e_1,209,217,272,14,0,0,2,4,0,1,8,55,63
p_248,0,5,e_0,246,278,295,14,0,0,10,4,0,1,32,17,49
p_247,0,5,e_0,250,278,295,14,0,0,9,4,0,1,28,17,45
p_249,0,6,e_0,239,278,300,14,0,0,12,3,0,0,39,22,61
p_245,0,7,e_0,269,278,305,14,0,0,3,4,0,1,9,27,36
p_242,0,8,e_0,277,278,310,14,0,0,0,4,0,1,1,32,33
p_246,0,10,e_0,262,278,318,14,0,0,5,4,0,1,16,40,56
p_244,0,12,e_0,271,278,326,14,0,0,2,4,0,1,7,48,55
p_241,0,1,e_3,283,327,334,14,0,0,14,3,0,0,44,7,51
p_236,0,1,e_3,305,327,334,7,1,0,7,4,0,1,22,7,29
p_233,0,1,e_3,311,327,334,5,1,0,5,4,0,1,16,7,23
p_243,0,15,e_0,272,278,337,14,0,0,2,4,0,1,6,59,65
p_230,0,3,e_3,319,327,342,2,1,0,2,4,0,1,8,15,23
p_228,0,4,e_3,325,327,347,1,1,0,1,4,0,1,2,20,22
p_232,0,5,e_3,314,327,352,4,1,0,4,4,0,1,13,25,38
p_237,0,7,e_3,304,327,360,8,1,0,8,4,0,1,23,33,56
p_231,0,7,e_3,317,327,360,3,1,0,3,4,0,1,10,33,43
p_235,0,8,e_3,308,327,365,6,1,0,6,4,0,1,19,38,57
p_234,0,8,e_3,310,327,365,6,1,0,6,4,0,1,17,38,55
p_240,0,9,e_3,301,327,370,8,1,0,8,4,0,1,26,43,69
p_239,0,11,e_3,302,327,378,8,1,0,8,4,0,1,25,51,76
p_227,0,12,e_3,327,327,383,0,0,0,0,3,0,0,0,56,56
p_226,0,2,e_1,329,376,386,26,10,10,15,3,0,0,47,10,57
p_223,0,2,e_1,336,376,386,25,9,9,13,4,0,1,40,10,50
p_209,0,2,e_1,357,376,386,20,7,7,6,4,0,1,19,10,29
p_238,0,13,e_3,303,327,388,8,1,0,8,4,0,1,24,61,85
p_229,0,13,e_3,320,327,388,2,1,0,2,4,0,1,7,61,68
p_214,0,3,e_1,349,376,391,22,8,8,9,4,0,1,27,15,42
p_225,0,5,e_2,330,377,394,26,10,10,15,3,0,0,47,17,64
p_224,0,5,e_1,331,376,399,26,10,10,15,4,0,1,45,23,68
p_222,0,5,e_1,337,376,399,24,9,9,13,4,0,1,39,23,62
p_219,0,5,e_1,342,376,399,23,8,8,11,4,0,1,34,23,57
p_221,0,6,e_1,339,376,404,24,9,9,12,4,0,1,37,28,65
p_220,0,6,e_1,341,376,404,23,8,8,12,4,0,1,35,28,63
p_210,0,6,e_1,354,376,404,21,7,7,7,4,0,1,22,28,50
p_212,0,7,e_1,351,376,409,21,8,8,8,4,0,1,25,33,58
p_191,0,10,e_2,376,377,411,15,4,4,0,4,0,1,1,34,35
p_218,0,11,e_1,343,376,423,23,8,8,11,4,0,1,33,47,80
p_216,0,1,e_3,347,429,434,4,8,8,4,3,8,1,82,5,87
p_190,0,1,e_0,379,427,434,15,3,3,15,3,0,0,48,7,55
p_183,0,1,e_0,396,427,434,11,1,0,10,4,0,1,31,7,38
p_215,0,15,e_1,348,376,437,22,8,8,9,4,0,1,28,61,89
p_213,0,15,e_1,350,376,437,22,8,8,8,4,0,1,26,61,87
p_211,0,15,e_1,353,376,437,21,7,7,8,4,0,1,23,61,84
p_182,0,2,e_0,397,427,439,11,1,0,10,4,0,1,30,12,42
p_180,0,2,e_0,399,427,439,10,1,0,9,4,0,1,28,12,40
p_178,0,3,e_0,401,427,444,9,1,0,9,4,0,1,26,17,43
p_186,0,4,e_0,390,427,449,13,1,0,12,4,0,1,37,22,59
p_176,0,4,e_0,403,427,449,9,1,0,8,4,0,1,24,22,46
p_217,0,7,e_3,346,429,454,4,7,7,4,3,8,0,83,25,108
p_189,0,8,e_0,382,427,463,14,3,3,15,4,0,1,45,36,81
p_179,0,8,e_0,400,427,463,9,1,0,9,4,0,1,27,36,63
p_177,0,9,e_0,402,427,468,9,1,0,8,4,0,1,25,41,66
p_158,0,1,e_2,430,462,469,14,2,2,10,4,0,1,32,7,39
p_146,0,1,e_2,453,462,469,7,1,1,3,4,0,1,9,7,16
p_185,0,10,e_0,391,427,473,12,1,0,12,4,0,1,36,46,82
p_187,0,12,e_0,389,427,481,13,1,0,12,4,0,1,38,54,92
p_184,0,12,e_0,392,427,481,12,1,0,11,4,0,1,35,54,89
p_188,0,13,e_0,384,427,486,14,2,2,14,4,0,1,43,59,102
p_159,0,6,e_2,429,462,486,14,2,2,10,3,0,0,33,24,57
p_150,0,6,e_2,443,462,486,10,1,1,6,4,0,1,19,24,43
p_154,0,7,e_2,436,462,491,13,1,1,9,4,0,1,26,29,55
p_205,0,2,e_1,362,484,494,19,6,6,4,4,0,1,122,10,132
p_181,0,15,e_0,398,427,494,10,1,0,9,4,0,1,29,67,96
p_148,0,8,e_2,449,462,496,9,1,1,4,4,0,1,13,34,47
p_153,0,9,e_2,437,462,501,13,1,1,8,4,0,1,25,39,64
p_147,0,9,e_2,452,462,501,7,1,1,3,4,0,1,10,39,49
p_200,0,4,e_1,367,484,502,18,5,5,3,4,0,1,117,18,135
p_196,0,4,e_1,371,484,502,17,4,4,1,4,0,1,113,18,131
p_201,0,5,e_1,366,484,507,18,5,5,3,4,0,1,118,23,141
p_145,0,11,e_2,454,462,509,7,0,0,2,4,0,1,8,47,55
p_208,0,6,e_1,358,484,512,19,7,7,6,4,0,1,126,28,154
p_194,0,6,e_1,373,484,512,17,4,4,1,4,0,1,111,28,139
p_157,0,14,e_2,431,462,520,14,2,2,10,4,0,1,31,58,89
p_155,0,14,e_2,435,462,520,13,1,1,9,4,0,1,27,58,85
p_117,0,10,e_3,485,486,520,0,0,0,0,3,0,0,1,34,35
p_116,0,10,e_3,486,486,520,0,1,1,0,3,0,1,0,34,34
p_198,0,9,e_1,369,484,523,17,4,4,2,4,0,1,115,39,154
p_138,0,11,e_3,463,486,525,7,0,0,7,3,0,0,23,39,62
p_156,0,15,e_2,434,462,525,13,1,1,9,4,0,1,28,63,91
p_152,0,15,e_2,441,462,525,11,1,1,7,4,0,1,21,63,84
p_151,0,15,e_2,442,462,525,11,1,1,7,4,0,1,20,63,83
p_149,0,15,e_2,444,462,525,10,1,1,6,4,0,1,18,63,81
p_197,0,10,e_1,370,484,528,17,4,4,2,4,0,1,114,44,158
p_207,0,11,e_1,359,484,533,19,7,7,6,4,0,1,125,49,174
p_206,0,12,e_1,361,484,538,19,6,6,5,4,0,1,123,54,177
p_203,0,12,e_1,364,484,538,18,5,5,4,4,0,1,120,54,174
p_204,0,14,e_1,363,484,546,18,6,6,4,4,0,1,121,62,183
p_167,0,1,e_0,413,541,546,5,1,0,4,4,0,1,128,5,133
p_161,0,1,e_0,421,541,546,2,1,0,2,4,0,1,120,5,125
p_202,0,15,e_1,365,484,551,18,5,5,3,4,0,1,119,67,186
p_199,0,15,e_1,368,484,551,17,5,5,3,4,0,1,116,67,183
p_195,0,15,e_1,372,484,551,17,4,4,1,4,0,1,112,67,179
p_165,0,4,e_0,417,541,557,4,1,0,3,4,0,1,124,16,140
p_169,0,9,e_0,411,541,574,6,1,0,5,4,0,1,130,33,163
p_163,0,10,e_0,419,541,579,3,1,0,2,4,0,1,122,38,160
p_86,0,2,e_2,544,572,580,11,0,0,9,4,0,1,28,8,36
p_173,0,11,e_0,407,541,584,7,1,0,7,4,0,1,134,43,177
p_164,0,11,e_0,418,541,584,3,1,0,3,4,0,1,123,43,166
p_162,0,11,e_0,420,541,584,3,1,0,2,4,0,1,121,43,164
p_143,0,3,e_2,456,572,585,7,0,0,2,4,0,1,116,13,129
p_166,0,12,e_0,416,541,589,4,1,0,3,4,0,1,125,48,173
p_171,0,13,e_0,409,541,594,7,1,0,6,4,0,1,132,53,185
p_168,0,13,e_0,412,541,594,6,1,0,5,4,0,1,129,53,182
p_141,0,6,e_2,458,572,596,7,0,0,1,4,0,1,114,24,138
p_175,0,14,e_0,405,541,599,8,1,0,7,4,0,1,136,58,194
p_174,0,14,e_0,406,541,599,7,1,0,7,4,0,1,135,58,193
p_170,0,14,e_0,410,541,599,6,1,0,5,4,0,1,131,58,189
p_80,0,7,e_2,552,572,601,11,0,0,6,4,0,1,20,29,49
p_172,0,15,e_0,408,541,604,7,1,0,6,4,0,1,133,63,196
p_130,0,1,e_1,472,598,605,4,1,0,4,4,0,1,126,7,133
p_140,0,8,e_2,459,572,606,7,0,0,1,4,0,1,113,34,147
p_83,0,8,e_2,549,572,606,11,0,0,8,4,0,1,23,34,57
p_144,0,9,e_2,455,572,611,7,0,0,2,4,0,1,117,39,156
p_142,0,9,e_2,457,572,611,7,0,0,2,4,0,1,115,39,154
p_136,0,3,e_1,465,598,613,7,1,0,6,4,0,1,133,15,148
p_129,0,3,e_1,473,598,613,4,1,0,4,4,0,1,125,15,140
p_139,0,10,e_2,461,572,616,7,0,0,0,3,0,0,111,44,155
p_137,0,4,e_1,464,598,618,7,1,0,6,4,0,1,134,20,154
p_84,0,12,e_2,546,572,624,11,0,0,9,4,0,1,26,52,78
p_78,0,12,e_2,556,572,624,11,0,0,5,4,0,1,16,52,68
p_192,0,8,e_1,375,598,632,16,4,4,0,3,0,0,223,34,257
p_82,0,14,e_2,550,572,632,11,0,0,7,4,0,1,22,60,82
p_81,0,14,e_2,551,572,632,11,0,0,7,4,0,1,21,60,81
p_79,0,14,e_2,553,572,632,11,0,0,6,4,0,1,19,60,79
p_85,0,15,e_2,545,572,637,11,0,0,9,4,0,1,27,65,92
p_135,0,10,e_1,466,598,640,7,1,0,6,4,0,1,132,42,174
p_127,0,10,e_1,475,598,640,3,1,0,3,4,0,1,123,42,165
p_193,0,11,e_1,374,598,645,16,4,4,1,4,0,1,224,47,271
p_132,0,11,e_1,470,598,645,5,1,0,5,4,0,1,128,47,175
p_128,0,11,e_1,474,598,645,4,1,0,3,4,0,1,124,47,171
p_133,0,12,e_1,469,598,650,6,1,0,5,4,0,1,129,52,181
p_126,0,12,e_1,476,598,650,3,1,0,2,4,0,1,122,52,174
p_42,0,6,e_3,598,634,654,11,0,0,11,3,0,0,36,20,56
p_113,0,1,e_0,489,651,656,22,2,2,13,5,1,1,162,5,167
p_131,0,14,e_1,471,598,658,5,1,0,4,4,0,1,127,60,187
p_125,0,14,e_1,477,598,658,3,1,0,2,4,0,1,121,60,181
p_134,0,15,e_1,467,598,663,6,1,0,5,4,0,1,131,65,196
p_114,0,3,e_0,488,651,664,22,2,2,13,5,1,1,163,13,176
p_106,0,3,e_0,500,651,664,18,2,2,13,4,0,1,151,13,164
p_37,0,9,e_3,615,634,665,6,1,0,6,4,0,1,19,31,50
p_35,0,9,e_3,630,634,665,1,1,0,1,4,0,1,4,31,35
p_41,0,11,e_3,600,634,673,11,1,0,11,4,0,1,34,39,73
p_108,0,6,e_0,496,651,675,20,2,2,15,4,0,1,155,24,179
p_39,0,12,e_3,607,634,678,9,1,0,9,4,0,1,27,44,71
p_102,0,7,e_0,509,651,680,16,2,2,11,4,0,1,142,29,171
p_40,0,13,e_3,602,634,683,11,1,0,11,4,0,1,32,49,81
p_38,0,13,e_3,608,634,683,9,1,0,9,4,0,1,26,49,75
p_36,0,13,e_3,628,634,683,2,1,0,2,4,0,1,6,49,55
p_111,0,8,e_0,491,651,685,22,2,2,14,5,1,1,160,34,194
p_115,0,9,e_0,487,651,690,22,2,2,13,5,1,1,164,39,203
p_77,0,3,e_2,557,684,695,11,0,0,5,4,0,1,127,11,138
p_72,0,3,e_2,562,684,695,11,0,0,3,4,0,1,122,11,133
p_71,0,3,e_2,564,684,695,11,0,0,2,4,0,1,120,11,131
p_70,0,3,e_2,565,684,695,11,0,0,2,4,0,1,119,11,130
p_67,0,3,e_2,568,684,695,11,0,0,1,4,0,1,116,11,127
p_66,0,3,e_2,569,684,695,11,0,0,1,4,0,1,115,11,126
p_30,0,3,e_2,668,684,695,17,3,3,5,4,0,1,16,11,27
p_112,0,11,e_0,490,651,698,22,2,2,14,5,1,1,161,47,208
p_110,0,11,e_0,492,651,698,21,2,2,14,5,1,1,159,47,206
p_107,0,11,e_0,499,651,698,19,2,2,14,4,0,1,152,47,199
p_103,0,11,e_0,508,651,698,16,2,2,11,4,0,1,143,47,190
p_105,0,12,e_0,502,651,703,18,2,2,13,4,0,1,149,52,201
p_75,0,5,e_2,559,684,703,11,0,0,4,4,0,1,125,19,144
p_29,0,5,e_2,670,684,703,16,3,3,5,4,0,1,14,19,33
p_76,0,6,e_2,558,684,708,11,0,0,5,4,0,1,126,24,150
p_31,0,6,e_2,666,684,708,17,3,3,6,4,0,1,18,24,42
p_104,0,14,e_0,503,651,711,17,2,2,12,4,0,1,148,60,208
p_74,0,7,e_2,560,684,713,11,0,0,4,4,0,1,124,29,153
p_119,0,1,e_1,483,710,715,1,1,0,0,4,0,1,227,5,232
p_65,0,1,e_1,573,710,715,11,0,0,8,4,0,1,137,5,142
p_160,0,15,e_0,426,651,716,1,1,0,0,3,0,0,225,65,290
p_109,0,15,e_0,493,651,716,21,2,2,15,2,1,1,158,65,223
p_64,0,4,e_1,574,710,726,11,0,0,8,4,0,1,136,16,152
p_73,0,11,e_2,561,684,727,11,0,0,3,4,0,1,123,43,166
p_61,0,6,e_1,579,710,734,11,0,0,6,4,0,1,131,24,155
p_68,0,13,e_2,567,684,735,11,0,0,1,4,0,1,117,51,168
p_124,0,7,e_1,478,710,739,3,1,0,2,4,0,1,232,29,261
p_118,0,7,e_1,484,710,739,0,1,0,0,3,0,0,226,29,255
p_69,0,14,e_2,566,684,740,11,0,0,2,4,0,1,118,56,174
p_60,0,10,e_1,580,710,750,11,0,0,6,4,0,1,130,40,170
p_123,0,11,e_1,479,710,755,2,1,0,2,4,0,1,231,45,276
p_121,0,11,e_1,481,710,755,2,1,0,1,4,0,1,229,45,274
p_120,0,11,e_1,482,710,755,1,1,0,0,4,0,1,228,45,273
p_58,0,11,e_1,582,710,755,11,0,0,5,4,0,1,128,45,173
p_63,0,13,e_1,577,710,763,11,0,0,7,4,0,1,133,53,186
p_62,0,13,e_1,578,710,763,11,0,0,6,4,0,1,132,53,185
p_22,0,3,e_3,719,753,764,11,1,0,11,4,0,1,34,11,45
p_59,0,14,e_1,581,710,768,11,0,0,5,4,0,1,129,58,187
p_96,0,1,e_0,517,763,768,13,2,2,8,4,0,1,246,5,251
p_21,0,4,e_3,731,753,769,7,1,0,7,4,0,1,22,16,38
p_122,0,15,e_1,480,710,773,2,1,0,1,4,0,1,230,63,293
p_92,0,4,e_0,525,763,779,11,0,0,5,4,0,1,238,16,254
p_88,0,5,e_0,538,763,784,11,0,0,1,4,0,1,225,21,246
p_99,0,6,e_0,514,763,789,14,2,2,9,4,0,1,249,26,275
p_94,0,6,e_0,519,763,789,12,1,1,7,4,0,1,244,26,270
p_16,0,2,e_2,780,784,792,21,2,2,1,4,0,1,4,8,12
p_98,0,7,e_0,515,763,794,13,2,2,9,4,0,1,248,31,279
p_97,0,7,e_0,516,763,794,13,2,2,8,4,0,1,247,31,278
p_23,0,12,e_3,711,753,795,13,0,0,13,3,0,0,42,42,84
p_101,0,8,e_0,511,763,799,15,2,2,10,4,0,1,252,36,288
p_87,0,8,e_0,539,763,799,11,0,0,0,4,0,1,224,36,260
p_20,0,14,e_3,734,753,803,6,1,0,6,4,0,1,19,50,69
p_100,0,9,e_0,513,763,804,14,2,2,9,4,0,1,250,41,291
p_89,0,9,e_0,535,763,804,11,0,0,2,4,0,1,228,41,269
p_91,0,12,e_0,526,763,815,11,0,0,5,4,0,1,237,52,289
p_27,0,10,e_2,677,784,818,14,1,1,2,4,0,1,107,34,141
p_18,0,10,e_2,766,784,818,25,3,3,6,4,0,1,18,34,52
p_17,0,10,e_2,776,784,818,22,2,2,3,4,0,1,8,34,42
p_93,0,13,e_0,520,763,820,12,1,1,7,4,0,1,243,57,300
p_90,0,13,e_0,527,763,820,11,0,0,4,4,0,1,236,57,293
p_28,0,11,e_2,676,784,823,15,2,2,3,4,0,1,108,39,147
p_95,0,14,e_0,518,763,825,13,2,2,7,4,0,1,245,62,307
p_45,0,2,e_1,595,820,828,11,0,0,1,4,0,1,225,8,233
p_55,0,3,e_1,585,820,833,11,0,0,4,4,0,1,235,13,248
p_54,0,3,e_1,586,820,833,11,0,0,4,4,0,1,234,13,247
p_52,0,3,e_1,588,820,833,11,0,0,3,4,0,1,232,13,245
p_48,0,4,e_1,592,820,838,11,0,0,2,4,0,1,228,18,246
p_46,0,4,e_1,594,820,838,11,0,0,1,4,0,1,226,18,244
p_56,0,6,e_1,584,820,846,11,0,0,4,4,0,1,236,26,262
p_50,0,7,e_1,590,820,851,11,0,0,2,4,0,1,230,31,261
p_43,0,7,e_1,597,820,851,11,0,0,0,3,0,0,223,31,254
p_44,0,8,e_1,596,820,856,11,0,0,0,4,0,1,224,36,260
p_53,0,9,e_1,587,820,861,11,0,0,3,4,0,1,233,41,274
p_51,0,9,e_1,589,820,861,11,0,0,3,4,0,1,231,41,272
p_47,0,9,e_1,593,820,861,11,0,0,2,4,0,1,227,41,268
p_57,0,11,e_1,583,820,869,11,0,0,5,4,0,1,237,49,286
p_9,0,2,e_0,846,869,877,14,0,0,8,4,0,1,23,8,31
p_49,0,14,e_1,591,820,880,11,0,0,2,4,0,1,229,60,289
p_32,0,6,e_0,650,869,891,21,5,5,0,4,0,1,219,22,241
p_10,0,8,e_2,835,870,896,14,0,0,11,3,0,0,35,26,61
p_19,0,11,e_0,754,869,908,28,4,4,3,4,0,1,115,39,154
p_34,0,12,e_0,646,869,913,23,5,5,2,4,0,1,223,44,267
p_4,0,1,e_3,886,919,924,11,1,0,11,4,0,1,33,5,38
p_33,0,15,e_0,649,869,924,21,5,5,0,4,0,1,220,55,275
p_24,0,2,e_1,695,924,932,13,0,0,5,4,0,1,229,8,237
p_6,0,3,e_3,877,919,932,14,1,0,14,4,0,1,42,13,55
p_7,0,5,e_3,875,919,940,14,1,1,14,3,0,1,44,21,65
p_1,0,5,e_3,894,919,940,8,1,0,8,4,0,1,25,21,46
p_14,0,4,e_1,794,924,940,16,2,2,8,4,0,1,130,16,146
p_5,0,8,e_3,883,919,951,12,1,0,12,4,0,1,36,32,68
p_3,0,8,e_3,888,919,951,10,1,0,10,4,0,1,31,32,63
p_26,0,8,e_1,684,924,954,13,0,0,8,4,0,1,240,30,270
p_25,0,8,e_1,686,924,954,13,0,0,8,4,0,1,238,30,268
p_15,0,9,e_1,793,924,959,17,2,2,9,4,0,1,131,35,166
p_11,0,9,e_1,807,924,959,14,0,0,4,4,0,1,117,35,152
p_8,0,11,e_3,874,919,962,14,0,0,14,3,0,0,45,43,88
p_2,0,11,e_3,892,919,962,9,1,0,9,4,0,1,27,43,70
p_13,0,11,e_1,796,924,967,16,1,1,8,4,0,1,128,43,171
p_12,0,11,e_1,798,924,967,16,1,1,7,4,0,1,126,43,169
p_300,0,4,e_0,8,8,24,0,0,0,0,3,0,0,0,16,16
p_299,0,5,e_1,9,9,28,0,0,0,0,3,0,0,0,19,19
p_297,0,6,e_3,15,16,38,0,0,0,0,3,0,0,1,22,23
p_298,0,9,e_2,11,12,43,0,0,0,0,3,0,0,1,31,32
p_286,0,3,e_1,46,47,58,6,0,0,0,4,0,1,1,11,12
p_296,0,4,e_0,28,43,59,9,1,1,4,3,0,0,15,16,31
p_289,0,4,e_0,43,43,59,6,0,0,0,3,0,0,0,16,16
p_295,0,5,e_1,29,47,66,9,1,1,5,3,0,0,18,19,37
p_287,0,5,e_1,45,47,66,6,0,0,1,4,0,1,2,19,21
p_292,0,6,e_0,38,43,67,6,0,0,1,4,0,1,5,24,29
p_290,0,6,e_0,40,43,67,6,0,0,1,4,0,1,3,24,27
p_288,0,8,e_1,44,47,77,6,0,0,1,4,0,1,3,30,33
p_281,0,1,e_3,73,73,80,0,0,0,0,3,0,0,0,7,7
p_291,0,11,e_0,39,43,84,6,0,0,1,4,0,1,4,41,45
p_294,0,12,e_0,31,43,89,8,1,1,4,4,0,1,12,46,58
p_293,0,12,e_0,33,43,89,7,1,1,3,4,0,1,10,46,56
p_285,0,4,e_3,53,73,91,6,0,0,6,3,0,0,20,18,38
p_284,0,4,e_3,54,73,91,6,1,0,6,4,0,1,19,18,37
p_282,0,7,e_3,66,73,102,2,1,0,2,4,0,1,7,29,36
p_283,0,9,e_3,57,73,110,5,1,0,5,4,0,1,16,37,53
p_278,0,2,e_1,77,103,111,18,4,4,8,4,0,1,26,8,34
p_279,0,5,e_1,76,103,122,18,4,4,8,2,1,0,27,19,46
p_277,0,6,e_1,82,103,127,17,3,3,7,4,0,1,21,24,45
p_274,0,8,e_1,88,103,135,15,3,3,5,4,0,1,15,32,47
p_271,0,1,e_3,121,140,145,6,1,0,6,4,0,1,19,5,24
p_276,0,11,e_1,84,103,146,16,3,3,6,4,0,1,19,43,62
p_280,0,14,e_2,75,105,149,18,4,4,9,3,0,0,30,44,74
p_273,0,4,e_3,110,140,156,9,0,0,9,3,0,0,30,16,46
p_275,0,14,e_1,86,103,157,16,3,3,6,4,0,1,17,54,71
p_270,0,9,e_3,122,140,173,6,1,0,6,4,0,1,18,33,51
p_269,0,9,e_3,127,140,173,4,1,0,4,4,0,1,13,33,46
p_272,0,10,e_3,113,140,178,9,1,0,9,4,0,1,27,38,65
p_267,0,1,e_0,148,182,187,18,3,3,11,4,0,1,34,5,39
p_268,0,2,e_0,144,182,192,19,4,4,12,3,0,0,38,10,48
p_265,0,4,e_0,152,182,200,17,3,3,10,4,0,1,30,18,48
p_262,0,5,e_0,157,182,205,16,2,2,8,4,0,1,25,23,48
p_261,0,5,e_0,164,182,205,14,2,2,6,4,0,1,18,23,41
p_266,0,6,e_0,151,182,210,17,3,3,10,4,0,1,31,28,59
p_263,0,7,e_0,154,182,215,16,3,3,9,4,0,1,28,33,61
p_260,0,7,e_0,165,182,215,14,2,2,6,4,0,1,17,33,50
p_258,0,7,e_0,168,182,215,13,2,2,4,4,0,1,14,33,47
p_255,0,3,e_3,184,215,226,10,1,0,10,4,0,1,31,11,42
p_264,0,11,e_0,153,182,229,17,3,3,10,4,0,1,29,47,76
p_254,0,4,e_3,187,215,231,9,1,0,9,4,0,1,28,16,44
p_253,0,5,e_3,190,215,236,8,1,0,8,4,0,1,25,21,46
p_252,0,5,e_3,205,215,236,3,1,0,3,4,0,1,10,21,31
p_257,0,14,e_0,169,182,240,12,2,2,4,4,0,1,13,58,71
p_259,0,15,e_0,167,182,245,13,2,2,5,4,0,1,15,63,78
p_256,0,10,e_3,182,215,253,10,0,0,10,3,0,0,33,38,71
p_250,0,2,e_1,217,262,270,30,5,5,14,3,0,0,45,8,53
p_251,0,15,e_3,209,215,270,2,1,0,2,4,0,1,6,55,61
p_248,0,5,e_1,246,262,281,22,2,2,5,4,0,1,16,19,35
p_247,0,5,e_1,250,262,281,21,2,2,4,4,0,1,12,19,31
p_249,0,6,e_1,239,262,286,24,2,2,7,4,0,1,23,24,47
p_241,0,1,e_2,283,307,312,15,0,0,8,4,0,1,24,5,29
p_236,0,1,e_2,305,307,312,15,0,0,0,4,0,1,2,5,7
p_245,0,7,e_2,269,307,332,15,1,1,13,4,0,1,38,25,63
p_237,0,7,e_2,304,307,332,15,0,0,1,4,0,1,3,25,28
p_233,0,1,e_1,311,329,334,15,0,0,6,4,0,1,18,5,23
p_242,0,8,e_2,277,307,337,15,0,0,10,4,0,1,30,30,60
p_240,0,9,e_2,301,307,342,15,0,0,2,4,0,1,6,35,41
p_230,0,3,e_1,319,329,342,15,0,0,3,4,0,1,10,13,23
p_246,0,10,e_2,262,307,347,17,1,1,14,3,0,0,45,40,85
p_228,0,4,e_1,325,329,347,15,0,0,1,4,0,1,4,18,22
p_239,0,11,e_2,302,307,352,15,0,0,2,4,0,1,5,45,50
p_232,0,5,e_1,314,329,352,15,0,0,5,4,0,1,15,23,38
p_244,0,12,e_2,271,307,357,15,0,0,12,4,0,1,36,50,86
p_231,0,7,e_1,317,329,360,15,0,0,4,4,0,1,12,31,43
p_238,0,13,e_2,303,307,362,15,0,0,1,4,0,1,4,55,59
p_235,0,8,e_1,308,329,365,15,0,0,6,3,0,0,21,36,57
p_234,0,8,e_1,310,329,365,15,0,0,6,4,0,1,19,36,55
p_243,0,15,e_2,272,307,370,15,0,0,12,4,0,1,35,63,98
p_227,0,12,e_1,327,329,379,15,0,0,1,4,0,1,2,50,52
p_216,0,1,e_0,347,376,383,10,1,0,9,4,0,1,29,7,36
p_229,0,13,e_1,320,329,384,15,0,0,3,4,0,1,9,55,64
p_190,0,1,e_3,379,380,385,10,1,1,0,5,1,0,1,5,6
p_226,0,2,e_0,329,376,388,15,0,0,15,3,0,0,47,12,59
p_223,0,2,e_0,336,376,388,14,1,0,13,4,0,1,40,12,52
p_214,0,3,e_0,349,376,393,9,1,0,9,4,0,1,27,17,44
p_225,0,5,e_3,330,378,399,15,0,0,15,3,0,0,48,21,69
p_224,0,5,e_0,331,376,401,15,1,0,15,4,0,1,45,25,70
p_222,0,5,e_0,337,376,401,14,1,0,13,4,0,1,39,25,64
p_219,0,5,e_0,342,376,401,12,1,0,11,4,0,1,34,25,59
p_221,0,6,e_0,339,376,406,13,1,0,12,4,0,1,37,30,67
p_220,0,6,e_0,341,376,406,12,1,0,11,4,0,1,35,30,65
p_217,0,7,e_0,346,376,411,11,1,0,10,4,0,1,30,35,65
p_212,0,7,e_0,351,376,411,9,1,0,8,4,0,1,25,35,60
p_167,0,1,e_3,413,416,423,1,1,0,1,4,0,1,3,7,10
p_218,0,11,e_0,343,376,425,11,1,0,11,4,0,1,33,49,82
p_180,0,2,e_3,399,416,428,5,1,1,5,2,1,1,17,12,29
p_183,0,1,e_1,396,425,430,6,2,2,10,4,0,1,29,5,34
p_161,0,1,e_1,421,425,430,30,11,11,1,4,0,1,4,5,9
p_178,0,3,e_3,401,416,433,5,1,0,5,4,0,1,15,17,32
p_182,0,2,e_1,397,425,435,5,2,2,9,4,0,1,28,10,38
p_158,0,1,e_2,430,430,437,28,10,10,0,3,0,1,0,7,7
p_176,0,4,e_3,403,416,438,4,1,0,4,4,0,1,13,22,35
p_215,0,15,e_0,348,376,439,10,1,0,9,4,0,1,28,63,91
p_213,0,15,e_0,350,376,439,9,1,0,9,4,0,1,26,63,89
p_211,0,15,e_0,353,376,439,8,1,0,7,4,0,1,23,63,86
p_186,0,4,e_1,390,425,443,8,2,2,12,4,0,1,35,18,53
p_165,0,4,e_1,417,425,443,30,11,11,2,4,0,1,8,18,26
p_179,0,8,e_3,400,416,452,5,1,0,5,4,0,1,16,36,52
p_159,0,6,e_2,429,430,454,28,10,10,0,3,0,0,1,24,25
p_177,0,9,e_3,402,416,457,4,1,0,4,4,0,1,14,41,55
p_169,0,9,e_3,411,416,457,2,1,0,2,4,0,1,5,41,46
p_189,0,8,e_2,382,430,462,10,2,2,15,3,0,0,48,32,80
p_185,0,10,e_1,391,425,463,7,2,2,11,4,0,1,34,38,72
p_163,0,10,e_1,419,425,463,30,11,11,2,4,0,1,6,38,44
p_173,0,11,e_3,407,416,465,3,1,0,3,4,0,1,9,49,58
p_164,0,11,e_1,418,425,468,30,11,11,2,4,0,1,7,43,50
p_162,0,11,e_1,420,425,468,30,11,11,2,4,0,1,5,43,48
p_187,0,12,e_3,389,416,470,8,1,1,2,5,1,0,27,54,81
p_184,0,12,e_1,392,425,473,7,2,2,11,4,0,1,33,48,81
p_171,0,13,e_3,409,416,475,2,1,0,2,4,0,1,7,59,66
p_168,0,13,e_3,412,416,475,1,1,0,1,4,0,1,4,59,63
p_188,0,13,e_1,384,425,478,9,1,1,13,2,1,0,41,53,94
p_175,0,14,e_3,405,416,480,3,1,0,3,4,0,1,11,64,75
p_174,0,14,e_3,406,416,480,3,1,0,3,4,0,1,10,64,74
p_170,0,14,e_3,410,416,480,2,1,0,2,4,0,1,6,64,70
p_172,0,15,e_3,408,416,485,3,1,0,3,4,0,1,8,69,77
p_160,0,15,e_2,426,430,485,29,11,11,1,4,0,1,4,55,59
p_181,0,15,e_1,398,425,486,5,2,2,9,4,0,1,27,61,88
p_209,0,2,e_0,357,486,496,7,1,0,6,4,0,1,129,10,139
p_205,0,2,e_0,362,486,496,5,1,0,5,4,0,1,124,10,134
p_200,0,4,e_0,367,486,504,4,1,0,3,4,0,1,119,18,137
p_196,0,4,e_0,371,486,504,2,1,0,2,4,0,1,115,18,133
p_201,0,5,e_0,366,486,509,4,1,0,3,4,0,1,120,23,143
p_210,0,6,e_0,354,486,514,8,1,0,7,4,0,1,132,28,160
p_208,0,6,e_0,358,486,514,7,1,0,6,4,0,1,128,28,156
p_198,0,9,e_0,369,486,525,3,1,0,2,4,0,1,117,39,156
p_197,0,10,e_0,370,486,530,3,1,0,2,4,0,1,116,44,160
p_207,0,11,e_0,359,486,535,6,1,0,5,4,0,1,127,49,176
p_113,0,1,e_3,489,532,537,14,1,0,14,4,0,1,43,5,48
p_206,0,12,e_0,361,486,540,6,1,0,5,4,0,1,125,54,179
p_203,0,12,e_0,364,486,540,4,1,0,4,4,0,1,122,54,176
p_114,0,3,e_1,488,533,544,15,1,0,15,4,0,1,45,11,56
p_106,0,3,e_1,500,533,544,11,1,0,11,4,0,1,33,11,44
p_204,0,14,e_0,363,486,548,5,1,0,4,4,0,1,123,62,185
p_202,0,15,e_0,365,486,553,4,1,0,4,4,0,1,121,67,188
p_199,0,15,e_0,368,486,553,3,1,0,3,4,0,1,118,67,185
p_94,0,6,e_3,519,532,554,4,1,0,4,4,0,1,13,22,35
p_108,0,6,e_1,496,533,555,12,1,0,12,4,0,1,37,22,59
p_99,0,6,e_1,514,533,555,6,1,0,6,4,0,1,19,22,41
p_98,0,7,e_3,515,532,559,5,1,0,5,4,0,1,17,27,44
p_102,0,7,e_1,509,533,560,8,1,0,8,4,0,1,24,27,51
p_115,0,9,e_2,487,534,563,15,1,0,15,3,0,0,47,29,76
p_111,0,8,e_1,491,533,565,14,1,0,14,4,0,1,42,32,74
p_101,0,8,e_1,511,533,565,7,1,0,7,4,0,1,22,32,54
p_100,0,9,e_1,513,533,570,6,1,0,6,4,0,1,20,37,57
p_110,0,11,e_3,492,532,573,13,1,0,13,4,0,1,40,41,81
p_116,0,10,e_1,486,533,575,15,1,0,15,2,1,0,47,42,89
p_166,0,12,e_3,416,532,578,0,0,0,0,3,0,0,116,46,162
p_112,0,11,e_1,490,533,580,14,1,0,14,4,0,1,43,47,90
p_107,0,11,e_1,499,533,580,11,1,0,11,4,0,1,34,47,81
p_103,0,11,e_1,508,533,580,8,1,0,8,4,0,1,25,47,72
p_105,0,12,e_1,502,533,585,10,1,0,10,4,0,1,31,52,83
p_95,0,14,e_3,518,532,586,4,1,0,4,4,0,1,14,54,68
p_104,0,14,e_1,503,533,593,10,1,0,10,4,0,1,30,60,90
p_109,0,15,e_1,493,533,598,13,1,0,13,4,0,1,40,65,105
p_86,0,2,e_2,544,592,602,25,5,5,3,5,1,1,48,10,58
p_71,0,3,e_2,564,592,607,20,3,3,9,4,0,1,28,15,43
p_70,0,3,e_2,565,592,607,19,3,3,9,4,0,1,27,15,42
p_67,0,3,e_2,568,592,607,18,3,3,8,4,0,1,24,15,39
p_66,0,3,e_2,569,592,607,18,3,3,8,4,0,1,23,15,38
p_88,0,5,e_2,538,592,615,27,5,5,1,5,1,1,54,23,77
p_194,0,6,e_0,373,600,622,1,1,0,1,4,0,1,227,22,249
p_150,0,6,e_0,443,600,622,25,8,8,14,4,0,1,157,22,179
p_87,0,8,e_2,539,592,626,27,5,5,1,5,1,1,53,34,87
p_83,0,8,e_2,549,592,626,24,5,5,5,5,1,1,43,34,77
p_154,0,7,e_0,436,600,627,26,9,9,14,5,1,1,164,27,191
p_89,0,9,e_2,535,592,631,27,6,6,0,5,1,0,57,39,96
p_192,0,8,e_0,375,600,632,1,1,0,0,4,0,1,225,32,257
p_148,0,8,e_0,449,600,632,23,8,8,12,4,0,1,151,32,183
p_153,0,9,e_0,437,600,637,4,8,8,15,5,1,1,163,37,200
p_84,0,12,e_2,546,592,642,24,5,5,4,5,1,1,46,50,96
p_191,0,10,e_0,376,600,642,1,1,0,0,3,0,0,224,42,266
p_193,0,11,e_0,374,600,647,1,1,0,1,4,0,1,226,47,273
p_68,0,13,e_2,567,592,647,19,3,3,8,4,0,1,25,55,80
p_96,0,1,e_1,517,645,650,5,1,0,5,4,0,1,128,5,133
p_82,0,14,e_2,550,592,652,23,5,5,5,5,1,1,42,60,102
p_81,0,14,e_2,551,592,652,23,5,5,5,5,1,1,41,60,101
p_69,0,14,e_2,566,592,652,19,3,3,9,4,0,1,26,60,86
p_85,0,15,e_2,545,592,657,25,5,5,3,5,1,1,47,65,112
p_157,0,14,e_0,431,600,658,28,10,10,12,5,1,1,169,58,227
p_155,0,14,e_0,435,600,658,27,9,9,14,5,1,1,165,58,223
p_92,0,4,e_1,525,645,661,2,1,0,2,4,0,1,120,16,136
p_195,0,15,e_0,372,600,663,2,1,0,1,4,0,1,228,63,291
p_156,0,15,e_0,434,600,663,27,9,9,13,5,1,1,166,63,229
p_152,0,15,e_0,441,600,663,26,8,8,15,4,0,1,159,63,222
p_151,0,15,e_0,442,600,663,25,8,8,15,4,0,1,158,63,221
p_149,0,15,e_0,444,600,663,25,8,8,14,4,0,1,156,63,219
p_97,0,7,e_1,516,645,672,5,1,0,5,4,0,1,129,27,156
p_37,0,9,e_1,615,645,680,11,1,0,10,4,0,1,30,35,65
p_35,0,9,e_1,630,645,680,5,1,0,5,4,0,1,15,35,50
p_34,0,12,e_3,646,647,685,0,1,0,0,4,0,1,1,38,39
p_40,0,13,e_3,602,647,690,14,0,0,14,3,0,0,45,43,88
p_91,0,12,e_1,526,645,691,2,1,0,2,4,0,1,119,46,165
p_39,0,12,e_1,607,645,691,13,1,0,12,4,0,1,38,46,84
p_93,0,13,e_1,520,645,696,4,1,0,4,4,0,1,125,51,176
p_90,0,13,e_1,527,645,696,2,1,0,2,4,0,1,118,51,169
p_38,0,13,e_1,608,645,696,13,1,0,12,4,0,1,37,51,88
p_36,0,13,e_1,628,645,696,6,1,0,6,4,0,1,17,51,68
p_65,0,1,e_2,573,704,709,17,2,2,6,4,0,1,131,5,136
p_146,0,1,e_0,453,710,715,22,7,7,11,4,0,1,257,5,262
p_55,0,3,e_2,585,704,717,14,0,0,2,4,0,1,119,13,132
p_54,0,3,e_2,586,704,717,14,0,0,2,4,0,1,118,13,131
p_52,0,3,e_2,588,704,717,14,0,0,1,4,0,1,116,13,129
p_64,0,4,e_2,574,704,722,17,2,2,6,4,0,1,130,18,148
p_143,0,3,e_0,456,710,723,21,7,7,10,4,0,1,254,13,267
p_136,0,3,e_0,465,710,723,19,5,5,7,4,0,1,245,13,258
p_137,0,4,e_0,464,710,728,19,5,5,7,4,0,1,246,18,264
p_61,0,6,e_2,579,704,730,16,1,1,4,4,0,1,125,26,151
p_56,0,6,e_2,584,704,730,15,1,1,3,4,0,1,120,26,146
p_141,0,6,e_0,458,710,736,21,6,6,9,4,0,1,252,26,278
p_53,0,9,e_2,587,704,741,14,0,0,2,4,0,1,117,37,154
p_51,0,9,e_2,589,704,741,14,0,0,1,4,0,1,115,37,152
p_140,0,8,e_0,459,710,744,21,6,6,9,4,0,1,251,34,285
p_60,0,10,e_2,580,704,746,16,1,1,4,4,0,1,124,42,166
p_147,0,9,e_0,452,710,749,22,7,7,11,4,0,1,258,39,297
p_144,0,9,e_0,455,710,749,21,7,7,10,4,0,1,255,39,294
p_142,0,9,e_0,457,710,749,21,6,6,10,4,0,1,253,39,292
p_58,0,11,e_2,582,704,751,15,1,1,3,4,0,1,122,47,169
p_57,0,11,e_2,583,704,751,15,1,1,3,4,0,1,121,47,168
p_139,0,10,e_0,461,710,754,20,6,6,8,4,0,1,249,44,293
p_135,0,10,e_0,466,710,754,19,5,5,6,4,0,1,244,44,288
p_63,0,13,e_2,577,704,759,16,1,1,5,4,0,1,127,55,182
p_62,0,13,e_2,578,704,759,16,1,1,4,4,0,1,126,55,181
p_145,0,11,e_0,454,710,759,22,7,7,11,4,0,1,256,49,305
p_138,0,11,e_0,463,710,759,19,6,6,8,4,0,1,247,49,296
p_22,0,3,e_1,719,752,763,13,0,0,11,4,0,1,33,11,44
p_133,0,12,e_0,469,710,764,18,4,4,5,4,0,1,241,54,295
p_59,0,14,e_2,581,704,764,16,1,1,4,4,0,1,123,60,183
p_21,0,4,e_1,731,752,768,13,0,0,7,4,0,1,21,16,37
p_134,0,15,e_0,467,710,775,19,5,5,6,4,0,1,243,65,308
p_23,0,12,e_1,711,752,794,13,0,0,13,3,0,0,41,42,83
p_20,0,14,e_1,734,752,802,13,0,0,6,4,0,1,18,50,68
p_16,0,2,e_3,780,796,806,5,1,0,5,4,0,1,16,10,26
p_14,0,4,e_3,794,796,814,0,1,0,0,4,0,1,2,18,20
p_24,0,2,e_2,695,808,816,13,0,0,3,4,0,1,113,8,121
p_30,0,3,e_2,668,808,821,20,2,2,12,4,0,1,140,13,153
p_48,0,4,e_2,592,808,826,14,0,0,0,3,0,0,216,18,234
p_130,0,1,e_0,472,822,827,18,4,4,4,4,0,1,350,5,355
p_119,0,1,e_0,483,822,827,15,2,2,1,4,0,1,339,5,344
p_15,0,9,e_3,793,796,831,1,1,0,1,4,0,1,3,35,38
p_29,0,5,e_2,670,808,831,19,2,2,11,4,0,1,138,23,161
p_129,0,3,e_0,473,822,835,17,4,4,4,4,0,1,349,13,362
p_32,0,6,e_2,650,808,836,26,2,2,13,5,2,1,158,28,186
p_31,0,6,e_2,666,808,836,20,2,2,13,4,0,1,142,28,170
p_18,0,10,e_3,766,796,836,10,1,0,10,4,0,1,30,40,70
p_17,0,10,e_3,776,796,836,6,1,0,6,4,0,1,20,40,60
p_19,0,11,e_3,754,796,841,13,0,0,13,3,0,0,42,45,87
p_13,0,11,e_3,796,796,841,0,0,0,0,3,0,0,0,45,45
p_50,0,7,e_2,590,808,841,14,0,0,1,4,0,1,218,33,251
p_26,0,8,e_2,684,808,846,14,2,2,7,4,0,1,124,38,162
p_25,0,8,e_2,686,808,846,14,1,1,6,4,0,1,122,38,160
p_124,0,7,e_0,478,822,849,17,3,3,2,4,0,1,344,27,371
p_118,0,7,e_0,484,822,849,15,1,1,0,4,0,1,338,27,365
p_11,0,9,e_2,807,808,851,20,4,4,0,4,0,1,1,43,44
p_27,0,10,e_2,677,808,856,16,2,2,9,4,0,1,131,48,179
p_127,0,10,e_0,475,822,860,17,3,3,3,4,0,1,347,38,385
p_28,0,11,e_2,676,808,861,17,2,2,9,4,0,1,132,53,185
p_12,0,11,e_2,798,808,861,22,5,5,3,4,0,1,10,53,63
p_132,0,11,e_0,470,822,865,18,4,4,5,4,0,1,352,43,395
p_128,0,11,e_0,474,822,865,17,4,4,4,4,0,1,348,43,391
p_123,0,11,e_0,479,822,865,16,2,2,2,4,0,1,343,43,386
p_121,0,11,e_0,481,822,865,16,2,2,1,4,0,1,341,43,384
p_120,0,11,e_0,482,822,865,16,2,2,1,4,0,1,340,43,383
p_126,0,12,e_0,476,822,870,17,3,3,3,4,0,1,346,48,394
p_49,0,14,e_2,591,808,872,14,0,0,0,4,0,1,217,64,281
p_33,0,15,e_2,649,808,877,26,2,2,13,5,2,1,159,69,228
p_131,0,14,e_0,471,822,878,18,4,4,5,4,0,1,351,56,407
p_125,0,14,e_0,477,822,878,17,3,3,3,4,0,1,345,56,401
p_122,0,15,e_0,480,822,883,16,2,2,2,4,0,1,342,61,403
p_6,0,3,e_1,877,880,891,2,1,0,1,4,0,1,3,11,14
p_9,0,2,e_3,846,882,892,11,0,0,11,3,0,0,36,10,46
p_7,0,5,e_1,875,880,899,2,1,0,1,4,0,1,5,19,24
p_10,0,8,e_1,835,880,910,12,1,1,14,3,0,0,45,30,75
p_5,0,8,e_3,883,884,912,4,1,1,0,5,1,0,1,28,29
p_8,0,11,e_1,874,880,921,3,1,0,2,4,0,1,6,41,47
p_4,0,1,e_2,886,933,938,16,2,2,15,3,0,0,47,5,52
p_45,0,2,e_0,595,930,938,14,0,0,2,4,0,1,335,8,343
p_77,0,3,e_0,557,930,943,21,4,4,14,4,0,1,373,13,386
p_72,0,3,e_0,562,930,943,20,3,3,12,4,0,1,368,13,381
p_46,0,4,e_0,594,930,948,14,0,0,2,4,0,1,336,18,354
p_75,0,5,e_0,559,930,953,21,3,3,14,4,0,1,371,23,394
p_76,0,6,e_0,558,930,958,21,3,3,14,4,0,1,372,28,400
p_80,0,7,e_0,552,930,963,23,5,5,15,2,1,1,378,33,411
p_74,0,7,e_0,560,930,963,21,3,3,13,4,0,1,370,33,403
p_43,0,7,e_0,597,930,963,14,0,0,1,4,0,1,333,33,366
p_44,0,8,e_0,596,930,968,14,0,0,1,4,0,1,334,38,372
p_47,0,9,e_0,593,930,973,14,0,0,2,4,0,1,337,43,380
p_117,0,10,e_0,485,930,978,15,1,0,0,3,0,0,445,48,493
p_73,0,11,e_0,561,930,983,21,3,3,13,4,0,1,369,53,422
p_78,0,12,e_0,556,930,988,22,4,4,14,4,0,1,374,58,432
p_79,0,14,e_0,553,930,996,22,4,4,15,4,0,1,377,66,443
p_1,0,5,e_0,894,1040,1057,14,1,1,12,4,0,1,146,17,163
p_42,0,6,e_0,598,1040,1062,14,0,0,0,4,0,1,442,22,464
p_3,0,8,e_0,888,1040,1070,15,2,2,14,4,0,1,152,30,182
p_41,0,11,e_0,600,1040,1081,14,0,0,0,3,0,0,440,41,481
p_2,0,11,e_0,892,1040,1081,14,1,1,12,4,0,1,148,41,189
p_300,0,4,e_0,8,9,25,0,0,0,0,3,0,0,1,16,17
p_299,0,5,e_1,9,10,29,0,0,0,0,3,0,0,1,19,20
p_297,0,6,e_3,15,15,37,0,0,0,0,3,0,0,0,22,22
p_298,0,9,e_2,11,12,43,0,0,0,0,3,0,0,1,31,32
p_296,0,4,e_0,28,42,56,9,1,1,4,3,0,0,14,14,28
p_286,0,3,e_1,46,46,59,6,0,0,0,3,0,0,0,13,13
p_289,0,4,e_1,43,46,64,6,0,0,1,4,0,1,3,18,21
p_292,0,6,e_0,38,42,64,6,0,0,1,4,0,1,4,22,26
p_290,0,6,e_0,40,42,64,6,0,0,0,4,0,1,2,22,24
p_295,0,5,e_1,29,46,69,9,1,1,5,2,1,0,17,23,40
p_287,0,5,e_1,45,46,69,6,0,0,0,4,0,1,1,23,24
p_281,0,1,e_3,73,74,79,0,1,0,0,4,0,1,1,5,6
p_288,0,8,e_1,44,46,80,6,0,0,1,4,0,1,2,34,36
p_291,0,11,e_0,39,42,81,6,0,0,1,4,0,1,3,39,42
p_294,0,12,e_0,31,42,86,8,1,1,3,4,0,1,11,44,55
p_293,0,12,e_0,33,42,86,7,1,1,3,4,0,1,9,44,53
p_285,0,4,e_3,53,74,90,6,0,0,6,3,0,0,21,16,37
p_284,0,4,e_3,54,74,90,6,1,0,6,4,0,1,20,16,36
p_282,0,7,e_3,66,74,101,2,1,0,2,4,0,1,8,27,35
p_283,0,9,e_3,57,74,109,5,1,0,5,4,0,1,17,35,52
p_278,0,2,e_2,77,105,113,17,4,4,9,4,0,1,28,8,36
p_279,0,5,e_2,76,105,124,18,4,4,9,4,0,1,29,19,48
p_277,0,6,e_1,82,109,129,16,3,3,8,3,0,0,27,20,47
p_274,0,8,e_2,88,105,135,15,3,3,6,4,0,1,17,30,47
p_271,0,1,e_3,121,139,144,6,1,0,6,4,0,1,18,5,23
p_276,0,11,e_2,84,105,146,16,3,3,7,4,0,1,21,41,62
p_273,0,4,e_3,110,139,155,9,0,0,9,3,0,0,29,16,45
p_280,0,14,e_2,75,105,157,18,4,4,9,3,0,0,30,52,82
p_275,0,14,e_2,86,105,157,15,3,3,6,4,0,1,19,52,71
p_270,0,9,e_3,122,139,172,6,1,0,6,4,0,1,17,33,50
p_269,0,9,e_3,127,139,172,4,1,0,4,4,0,1,12,33,45
p_267,0,1,e_1,148,165,172,18,3,3,5,4,0,1,17,7,24
p_272,0,10,e_3,113,139,177,9,1,0,9,4,0,1,26,38,64
p_268,0,2,e_1,144,165,177,19,3,3,6,3,0,0,21,12,33
p_265,0,4,e_1,152,165,185,17,3,3,4,4,0,1,13,20,33
p_262,0,5,e_1,157,165,190,16,2,2,3,4,0,1,8,25,33
p_261,0,5,e_1,164,165,190,14,2,2,0,3,0,0,1,25,26
p_266,0,6,e_1,151,165,195,17,3,3,5,4,0,1,14,30,44
p_263,0,7,e_1,154,165,200,16,3,3,4,4,0,1,11,35,46
p_260,0,7,e_1,165,165,200,13,2,2,0,3,0,1,0,35,35
p_264,0,11,e_1,153,165,214,17,3,3,4,4,0,1,12,49,61
p_255,0,3,e_0,184,205,216,10,0,0,7,4,0,1,21,11,32
p_254,0,4,e_0,187,205,221,10,0,0,6,4,0,1,18,16,34
p_253,0,5,e_0,190,205,226,10,0,0,5,4,0,1,15,21,36
p_258,0,7,e_0,168,205,234,12,2,2,12,4,0,1,37,29,66
p_256,0,10,e_0,182,205,245,10,0,0,7,4,0,1,23,40,63
p_250,0,2,e_3,217,238,246,7,1,0,7,4,0,1,21,8,29
p_252,0,5,e_3,205,238,257,10,0,0,10,3,0,0,33,19,52
p_257,0,14,e_0,169,205,259,12,2,2,12,4,0,1,36,54,90
p_259,0,15,e_0,167,205,264,13,2,2,12,3,0,0,38,59,97
p_251,0,15,e_3,209,238,289,10,1,0,10,4,0,1,29,51,80
p_248,0,5,e_1,246,275,292,28,2,2,10,4,0,1,29,17,46
p_247,0,5,e_1,250,275,292,27,2,2,8,4,0,1,25,17,42
p_249,0,6,e_1,239,275,297,30,3,3,11,3,0,0,36,22,58
p_245,0,7,e_1,269,275,302,22,1,1,2,4,0,1,6,27,33
p_246,0,10,e_1,262,275,313,24,1,1,4,4,0,1,13,38,51
p_244,0,12,e_1,271,275,321,21,1,1,1,4,0,1,4,46,50
p_241,0,1,e_2,283,321,326,17,1,1,13,4,0,1,38,5,43
p_236,0,1,e_2,305,321,326,15,0,0,5,4,0,1,16,5,21
p_233,0,1,e_2,311,321,326,15,0,0,3,4,0,1,10,5,15
p_243,0,15,e_1,272,275,332,20,1,1,1,4,0,1,3,57,60
p_230,0,3,e_2,319,321,334,15,0,0,0,4,0,1,2,13,15
p_232,0,5,e_2,314,321,342,15,0,0,2,4,0,1,7,21,28
p_237,0,7,e_2,304,321,350,15,0,0,5,4,0,1,17,29,46
p_231,0,7,e_2,317,321,350,15,0,0,1,4,0,1,4,29,33
p_242,0,8,e_2,277,321,355,19,1,1,14,3,0,0,44,34,78
p_235,0,8,e_2,308,321,355,15,0,0,4,4,0,1,13,34,47
p_234,0,8,e_2,310,321,355,15,0,0,3,4,0,1,11,34,45
p_240,0,9,e_2,301,321,360,15,0,0,7,4,0,1,20,39,59
p_239,0,11,e_2,302,321,368,15,0,0,6,4,0,1,19,47,66
p_238,0,13,e_2,303,321,376,15,0,0,6,4,0,1,18,55,73
p_229,0,13,e_2,320,321,376,15,0,0,0,4,0,1,1,55,56
p_216,0,1,e_0,347,372,379,9,1,0,8,4,0,1,25,7,32
p_226,0,2,e_0,329,372,384,15,1,0,14,4,0,1,43,12,55
p_223,0,2,e_0,336,372,384,13,1,0,12,4,0,1,36,12,48
p_214,0,3,e_0,349,372,389,8,1,0,7,4,0,1,23,17,40
p_228,0,4,e_0,325,372,394,15,0,0,15,3,0,0,47,22,69
p_224,0,5,e_1,331,379,396,14,1,0,15,2,1,0,48,17,65
p_194,0,6,e_3,373,375,397,0,1,0,0,4,0,1,2,22,24
p_225,0,5,e_0,330,372,399,15,1,0,14,4,0,1,42,27,69
p_222,0,5,e_0,337,372,399,13,1,0,12,4,0,1,35,27,62
p_219,0,5,e_0,342,372,399,11,1,0,10,4,0,1,30,27,57
p_221,0,6,e_0,339,372,404,12,1,0,11,4,0,1,33,32,65
p_220,0,6,e_0,341,372,404,11,1,0,10,4,0,1,31,32,63
p_192,0,8,e_3,375,375,405,0,1,1,0,3,0,1,0,30,30
p_217,0,7,e_0,346,372,409,9,1,0,8,4,0,1,26,37,63
p_212,0,7,e_0,351,372,409,8,1,0,7,4,0,1,21,37,58
p_191,0,10,e_1,376,379,413,24,5,5,1,4,0,1,3,34,37
p_193,0,11,e_3,374,375,416,0,0,0,0,3,0,0,1,41,42
p_227,0,12,e_3,327,375,421,15,0,0,15,3,0,0,48,46,94
p_218,0,11,e_0,343,372,423,10,1,0,9,4,0,1,29,51,80
p_190,0,1,e_2,379,421,428,24,4,4,13,3,0,0,42,7,49
p_183,0,1,e_2,396,421,428,18,4,4,8,4,0,1,25,7,32
p_182,0,2,e_2,397,421,433,18,3,3,8,4,0,1,24,12,36
p_180,0,2,e_2,399,421,433,18,3,3,7,4,0,1,22,12,34
p_215,0,15,e_0,348,372,437,9,1,0,8,4,0,1,24,65,89
p_213,0,15,e_0,350,372,437,8,1,0,7,4,0,1,22,65,87
p_178,0,3,e_2,401,421,438,17,3,3,6,4,0,1,20,17,37
p_186,0,4,e_2,390,421,443,20,4,4,10,4,0,1,31,22,53
p_176,0,4,e_2,403,421,443,16,3,3,6,4,0,1,18,22,40
p_189,0,8,e_2,382,421,457,23,4,4,13,4,0,1,39,36,75
p_179,0,8,e_2,400,421,457,17,3,3,7,4,0,1,21,36,57
p_177,0,9,e_2,402,421,462,17,3,3,6,4,0,1,19,41,60
p_158,0,1,e_1,430,458,465,12,0,0,9,4,0,1,28,7,35
p_146,0,1,e_1,453,458,465,12,0,0,2,4,0,1,5,7,12
p_185,0,10,e_2,391,421,467,20,4,4,10,4,0,1,30,46,76
p_187,0,12,e_2,389,421,475,21,4,4,11,4,0,1,32,54,86
p_184,0,12,e_2,392,421,475,19,4,4,9,4,0,1,29,54,83
p_188,0,13,e_2,384,421,480,22,4,4,12,4,0,1,37,59,96
p_159,0,6,e_1,429,458,482,12,0,0,9,4,0,1,29,24,53
p_150,0,6,e_1,443,458,482,12,0,0,5,4,0,1,15,24,39
p_154,0,7,e_1,436,458,487,12,0,0,7,4,0,1,22,29,51
p_181,0,15,e_2,398,421,488,18,3,3,7,4,0,1,23,67,90
p_209,0,2,e_0,357,484,492,6,1,0,5,4,0,1,127,8,135
p_205,0,2,e_0,362,484,492,4,1,0,3,4,0,1,122,8,130
p_148,0,8,e_1,449,458,492,12,0,0,3,4,0,1,9,34,43
p_153,0,9,e_1,437,458,497,12,0,0,7,4,0,1,21,39,60
p_147,0,9,e_1,452,458,497,12,0,0,2,4,0,1,6,39,45
p_200,0,4,e_0,367,484,500,2,1,0,2,4,0,1,117,16,133
p_201,0,5,e_0,366,484,505,3,1,0,2,4,0,1,118,21,139
p_210,0,6,e_0,354,484,510,7,1,0,6,4,0,1,130,26,156
p_208,0,6,e_0,358,484,510,6,1,0,5,4,0,1,126,26,152
p_157,0,14,e_1,431,458,514,12,0,0,9,4,0,1,27,56,83
p_155,0,14,e_1,435,458,514,12,0,0,7,4,0,1,23,56,79
p_160,0,15,e_1,426,458,519,12,0,0,10,3,0,0,32,61,93
p_156,0,15,e_1,434,458,519,12,0,0,8,4,0,1,24,61,85
p_152,0,15,e_1,441,458,519,12,0,0,6,4,0,1,17,61,78
p_151,0,15,e_1,442,458,519,12,0,0,5,4,0,1,16,61,77
p_149,0,15,e_1,444,458,519,12,0,0,5,4,0,1,14,61,75
p_198,0,9,e_0,369,484,521,2,1,0,1,4,0,1,115,37,152
p_197,0,10,e_0,370,484,526,1,1,0,0,4,0,1,114,42,156
p_113,0,1,e_3,489,522,527,11,1,0,11,4,0,1,33,5,38
p_207,0,11,e_0,359,484,531,5,1,0,4,4,0,1,125,47,172
p_114,0,3,e_3,488,522,535,11,1,0,11,4,0,1,34,13,47
p_106,0,3,e_3,500,522,535,7,1,0,7,4,0,1,22,13,35
p_206,0,12,e_0,361,484,536,5,1,0,3,4,0,1,123,52,175
p_203,0,12,e_0,364,484,536,4,1,0,3,4,0,1,120,52,172
p_167,0,1,e_2,413,535,542,14,2,2,3,4,0,1,122,7,129
p_161,0,1,e_2,421,535,542,12,0,0,0,3,0,1,114,7,121
p_204,0,14,e_0,363,484,544,4,1,0,3,4,0,1,121,60,181
p_108,0,6,e_3,496,522,546,8,1,0,8,4,0,1,26,24,50
p_211,0,15,e_0,353,484,549,7,1,0,6,4,0,1,131,65,196
p_202,0,15,e_0,365,484,549,3,1,0,2,4,0,1,119,65,184
p_199,0,15,e_0,368,484,549,2,1,0,1,4,0,1,116,65,181
p_118,0,7,e_3,484,522,551,12,0,0,12,3,0,0,38,29,67
p_165,0,4,e_2,417,535,553,13,1,1,1,4,0,1,118,18,136
p_111,0,8,e_3,491,522,556,10,1,0,10,4,0,1,31,34,65
p_115,0,9,e_3,487,522,561,12,1,0,12,4,0,1,35,39,74
p_117,0,10,e_3,485,522,566,12,1,0,12,4,0,1,37,44,81
p_116,0,10,e_3,486,522,566,12,1,0,12,4,0,1,36,44,80
p_169,0,9,e_2,411,535,570,15,2,2,3,4,0,1,124,35,159
p_112,0,11,e_3,490,522,571,10,1,0,10,4,0,1,32,49,81
p_110,0,11,e_3,492,522,571,10,1,0,10,4,0,1,30,49,79
p_107,0,11,e_3,499,522,571,7,1,0,7,4,0,1,23,49,72
p_163,0,10,e_2,419,535,575,13,1,1,0,4,0,1,116,40,156
p_105,0,12,e_3,502,522,576,7,1,0,7,4,0,1,20,54,74
p_86,0,2,e_1,544,566,576,25,10,10,7,4,0,1,22,10,32
p_173,0,11,e_2,407,535,580,16,2,2,5,4,0,1,128,45,173
p_164,0,11,e_2,418,535,580,13,1,1,1,4,0,1,117,45,162
p_162,0,11,e_2,420,535,580,12,1,1,0,3,0,0,115,45,160
p_143,0,3,e_1,456,566,581,12,0,0,1,4,0,1,110,15,125
p_104,0,14,e_3,503,522,584,6,1,0,6,4,0,1,19,62,81
p_166,0,12,e_2,416,535,585,13,1,1,2,4,0,1,119,50,169
p_88,0,5,e_1,538,566,589,26,10,10,9,4,0,1,28,23,51
p_109,0,15,e_3,493,522,589,10,1,0,10,4,0,1,29,67,96
p_171,0,13,e_2,409,535,590,15,2,2,4,4,0,1,126,55,181
p_168,0,13,e_2,412,535,590,14,2,2,3,4,0,1,123,55,178
p_141,0,6,e_1,458,566,594,12,0,0,0,3,0,1,108,28,136
p_175,0,14,e_2,405,535,595,16,2,2,5,4,0,1,130,60,190
p_174,0,14,e_2,406,535,595,16,2,2,5,4,0,1,129,60,189
p_170,0,14,e_2,410,535,595,15,2,2,3,4,0,1,125,60,185
p_80,0,7,e_1,552,566,599,23,8,8,5,4,0,1,14,33,47
p_172,0,15,e_2,408,535,600,16,2,2,4,4,0,1,127,65,192
p_130,0,1,e_0,472,596,601,12,0,0,4,4,0,1,124,5,129
p_87,0,8,e_1,539,566,604,26,10,10,9,4,0,1,27,38,65
p_83,0,8,e_1,549,566,604,23,9,9,6,4,0,1,17,38,55
p_136,0,3,e_0,465,596,609,12,0,0,6,4,0,1,131,13,144
p_129,0,3,e_0,473,596,609,12,0,0,3,4,0,1,123,13,136
p_144,0,9,e_1,455,566,609,12,0,0,1,4,0,1,111,43,154
p_142,0,9,e_1,457,566,609,12,0,0,0,3,0,0,109,43,152
p_196,0,4,e_0,371,596,614,1,1,0,0,4,0,1,225,18,243
p_137,0,4,e_0,464,596,614,12,0,0,6,4,0,1,132,18,150
p_145,0,11,e_1,454,566,617,12,0,0,1,4,0,1,112,51,163
p_84,0,12,e_1,546,566,622,24,9,9,7,4,0,1,20,56,76
p_140,0,8,e_0,459,596,628,12,0,0,8,4,0,1,137,32,169
p_82,0,14,e_1,550,566,630,23,8,8,5,4,0,1,16,64,80
p_81,0,14,e_1,551,566,630,23,8,8,5,4,0,1,15,64,79
p_79,0,14,e_1,553,566,630,23,8,8,4,4,0,1,13,64,77
p_85,0,15,e_1,545,566,635,24,9,9,7,4,0,1,21,69,90
p_139,0,10,e_0,461,596,636,12,0,0,8,4,0,1,135,40,175
p_135,0,10,e_0,466,596,636,12,0,0,6,4,0,1,130,40,170
p_96,0,1,e_3,517,636,641,1,1,0,1,4,0,1,119,5,124
p_138,0,11,e_0,463,596,641,12,0,0,7,4,0,1,133,45,178
p_132,0,11,e_0,470,596,641,12,0,0,4,4,0,1,126,45,171
p_128,0,11,e_0,474,596,641,12,0,0,3,4,0,1,122,45,167
p_133,0,12,e_0,469,596,646,12,0,0,5,4,0,1,127,50,177
p_131,0,14,e_0,471,596,654,12,0,0,4,4,0,1,125,58,183
p_99,0,6,e_3,514,636,658,3,1,0,3,4,0,1,122,22,144
p_94,0,6,e_3,519,636,658,1,1,0,1,4,0,1,117,22,139
p_42,0,6,e_3,598,636,658,12,1,0,12,4,0,1,38,22,60
p_195,0,15,e_0,372,596,659,1,1,0,0,3,0,0,224,63,287
p_134,0,15,e_0,467,596,659,12,0,0,6,4,0,1,129,63,192
p_92,0,4,e_2,525,647,661,29,12,12,3,4,0,1,122,14,136
p_102,0,7,e_3,509,636,663,4,1,0,4,4,0,1,127,27,154
p_98,0,7,e_3,515,636,663,2,1,0,2,4,0,1,121,27,148
p_97,0,7,e_3,516,636,663,2,1,0,2,4,0,1,120,27,147
p_43,0,7,e_3,597,636,663,13,1,0,13,4,0,1,39,27,66
p_101,0,8,e_3,511,636,668,3,1,0,3,4,0,1,125,32,157
p_44,0,8,e_3,596,636,668,13,1,0,13,4,0,1,40,32,72
p_100,0,9,e_3,513,636,673,3,1,0,3,4,0,1,123,37,160
p_89,0,9,e_2,535,647,678,27,10,10,0,3,0,0,112,31,143
p_103,0,11,e_3,508,636,681,4,1,0,4,4,0,1,128,45,173
p_41,0,11,e_3,600,636,681,12,1,0,12,4,0,1,36,45,81
p_93,0,13,e_3,520,636,689,1,1,0,1,4,0,1,116,53,169
p_91,0,12,e_2,526,647,689,29,11,11,3,4,0,1,121,42,163
p_34,0,12,e_2,646,647,689,26,8,8,0,4,0,1,1,42,43
p_77,0,3,e_1,557,682,693,22,7,7,3,4,0,1,125,11,136
p_72,0,3,e_1,562,682,693,21,6,6,1,4,0,1,120,11,131
p_71,0,3,e_1,564,682,693,20,6,6,0,4,0,1,118,11,129
p_70,0,3,e_1,565,682,693,20,5,5,0,3,0,0,117,11,128
p_30,0,3,e_1,668,682,693,20,5,5,5,4,0,1,14,11,25
p_90,0,13,e_2,527,647,694,29,11,11,3,4,0,1,120,47,167
p_95,0,14,e_3,518,636,694,1,1,0,1,4,0,1,118,58,176
p_75,0,5,e_1,559,682,701,21,7,7,2,4,0,1,123,19,142
p_29,0,5,e_1,670,682,701,20,5,5,4,4,0,1,12,19,31
p_76,0,6,e_1,558,682,706,22,7,7,2,4,0,1,124,24,148
p_32,0,6,e_1,650,682,706,25,8,8,10,4,0,1,32,24,56
p_31,0,6,e_1,666,682,706,20,6,6,5,4,0,1,16,24,40
p_74,0,7,e_1,560,682,711,21,7,7,2,4,0,1,122,29,151
p_119,0,1,e_0,483,706,711,12,0,0,0,4,0,1,223,5,228
p_65,0,1,e_0,573,706,711,19,4,4,7,4,0,1,133,5,138
p_67,0,3,e_0,568,706,719,20,5,5,9,4,0,1,138,13,151
p_66,0,3,e_0,569,706,719,20,5,5,9,4,0,1,137,13,150
p_64,0,4,e_0,574,706,724,18,4,4,7,4,0,1,132,18,150
p_73,0,11,e_1,561,682,725,21,6,6,1,4,0,1,121,43,164
p_78,0,12,e_1,556,682,730,22,7,7,3,4,0,1,126,48,174
p_124,0,7,e_0,478,706,735,12,0,0,2,4,0,1,228,29,257
p_69,0,14,e_1,566,682,738,20,5,5,0,3,0,1,116,56,172
p_33,0,15,e_1,649,682,743,25,8,8,11,4,0,1,33,61,94
p_127,0,10,e_0,475,706,746,12,0,0,3,4,0,1,231,40,271
p_22,0,3,e_3,719,738,749,6,1,0,6,4,0,1,19,11,30
p_123,0,11,e_0,479,706,751,12,0,0,2,4,0,1,227,45,272
p_121,0,11,e_0,481,706,751,12,0,0,1,4,0,1,225,45,270
p_120,0,11,e_0,482,706,751,12,0,0,0,4,0,1,224,45,269
p_21,0,4,e_3,731,738,754,2,1,0,2,4,0,1,7,16,23
p_126,0,12,e_0,476,706,756,12,0,0,2,4,0,1,230,50,280
p_68,0,13,e_0,567,706,761,20,5,5,10,4,0,1,139,55,194
p_63,0,13,e_0,577,706,761,18,3,3,6,4,0,1,129,55,184
p_125,0,14,e_0,477,706,766,12,0,0,2,4,0,1,229,60,289
p_37,0,9,e_3,615,738,771,7,1,0,7,4,0,1,123,33,156
p_35,0,9,e_3,630,738,771,2,1,0,2,4,0,1,108,33,141
p_122,0,15,e_0,480,706,771,12,0,0,1,4,0,1,226,65,291
p_39,0,12,e_3,607,738,782,10,1,0,10,4,0,1,131,44,175
p_23,0,12,e_3,711,738,782,9,1,0,9,4,0,1,27,44,71
p_40,0,13,e_3,602,738,787,11,1,0,11,4,0,1,136,49,185
p_38,0,13,e_3,608,738,787,9,1,0,9,4,0,1,130,49,179
p_36,0,13,e_3,628,738,787,2,1,0,2,4,0,1,110,49,159
p_20,0,14,e_3,734,738,792,1,1,0,1,4,0,1,4,54,58
p_16,0,2,e_1,780,790,798,17,3,3,3,4,0,1,10,8,18
p_14,0,4,e_2,794,796,810,14,0,0,1,4,0,1,2,14,16
p_27,0,10,e_1,677,790,824,18,4,4,1,4,0,1,113,34,147
p_18,0,10,e_1,766,790,824,21,4,4,8,4,0,1,24,34,58
p_17,0,10,e_1,776,790,824,18,3,3,4,4,0,1,14,34,48
p_15,0,9,e_2,793,796,827,14,0,0,1,4,0,1,3,31,34
p_55,0,3,e_0,585,818,829,16,2,2,4,4,0,1,233,11,244
p_54,0,3,e_0,586,818,829,16,2,2,3,4,0,1,232,11,243
p_52,0,3,e_0,588,818,829,15,1,1,2,4,0,1,230,11,241
p_28,0,11,e_1,676,790,829,19,4,4,2,4,0,1,114,39,153
p_48,0,4,e_0,592,818,834,15,1,0,1,4,0,1,226,16,242
p_19,0,11,e_2,754,796,835,24,4,4,13,3,0,0,42,39,81
p_61,0,6,e_0,579,818,842,17,3,3,5,4,0,1,239,24,263
p_56,0,6,e_0,584,818,842,16,2,2,4,4,0,1,234,24,258
p_50,0,7,e_0,590,818,847,15,1,0,2,4,0,1,228,29,257
p_53,0,9,e_0,587,818,855,16,2,2,3,4,0,1,231,37,268
p_51,0,9,e_0,589,818,855,15,1,1,2,4,0,1,229,37,266
p_60,0,10,e_0,580,818,860,17,3,3,5,4,0,1,238,42,280
p_58,0,11,e_0,582,818,865,17,3,3,5,4,0,1,236,47,283
p_57,0,11,e_0,583,818,865,16,3,3,4,4,0,1,235,47,282
p_62,0,13,e_0,578,818,873,18,3,3,6,4,0,1,240,55,295
p_59,0,14,e_0,581,818,878,17,3,3,5,4,0,1,237,60,297
p_49,0,14,e_0,591,818,878,15,1,0,2,4,0,1,227,60,287
p_9,0,2,e_1,846,871,879,14,0,0,8,4,0,1,25,8,33
p_10,0,8,e_1,835,871,899,14,0,0,11,3,0,0,36,28,64
p_4,0,1,e_2,886,910,915,14,0,0,8,4,0,1,24,5,29
p_6,0,3,e_2,877,910,923,14,0,0,11,4,0,1,33,13,46
p_45,0,2,e_0,595,922,930,14,1,0,0,4,0,1,327,8,335
p_24,0,2,e_0,695,922,930,14,1,0,4,4,0,1,227,8,235
p_7,0,5,e_2,875,910,931,14,0,0,11,3,0,1,35,21,56
p_1,0,5,e_2,894,910,931,14,0,0,5,4,0,1,16,21,37
p_46,0,4,e_0,594,922,938,14,1,0,0,4,0,1,328,16,344
p_5,0,8,e_2,883,910,942,14,0,0,9,4,0,1,27,32,59
p_3,0,8,e_2,888,910,942,14,0,0,7,4,0,1,22,32,54
p_26,0,8,e_0,684,922,952,17,3,3,7,4,0,1,238,30,268
p_25,0,8,e_0,686,922,952,16,3,3,6,4,0,1,236,30,266
p_8,0,11,e_2,874,910,953,14,0,0,11,3,0,0,36,43,79
p_2,0,11,e_2,892,910,953,14,0,0,6,4,0,1,18,43,61
p_47,0,9,e_0,593,922,957,14,1,0,1,4,0,1,329,35,364
p_11,0,9,e_0,807,922,957,14,0,0,3,4,0,1,115,35,150
p_13,0,11,e_0,796,922,965,14,0,0,7,4,0,1,126,43,169
p_12,0,11,e_0,798,922,965,14,0,0,6,4,0,1,124,43,167
p_300,0,4,e_0,8,9,25,0,0,0,0,3,0,0,1,16,17
p_299,0,5,e_1,9,9,28,0,0,0,0,3,0,0,0,19,19
p_297,0,6,e_3,15,16,38,0,0,0,0,3,0,0,1,22,23
p_298,0,9,e_2,11,12,43,0,0,0,0,3,0,0,1,31,32
p_296,0,4,e_0,28,42,56,9,1,1,4,3,0,0,14,14,28
p_286,0,3,e_1,46,47,60,4,1,0,0,3,0,0,1,13,14
p_290,0,6,e_0,40,42,64,6,1,0,0,4,0,1,2,22,24
p_295,0,5,e_1,29,47,68,9,1,1,5,3,0,0,18,21,39
p_287,0,5,e_1,45,47,68,4,1,0,0,4,0,1,2,21,23
p_285,0,4,e_3,53,59,73,2,1,0,2,4,0,1,6,14,20
p_284,0,4,e_3,54,59,73,1,1,0,1,4,0,1,5,14,19
p_288,0,8,e_1,44,47,79,5,1,0,1,4,0,1,3,32,35
p_291,0,11,e_0,39,42,81,6,1,1,1,4,0,1,3,39,42
p_292,0,6,e_3,38,59,81,6,0,0,6,3,0,0,21,22,43
p_294,0,12,e_0,31,42,86,8,1,1,3,4,0,1,11,44,55
p_293,0,12,e_0,33,42,86,8,1,1,3,4,0,1,9,44,53
p_289,0,4,e_2,43,73,87,5,1,0,9,3,0,0,30,14,44
p_283,0,9,e_3,57,59,92,1,1,0,1,4,0,1,2,33,35
p_282,0,7,e_2,66,73,98,16,3,3,2,4,0,1,7,25,32
p_281,0,1,e_1,73,105,110,4,2,2,6,5,1,0,32,5,37
p_278,0,2,e_1,77,105,115,13,2,2,8,5,1,1,28,10,38
p_279,0,5,e_1,76,105,126,14,2,2,7,5,1,1,29,21,50
p_271,0,1,e_0,121,124,129,7,1,0,1,4,0,1,3,5,8
p_277,0,6,e_1,82,105,131,12,1,1,8,4,0,1,23,26,49
p_274,0,8,e_1,88,105,139,10,1,1,6,4,0,1,17,34,51
p_273,0,4,e_2,110,133,147,9,0,0,7,3,0,0,23,14,37
p_276,0,11,e_1,84,105,150,12,1,1,7,4,0,1,21,45,66
p_270,0,9,e_0,122,124,155,7,1,0,1,4,0,1,2,31,33
p_280,0,14,e_1,75,105,161,14,2,2,7,5,1,1,30,56,86
p_269,0,9,e_2,127,133,164,5,1,0,2,4,0,1,6,31,37
p_275,0,14,e_0,86,124,172,11,1,1,12,2,1,0,38,48,86
p_272,0,10,e_3,113,143,175,9,0,0,9,3,0,0,30,32,62
p_267,0,1,e_2,148,193,198,19,2,2,4,5,1,0,45,5,50
p_255,0,3,e_2,184,193,206,8,1,0,3,4,0,1,9,13,22
p_265,0,4,e_2,152,193,211,18,2,2,5,5,1,1,41,18,59
p_254,0,4,e_2,187,193,211,6,1,0,2,4,0,1,6,18,24
p_268,0,2,e_3,144,207,215,20,1,1,0,5,1,0,63,8,71
p_262,0,5,e_2,157,193,216,16,2,2,7,5,1,1,36,23,59
p_261,0,5,e_2,164,193,216,13,2,2,9,4,0,1,29,23,52
p_253,0,5,e_2,190,193,216,5,1,0,1,4,0,1,3,23,26
p_260,0,7,e_2,165,193,224,13,2,2,9,4,0,1,28,31,59
p_258,0,7,e_2,168,193,224,12,2,2,8,4,0,1,25,31,56
p_252,0,5,e_1,205,205,224,0,1,0,0,3,0,0,0,19,19
p_266,0,6,e_1,151,205,229,18,2,2,11,5,1,0,54,24,78
p_250,0,2,e_3,217,225,233,2,0,0,2,3,0,0,8,8,16
p_256,0,10,e_2,182,193,235,8,1,0,4,4,0,1,11,42,53
p_263,0,7,e_0,154,216,239,17,2,2,9,2,2,0,62,23,85
p_264,0,11,e_2,153,193,240,17,2,2,6,5,1,1,40,47,87
p_257,0,14,e_2,169,193,251,12,2,2,8,4,0,1,24,58,82
p_259,0,15,e_2,167,193,256,12,2,2,8,4,0,1,26,63,89
p_251,0,15,e_0,209,216,265,4,1,1,2,4,0,1,7,49,56
p_248,0,5,e_3,246,247,266,0,0,0,0,3,0,0,1,19,20
p_249,0,6,e_3,239,247,271,2,0,0,2,3,0,0,8,24,32
p_247,0,5,e_1,250,270,289,12,2,2,6,3,0,0,20,19,39
p_241,0,1,e_3,283,291,296,3,1,0,3,4,0,1,8,5,13
p_245,0,7,e_1,269,270,297,7,1,1,0,3,0,0,1,27,28
p_246,0,10,e_1,262,270,308,8,2,2,2,4,0,1,8,38,46
p_242,0,8,e_3,277,291,319,4,1,0,4,4,0,1,14,28,42
p_236,0,1,e_0,305,319,324,20,2,2,5,4,0,1,14,5,19
p_233,0,1,e_0,311,319,324,19,2,2,2,4,0,1,8,5,13
p_244,0,12,e_3,271,291,333,6,0,0,6,2,1,0,20,42,62
p_232,0,5,e_0,314,319,338,18,2,2,2,4,0,1,5,19,24
p_237,0,7,e_0,304,319,346,21,2,2,5,4,0,1,15,27,42
p_231,0,7,e_0,317,319,346,17,2,2,0,4,0,1,2,27,29
p_226,0,2,e_1,329,340,350,13,1,1,4,4,0,1,11,10,21
p_223,0,2,e_1,336,340,350,12,0,0,1,4,0,1,4,10,14
p_234,0,8,e_0,310,319,351,19,2,2,3,4,0,1,9,32,41
p_230,0,3,e_1,319,340,355,16,1,1,7,4,0,1,21,15,36
p_216,0,1,e_2,347,349,356,10,1,0,0,4,0,1,2,7,9
p_228,0,4,e_1,325,340,360,14,1,1,5,4,0,1,15,20,35
p_239,0,11,e_0,302,319,362,21,2,2,5,4,0,1,17,43,60
p_214,0,3,e_2,349,349,364,10,1,0,0,3,0,0,0,15,15
p_225,0,5,e_1,330,340,365,13,1,1,3,4,0,1,10,25,35
p_224,0,5,e_1,331,340,365,12,1,1,3,4,0,1,9,25,34
p_222,0,5,e_1,337,340,365,12,0,0,1,4,0,1,3,25,28
p_221,0,6,e_1,339,340,370,12,0,0,0,3,0,0,1,30,31
p_238,0,13,e_0,303,319,370,21,2,2,5,4,0,1,16,51,67
p_219,0,5,e_2,342,349,372,12,1,0,2,4,0,1,7,23,30
p_235,0,8,e_1,308,340,378,19,2,2,10,2,1,0,32,38,70
p_243,0,15,e_0,272,319,378,6,1,0,15,3,0,0,47,59,106
p_217,0,7,e_2,346,349,380,11,1,0,1,4,0,1,3,31,34
p_209,0,2,e_3,357,379,387,7,1,0,7,4,0,1,22,8,30
p_205,0,2,e_3,362,379,387,6,1,0,6,4,0,1,17,8,25
p_240,0,9,e_2,301,349,388,22,2,2,15,3,0,0,48,39,87
p_227,0,12,e_1,327,340,392,14,1,1,4,4,0,1,13,52,65
p_200,0,4,e_3,367,379,395,4,1,0,4,4,0,1,12,16,28
p_218,0,11,e_2,343,349,396,12,1,0,2,4,0,1,6,47,53
p_229,0,13,e_1,320,340,397,16,1,1,7,4,0,1,20,57,77
p_201,0,5,e_3,366,379,400,4,1,0,4,4,0,1,13,21,34
p_220,0,6,e_3,341,379,405,12,0,0,12,3,0,0,38,26,64
p_210,0,6,e_3,354,379,405,8,1,0,8,4,0,1,25,26,51
p_208,0,6,e_3,358,379,405,7,1,0,7,4,0,1,21,26,47
p_212,0,7,e_3,351,379,410,9,1,0,9,4,0,1,28,31,59
p_215,0,15,e_2,348,349,410,10,1,0,0,4,0,1,1,61,62
p_207,0,11,e_3,359,379,424,6,1,0,6,4,0,1,20,45,65
p_206,0,12,e_3,361,379,429,6,1,0,6,4,0,1,18,50,68
p_203,0,12,e_3,364,379,429,5,1,0,5,4,0,1,15,50,65
p_190,0,1,e_0,379,427,434,30,9,9,15,3,0,0,48,7,55
p_183,0,1,e_0,396,427,434,26,8,8,10,4,0,1,31,7,38
p_204,0,14,e_3,363,379,437,5,1,0,5,4,0,1,16,58,74
p_180,0,2,e_0,399,427,439,25,7,7,9,4,0,1,28,12,40
p_213,0,15,e_3,350,379,442,10,1,0,10,4,0,1,29,63,92
p_211,0,15,e_3,353,379,442,9,1,0,9,4,0,1,26,63,89
p_202,0,15,e_3,365,379,442,5,1,0,5,4,0,1,14,63,77
p_178,0,3,e_0,401,427,444,25,7,7,8,4,0,1,26,17,43
p_158,0,1,e_1,430,438,445,18,3,3,3,4,0,1,8,7,15
p_186,0,4,e_0,390,427,449,27,9,9,12,4,0,1,37,22,59
p_176,0,4,e_0,403,427,449,24,7,7,8,4,0,1,24,22,46
p_182,0,2,e_1,397,438,450,26,8,8,13,2,1,0,41,12,53
p_189,0,8,e_0,382,427,463,29,10,10,15,4,0,1,45,36,81
p_179,0,8,e_0,400,427,463,25,7,7,9,4,0,1,27,36,63
p_146,0,1,e_2,453,457,464,12,1,0,1,4,0,1,4,7,11
p_159,0,6,e_1,429,438,464,18,3,3,3,4,0,1,9,26,35
p_177,0,9,e_0,402,427,468,25,7,7,8,4,0,1,25,41,66
p_154,0,7,e_1,436,438,469,16,2,2,0,4,0,1,2,31,33
p_143,0,3,e_2,456,457,472,11,1,0,0,3,0,0,1,15,16
p_185,0,10,e_0,391,427,473,27,9,9,12,4,0,1,36,46,82
p_153,0,9,e_1,437,438,477,16,2,2,0,3,0,0,1,39,40
p_187,0,12,e_0,389,427,481,28,9,9,13,4,0,1,38,54,92
p_184,0,12,e_0,392,427,481,27,9,9,12,4,0,1,35,54,89
p_150,0,6,e_2,443,457,483,15,1,0,4,4,0,1,14,26,40
p_188,0,13,e_0,384,427,486,29,10,10,14,4,0,1,43,59,102
p_148,0,8,e_2,449,457,491,13,1,0,3,4,0,1,8,34,42
p_175,0,14,e_0,405,427,491,24,6,6,7,4,0,1,22,64,86
p_157,0,14,e_1,431,438,494,18,3,3,2,4,0,1,7,56,63
p_155,0,14,e_1,435,438,494,17,3,3,1,4,0,1,3,56,59
p_147,0,9,e_2,452,457,496,12,1,0,2,4,0,1,5,39,44
p_144,0,9,e_2,455,457,496,11,1,0,0,4,0,1,2,39,41
p_142,0,9,e_2,457,457,496,11,1,0,0,3,0,1,0,39,39
p_181,0,15,e_0,398,427,496,25,8,8,9,4,0,1,29,69,98
p_156,0,15,e_1,434,438,499,17,3,3,1,4,0,1,4,61,65
p_136,0,3,e_3,465,489,502,8,1,0,8,4,0,1,24,13,37
p_145,0,11,e_2,454,457,504,11,1,0,1,4,0,1,3,47,50
p_196,0,4,e_3,371,489,507,2,1,0,2,4,0,1,118,18,136
p_137,0,4,e_3,464,489,507,8,1,0,8,4,0,1,25,18,43
p_171,0,13,e_2,409,457,512,23,6,6,15,2,1,0,48,55,103
p_194,0,6,e_3,373,489,515,2,1,0,2,4,0,1,116,26,142
p_141,0,6,e_3,458,489,515,10,1,0,10,4,0,1,31,26,57
p_152,0,15,e_2,441,457,520,15,1,1,5,4,0,1,16,63,79
p_151,0,15,e_2,442,457,520,15,1,0,5,4,0,1,15,63,78
p_149,0,15,e_2,444,457,520,15,1,0,4,4,0,1,13,63,76
p_192,0,8,e_3,375,489,523,1,1,0,1,4,0,1,114,34,148
p_140,0,8,e_3,459,489,523,10,1,0,10,4,0,1,30,34,64
p_198,0,9,e_3,369,489,528,3,1,0,3,4,0,1,120,39,159
p_197,0,10,e_3,370,489,533,3,1,0,3,4,0,1,119,44,163
p_191,0,10,e_3,376,489,533,1,1,0,1,4,0,1,113,44,157
p_139,0,10,e_3,461,489,533,9,1,0,9,4,0,1,28,44,72
p_193,0,11,e_3,374,489,538,1,1,0,1,4,0,1,115,49,164
p_138,0,11,e_3,463,489,538,9,1,0,9,4,0,1,26,49,75
p_167,0,1,e_0,413,543,548,23,5,5,5,4,0,1,130,5,135
p_161,0,1,e_0,421,543,548,20,5,5,2,4,0,1,122,5,127
p_199,0,15,e_3,368,489,552,3,1,0,3,4,0,1,121,63,184
p_195,0,15,e_3,372,489,552,2,1,0,2,4,0,1,117,63,180
p_86,0,2,e_1,544,546,556,18,2,2,1,4,0,1,2,10,12
p_165,0,4,e_0,417,543,559,21,5,5,3,4,0,1,126,16,142
p_169,0,9,e_0,411,543,576,23,5,5,5,4,0,1,132,33,165
p_163,0,10,e_0,419,543,581,20,5,5,3,4,0,1,124,38,162
p_77,0,3,e_2,557,568,581,14,1,0,4,4,0,1,11,13,24
p_72,0,3,e_2,562,568,581,12,1,0,2,4,0,1,6,13,19
p_71,0,3,e_2,564,568,581,12,1,0,1,4,0,1,4,13,17
p_173,0,11,e_0,407,543,586,24,6,6,6,4,0,1,136,43,179
p_164,0,11,e_0,418,543,586,21,5,5,3,4,0,1,125,43,168
p_162,0,11,e_0,420,543,586,20,5,5,2,4,0,1,123,43,166
p_112,0,11,e_0,490,543,586,30,8,8,14,2,2,1,53,43,96
p_75,0,5,e_2,559,568,589,13,1,0,3,4,0,1,9,21,30
p_166,0,12,e_0,416,543,591,21,5,5,3,4,0,1,127,48,175
p_76,0,6,e_2,558,568,594,13,1,0,3,4,0,1,10,26,36
p_168,0,13,e_0,412,543,596,23,5,5,5,4,0,1,131,53,184
p_109,0,15,e_1,493,546,597,30,8,8,14,2,2,0,53,51,104
p_85,0,15,e_1,545,546,597,17,2,2,0,3,0,0,1,51,52
p_80,0,7,e_2,552,568,599,15,1,1,5,4,0,1,16,31,47
p_74,0,7,e_2,560,568,599,13,1,0,2,4,0,1,8,31,39
p_174,0,14,e_0,406,543,601,24,6,6,7,4,0,1,137,58,195
p_170,0,14,e_0,410,543,601,23,5,5,5,4,0,1,133,58,191
p_130,0,1,e_3,472,599,604,6,1,0,6,4,0,1,127,5,132
p_83,0,8,e_2,549,568,604,16,2,2,6,4,0,1,19,36,55
p_172,0,15,e_0,408,543,606,24,6,6,6,4,0,1,135,63,198
p_160,0,15,e_0,426,543,606,19,4,4,0,3,0,0,117,63,180
p_129,0,3,e_3,473,599,612,5,1,0,5,4,0,1,126,13,139
p_73,0,11,e_2,561,568,615,12,1,0,2,4,0,1,7,47,54
p_84,0,12,e_2,546,568,620,17,2,2,7,4,0,1,22,52,74
p_78,0,12,e_2,556,568,620,14,1,0,4,4,0,1,12,52,64
p_93,0,13,e_2,520,568,625,23,6,6,15,3,0,0,48,57,105
p_124,0,7,e_3,478,599,626,3,1,0,3,4,0,1,121,27,148
p_82,0,14,e_2,550,568,630,16,2,2,6,4,0,1,18,62,80
p_81,0,14,e_2,551,568,630,15,2,2,6,4,0,1,17,62,79
p_79,0,14,e_2,553,568,630,15,1,0,5,4,0,1,15,62,77
p_135,0,10,e_3,466,599,637,7,1,0,7,4,0,1,133,38,171
p_127,0,10,e_3,475,599,637,5,1,0,5,4,0,1,124,38,162
p_132,0,11,e_3,470,599,642,6,1,0,6,4,0,1,129,43,172
p_128,0,11,e_3,474,599,642,5,1,0,5,4,0,1,125,43,168
p_123,0,11,e_3,479,599,642,3,1,0,3,4,0,1,120,43,163
p_121,0,11,e_3,481,599,642,3,1,0,3,4,0,1,118,43,161
p_133,0,12,e_3,469,599,647,7,1,0,7,4,0,1,130,48,178
p_126,0,12,e_3,476,599,647,4,1,0,4,4,0,1,123,48,171
p_131,0,14,e_3,471,599,655,6,1,0,6,4,0,1,128,56,184
p_125,0,14,e_3,477,599,655,4,1,0,4,4,0,1,122,56,178
p_96,0,1,e_0,517,653,658,24,6,6,8,4,0,1,136,5,141
p_134,0,15,e_3,467,599,660,7,1,0,7,4,0,1,132,61,193
p_122,0,15,e_3,480,599,660,3,1,0,3,4,0,1,119,61,180
p_106,0,3,e_0,500,653,666,27,9,9,14,4,0,1,153,13,166
p_37,0,9,e_1,615,648,677,26,7,7,11,4,0,1,33,29,62
p_35,0,9,e_1,630,648,677,22,6,6,6,4,0,1,18,29,47
p_108,0,6,e_0,496,653,677,29,9,9,15,4,0,1,157,24,181
p_99,0,6,e_0,514,653,677,24,7,7,10,4,0,1,139,24,163
p_102,0,7,e_0,509,653,682,26,7,7,11,4,0,1,144,29,173
p_98,0,7,e_0,515,653,682,24,6,6,9,4,0,1,138,29,167
p_97,0,7,e_0,516,653,682,24,6,6,9,4,0,1,137,29,166
p_41,0,11,e_1,600,648,685,30,8,8,15,3,0,0,48,37,85
p_70,0,3,e_2,565,674,685,11,1,0,1,4,0,1,109,11,120
p_67,0,3,e_2,568,674,685,10,1,0,0,3,0,1,106,11,117
p_30,0,3,e_2,668,674,685,13,1,0,2,4,0,1,6,11,17
p_111,0,8,e_0,491,653,687,30,8,8,14,2,2,1,162,34,196
p_101,0,8,e_0,511,653,687,25,7,7,10,4,0,1,142,34,176
p_39,0,12,e_1,607,648,690,29,8,8,14,4,0,1,41,42,83
p_34,0,12,e_1,646,648,690,18,3,3,1,4,0,1,2,42,44
p_100,0,9,e_0,513,653,692,24,7,7,10,4,0,1,140,39,179
p_29,0,5,e_2,670,674,693,12,1,0,1,4,0,1,4,19,23
p_40,0,13,e_1,602,648,695,29,9,9,15,4,0,1,46,47,93
p_38,0,13,e_1,608,648,695,28,8,8,13,4,0,1,40,47,87
p_36,0,13,e_1,628,648,695,23,6,6,7,4,0,1,20,47,67
p_31,0,6,e_2,666,674,698,14,1,0,3,4,0,1,8,24,32
p_110,0,11,e_0,492,653,700,30,8,8,14,5,1,1,161,47,208
p_107,0,11,e_0,499,653,700,28,9,9,14,4,0,1,154,47,201
p_103,0,11,e_0,508,653,700,26,7,7,12,4,0,1,145,47,192
p_105,0,12,e_0,502,653,705,27,8,8,13,4,0,1,151,52,203
p_119,0,1,e_3,483,707,712,2,1,0,2,4,0,1,224,5,229
p_113,0,1,e_3,489,707,712,0,1,1,0,3,0,1,218,5,223
p_65,0,1,e_3,573,707,712,9,1,0,9,4,0,1,134,5,139
p_104,0,14,e_0,503,653,713,27,8,8,13,4,0,1,150,60,210
p_114,0,3,e_3,488,707,720,0,0,0,0,3,0,0,219,13,232
p_66,0,3,e_3,569,707,720,10,1,0,10,4,0,1,138,13,151
p_68,0,13,e_2,567,674,721,11,1,0,0,3,0,0,107,47,154
p_64,0,4,e_3,574,707,725,8,1,0,8,4,0,1,133,18,151
p_69,0,14,e_2,566,674,726,11,1,0,1,4,0,1,108,52,160
p_61,0,6,e_3,579,707,733,7,1,0,7,4,0,1,128,26,154
p_118,0,7,e_3,484,707,738,1,1,0,1,4,0,1,223,31,254
p_24,0,2,e_1,695,737,745,4,1,0,13,3,0,0,42,8,50
p_115,0,9,e_3,487,707,746,0,1,0,0,4,0,1,220,39,259
p_22,0,3,e_1,719,737,750,23,8,8,6,4,0,1,18,13,31
p_117,0,10,e_3,485,707,751,1,1,0,1,4,0,1,222,44,266
p_116,0,10,e_3,486,707,751,1,1,0,1,4,0,1,221,44,265
p_60,0,10,e_3,580,707,751,6,1,0,6,4,0,1,127,44,171
p_21,0,4,e_1,731,737,755,20,7,7,2,4,0,1,6,18,24
p_120,0,11,e_3,482,707,756,2,1,0,2,4,0,1,225,49,274
p_63,0,13,e_3,577,707,764,7,1,0,7,4,0,1,130,57,187
p_62,0,13,e_3,578,707,764,7,1,0,7,4,0,1,129,57,186
p_92,0,4,e_0,525,757,771,22,5,5,6,4,0,1,232,14,246
p_88,0,5,e_0,538,757,776,19,2,2,2,4,0,1,219,19,238
p_23,0,12,e_1,711,737,781,25,10,10,9,4,0,1,26,44,70
p_94,0,6,e_0,519,757,781,23,6,6,8,4,0,1,238,24,262
p_32,0,6,e_0,650,757,781,17,3,3,1,4,0,1,107,24,131
p_20,0,14,e_1,734,737,789,20,6,6,1,4,0,1,3,52,55
p_87,0,8,e_0,539,757,789,19,2,2,1,4,0,1,218,32,250
p_89,0,9,e_0,535,757,794,20,3,3,2,4,0,1,222,37,259
p_19,0,11,e_0,754,757,802,16,3,3,1,4,0,1,3,45,48
p_91,0,12,e_0,526,757,807,21,5,5,5,4,0,1,231,50,281
p_90,0,13,e_0,527,757,812,21,5,5,5,4,0,1,230,55,285
p_45,0,2,e_3,595,805,813,1,1,0,1,4,0,1,210,8,218
p_95,0,14,e_0,518,757,817,24,6,6,8,4,0,1,239,60,299
p_55,0,3,e_3,585,805,818,5,1,0,5,4,0,1,220,13,233
p_54,0,3,e_3,586,805,818,4,1,0,4,4,0,1,219,13,232
p_52,0,3,e_3,588,805,818,3,1,0,3,4,0,1,217,13,230
p_33,0,15,e_0,649,757,822,18,3,3,1,4,0,1,108,65,173
p_48,0,4,e_3,592,805,823,2,1,0,2,4,0,1,213,18,231
p_46,0,4,e_3,594,805,823,2,1,0,2,4,0,1,211,18,229
p_56,0,6,e_3,584,805,831,5,1,0,5,4,0,1,221,26,247
p_50,0,7,e_3,590,805,836,3,1,0,3,4,0,1,215,31,246
p_11,0,9,e_2,807,811,840,28,8,8,1,4,0,1,4,29,33
p_53,0,9,e_3,587,805,844,4,1,0,4,4,0,1,218,39,257
p_51,0,9,e_3,589,805,844,3,1,0,3,4,0,1,216,39,255
p_47,0,9,e_3,593,805,844,2,1,0,2,4,0,1,212,39,251
p_18,0,10,e_2,766,811,845,13,1,0,14,3,0,0,45,34,79
p_58,0,11,e_3,582,805,852,5,1,0,5,4,0,1,223,47,270
p_57,0,11,e_3,583,805,852,5,1,0,5,4,0,1,222,47,269
p_59,0,14,e_3,581,805,863,6,1,0,6,4,0,1,224,58,282
p_49,0,14,e_3,591,805,863,3,1,0,3,4,0,1,214,58,272
p_9,0,2,e_2,846,879,887,19,3,3,10,3,0,0,33,8,41
p_6,0,3,e_1,877,879,890,10,1,0,1,4,0,1,2,11,13
p_7,0,5,e_1,875,879,898,10,1,0,1,4,0,1,4,19,23
p_10,0,8,e_1,835,879,909,21,5,5,14,3,0,0,44,30,74
p_4,0,1,e_3,886,907,912,7,1,0,7,4,0,1,21,5,26
p_1,0,5,e_2,894,896,913,4,1,0,0,4,0,1,2,17,19
p_16,0,2,e_3,780,907,917,8,1,0,8,4,0,1,127,10,137
p_8,0,11,e_1,874,879,920,11,1,0,1,4,0,1,5,41,46
p_3,0,8,e_2,888,896,924,6,1,0,2,3,0,0,8,28,36
p_14,0,4,e_3,794,907,925,3,1,0,3,4,0,1,113,18,131
p_42,0,6,e_3,598,907,933,0,1,0,0,4,0,1,309,26,335
p_2,0,11,e_2,892,896,935,5,1,0,1,4,0,1,4,39,43
p_43,0,7,e_3,597,907,938,1,1,0,1,4,0,1,310,31,341
p_44,0,8,e_3,596,907,943,1,1,0,1,4,0,1,311,36,347
p_26,0,8,e_3,684,907,943,7,1,0,7,4,0,1,223,36,259
p_25,0,8,e_3,686,907,943,7,1,0,7,4,0,1,221,36,257
p_15,0,9,e_3,793,907,948,4,1,0,4,4,0,1,114,41,155
p_27,0,10,e_3,677,907,953,10,1,0,10,4,0,1,230,46,276
p_17,0,10,e_3,776,907,953,10,1,0,10,4,0,1,131,46,177
p_5,0,8,e_0,883,930,956,8,1,0,15,3,0,0,47,26,73
p_28,0,11,e_3,676,907,958,10,1,0,10,4,0,1,231,51,282
p_13,0,11,e_3,796,907,958,3,1,0,3,4,0,1,111,51,162
p_12,0,11,e_3,798,907,958,2,1,0,2,4,0,1,109,51,160
p_300,0,4,e_0,8,8,24,0,0,0,0,3,0,0,0,16,16
p_299,0,5,e_1,9,9,28,0,0,0,0,3,0,0,0,19,19
p_297,0,6,e_3,15,16,38,0,0,0,0,3,0,0,1,22,23
p_298,0,9,e_2,11,12,43,0,0,0,0,3,0,0,1,31,32
p_296,0,4,e_0,28,43,57,9,1,1,4,3,0,0,15,14,29
p_286,0,3,e_1,46,47,58,6,0,0,0,4,0,1,1,11,12
p_289,0,4,e_1,43,47,63,6,0,0,1,4,0,1,4,16,20
p_292,0,6,e_0,38,43,65,6,0,0,1,4,0,1,5,22,27
p_290,0,6,e_0,40,43,65,6,0,0,1,4,0,1,3,22,25
p_295,0,5,e_1,29,47,68,9,1,1,5,3,0,0,18,21,39
p_287,0,5,e_1,45,47,68,6,0,0,1,4,0,1,2,21,23
p_288,0,8,e_1,44,47,79,6,0,0,1,4,0,1,3,32,35
p_281,0,1,e_3,73,73,80,0,0,0,0,3,0,0,0,7,7
p_291,0,11,e_0,39,43,82,6,0,0,1,4,0,1,4,39,43
p_294,0,12,e_0,31,43,87,8,1,1,4,4,0,1,12,44,56
p_293,0,12,e_0,33,43,87,7,1,1,3,4,0,1,10,44,54
p_285,0,4,e_3,53,73,91,6,0,0,6,3,0,0,20,18,38
p_284,0,4,e_3,54,73,91,6,1,0,6,4,0,1,19,18,37
p_282,0,7,e_3,66,73,102,2,1,0,2,4,0,1,7,29,36
p_283,0,9,e_3,57,73,110,5,1,0,5,4,0,1,16,37,53
p_278,0,2,e_2,77,104,112,18,4,4,9,4,0,1,27,8,35
p_279,0,5,e_2,76,104,123,18,4,4,9,4,0,1,28,19,47
p_277,0,6,e_2,82,104,128,17,3,3,7,4,0,1,22,24,46
p_274,0,8,e_2,88,104,136,15,3,3,5,4,0,1,16,32,48
p_271,0,1,e_1,121,136,141,9,0,0,5,4,0,1,15,5,20
p_276,0,11,e_2,84,104,147,16,3,3,7,4,0,1,20,43,63
p_273,0,4,e_1,110,136,152,9,0,0,8,3,0,0,26,16,42
p_280,0,14,e_2,75,104,158,18,4,4,9,3,0,0,29,54,83
p_275,0,14,e_2,86,104,158,15,3,3,6,4,0,1,18,54,72
p_270,0,9,e_1,122,136,169,9,0,0,5,4,0,1,14,33,47
p_269,0,9,e_1,127,136,169,9,0,0,3,4,0,1,9,33,42
p_272,0,10,e_1,113,136,174,9,0,0,8,4,0,1,23,38,61
p_267,0,1,e_3,148,173,178,8,1,0,8,4,0,1,25,5,30
p_268,0,2,e_3,144,173,183,9,0,0,9,3,0,0,29,10,39
p_265,0,4,e_3,152,173,191,7,1,0,7,4,0,1,21,18,39
p_262,0,5,e_3,157,173,196,5,1,0,5,4,0,1,16,23,39
p_261,0,5,e_3,164,173,196,3,1,0,3,4,0,1,9,23,32
p_263,0,7,e_3,154,173,204,6,1,0,6,4,0,1,19,31,50
p_260,0,7,e_3,165,173,204,2,1,0,2,4,0,1,8,31,39
p_258,0,7,e_3,168,173,204,1,1,0,1,4,0,1,5,31,36
p_264,0,11,e_3,153,173,218,7,1,0,7,4,0,1,20,45,65
p_255,0,3,e_1,184,206,219,28,6,6,7,4,0,1,22,13,35
p_254,0,4,e_1,187,206,224,27,6,6,6,4,0,1,19,18,37
p_253,0,5,e_1,190,206,229,26,6,6,5,4,0,1,16,23,39
p_252,0,5,e_1,205,206,229,23,3,3,0,3,0,0,1,23,24
p_257,0,14,e_3,169,173,229,1,1,0,1,4,0,1,4,56,60
p_266,0,6,e_1,151,206,234,7,1,0,4,3,3,0,55,28,83
p_259,0,15,e_3,167,173,234,2,1,0,2,4,0,1,6,61,67
p_256,0,10,e_1,182,206,248,28,6,6,8,4,0,1,24,42,66
p_250,0,2,e_0,217,247,257,19,3,3,10,4,0,1,30,10,40
p_248,0,5,e_0,246,247,268,15,0,0,0,3,0,0,1,21,22
p_249,0,6,e_0,239,247,273,15,0,0,3,4,0,1,8,26,34
p_247,0,5,e_1,250,283,300,15,0,0,10,3,0,0,33,17,50
p_251,0,15,e_0,209,247,302,22,3,3,12,3,0,0,38,55,93
p_245,0,7,e_1,269,283,308,15,0,0,5,4,0,1,14,25,39
p_242,0,8,e_1,277,283,313,15,0,0,2,4,0,1,6,30,36
p_246,0,10,e_1,262,283,321,15,0,0,7,4,0,1,21,38,59
p_244,0,12,e_1,271,283,329,15,0,0,4,4,0,1,12,46,58
p_241,0,1,e_2,283,328,335,15,0,0,14,3,0,0,45,7,52
p_236,0,1,e_2,305,328,335,15,0,0,7,4,0,1,23,7,30
p_233,0,1,e_2,311,328,335,15,0,0,6,4,0,1,17,7,24
p_243,0,15,e_1,272,283,340,15,0,0,4,4,0,1,11,57,68
p_230,0,3,e_2,319,328,343,15,0,0,3,4,0,1,9,15,24
p_228,0,4,e_2,325,328,348,15,0,0,1,4,0,1,3,20,23
p_232,0,5,e_2,314,328,353,15,0,0,5,4,0,1,14,25,39
p_237,0,7,e_2,304,328,361,15,0,0,8,4,0,1,24,33,57
p_231,0,7,e_2,317,328,361,15,0,0,4,4,0,1,11,33,44
p_235,0,8,e_2,308,328,366,15,0,0,6,4,0,1,20,38,58
p_234,0,8,e_2,310,328,366,15,0,0,6,4,0,1,18,38,56
p_240,0,9,e_2,301,328,371,15,0,0,9,4,0,1,27,43,70
p_239,0,11,e_2,302,328,379,15,0,0,8,4,0,1,26,51,77
p_216,0,1,e_0,347,377,384,10,1,0,10,4,0,1,30,7,37
p_227,0,12,e_2,327,328,384,15,0,0,0,3,0,0,1,56,57
p_226,0,2,e_0,329,377,389,15,0,0,15,3,0,0,48,12,60
p_223,0,2,e_0,336,377,389,14,1,0,14,4,0,1,41,12,53
p_238,0,13,e_2,303,328,389,15,0,0,8,4,0,1,25,61,86
p_229,0,13,e_2,320,328,389,15,0,0,3,4,0,1,8,61,69
p_214,0,3,e_0,349,377,394,9,1,0,9,4,0,1,28,17,45
p_225,0,5,e_3,330,378,395,15,0,0,15,3,0,0,48,17,65
p_224,0,5,e_0,331,377,402,15,1,0,15,4,0,1,46,25,71
p_222,0,5,e_0,337,377,402,13,1,0,13,4,0,1,40,25,65
p_219,0,5,e_0,342,377,402,12,1,0,11,4,0,1,35,25,60
p_221,0,6,e_0,339,377,407,13,1,0,13,4,0,1,38,30,68
p_220,0,6,e_0,341,377,407,12,1,0,12,4,0,1,36,30,66
p_217,0,7,e_0,346,377,412,11,1,0,10,4,0,1,31,35,66
p_212,0,7,e_0,351,377,412,9,1,0,9,4,0,1,26,35,61
p_190,0,1,e_3,379,412,417,10,1,1,0,5,1,0,33,5,38
p_183,0,1,e_3,396,412,417,5,1,0,5,4,0,1,16,5,21
p_182,0,2,e_3,397,412,422,5,1,0,5,4,0,1,15,10,25
p_180,0,2,e_3,399,412,422,4,1,0,4,4,0,1,13,10,23
p_218,0,11,e_0,343,377,426,12,1,0,11,4,0,1,34,49,83
p_178,0,3,e_3,401,412,427,4,1,0,4,4,0,1,11,15,26
p_186,0,4,e_3,390,412,432,7,2,2,3,5,1,1,22,20,42
p_176,0,4,e_3,403,412,432,3,1,0,3,4,0,1,9,20,29
p_215,0,15,e_0,348,377,440,10,1,0,10,4,0,1,29,63,92
p_213,0,15,e_0,350,377,440,9,1,0,9,4,0,1,27,63,90
p_211,0,15,e_0,353,377,440,8,1,0,8,4,0,1,24,63,87
p_189,0,8,e_3,382,412,446,9,2,2,1,5,1,1,30,34,64
p_179,0,8,e_3,400,412,446,4,1,0,4,4,0,1,12,34,46
p_177,0,9,e_3,402,412,451,3,1,0,3,4,0,1,10,39,49
p_185,0,10,e_3,391,412,456,6,2,2,4,5,1,1,21,44,65
p_167,0,1,e_2,413,454,461,30,10,10,13,3,0,1,41,7,48
p_161,0,1,e_2,421,454,461,28,10,10,11,4,0,1,33,7,40
p_158,0,1,e_2,430,454,461,27,8,8,8,4,0,1,24,7,31
p_187,0,12,e_3,389,412,464,7,2,2,3,5,1,1,23,52,75
p_184,0,12,e_3,392,412,464,6,2,2,4,5,1,1,20,52,72
p_188,0,13,e_3,384,412,469,9,2,2,1,5,1,1,28,57,85
p_165,0,4,e_2,417,454,472,29,10,10,12,4,0,1,37,18,55
p_181,0,15,e_3,398,412,477,4,1,0,4,4,0,1,14,65,79
p_159,0,6,e_2,429,454,480,27,8,8,8,4,0,1,25,26,51
p_154,0,7,e_2,436,454,485,25,7,7,6,4,0,1,18,31,49
p_163,0,10,e_2,419,454,496,29,10,10,12,4,0,1,35,42,77
p_209,0,2,e_0,357,487,497,7,1,0,7,4,0,1,130,10,140
p_205,0,2,e_0,362,487,497,5,1,0,5,4,0,1,125,10,135
p_164,0,11,e_2,418,454,501,29,10,10,12,4,0,1,36,47,83
p_162,0,11,e_2,420,454,501,29,10,10,11,4,0,1,34,47,81
p_200,0,4,e_0,367,487,505,4,1,0,3,4,0,1,120,18,138
p_196,0,4,e_0,371,487,505,2,1,0,2,4,0,1,116,18,134
p_166,0,12,e_2,416,454,506,29,10,10,12,4,0,1,38,52,90
p_201,0,5,e_0,366,487,510,4,1,0,3,4,0,1,121,23,144
p_168,0,13,e_2,412,454,511,30,10,10,13,3,0,0,42,57,99
p_210,0,6,e_0,354,487,515,8,1,0,7,4,0,1,133,28,161
p_208,0,6,e_0,358,487,515,7,1,0,6,4,0,1,129,28,157
p_157,0,14,e_2,431,454,516,4,7,7,8,4,0,1,23,62,85
p_155,0,14,e_2,435,454,516,25,7,7,6,4,0,1,19,62,81
p_160,0,15,e_2,426,454,521,27,8,8,9,4,0,1,28,67,95
p_156,0,15,e_2,434,454,521,26,7,7,6,4,0,1,20,67,87
p_198,0,9,e_0,369,487,526,3,1,0,3,4,0,1,118,39,157
p_113,0,1,e_3,489,524,529,11,1,0,11,4,0,1,35,5,40
p_197,0,10,e_0,370,487,531,3,1,0,2,4,0,1,117,44,161
p_207,0,11,e_0,359,487,536,6,1,0,6,4,0,1,128,49,177
p_114,0,3,e_3,488,524,537,12,1,0,12,4,0,1,36,13,49
p_206,0,12,e_0,361,487,541,6,1,0,5,4,0,1,126,54,180
p_203,0,12,e_0,364,487,541,4,1,0,4,4,0,1,123,54,177
p_108,0,6,e_3,496,524,548,9,1,0,9,4,0,1,28,24,52
p_204,0,14,e_0,363,487,549,5,1,0,5,4,0,1,124,62,186
p_202,0,15,e_0,365,487,554,4,1,0,4,4,0,1,122,67,189
p_199,0,15,e_0,368,487,554,3,1,0,3,4,0,1,119,67,186
p_111,0,8,e_3,491,524,556,11,1,0,11,4,0,1,33,32,65
p_169,0,9,e_3,411,524,561,0,1,0,0,4,0,1,113,37,150
p_173,0,11,e_3,407,524,569,2,1,0,2,4,0,1,117,45,162
p_112,0,11,e_3,490,524,569,11,1,0,11,4,0,1,34,45,79
p_110,0,11,e_3,492,524,569,11,1,0,11,4,0,1,32,45,77
p_107,0,11,e_3,499,524,569,8,1,0,8,4,0,1,25,45,70
p_146,0,1,e_2,453,568,575,21,5,5,0,3,0,0,115,7,122
p_171,0,13,e_3,409,524,577,1,1,0,1,4,0,1,115,53,168
p_175,0,14,e_3,405,524,582,2,1,0,2,4,0,1,119,58,177
p_174,0,14,e_3,406,524,582,2,1,0,2,4,0,1,118,58,176
p_170,0,14,e_3,410,524,582,1,1,0,1,4,0,1,114,58,172
p_92,0,4,e_2,525,568,586,30,9,9,14,4,0,1,43,18,61
p_172,0,15,e_3,408,524,587,1,1,0,1,4,0,1,116,63,179
p_109,0,15,e_3,493,524,587,10,1,0,10,4,0,1,31,63,94
p_88,0,5,e_2,538,568,591,27,8,8,10,4,0,1,30,23,53
p_150,0,6,e_2,443,568,596,23,7,7,3,4,0,1,125,28,153
p_148,0,8,e_2,449,568,604,21,6,6,1,4,0,1,119,36,155
p_87,0,8,e_2,539,568,604,27,8,8,10,4,0,1,29,36,65
p_153,0,9,e_2,437,568,609,25,7,7,6,4,0,1,131,41,172
p_147,0,9,e_2,452,568,609,21,5,5,1,4,0,1,116,41,157
p_89,0,9,e_2,535,568,609,28,9,9,11,4,0,1,33,41,74
p_143,0,3,e_0,456,601,612,20,4,4,10,4,0,1,145,11,156
p_136,0,3,e_0,465,601,612,18,3,3,7,4,0,1,136,11,147
p_137,0,4,e_0,464,601,617,18,3,3,8,4,0,1,137,16,153
p_145,0,11,e_2,454,568,617,21,5,5,0,3,0,1,114,49,163
p_91,0,12,e_2,526,568,622,30,9,9,14,4,0,1,42,54,96
p_194,0,6,e_0,373,601,625,2,1,0,1,4,0,1,228,24,252
p_141,0,6,e_0,458,601,625,20,4,4,9,4,0,1,143,24,167
p_90,0,13,e_2,527,568,627,29,10,10,14,4,0,1,41,59,100
p_192,0,8,e_0,375,601,633,1,1,0,0,4,0,1,226,32,258
p_140,0,8,e_0,459,601,633,19,4,4,9,4,0,1,142,32,174
p_152,0,15,e_2,441,568,635,24,7,7,4,4,0,1,127,67,194
p_151,0,15,e_2,442,568,635,23,7,7,4,4,0,1,126,67,193
p_149,0,15,e_2,444,568,635,23,7,7,3,4,0,1,124,67,191
p_144,0,9,e_0,455,601,638,20,4,4,11,4,0,1,146,37,183
p_142,0,9,e_0,457,601,638,20,4,4,10,4,0,1,144,37,181
p_96,0,1,e_3,517,634,639,2,1,0,2,4,0,1,117,5,122
p_191,0,10,e_0,376,601,643,0,1,0,0,3,0,0,225,42,267
p_139,0,10,e_0,461,601,643,19,4,4,9,4,0,1,140,42,182
p_135,0,10,e_0,466,601,643,18,3,3,7,4,0,1,135,42,177
p_106,0,3,e_3,500,634,647,8,1,0,8,4,0,1,134,13,147
p_193,0,11,e_0,374,601,648,1,1,0,1,4,0,1,227,47,274
p_138,0,11,e_0,463,601,648,18,4,4,8,4,0,1,138,47,185
p_99,0,6,e_3,514,634,658,3,1,0,3,4,0,1,120,24,144
p_94,0,6,e_3,519,634,658,2,1,0,2,4,0,1,115,24,139
p_195,0,15,e_0,372,601,662,2,1,0,2,4,0,1,229,61,290
p_102,0,7,e_3,509,634,663,5,1,0,5,4,0,1,125,29,154
p_98,0,7,e_3,515,634,663,3,1,0,3,4,0,1,119,29,148
p_97,0,7,e_3,516,634,663,2,1,0,2,4,0,1,118,29,147
p_101,0,8,e_3,511,634,668,4,1,0,4,4,0,1,123,34,157
p_100,0,9,e_3,513,634,673,3,1,0,3,4,0,1,121,39,160
p_103,0,11,e_3,508,634,681,5,1,0,5,4,0,1,126,47,173
p_105,0,12,e_3,502,634,686,7,1,0,7,4,0,1,132,52,184
p_86,0,2,e_2,544,682,690,25,8,8,8,4,0,1,138,8,146
p_93,0,13,e_3,520,634,691,1,1,0,1,4,0,1,114,57,171
p_40,0,13,e_3,602,634,691,10,1,0,10,4,0,1,32,57,89
p_77,0,3,e_2,557,682,695,22,6,6,3,4,0,1,125,13,138
p_72,0,3,e_2,562,682,695,21,5,5,2,4,0,1,120,13,133
p_104,0,14,e_3,503,634,696,7,1,0,7,4,0,1,131,62,193
p_95,0,14,e_3,518,634,696,2,1,0,2,4,0,1,116,62,178
p_75,0,5,e_2,559,682,703,21,6,6,3,4,0,1,123,21,144
p_76,0,6,e_2,558,682,708,22,6,6,3,4,0,1,124,26,150
p_80,0,7,e_2,552,682,713,23,7,7,5,4,0,1,130,31,161
p_74,0,7,e_2,560,682,713,21,5,5,2,4,0,1,122,31,153
p_130,0,1,e_0,472,709,714,16,2,2,5,4,0,1,237,5,242
p_83,0,8,e_2,549,682,718,24,7,7,6,4,0,1,133,36,169
p_129,0,3,e_0,473,709,722,16,2,2,5,4,0,1,236,13,249
p_73,0,11,e_2,561,682,729,21,5,5,2,4,0,1,121,47,168
p_84,0,12,e_2,546,682,734,24,8,8,7,4,0,1,136,52,188
p_78,0,12,e_2,556,682,734,22,6,6,4,4,0,1,126,52,178
p_124,0,7,e_0,478,709,736,15,1,0,3,4,0,1,231,27,258
p_82,0,14,e_2,550,682,742,24,7,7,6,4,0,1,132,60,192
p_81,0,14,e_2,551,682,742,24,7,7,6,4,0,1,131,60,191
p_79,0,14,e_2,553,682,742,23,7,7,5,4,0,1,129,60,189
p_85,0,15,e_2,545,682,747,25,8,8,7,4,0,1,137,65,202
p_127,0,10,e_0,475,709,747,16,2,2,4,4,0,1,234,38,272
p_22,0,3,e_3,719,740,751,7,1,0,7,4,0,1,21,11,32
p_132,0,11,e_0,470,709,752,17,2,2,6,4,0,1,239,43,282
p_128,0,11,e_0,474,709,752,16,2,2,4,4,0,1,235,43,278
p_123,0,11,e_0,479,709,752,15,1,0,3,4,0,1,230,43,273
p_121,0,11,e_0,481,709,752,14,1,0,2,4,0,1,228,43,271
p_120,0,11,e_0,482,709,752,14,1,0,2,4,0,1,227,43,270
p_21,0,4,e_3,731,740,756,3,1,0,3,4,0,1,9,16,25
p_133,0,12,e_0,469,709,757,17,2,2,6,4,0,1,240,48,288
p_126,0,12,e_0,476,709,757,15,1,1,3,4,0,1,233,48,281
p_131,0,14,e_0,471,709,765,17,2,2,5,4,0,1,238,56,294
p_125,0,14,e_0,477,709,765,15,1,0,3,4,0,1,232,56,288
p_134,0,15,e_0,467,709,770,17,3,3,6,4,0,1,242,61,303
p_122,0,15,e_0,480,709,770,15,1,0,2,4,0,1,229,61,290
p_37,0,9,e_3,615,740,773,6,1,0,6,4,0,1,125,33,158
p_35,0,9,e_3,630,740,773,1,1,0,1,4,0,1,110,33,143
p_39,0,12,e_3,607,740,784,9,1,0,9,4,0,1,133,44,177
p_23,0,12,e_3,711,740,784,9,1,0,9,4,0,1,29,44,73
p_38,0,13,e_3,608,740,789,8,1,0,8,4,0,1,132,49,181
p_36,0,13,e_3,628,740,789,2,1,0,2,4,0,1,112,49,161
p_20,0,14,e_3,734,740,794,2,1,0,2,4,0,1,6,54,60
p_71,0,3,e_2,564,794,807,20,5,5,1,4,0,1,230,13,243
p_70,0,3,e_2,565,794,807,20,5,5,1,4,0,1,229,13,242
p_67,0,3,e_2,568,794,807,19,4,4,0,3,0,1,226,13,239
p_30,0,3,e_2,668,794,807,20,6,6,5,4,0,1,126,13,139
p_29,0,5,e_2,670,794,815,20,6,6,4,4,0,1,124,21,145
p_32,0,6,e_2,650,794,820,25,9,9,11,4,0,1,144,26,170
p_31,0,6,e_2,666,794,820,21,7,7,5,4,0,1,128,26,154
p_119,0,1,e_0,483,817,822,14,1,0,1,4,0,1,334,5,339
p_65,0,1,e_0,573,817,822,18,4,4,9,4,0,1,244,5,249
p_66,0,3,e_0,569,817,830,19,4,4,10,4,0,1,248,13,261
p_27,0,10,e_2,677,794,834,18,5,5,1,4,0,1,117,40,157
p_18,0,10,e_2,766,794,834,21,4,4,9,4,0,1,28,40,68
p_64,0,4,e_0,574,817,835,18,4,4,9,4,0,1,243,18,261
p_28,0,11,e_2,676,794,839,18,5,5,2,4,0,1,118,45,163
p_19,0,11,e_2,754,794,839,24,5,5,13,4,0,1,40,45,85
p_61,0,6,e_0,579,817,843,17,3,3,7,4,0,1,238,26,264
p_34,0,12,e_2,646,794,844,25,10,10,12,4,0,1,148,50,198
p_118,0,7,e_0,484,817,848,13,1,0,1,4,0,1,333,31,364
p_68,0,13,e_2,567,794,849,19,5,5,0,3,0,0,227,55,282
p_69,0,14,e_2,566,794,854,20,5,5,1,4,0,1,228,60,288
p_115,0,9,e_0,487,817,856,12,1,0,0,3,0,1,330,39,369
p_33,0,15,e_2,649,794,859,25,9,9,11,4,0,1,145,65,210
p_117,0,10,e_0,485,817,861,13,1,0,0,4,0,1,332,44,376
p_116,0,10,e_0,486,817,861,13,1,0,0,3,0,0,331,44,375
p_60,0,10,e_0,580,817,861,17,3,3,7,4,0,1,237,44,281
p_58,0,11,e_0,582,817,866,16,2,2,6,4,0,1,235,49,284
p_57,0,11,e_0,583,817,866,16,2,2,6,4,0,1,234,49,283
p_63,0,13,e_0,577,817,874,17,3,3,8,4,0,1,240,57,297
p_62,0,13,e_0,578,817,874,17,3,3,7,4,0,1,239,57,296
p_59,0,14,e_0,581,817,879,16,3,3,7,4,0,1,236,62,298
p_9,0,2,e_3,846,879,887,11,1,0,11,4,0,1,33,8,41
p_6,0,3,e_3,877,879,892,0,1,0,0,4,0,1,2,13,15
p_7,0,5,e_3,875,879,900,1,1,0,1,4,0,1,4,21,25
p_4,0,1,e_2,886,906,911,20,4,4,6,4,0,1,20,5,25
p_10,0,8,e_3,835,879,911,14,0,0,14,3,0,0,44,32,76
p_16,0,2,e_2,780,906,916,17,3,3,4,4,0,1,126,10,136
p_8,0,11,e_3,874,879,922,1,1,0,1,4,0,1,5,43,48
p_14,0,4,e_2,794,906,924,14,0,0,0,3,0,0,112,18,130
p_1,0,5,e_2,894,906,929,19,3,3,4,4,0,1,12,23,35
p_45,0,2,e_0,595,923,931,13,1,0,2,4,0,1,328,8,336
p_55,0,3,e_0,585,923,936,15,2,2,5,4,0,1,338,13,351
p_54,0,3,e_0,586,923,936,15,1,1,5,4,0,1,337,13,350
p_52,0,3,e_0,588,923,936,15,1,0,4,4,0,1,335,13,348
p_5,0,8,e_2,883,906,940,21,5,5,7,4,0,1,23,34,57
p_3,0,8,e_2,888,906,940,20,4,4,6,4,0,1,18,34,52
p_48,0,4,e_0,592,923,941,14,1,0,3,4,0,1,331,18,349
p_46,0,4,e_0,594,923,941,13,1,0,2,4,0,1,329,18,347
p_15,0,9,e_2,793,906,945,14,1,1,0,4,0,1,113,39,152
p_56,0,6,e_0,584,923,949,16,2,2,5,4,0,1,339,26,365
p_42,0,6,e_0,598,923,949,12,1,0,1,4,0,1,325,26,351
p_17,0,10,e_2,776,906,950,18,3,3,6,4,0,1,130,44,174
p_50,0,7,e_0,590,923,954,15,1,0,4,4,0,1,333,31,364
p_43,0,7,e_0,597,923,954,12,1,0,1,4,0,1,326,31,357
p_2,0,11,e_2,892,906,955,19,3,3,5,4,0,1,14,49,63
p_44,0,8,e_0,596,923,959,12,1,0,1,4,0,1,327,36,363
p_53,0,9,e_0,587,923,964,15,1,0,4,4,0,1,336,41,377
p_51,0,9,e_0,589,923,964,15,1,0,4,4,0,1,334,41,375
p_47,0,9,e_0,593,923,964,13,1,0,2,4,0,1,330,41,371
p_49,0,14,e_0,591,923,981,14,1,0,3,4,0,1,332,58,390
p_24,0,2,e_0,695,1025,1033,14,1,1,4,4,0,1,330,8,338
p_26,0,8,e_0,684,1025,1053,16,4,4,8,4,0,1,341,28,369
p_25,0,8,e_0,686,1025,1053,16,3,3,8,4,0,1,339,28,367
p_11,0,9,e_0,807,1025,1058,14,0,0,3,4,0,1,218,33,251
p_41,0,11,e_0,600,1025,1066,11,1,0,0,4,0,1,425,41,466
p_13,0,11,e_0,796,1025,1066,14,0,0,7,4,0,1,229,41,270
p_12,0,11,e_0,798,1025,1066,14,0,0,6,4,0,1,227,41,268
p_300,0,4,e_0,8,9,25,0,0,0,0,3,0,0,1,16,17
p_299,0,5,e_1,9,10,29,0,0,0,0,3,0,0,1,19,20
p_297,0,6,e_3,15,15,37,0,0,0,0,3,0,0,0,22,22
p_298,0,9,e_2,11,11,42,0,0,0,0,3,0,0,0,31,31
p_296,0,4,e_0,28,42,56,9,1,1,4,3,0,0,14,14,28
p_295,0,5,e_0,29,42,61,8,1,1,4,4,0,1,13,19,32
p_292,0,6,e_0,38,42,66,6,0,0,1,4,0,1,4,24,28
p_290,0,6,e_0,40,42,66,6,0,0,1,4,0,1,2,24,26
p_286,0,3,e_1,46,61,72,6,1,0,5,4,0,1,15,11,26
p_289,0,4,e_1,43,61,77,6,0,0,5,3,0,0,18,16,34
p_285,0,4,e_1,53,61,77,4,1,0,3,4,0,1,8,16,24
p_284,0,4,e_1,54,61,77,4,1,0,2,4,0,1,7,16,23
p_287,0,5,e_1,45,61,82,6,1,0,5,4,0,1,16,21,37
p_291,0,11,e_0,39,42,83,6,0,0,1,4,0,1,3,41,44
p_294,0,12,e_0,31,42,88,8,1,1,3,4,0,1,11,46,57
p_293,0,12,e_0,33,42,88,7,1,1,3,4,0,1,9,46,55
p_288,0,8,e_3,44,65,91,6,0,0,6,3,0,0,21,26,47
p_283,0,9,e_1,57,61,96,3,1,0,1,4,0,1,4,35,39
p_281,0,1,e_2,73,95,100,14,1,1,7,4,0,1,22,5,27
p_278,0,2,e_2,77,95,105,12,1,1,6,4,0,1,18,10,28
p_279,0,5,e_2,76,95,116,13,1,1,6,4,0,1,19,21,40
p_277,0,6,e_2,82,95,121,11,1,1,4,4,0,1,13,26,39
p_282,0,7,e_2,66,95,126,16,1,1,9,3,0,0,29,31,60
p_274,0,8,e_2,88,95,131,9,1,1,2,4,0,1,7,36,43
p_276,0,11,e_2,84,95,142,10,1,1,4,4,0,1,11,47,58
p_271,0,1,e_3,121,137,142,5,1,0,5,4,0,1,16,5,21
p_280,0,14,e_2,75,95,153,13,1,1,7,4,0,1,20,58,78
p_275,0,14,e_2,86,95,153,9,1,1,3,4,0,1,9,58,67
p_273,0,4,e_3,110,137,153,8,0,0,8,3,0,0,27,16,43
p_270,0,9,e_3,122,137,170,5,1,0,5,4,0,1,15,33,48
p_269,0,9,e_3,127,137,170,3,1,0,3,4,0,1,10,33,43
p_272,0,10,e_3,113,137,175,8,1,0,8,4,0,1,24,38,62
p_267,0,1,e_1,148,174,179,17,3,3,8,4,0,1,26,5,31
p_268,0,2,e_1,144,174,184,19,3,3,9,3,0,0,30,10,40
p_265,0,4,e_1,152,174,192,16,3,3,7,4,0,1,22,18,40
p_262,0,5,e_1,157,174,197,15,2,2,5,4,0,1,17,23,40
p_261,0,5,e_1,164,174,197,13,2,2,3,4,0,1,10,23,33
p_266,0,6,e_1,151,174,202,16,3,3,7,4,0,1,23,28,51
p_263,0,7,e_1,154,174,207,16,2,2,7,4,0,1,20,33,53
p_260,0,7,e_1,165,174,207,12,2,2,3,4,0,1,9,33,42
p_258,0,7,e_1,168,174,207,12,2,2,2,4,0,1,6,33,39
p_264,0,11,e_1,153,174,221,16,2,2,7,4,0,1,21,47,68
p_255,0,3,e_3,184,214,225,10,1,0,10,4,0,1,30,11,41
p_254,0,4,e_3,187,214,230,9,1,0,9,4,0,1,27,16,43
p_257,0,14,e_1,169,174,232,11,2,2,1,4,0,1,5,58,63
p_253,0,5,e_3,190,214,235,8,1,0,8,4,0,1,24,21,45
p_252,0,5,e_3,205,214,235,3,1,0,3,4,0,1,9,21,30
p_259,0,15,e_1,167,174,237,12,2,2,2,4,0,1,7,63,70
p_256,0,10,e_3,182,214,252,10,0,0,10,3,0,0,32,38,70
p_250,0,2,e_0,217,256,264,29,5,5,12,3,0,0,39,8,47
p_251,0,15,e_3,209,214,269,2,1,0,2,4,0,1,5,55,60
p_248,0,5,e_0,246,256,275,22,2,2,3,4,0,1,10,19,29
p_247,0,5,e_0,250,256,275,20,2,2,2,4,0,1,6,19,25
p_249,0,6,e_0,239,256,280,24,2,2,6,4,0,1,17,24,41
p_241,0,1,e_0,283,300,305,15,0,0,6,4,0,1,17,5,22
p_236,0,1,e_2,305,307,312,15,0,0,0,4,0,1,2,5,7
p_245,0,7,e_2,269,307,332,15,0,0,12,4,0,1,38,25,63
p_237,0,7,e_2,304,307,332,15,0,0,1,4,0,1,3,25,28
p_242,0,8,e_2,277,307,337,15,0,0,10,4,0,1,30,30,60
p_244,0,12,e_0,271,300,340,15,0,0,4,5,2,0,29,40,69
p_240,0,9,e_2,301,307,342,15,0,0,2,4,0,1,6,35,41
p_246,0,10,e_2,262,307,347,17,1,1,14,3,0,0,45,40,85
p_239,0,11,e_2,302,307,352,15,0,0,1,4,0,1,5,45,50
p_238,0,13,e_2,303,307,360,15,0,0,1,4,0,1,4,53,57
p_233,0,1,e_1,311,356,361,15,1,0,15,4,0,1,45,5,50
p_226,0,2,e_1,329,356,366,9,1,0,9,4,0,1,27,10,37
p_223,0,2,e_1,336,356,366,7,1,0,6,4,0,1,20,10,30
p_243,0,15,e_2,272,307,368,15,0,0,11,4,0,1,35,61,96
p_230,0,3,e_1,319,356,371,13,1,0,12,4,0,1,37,15,52
p_228,0,4,e_1,325,356,376,10,1,0,10,4,0,1,31,20,51
p_232,0,5,e_1,314,356,381,14,1,0,14,4,0,1,42,25,67
p_225,0,5,e_1,330,356,381,9,1,0,9,4,0,1,26,25,51
p_224,0,5,e_1,331,356,381,8,1,0,8,4,0,1,25,25,50
p_222,0,5,e_1,337,356,381,6,1,0,6,4,0,1,19,25,44
p_234,0,8,e_3,310,357,383,15,0,0,15,3,0,0,47,26,73
p_221,0,6,e_1,339,356,386,6,1,0,5,4,0,1,17,30,47
p_220,0,6,e_1,341,356,386,5,1,0,5,4,0,1,15,30,45
p_231,0,7,e_1,317,356,391,13,1,0,13,4,0,1,39,35,74
p_235,0,8,e_1,308,356,396,15,0,0,15,3,0,0,48,40,88
p_209,0,2,e_0,357,396,404,16,1,1,12,3,0,0,39,8,47
p_205,0,2,e_0,362,396,404,15,1,1,11,4,0,1,34,8,42
p_227,0,12,e_1,327,356,410,10,1,0,10,4,0,1,29,54,83
p_200,0,4,e_0,367,396,412,13,1,1,10,4,0,1,29,16,45
p_196,0,4,e_0,371,396,412,12,1,1,8,4,0,1,25,16,41
p_229,0,13,e_1,320,356,415,12,1,0,12,4,0,1,36,59,95
p_201,0,5,e_0,366,396,417,14,1,1,10,4,0,1,30,21,51
p_208,0,6,e_0,358,396,422,16,1,1,12,4,0,1,38,26,64
p_183,0,1,e_3,396,422,429,8,0,0,8,3,0,0,26,7,33
p_198,0,9,e_0,369,396,433,13,1,1,9,4,0,1,27,37,64
p_182,0,2,e_3,397,422,434,8,1,0,8,4,0,1,25,12,37
p_180,0,2,e_3,399,422,434,7,1,0,7,4,0,1,23,12,35
p_197,0,10,e_0,370,396,438,12,1,1,8,4,0,1,26,42,68
p_178,0,3,e_3,401,422,439,7,1,0,7,4,0,1,21,17,38
p_207,0,11,e_0,359,396,443,16,1,1,12,4,0,1,37,47,84
p_176,0,4,e_3,403,422,444,6,1,0,6,4,0,1,19,22,41
p_206,0,12,e_0,361,396,448,15,1,1,11,4,0,1,35,52,87
p_203,0,12,e_0,364,396,448,14,1,1,10,4,0,1,32,52,84
p_204,0,14,e_0,363,396,456,14,1,1,11,4,0,1,33,60,93
p_179,0,8,e_3,400,422,458,7,1,0,7,4,0,1,22,36,58
p_202,0,15,e_0,365,396,461,14,1,1,10,4,0,1,31,65,96
p_199,0,15,e_0,368,396,461,13,1,1,9,4,0,1,28,65,93
p_195,0,15,e_0,372,396,461,11,1,1,8,4,0,1,24,65,89
p_177,0,9,e_3,402,422,463,7,1,0,7,4,0,1,20,41,61
p_169,0,9,e_3,411,422,463,3,1,0,3,4,0,1,11,41,52
p_216,0,1,e_1,347,456,463,3,1,0,3,4,0,1,109,7,116
p_158,0,1,e_1,430,456,463,29,10,10,8,4,0,1,26,7,33
p_214,0,3,e_1,349,456,471,2,1,0,2,4,0,1,107,15,122
p_173,0,11,e_3,407,422,471,5,1,0,5,4,0,1,15,49,64
p_219,0,5,e_1,342,456,479,5,1,0,5,4,0,1,114,23,137
p_171,0,13,e_3,409,422,479,4,1,0,4,4,0,1,13,57,70
p_210,0,6,e_1,354,456,484,1,1,0,0,4,0,1,102,28,130
p_159,0,6,e_1,429,456,484,29,10,10,9,4,0,1,27,28,55
p_175,0,14,e_3,405,422,484,6,1,0,6,4,0,1,17,62,79
p_174,0,14,e_3,406,422,484,5,1,0,5,4,0,1,16,62,78
p_170,0,14,e_3,410,422,484,4,1,0,4,4,0,1,12,62,74
p_217,0,7,e_1,346,456,489,4,1,0,3,4,0,1,110,33,143
p_212,0,7,e_1,351,456,489,2,1,0,1,4,0,1,105,33,138
p_181,0,15,e_3,398,422,489,8,1,0,8,4,0,1,24,67,91
p_172,0,15,e_3,408,422,489,4,1,0,4,4,0,1,14,67,81
p_218,0,11,e_1,343,456,503,5,1,0,4,4,0,1,113,47,160
p_130,0,1,e_2,472,504,509,19,4,4,11,4,0,1,32,5,37
p_157,0,14,e_1,431,456,514,29,10,10,8,4,0,1,25,58,83
p_190,0,1,e_0,379,508,515,9,1,1,6,4,0,1,129,7,136
p_136,0,3,e_2,465,504,517,21,5,5,13,4,0,1,39,13,52
p_129,0,3,e_2,473,504,517,19,4,4,10,4,0,1,31,13,44
p_215,0,15,e_1,348,456,519,3,1,0,2,4,0,1,108,63,171
p_213,0,15,e_1,350,456,519,2,1,0,2,4,0,1,106,63,169
p_211,0,15,e_1,353,456,519,1,1,0,1,4,0,1,103,63,166
p_160,0,15,e_1,426,456,519,30,10,10,10,4,0,1,30,63,93
p_156,0,15,e_1,434,456,519,28,9,9,7,4,0,1,22,63,85
p_137,0,4,e_2,464,504,522,21,5,5,13,4,0,1,40,18,58
p_186,0,4,e_0,390,508,526,8,0,0,2,4,0,1,118,18,136
p_141,0,6,e_2,458,504,530,22,6,6,15,4,0,1,46,26,72
p_194,0,6,e_0,373,508,534,11,1,1,7,4,0,1,135,26,161
p_140,0,8,e_2,459,504,538,22,6,6,15,4,0,1,45,34,79
p_192,0,8,e_0,375,508,542,11,1,1,7,4,0,1,133,34,167
p_189,0,8,e_0,382,508,542,8,0,0,5,4,0,1,126,34,160
p_142,0,9,e_2,457,504,543,22,7,7,15,3,0,0,47,39,86
p_167,0,1,e_3,413,536,543,3,1,0,3,4,0,1,123,7,130
p_161,0,1,e_3,421,536,543,0,0,0,0,3,0,0,115,7,122
p_96,0,1,e_3,517,536,543,6,1,0,6,4,0,1,19,7,26
p_139,0,10,e_2,461,504,548,21,6,6,14,4,0,1,43,44,87
p_135,0,10,e_2,466,504,548,20,5,5,12,4,0,1,38,44,82
p_191,0,10,e_0,376,508,550,10,1,1,7,4,0,1,132,42,174
p_185,0,10,e_0,391,508,550,8,0,0,1,4,0,1,117,42,159
p_138,0,11,e_2,463,504,553,21,5,5,13,4,0,1,41,49,90
p_132,0,11,e_2,470,504,553,19,5,5,11,4,0,1,34,49,83
p_128,0,11,e_2,474,504,553,19,4,4,10,4,0,1,30,49,79
p_165,0,4,e_3,417,536,554,1,1,0,1,4,0,1,119,18,137
p_193,0,11,e_0,374,508,555,11,1,1,7,4,0,1,134,47,181
p_103,0,11,e_0,508,508,555,9,1,0,0,3,0,0,0,47,47
p_133,0,12,e_2,469,504,558,20,5,5,12,4,0,1,35,54,89
p_187,0,12,e_0,389,508,560,8,0,0,2,4,0,1,119,52,171
p_184,0,12,e_0,392,508,560,8,0,0,1,4,0,1,116,52,168
p_99,0,6,e_3,514,536,562,7,1,0,7,4,0,1,22,26,48
p_188,0,13,e_0,384,508,565,8,0,0,4,4,0,1,124,57,181
p_131,0,14,e_2,471,504,566,19,4,4,11,4,0,1,33,62,95
p_102,0,7,e_3,509,536,567,9,1,0,9,4,0,1,27,31,58
p_98,0,7,e_3,515,536,567,7,1,0,7,4,0,1,21,31,52
p_97,0,7,e_3,516,536,567,7,1,0,7,4,0,1,20,31,51
p_146,0,1,e_1,453,566,571,24,7,7,1,4,0,1,113,5,118
p_134,0,15,e_2,467,504,571,20,5,5,12,4,0,1,37,67,104
p_101,0,8,e_3,511,536,572,8,1,0,8,4,0,1,25,36,61
p_100,0,9,e_3,513,536,577,8,1,0,8,4,0,1,23,41,64
p_143,0,3,e_1,456,566,579,23,7,7,0,3,0,0,110,13,123
p_163,0,10,e_3,419,536,582,1,1,0,1,4,0,1,117,46,163
p_88,0,5,e_1,538,566,587,26,10,10,9,4,0,1,28,21,49
p_164,0,11,e_3,418,536,587,1,1,0,1,4,0,1,118,51,169
p_162,0,11,e_3,420,536,587,0,1,0,0,4,0,1,116,51,167
p_150,0,6,e_1,443,566,592,4,7,7,4,4,0,1,123,26,149
p_166,0,12,e_3,416,536,592,2,1,0,2,4,0,1,120,56,176
p_168,0,13,e_3,412,536,597,3,1,0,3,4,0,1,124,61,185
p_154,0,7,e_1,436,566,597,28,9,9,6,4,0,1,130,31,161
p_148,0,8,e_1,449,566,602,25,7,7,2,4,0,1,117,36,153
p_87,0,8,e_1,539,566,602,26,10,10,9,4,0,1,27,36,63
p_153,0,9,e_1,437,566,607,27,9,9,6,4,0,1,129,41,170
p_147,0,9,e_1,452,566,607,24,7,7,1,4,0,1,114,41,155
p_144,0,9,e_1,455,566,607,23,7,7,0,4,0,1,111,41,152
p_65,0,1,e_0,573,608,615,18,6,6,11,4,0,1,35,7,42
p_145,0,11,e_1,454,566,615,23,7,7,0,4,0,1,112,49,161
p_67,0,3,e_0,568,608,623,19,7,7,13,4,0,1,40,15,55
p_66,0,3,e_0,569,608,623,19,7,7,13,4,0,1,39,15,54
p_55,0,3,e_0,585,608,623,15,4,4,8,4,0,1,23,15,38
p_119,0,1,e_2,483,618,623,16,2,2,7,4,0,1,135,5,140
p_113,0,1,e_2,489,618,623,15,1,1,5,4,0,1,129,5,134
p_155,0,14,e_1,435,566,626,28,9,9,7,4,0,1,131,60,191
p_64,0,4,e_0,574,608,628,18,6,6,11,4,0,1,34,20,54
p_152,0,15,e_1,441,566,631,27,8,8,5,4,0,1,125,65,190
p_151,0,15,e_1,442,566,631,27,8,8,4,4,0,1,124,65,189
p_149,0,15,e_1,444,566,631,26,7,7,4,4,0,1,122,65,187
p_114,0,3,e_2,488,618,631,15,1,1,5,4,0,1,130,13,143
p_61,0,6,e_0,579,608,636,17,5,5,9,4,0,1,29,28,57
p_56,0,6,e_0,584,608,636,16,4,4,8,4,0,1,24,28,52
p_124,0,7,e_2,478,618,645,17,3,3,8,4,0,1,140,27,167
p_118,0,7,e_2,484,618,645,16,2,2,6,4,0,1,134,27,161
p_60,0,10,e_0,580,608,650,16,5,5,9,4,0,1,28,42,70
p_92,0,4,e_3,525,638,652,4,1,0,4,4,0,1,113,14,127
p_115,0,9,e_2,487,618,653,16,2,2,6,4,0,1,131,35,166
p_58,0,11,e_0,582,608,655,16,4,4,9,4,0,1,26,47,73
p_57,0,11,e_0,583,608,655,16,4,4,8,4,0,1,25,47,72
p_127,0,10,e_2,475,618,658,18,4,4,9,4,0,1,143,40,183
p_117,0,10,e_2,485,618,658,16,2,2,6,4,0,1,133,40,173
p_116,0,10,e_2,486,618,658,16,2,2,6,4,0,1,132,40,172
p_94,0,6,e_3,519,638,660,5,1,0,5,4,0,1,119,22,141
p_68,0,13,e_0,567,608,663,19,7,7,13,3,0,1,41,55,96
p_63,0,13,e_0,577,608,663,17,5,5,10,4,0,1,31,55,86
p_62,0,13,e_0,578,608,663,17,5,5,10,4,0,1,30,55,85
p_123,0,11,e_2,479,618,663,17,3,3,8,4,0,1,139,45,184
p_121,0,11,e_2,481,618,663,17,3,3,8,4,0,1,137,45,182
p_120,0,11,e_2,482,618,663,17,3,3,7,4,0,1,136,45,181
p_69,0,14,e_0,566,608,668,19,8,8,13,3,0,0,42,60,102
p_59,0,14,e_0,581,608,668,16,5,5,9,4,0,1,27,60,87
p_126,0,12,e_2,476,618,668,18,4,4,9,4,0,1,142,50,192
p_89,0,9,e_3,535,638,671,0,0,0,0,3,0,0,103,33,136
p_35,0,9,e_3,630,638,671,3,1,0,3,4,0,1,8,33,41
p_125,0,14,e_2,477,618,676,17,4,4,9,4,0,1,141,58,199
p_122,0,15,e_2,480,618,681,17,3,3,8,4,0,1,138,63,201
p_91,0,12,e_3,526,638,682,3,1,0,3,4,0,1,112,44,156
p_86,0,2,e_1,544,678,686,25,10,10,7,4,0,1,134,8,142
p_93,0,13,e_3,520,638,687,5,1,0,5,4,0,1,118,49,167
p_90,0,13,e_3,527,638,687,3,1,0,3,4,0,1,111,49,160
p_36,0,13,e_3,628,638,687,3,1,0,3,4,0,1,10,49,59
p_77,0,3,e_1,557,678,691,21,9,9,3,4,0,1,121,13,134
p_72,0,3,e_1,562,678,691,20,8,8,1,4,0,1,116,13,129
p_95,0,14,e_3,518,638,692,6,1,0,6,4,0,1,120,54,174
p_75,0,5,e_1,559,678,699,21,9,9,2,4,0,1,119,21,140
p_76,0,6,e_1,558,678,704,21,9,9,2,4,0,1,120,26,146
p_80,0,7,e_1,552,678,709,22,10,10,4,4,0,1,126,31,157
p_74,0,7,e_1,560,678,709,21,9,9,2,4,0,1,118,31,149
p_83,0,8,e_1,549,678,714,24,10,10,6,4,0,1,129,36,165
p_45,0,2,e_0,595,712,722,13,2,2,4,4,0,1,117,10,127
p_73,0,11,e_1,561,678,725,20,9,9,1,4,0,1,117,47,164
p_54,0,3,e_0,586,712,727,15,4,4,7,4,0,1,126,15,141
p_52,0,3,e_0,588,712,727,15,3,3,7,4,0,1,124,15,139
p_84,0,12,e_1,546,678,730,25,10,10,6,4,0,1,132,52,184
p_78,0,12,e_1,556,678,730,22,9,9,3,4,0,1,122,52,174
p_48,0,4,e_0,592,712,732,14,2,2,5,4,0,1,120,20,140
p_46,0,4,e_0,594,712,732,14,2,2,4,4,0,1,118,20,138
p_82,0,14,e_1,550,678,738,23,10,10,5,4,0,1,128,60,188
p_81,0,14,e_1,551,678,738,23,10,10,5,4,0,1,127,60,187
p_79,0,14,e_1,553,678,738,4,9,9,4,4,0,1,125,60,185
p_106,0,3,e_2,500,728,739,12,1,0,1,4,0,1,228,11,239
p_22,0,3,e_2,719,728,739,14,0,0,3,4,0,1,9,11,20
p_42,0,6,e_0,598,712,740,13,1,0,3,4,0,1,114,28,142
p_85,0,15,e_1,545,678,743,25,10,10,7,4,0,1,133,65,198
p_50,0,7,e_0,590,712,745,15,3,3,6,4,0,1,122,33,155
p_43,0,7,e_0,597,712,745,13,1,0,3,4,0,1,115,33,148
p_44,0,8,e_0,596,712,750,13,1,1,4,4,0,1,116,38,154
p_108,0,6,e_2,496,728,750,13,1,0,3,4,0,1,232,22,254
p_53,0,9,e_0,587,712,755,15,3,3,7,4,0,1,125,43,168
p_51,0,9,e_0,589,712,755,15,3,3,6,4,0,1,123,43,166
p_47,0,9,e_0,593,712,755,14,2,2,5,4,0,1,119,43,162
p_111,0,8,e_2,491,728,758,15,1,0,4,4,0,1,237,30,267
p_37,0,9,e_2,615,728,763,7,1,0,1,4,0,1,113,35,148
p_41,0,11,e_0,600,712,763,12,1,0,2,4,0,1,112,51,163
p_40,0,13,e_0,602,712,771,12,1,0,2,4,0,1,110,59,169
p_112,0,11,e_2,490,728,771,15,1,0,4,4,0,1,238,43,281
p_110,0,11,e_2,492,728,771,14,1,0,4,4,0,1,236,43,279
p_107,0,11,e_2,499,728,771,12,1,0,2,4,0,1,229,43,272
p_105,0,12,e_2,502,728,776,11,1,0,0,4,0,1,226,48,274
p_49,0,14,e_0,591,712,776,14,3,3,5,4,0,1,121,64,185
p_38,0,13,e_2,608,728,781,10,1,0,3,4,0,1,120,53,173
p_104,0,14,e_2,503,728,786,11,1,0,0,4,0,1,225,58,283
p_21,0,4,e_3,731,776,790,14,0,0,14,3,0,0,45,14,59
p_109,0,15,e_2,493,728,791,14,1,0,3,4,0,1,235,63,298
p_16,0,2,e_1,780,790,798,27,4,4,3,4,0,1,10,8,18
p_71,0,3,e_1,564,790,803,20,8,8,1,4,0,1,226,13,239
p_70,0,3,e_1,565,790,803,20,8,8,0,4,0,1,225,13,238
p_30,0,3,e_1,668,790,803,20,4,4,3,4,0,1,122,13,135
p_18,0,10,e_3,766,776,810,3,1,0,3,4,0,1,10,34,44
p_29,0,5,e_1,670,790,811,19,3,3,2,4,0,1,120,21,141
p_19,0,11,e_3,754,776,815,7,1,0,7,4,0,1,22,39,61
p_32,0,6,e_1,650,790,816,24,6,6,9,4,0,1,140,26,166
p_31,0,6,e_1,666,790,816,20,4,4,4,4,0,1,124,26,150
p_20,0,14,e_3,734,776,826,14,1,0,14,4,0,1,42,50,92
p_24,0,2,e_0,695,820,828,14,0,0,5,4,0,1,125,8,133
p_27,0,10,e_1,677,790,830,18,3,3,0,4,0,1,113,40,153
p_17,0,10,e_1,776,790,830,28,4,4,5,4,0,1,14,40,54
p_28,0,11,e_1,676,790,835,18,3,3,0,4,0,1,114,45,159
p_14,0,4,e_0,794,820,836,23,3,3,9,4,0,1,26,16,42
p_34,0,12,e_1,646,790,840,26,6,6,11,4,0,1,144,50,194
p_26,0,8,e_0,684,820,850,16,2,2,9,4,0,1,136,30,166
p_25,0,8,e_0,686,820,850,15,2,2,9,4,0,1,134,30,164
p_33,0,15,e_1,649,790,851,25,6,6,10,4,0,1,141,61,202
p_15,0,9,e_0,793,820,855,23,3,3,9,4,0,1,27,35,62
p_11,0,9,e_0,807,820,855,19,3,3,4,4,0,1,13,35,48
p_13,0,11,e_0,796,820,863,22,3,3,8,4,0,1,24,43,67
p_12,0,11,e_0,798,820,863,22,3,3,7,4,0,1,22,43,65
p_39,0,12,e_0,607,820,868,10,1,0,0,3,0,0,213,48,261
p_23,0,12,e_0,711,820,868,14,0,0,0,3,0,0,109,48,157
p_4,0,1,e_3,886,890,895,1,1,0,1,4,0,1,4,5,9
p_9,0,2,e_3,846,890,900,14,0,0,14,3,0,0,44,10,54
p_6,0,3,e_3,877,890,905,4,1,0,4,4,0,1,13,15,28
p_7,0,5,e_3,875,890,913,5,1,0,5,4,0,1,15,23,38
p_1,0,5,e_0,894,906,923,21,6,6,4,4,0,1,12,17,29
p_5,0,8,e_3,883,890,924,2,1,0,2,4,0,1,7,34,41
p_3,0,8,e_3,888,890,924,1,1,0,1,4,0,1,2,34,36
p_10,0,8,e_0,835,906,934,14,0,0,4,3,5,0,71,28,99
p_8,0,11,e_3,874,890,935,5,1,0,5,4,0,1,16,45,61
p_2,0,11,e_0,892,906,945,22,6,6,5,4,0,1,14,39,53
p_300,0,4,e_0,8,9,25,0,0,0,0,3,0,0,1,16,17
p_299,0,5,e_1,9,10,29,0,0,0,0,3,0,0,1,19,20
p_297,0,6,e_3,15,15,37,0,0,0,0,3,0,0,0,22,22
p_298,0,9,e_2,11,12,43,0,0,0,0,3,0,0,1,31,32
p_286,0,3,e_1,46,47,58,6,0,0,0,4,0,1,1,11,12
p_296,0,4,e_0,28,43,59,9,1,1,4,3,0,0,15,16,31
p_289,0,4,e_0,43,43,59,6,0,0,0,3,0,0,0,16,16
p_295,0,5,e_1,29,47,66,9,1,1,5,3,0,0,18,19,37
p_287,0,5,e_1,45,47,66,6,0,0,0,4,0,1,2,19,21
p_292,0,6,e_0,38,43,67,6,0,0,2,4,0,1,5,24,29
p_290,0,6,e_0,40,43,67,6,0,0,1,4,0,1,3,24,27
p_288,0,8,e_1,44,47,77,6,0,0,1,4,0,1,3,30,33
p_281,0,1,e_3,73,74,81,0,0,0,0,3,0,0,1,7,8
p_291,0,11,e_0,39,43,84,6,0,0,1,4,0,1,4,41,45
p_294,0,12,e_0,31,43,89,8,1,1,4,4,0,1,12,46,58
p_293,0,12,e_0,33,43,89,7,1,1,3,4,0,1,10,46,56
p_285,0,4,e_3,53,74,92,6,0,0,6,3,0,0,21,18,39
p_284,0,4,e_3,54,74,92,6,1,0,6,4,0,1,20,18,38
p_282,0,7,e_3,66,74,103,2,1,0,2,4,0,1,8,29,37
p_283,0,9,e_3,57,74,111,6,1,0,6,4,0,1,17,37,54
p_278,0,2,e_1,77,103,111,18,4,4,8,2,1,1,26,8,34
p_279,0,5,e_1,76,103,122,18,4,4,8,5,1,0,27,19,46
p_277,0,6,e_1,82,103,127,17,3,3,7,4,0,1,21,24,45
p_274,0,8,e_1,88,103,135,15,3,3,5,4,0,1,15,32,47
p_271,0,1,e_3,121,140,145,6,1,0,6,4,0,1,19,5,24
p_276,0,11,e_1,84,103,146,17,3,3,6,4,0,1,19,43,62
p_280,0,14,e_2,75,104,148,18,4,4,9,3,0,0,29,44,73
p_273,0,4,e_3,110,140,156,9,1,1,9,5,1,0,30,16,46
p_275,0,14,e_1,86,103,157,16,3,3,6,4,0,1,17,54,71
p_270,0,9,e_3,122,140,173,6,1,0,6,4,0,1,18,33,51
p_269,0,9,e_3,127,140,173,4,1,0,4,4,0,1,13,33,46
p_272,0,10,e_3,113,140,178,9,1,0,9,4,0,1,27,38,65
p_267,0,1,e_0,148,182,189,18,3,3,11,4,0,1,34,7,41
p_268,0,2,e_0,144,182,194,19,4,4,12,3,0,0,38,12,50
p_265,0,4,e_0,152,182,202,17,3,3,10,4,0,1,30,20,50
p_262,0,5,e_0,157,182,207,16,2,2,8,4,0,1,25,25,50
p_261,0,5,e_0,164,182,207,14,2,2,6,4,0,1,18,25,43
p_266,0,6,e_0,151,182,212,17,3,3,10,4,0,1,31,30,61
p_263,0,7,e_0,154,182,217,16,3,3,9,4,0,1,28,35,63
p_260,0,7,e_0,165,182,217,13,2,2,5,4,0,1,17,35,52
p_258,0,7,e_0,168,182,217,12,2,2,4,4,0,1,14,35,49
p_255,0,3,e_3,184,216,227,10,0,0,10,3,0,0,32,11,43
p_256,0,10,e_0,182,182,228,10,0,0,0,3,0,0,0,46,46
p_254,0,4,e_3,187,216,232,9,1,0,9,4,0,1,29,16,45
p_264,0,11,e_0,153,182,233,17,3,3,9,4,0,1,29,51,80
p_253,0,5,e_3,190,216,237,8,1,0,8,4,0,1,26,21,47
p_252,0,5,e_3,205,216,237,4,1,0,4,4,0,1,11,21,32
p_257,0,14,e_0,169,182,244,12,2,2,4,4,0,1,13,62,75
p_259,0,15,e_0,167,182,249,13,2,2,5,4,0,1,15,67,82
p_251,0,15,e_3,209,216,269,2,1,0,2,4,0,1,7,53,60
p_250,0,2,e_1,217,262,270,30,4,4,14,3,0,0,45,8,53
p_248,0,5,e_1,246,262,281,22,1,1,5,4,0,1,16,19,35
p_247,0,5,e_1,250,262,281,21,1,1,4,4,0,1,12,19,31
p_249,0,6,e_1,239,262,286,25,1,1,8,4,0,1,23,24,47
p_241,0,1,e_2,283,306,311,15,0,0,7,4,0,1,23,5,28
p_236,0,1,e_2,305,306,311,15,0,0,0,4,0,1,1,5,6
p_245,0,7,e_2,269,306,331,15,0,0,12,4,0,1,37,25,62
p_237,0,7,e_2,304,306,331,15,0,0,1,4,0,1,2,25,27
p_233,0,1,e_1,311,328,333,15,0,0,5,4,0,1,17,5,22
p_242,0,8,e_2,277,306,336,15,0,0,10,4,0,1,29,30,59
p_240,0,9,e_2,301,306,341,15,0,0,1,4,0,1,5,35,40
p_230,0,3,e_1,319,328,341,15,0,0,3,4,0,1,9,13,22
p_228,0,4,e_1,325,328,346,15,0,0,1,4,0,1,3,18,21
p_246,0,10,e_2,262,306,346,17,1,1,14,3,0,0,44,40,84
p_239,0,11,e_2,302,306,351,15,0,0,1,4,0,1,4,45,49
p_232,0,5,e_1,314,328,351,15,0,0,4,4,0,1,14,23,37
p_244,0,12,e_2,271,306,356,15,0,0,12,4,0,1,35,50,85
p_231,0,7,e_1,317,328,359,15,0,0,4,4,0,1,11,31,42
p_238,0,13,e_2,303,306,361,15,0,0,1,4,0,1,3,55,58
p_235,0,8,e_1,308,328,364,15,0,0,6,3,0,0,20,36,56
p_234,0,8,e_1,310,328,364,15,0,0,6,4,0,1,18,36,54
p_243,0,15,e_2,272,306,369,15,0,0,11,4,0,1,34,63,97
p_227,0,12,e_1,327,328,378,15,0,0,0,4,0,1,1,50,51
p_216,0,1,e_0,347,376,383,10,1,0,9,4,0,1,29,7,36
p_229,0,13,e_1,320,328,383,15,0,0,3,4,0,1,8,55,63
p_226,0,2,e_0,329,376,388,15,0,0,15,3,0,0,47,12,59
p_223,0,2,e_0,336,376,388,14,1,0,13,4,0,1,40,12,52
p_214,0,3,e_0,349,376,393,10,1,0,9,4,0,1,27,17,44
p_225,0,5,e_3,330,378,395,15,0,0,15,3,0,0,48,17,65
p_224,0,5,e_0,331,376,401,15,1,1,15,4,0,1,45,25,70
p_222,0,5,e_0,337,376,401,13,1,0,13,4,0,1,39,25,64
p_219,0,5,e_0,342,376,401,12,1,0,11,4,0,1,34,25,59
p_221,0,6,e_0,339,376,406,13,1,0,12,4,0,1,37,30,67
p_220,0,6,e_0,341,376,406,12,1,0,11,4,0,1,35,30,65
p_217,0,7,e_0,346,376,411,11,1,0,10,4,0,1,30,35,65
p_212,0,7,e_0,351,376,411,9,1,0,8,4,0,1,25,35,60
p_191,0,10,e_3,376,378,412,0,1,0,0,4,0,1,2,34,36
p_218,0,11,e_0,343,376,425,12,1,0,11,4,0,1,33,49,82
p_183,0,1,e_1,396,424,429,15,1,1,9,4,0,1,28,5,33
p_190,0,1,e_2,379,426,433,20,2,2,15,3,0,0,47,7,54
p_182,0,2,e_1,397,424,434,15,1,1,9,4,0,1,27,10,37
p_180,0,2,e_1,399,424,434,14,1,1,8,4,0,1,25,10,35
p_178,0,3,e_1,401,424,439,14,1,1,7,4,0,1,23,15,38
p_215,0,15,e_0,348,376,439,10,1,0,9,4,0,1,28,63,91
p_213,0,15,e_0,350,376,439,9,1,0,8,4,0,1,26,63,89
p_211,0,15,e_0,353,376,439,8,1,0,7,4,0,1,23,63,86
p_186,0,4,e_1,390,424,444,16,2,2,11,4,0,1,34,20,54
p_176,0,4,e_1,403,424,444,13,1,1,7,4,0,1,21,20,41
p_189,0,8,e_1,382,424,458,19,2,2,13,2,1,0,42,34,76
p_179,0,8,e_1,400,424,458,14,1,1,8,4,0,1,24,34,58
p_177,0,9,e_1,402,424,463,13,1,1,7,4,0,1,22,39,61
p_158,0,1,e_3,430,461,466,10,1,0,10,4,0,1,31,5,36
p_146,0,1,e_3,453,461,466,2,1,0,2,4,0,1,8,5,13
p_185,0,10,e_1,391,424,468,16,2,2,11,4,0,1,33,44,77
p_187,0,12,e_1,389,424,476,17,2,2,11,4,0,1,35,52,87
p_184,0,12,e_1,392,424,476,16,2,2,11,4,0,1,32,52,84
p_160,0,15,e_2,426,426,477,10,0,0,0,3,0,0,0,51,51
p_188,0,13,e_1,384,424,481,19,2,2,13,4,0,1,40,57,97
p_159,0,6,e_3,429,461,483,10,0,0,10,3,0,0,32,22,54
p_150,0,6,e_3,443,461,483,6,1,0,6,4,0,1,18,22,40
p_175,0,14,e_1,405,424,486,12,1,1,6,4,0,1,19,62,81
p_154,0,7,e_3,436,461,488,8,1,0,8,4,0,1,25,27,52
p_181,0,15,e_1,398,424,491,14,1,1,9,4,0,1,26,67,93
p_148,0,8,e_3,449,461,493,4,1,0,4,4,0,1,12,32,44
p_209,0,2,e_0,357,486,496,7,1,0,6,4,0,1,129,10,139
p_205,0,2,e_0,362,486,496,5,1,0,4,4,0,1,124,10,134
p_153,0,9,e_3,437,461,498,8,1,0,8,4,0,1,24,37,61
p_147,0,9,e_3,452,461,498,3,1,0,3,4,0,1,9,37,46
p_200,0,4,e_0,367,486,504,4,1,0,3,4,0,1,119,18,137
p_196,0,4,e_0,371,486,504,2,1,0,1,4,0,1,115,18,133
p_145,0,11,e_3,454,461,506,2,1,0,2,4,0,1,7,45,52
p_201,0,5,e_0,366,486,509,4,1,0,3,4,0,1,120,23,143
p_210,0,6,e_0,354,486,514,8,1,0,7,4,0,1,132,28,160
p_208,0,6,e_0,358,486,514,7,1,0,6,4,0,1,128,28,156
p_157,0,14,e_3,431,461,517,10,1,0,10,4,0,1,30,56,86
p_155,0,14,e_3,435,461,517,8,1,0,8,4,0,1,26,56,82
p_156,0,15,e_3,434,461,522,9,1,0,9,4,0,1,27,61,88
p_152,0,15,e_3,441,461,522,6,1,0,6,4,0,1,20,61,81
p_151,0,15,e_3,442,461,522,6,1,0,6,4,0,1,19,61,80
p_149,0,15,e_3,444,461,522,5,1,0,5,4,0,1,17,61,78
p_198,0,9,e_0,369,486,525,3,1,0,2,4,0,1,117,39,156
p_197,0,10,e_0,370,486,530,2,1,0,2,4,0,1,116,44,160
p_207,0,11,e_0,359,486,535,6,1,0,5,4,0,1,127,49,176
p_206,0,12,e_0,361,486,540,5,1,0,5,4,0,1,125,54,179
p_203,0,12,e_0,364,486,540,4,1,0,4,4,0,1,122,54,176
p_113,0,1,e_2,489,535,540,23,6,6,15,4,0,1,46,5,51
p_167,0,1,e_1,413,538,545,10,0,0,3,4,0,1,125,7,132
p_161,0,1,e_1,421,538,545,10,0,0,1,4,0,1,117,7,124
p_114,0,3,e_2,488,535,548,23,6,6,15,4,0,1,47,13,60
p_204,0,14,e_0,363,486,548,5,1,0,4,4,0,1,123,62,185
p_202,0,15,e_0,365,486,553,4,1,0,4,4,0,1,121,67,188
p_199,0,15,e_0,368,486,553,3,1,0,2,4,0,1,118,67,185
p_165,0,4,e_1,417,538,556,10,0,0,2,4,0,1,121,18,139
p_108,0,6,e_2,496,535,559,21,5,5,13,4,0,1,39,24,63
p_99,0,6,e_2,514,535,559,17,3,3,7,4,0,1,21,24,45
p_102,0,7,e_2,509,535,564,19,3,3,9,4,0,1,26,29,55
p_101,0,8,e_2,511,535,569,18,3,3,8,4,0,1,24,34,58
p_111,0,8,e_1,491,538,570,23,6,6,15,4,0,1,47,32,79
p_115,0,9,e_2,487,535,574,23,6,6,15,3,0,0,48,39,87
p_100,0,9,e_2,513,535,574,17,3,3,7,4,0,1,22,39,61
p_169,0,9,e_1,411,538,575,10,1,1,4,4,0,1,127,37,164
p_86,0,2,e_3,544,569,577,8,1,0,8,4,0,1,25,8,33
p_163,0,10,e_1,419,538,580,10,0,0,2,4,0,1,119,42,161
p_143,0,3,e_3,456,569,582,2,1,0,2,4,0,1,113,13,126
p_112,0,11,e_2,490,535,582,23,6,6,15,4,0,1,45,47,92
p_110,0,11,e_2,492,535,582,22,6,6,14,4,0,1,43,47,90
p_107,0,11,e_2,499,535,582,21,4,4,12,4,0,1,36,47,83
p_103,0,11,e_2,508,535,582,19,3,3,9,4,0,1,27,47,74
p_173,0,11,e_1,407,538,585,11,1,1,5,4,0,1,131,47,178
p_164,0,11,e_1,418,538,585,10,0,0,2,4,0,1,120,47,167
p_162,0,11,e_1,420,538,585,10,0,0,1,4,0,1,118,47,165
p_105,0,12,e_2,502,535,587,20,4,4,11,4,0,1,33,52,85
p_166,0,12,e_1,416,538,590,10,0,0,2,4,0,1,122,52,174
p_141,0,6,e_3,458,569,593,1,1,0,1,4,0,1,111,24,135
p_104,0,14,e_2,503,535,595,20,4,4,11,4,0,1,32,60,92
p_171,0,13,e_1,409,538,595,11,1,1,5,4,0,1,129,57,186
p_168,0,13,e_1,412,538,595,10,0,0,4,4,0,1,126,57,183
p_80,0,7,e_3,552,569,598,5,1,0,5,4,0,1,17,29,46
p_109,0,15,e_2,493,535,600,22,5,5,14,4,0,1,42,65,107
p_174,0,14,e_1,406,538,600,12,1,1,6,4,0,1,132,62,194
p_170,0,14,e_1,410,538,600,11,1,1,4,4,0,1,128,62,190
p_140,0,8,e_3,459,569,603,1,1,0,1,4,0,1,110,34,144
p_87,0,8,e_3,539,569,603,10,1,0,10,4,0,1,30,34,64
p_83,0,8,e_3,549,569,603,7,1,0,7,4,0,1,20,34,54
p_172,0,15,e_1,408,538,605,11,1,1,5,4,0,1,130,67,197
p_130,0,1,e_0,472,600,607,27,8,8,4,4,0,1,128,7,135
p_144,0,9,e_3,455,569,608,2,1,0,2,4,0,1,114,39,153
p_142,0,9,e_3,457,569,608,1,1,0,1,4,0,1,112,39,151
p_136,0,3,e_0,465,600,615,29,9,9,7,4,0,1,135,15,150
p_129,0,3,e_0,473,600,615,27,8,8,4,4,0,1,127,15,142
p_84,0,12,e_3,546,569,619,8,1,0,8,4,0,1,23,50,73
p_78,0,12,e_3,556,569,619,4,1,0,4,4,0,1,13,50,63
p_137,0,4,e_0,464,600,620,30,8,8,7,4,0,1,136,20,156
p_82,0,14,e_3,550,569,627,6,1,0,6,4,0,1,19,58,77
p_81,0,14,e_3,551,569,627,6,1,0,6,4,0,1,18,58,76
p_79,0,14,e_3,553,569,627,5,1,0,5,4,0,1,16,58,74
p_194,0,6,e_0,373,600,628,1,1,0,1,4,0,1,227,28,255
p_85,0,15,e_3,545,569,632,8,1,0,8,4,0,1,24,63,87
p_192,0,8,e_0,375,600,636,1,1,0,0,3,0,0,225,36,261
p_139,0,10,e_0,461,600,644,30,8,8,8,4,0,1,139,44,183
p_135,0,10,e_0,466,600,644,29,8,8,6,4,0,1,134,44,178
p_193,0,11,e_0,374,600,649,1,1,0,0,4,0,1,226,49,275
p_138,0,11,e_0,463,600,649,30,8,8,8,4,0,1,137,49,186
p_132,0,11,e_0,470,600,649,28,8,8,5,4,0,1,130,49,179
p_96,0,1,e_2,517,647,652,16,2,2,6,4,0,1,130,5,135
p_133,0,12,e_0,469,600,654,28,8,8,5,4,0,1,131,54,185
p_131,0,14,e_0,471,600,662,28,8,8,5,4,0,1,129,62,191
p_92,0,4,e_2,525,647,663,14,1,0,3,4,0,1,122,16,138
p_106,0,3,e_1,500,652,663,21,4,4,12,4,0,1,152,11,163
p_195,0,15,e_0,372,600,667,2,1,0,1,4,0,1,228,67,295
p_134,0,15,e_0,467,600,667,29,8,8,6,4,0,1,133,67,200
p_88,0,5,e_1,538,652,671,10,1,0,0,3,0,0,114,19,133
p_94,0,6,e_2,519,647,671,16,2,2,5,4,0,1,128,24,152
p_32,0,6,e_1,650,652,676,9,1,0,0,4,0,1,2,24,26
p_98,0,7,e_2,515,647,676,16,3,3,6,4,0,1,132,29,161
p_97,0,7,e_2,516,647,676,16,3,3,6,4,0,1,131,29,160
p_37,0,9,e_2,615,647,684,19,4,4,10,4,0,1,32,37,69
p_35,0,9,e_2,630,647,684,16,2,2,6,4,0,1,17,37,54
p_89,0,9,e_1,535,652,687,11,1,0,1,4,0,1,117,35,152
p_77,0,3,e_3,557,679,690,4,1,0,4,4,0,1,122,11,133
p_72,0,3,e_3,562,679,690,2,1,0,2,4,0,1,117,11,128
p_71,0,3,e_3,564,679,690,2,1,0,2,4,0,1,115,11,126
p_70,0,3,e_3,565,679,690,1,1,0,1,4,0,1,114,11,125
p_67,0,3,e_3,568,679,690,0,1,0,0,4,0,1,111,11,122
p_30,0,3,e_3,668,679,690,3,1,0,3,4,0,1,11,11,22
p_91,0,12,e_2,526,647,695,14,1,0,3,4,0,1,121,48,169
p_39,0,12,e_2,607,647,695,21,5,5,13,4,0,1,40,48,88
p_34,0,12,e_2,646,647,695,11,1,0,0,4,0,1,1,48,49
p_75,0,5,e_3,559,679,698,3,1,0,3,4,0,1,120,19,139
p_29,0,5,e_3,670,679,698,3,1,0,3,4,0,1,9,19,28
p_93,0,13,e_2,520,647,700,16,2,2,5,4,0,1,127,53,180
p_40,0,13,e_2,602,647,700,22,6,6,15,4,0,1,45,53,98
p_38,0,13,e_2,608,647,700,21,4,4,13,4,0,1,39,53,92
p_36,0,13,e_2,628,647,700,16,2,2,6,4,0,1,19,53,72
p_90,0,13,e_1,527,652,701,14,1,0,3,4,0,1,125,49,174
p_76,0,6,e_3,558,679,703,4,1,0,4,4,0,1,121,24,145
p_31,0,6,e_3,666,679,703,4,1,0,4,4,0,1,13,24,37
p_95,0,14,e_1,518,652,706,16,2,2,6,4,0,1,134,54,188
p_74,0,7,e_3,560,679,708,3,1,0,3,4,0,1,119,29,148
p_33,0,15,e_1,649,652,711,10,1,0,1,4,0,1,3,59,62
p_119,0,1,e_0,483,714,719,24,7,7,1,4,0,1,231,5,236
p_65,0,1,e_0,573,714,719,29,10,10,9,4,0,1,141,5,146
p_73,0,11,e_3,561,679,722,3,1,0,3,4,0,1,118,43,161
p_28,0,11,e_3,676,679,722,1,1,0,1,4,0,1,3,43,46
p_66,0,3,e_0,569,714,727,30,9,9,10,4,0,1,145,13,158
p_68,0,13,e_3,567,679,730,1,1,0,1,4,0,1,112,51,163
p_69,0,14,e_3,566,679,735,1,1,0,1,4,0,1,113,56,169
p_124,0,7,e_0,478,714,741,26,8,8,3,4,0,1,236,27,263
p_118,0,7,e_0,484,714,741,24,7,7,0,4,0,1,230,27,257
p_127,0,10,e_0,475,714,752,27,8,8,4,4,0,1,239,38,277
p_117,0,10,e_0,485,714,752,24,7,7,0,3,0,0,229,38,267
p_116,0,10,e_0,486,714,752,24,7,7,0,3,0,1,228,38,266
p_128,0,11,e_0,474,714,757,27,8,8,4,4,0,1,240,43,283
p_123,0,11,e_0,479,714,757,25,8,8,2,4,0,1,235,43,278
p_121,0,11,e_0,481,714,757,25,8,8,2,4,0,1,233,43,276
p_120,0,11,e_0,482,714,757,24,7,7,1,4,0,1,232,43,275
p_126,0,12,e_0,476,714,762,26,8,8,3,4,0,1,238,48,286
p_125,0,14,e_0,477,714,770,26,8,8,3,4,0,1,237,56,293
p_22,0,3,e_2,719,760,771,18,4,4,13,3,0,0,41,11,52
p_122,0,15,e_0,480,714,775,25,8,8,2,4,0,1,234,61,295
p_21,0,4,e_2,731,760,776,15,2,2,9,4,0,1,29,16,45
p_19,0,11,e_2,754,760,799,8,1,0,2,4,0,1,6,39,45
p_20,0,14,e_2,734,760,810,14,2,2,8,4,0,1,26,50,76
p_27,0,10,e_3,677,779,811,1,1,0,1,4,0,1,102,32,134
p_18,0,10,e_3,766,779,811,4,1,0,4,4,0,1,13,32,45
p_17,0,10,e_3,776,779,811,1,1,0,1,4,0,1,3,32,35
p_55,0,3,e_0,585,822,833,27,8,8,5,4,0,1,237,11,248
p_54,0,3,e_0,586,822,833,26,8,8,5,4,0,1,236,11,247
p_52,0,3,e_0,588,822,833,25,8,8,4,4,0,1,234,11,245
p_16,0,2,e_1,780,828,836,20,1,1,15,3,0,0,48,8,56
p_64,0,4,e_0,574,822,838,29,10,10,9,4,0,1,248,16,264
p_61,0,6,e_0,579,822,846,28,9,9,7,4,0,1,243,24,267
p_56,0,6,e_0,584,822,846,27,8,8,5,4,0,1,238,24,262
p_50,0,7,e_0,590,822,851,25,8,8,3,4,0,1,232,29,261
p_53,0,9,e_0,587,822,859,26,8,8,4,4,0,1,235,37,272
p_51,0,9,e_0,589,822,859,25,8,8,4,4,0,1,233,37,270
p_60,0,10,e_0,580,822,864,28,9,9,7,4,0,1,242,42,284
p_58,0,11,e_0,582,822,869,27,8,8,6,4,0,1,240,47,287
p_57,0,11,e_0,583,822,869,27,8,8,6,4,0,1,239,47,286
p_10,0,8,e_1,835,844,870,10,0,0,2,2,1,0,9,26,35
p_63,0,13,e_0,577,822,877,28,9,9,8,4,0,1,245,55,300
p_62,0,13,e_0,578,822,877,28,9,9,7,4,0,1,244,55,299
p_59,0,14,e_0,581,822,882,27,9,9,6,4,0,1,241,60,301
p_9,0,2,e_3,846,878,888,10,0,0,10,3,0,0,32,10,42
p_6,0,3,e_3,877,878,893,0,0,0,0,3,0,0,1,15,16
p_7,0,5,e_3,875,878,901,1,1,0,1,4,0,1,3,23,26
p_4,0,1,e_1,886,910,915,20,4,4,8,4,0,1,24,5,29
p_8,0,11,e_3,874,878,921,1,1,0,1,4,0,1,4,43,47
p_1,0,5,e_1,894,910,929,19,2,2,5,4,0,1,16,19,35
p_45,0,2,e_0,595,926,934,24,7,7,1,4,0,1,331,8,339
p_24,0,2,e_0,695,926,934,24,7,7,6,4,0,1,231,8,239
p_5,0,8,e_1,883,910,940,21,4,4,8,3,0,0,27,30,57
p_3,0,8,e_1,888,910,940,20,3,3,7,4,0,1,22,30,52
p_48,0,4,e_0,592,926,942,24,8,8,3,4,0,1,334,16,350
p_46,0,4,e_0,594,926,942,24,7,7,2,4,0,1,332,16,348
p_14,0,4,e_0,794,926,942,16,1,1,9,4,0,1,132,16,148
p_42,0,6,e_0,598,926,950,23,6,6,0,4,0,1,328,24,352
p_2,0,11,e_1,892,910,951,19,2,2,6,4,0,1,18,41,59
p_43,0,7,e_0,597,926,955,23,6,6,1,4,0,1,329,29,358
p_44,0,8,e_0,596,926,960,23,7,7,1,4,0,1,330,34,364
p_26,0,8,e_0,684,926,960,27,8,8,10,4,0,1,242,34,276
p_25,0,8,e_0,686,926,960,26,8,8,9,4,0,1,240,34,274
p_47,0,9,e_0,593,926,965,24,7,7,2,4,0,1,333,39,372
p_15,0,9,e_0,793,926,965,16,1,1,10,4,0,1,133,39,172
p_41,0,11,e_0,600,926,973,23,6,6,0,3,0,0,326,47,373
p_23,0,12,e_0,711,926,978,21,4,4,1,4,0,1,215,52,267
p_49,0,14,e_0,591,926,986,24,8,8,3,4,0,1,335,60,395
p_11,0,9,e_0,807,1030,1059,11,1,1,5,4,0,1,223,29,252
p_13,0,11,e_0,796,1030,1067,15,1,1,9,4,0,1,234,37,271
p_12,0,11,e_0,798,1030,1067,14,1,1,8,4,0,1,232,37,269
